,5 Minutes,Lane 1 Flow (Veh/5 Minutes),Lane 2 Flow (Veh/5 Minutes),Lane 3 Flow (Veh/5 Minutes),Flow (Veh/5 Minutes),# Lane Points,% Observed
0,3/01/2018 0:00,40,53,30,123,3,66.7
1,3/01/2018 0:05,38,49,28,115,3,66.7
2,3/01/2018 0:10,52,58,28,138,3,66.7
3,3/01/2018 0:15,43,61,40,144,3,66.7
4,3/01/2018 0:20,47,54,31,132,3,66.7
5,3/01/2018 0:25,43,55,32,130,3,66.7
6,3/01/2018 0:30,34,56,17,107,3,66.7
7,3/01/2018 0:35,43,57,31,131,3,66.7
8,3/01/2018 0:40,39,62,33,134,3,66.7
9,3/01/2018 0:45,38,43,21,102,3,66.7
10,3/01/2018 0:50,35,53,26,114,3,66.7
11,3/01/2018 0:55,28,32,21,81,3,66.7
12,3/01/2018 1:00,34,39,22,95,3,66.7
13,3/01/2018 1:05,34,51,22,107,3,66.7
14,3/01/2018 1:10,25,41,16,82,3,66.7
15,3/01/2018 1:15,29,37,21,87,3,66.7
16,3/01/2018 1:20,36,42,23,101,3,66.7
17,3/01/2018 1:25,33,38,24,95,3,66.7
18,3/01/2018 1:30,27,36,18,81,3,66.7
19,3/01/2018 1:35,29,32,18,79,3,66.7
20,3/01/2018 1:40,32,32,19,83,3,66.7
21,3/01/2018 1:45,29,36,14,79,3,66.7
22,3/01/2018 1:50,24,32,13,69,3,66.7
23,3/01/2018 1:55,25,31,13,69,3,66.7
24,3/01/2018 2:00,30,28,15,73,3,66.7
25,3/01/2018 2:05,32,20,18,70,3,66.7
26,3/01/2018 2:10,26,30,17,73,3,66.7
27,3/01/2018 2:15,25,32,15,72,3,66.7
28,3/01/2018 2:20,26,40,18,84,3,66.7
29,3/01/2018 2:25,26,34,14,74,3,66.7
30,3/01/2018 2:30,18,22,8,48,3,66.7
31,3/01/2018 2:35,28,24,18,70,3,66.7
32,3/01/2018 2:40,30,32,26,88,3,66.7
33,3/01/2018 2:45,25,27,14,66,3,66.7
34,3/01/2018 2:50,24,32,15,71,3,66.7
35,3/01/2018 2:55,18,18,7,43,3,66.7
36,3/01/2018 3:00,30,28,18,76,3,66.7
37,3/01/2018 3:05,26,25,14,65,3,66.7
38,3/01/2018 3:10,25,22,12,59,3,66.7
39,3/01/2018 3:15,18,19,11,48,3,66.7
40,3/01/2018 3:20,20,21,8,49,3,66.7
41,3/01/2018 3:25,19,17,10,46,3,66.7
42,3/01/2018 3:30,27,32,11,70,3,66.7
43,3/01/2018 3:35,24,27,19,70,3,66.7
44,3/01/2018 3:40,31,30,16,77,3,66.7
45,3/01/2018 3:45,28,23,11,62,3,66.7
46,3/01/2018 3:50,20,18,9,47,3,66.7
47,3/01/2018 3:55,22,22,14,58,3,66.7
48,3/01/2018 4:00,23,19,10,52,3,66.7
49,3/01/2018 4:05,30,31,20,81,3,66.7
50,3/01/2018 4:10,25,29,14,68,3,66.7
51,3/01/2018 4:15,28,33,17,78,3,66.7
52,3/01/2018 4:20,26,30,18,74,3,66.7
53,3/01/2018 4:25,20,36,10,66,3,66.7
54,3/01/2018 4:30,39,44,20,103,3,66.7
55,3/01/2018 4:35,28,37,22,87,3,66.7
56,3/01/2018 4:40,30,40,20,90,3,66.7
57,3/01/2018 4:45,30,36,12,78,3,66.7
58,3/01/2018 4:50,48,55,47,150,3,0.0
59,3/01/2018 4:55,49,56,49,154,3,0.0
60,3/01/2018 5:00,36,10,30,76,3,66.7
61,3/01/2018 5:05,36,45,19,100,3,66.7
62,3/01/2018 5:10,46,65,30,141,3,66.7
63,3/01/2018 5:15,51,58,50,159,3,0.0
64,3/01/2018 5:20,56,63,55,174,3,0.0
65,3/01/2018 5:25,56,62,54,172,3,0.0
66,3/01/2018 5:30,62,67,59,188,3,0.0
67,3/01/2018 5:35,64,70,61,195,3,0.0
68,3/01/2018 5:40,67,72,63,202,3,0.0
69,3/01/2018 5:45,70,75,65,210,3,0.0
70,3/01/2018 5:50,70,75,65,210,3,0.0
71,3/01/2018 5:55,67,72,63,202,3,0.0
72,3/01/2018 6:00,60,66,57,183,3,0.0
73,3/01/2018 6:05,57,60,60,177,3,66.7
74,3/01/2018 6:10,51,66,43,160,3,66.7
75,3/01/2018 6:15,73,77,68,218,3,0.0
76,3/01/2018 6:20,63,69,60,192,3,0.0
77,3/01/2018 6:25,71,76,67,214,3,0.0
78,3/01/2018 6:30,75,80,70,225,3,0.0
79,3/01/2018 6:35,72,87,45,204,3,66.7
80,3/01/2018 6:40,70,94,51,215,3,66.7
81,3/01/2018 6:45,71,97,50,218,3,66.7
82,3/01/2018 6:50,74,81,54,209,3,66.7
83,3/01/2018 6:55,68,88,54,210,3,66.7
84,3/01/2018 7:00,69,99,63,231,3,66.7
85,3/01/2018 7:05,74,107,65,246,3,66.7
86,3/01/2018 7:10,74,94,62,230,3,66.7
87,3/01/2018 7:15,84,101,65,250,3,66.7
88,3/01/2018 7:20,86,108,82,276,3,66.7
89,3/01/2018 7:25,75,125,59,259,3,66.7
90,3/01/2018 7:30,86,100,83,269,3,66.7
91,3/01/2018 7:35,79,106,68,253,3,66.7
92,3/01/2018 7:40,63,84,63,210,3,66.7
93,3/01/2018 7:45,78,111,63,252,3,66.7
94,3/01/2018 7:50,72,96,53,221,3,66.7
95,3/01/2018 7:55,74,98,69,241,3,66.7
96,3/01/2018 8:00,76,106,76,258,3,66.7
97,3/01/2018 8:05,79,105,67,251,3,66.7
98,3/01/2018 8:10,85,104,64,253,3,66.7
99,3/01/2018 8:15,84,112,56,252,3,66.7
100,3/01/2018 8:20,85,86,71,242,3,66.7
101,3/01/2018 8:25,90,112,58,260,3,66.7
102,3/01/2018 8:30,65,74,48,187,3,66.7
103,3/01/2018 8:35,88,111,64,263,3,66.7
104,3/01/2018 8:40,80,107,61,248,3,66.7
105,3/01/2018 8:45,70,96,59,225,3,66.7
106,3/01/2018 8:50,86,99,58,243,3,66.7
107,3/01/2018 8:55,77,88,58,223,3,66.7
108,3/01/2018 9:00,78,91,60,229,3,66.7
109,3/01/2018 9:05,70,94,64,228,3,66.7
110,3/01/2018 9:10,73,95,52,220,3,66.7
111,3/01/2018 9:15,68,84,55,207,3,66.7
112,3/01/2018 9:20,66,90,48,204,3,66.7
113,3/01/2018 9:25,75,84,63,222,3,66.7
114,3/01/2018 9:30,75,99,63,237,3,66.7
115,3/01/2018 9:35,71,98,61,230,3,66.7
116,3/01/2018 9:40,81,89,57,227,3,66.7
117,3/01/2018 9:45,73,93,53,219,3,66.7
118,3/01/2018 9:50,75,91,55,221,3,66.7
119,3/01/2018 9:55,70,86,51,207,3,66.7
120,3/01/2018 10:00,79,98,66,243,3,66.7
121,3/01/2018 10:05,76,100,57,233,3,66.7
122,3/01/2018 10:10,75,81,69,225,3,66.7
123,3/01/2018 10:15,75,91,58,224,3,66.7
124,3/01/2018 10:20,74,98,64,236,3,66.7
125,3/01/2018 10:25,75,95,64,234,3,66.7
126,3/01/2018 10:30,73,100,50,223,3,66.7
127,3/01/2018 10:35,76,82,56,214,3,66.7
128,3/01/2018 10:40,78,86,59,223,3,66.7
129,3/01/2018 10:45,76,100,60,236,3,66.7
130,3/01/2018 10:50,63,91,54,208,3,66.7
131,3/01/2018 10:55,73,91,59,223,3,66.7
132,3/01/2018 11:00,75,101,63,239,3,66.7
133,3/01/2018 11:05,71,92,54,217,3,66.7
134,3/01/2018 11:10,82,92,59,233,3,66.7
135,3/01/2018 11:15,73,101,64,238,3,66.7
136,3/01/2018 11:20,79,103,61,243,3,66.7
137,3/01/2018 11:25,85,90,55,230,3,66.7
138,3/01/2018 11:30,86,95,57,238,3,66.7
139,3/01/2018 11:35,86,98,53,237,3,66.7
140,3/01/2018 11:40,90,103,72,265,3,66.7
141,3/01/2018 11:45,75,104,58,237,3,66.7
142,3/01/2018 11:50,79,94,73,246,3,66.7
143,3/01/2018 11:55,69,87,52,208,3,66.7
144,3/01/2018 12:00,69,87,64,220,3,66.7
145,3/01/2018 12:05,79,93,60,232,3,66.7
146,3/01/2018 12:10,83,94,58,235,3,66.7
147,3/01/2018 12:15,87,95,71,253,3,66.7
148,3/01/2018 12:20,81,91,57,229,3,66.7
149,3/01/2018 12:25,84,100,56,240,3,66.7
150,3/01/2018 12:30,70,94,53,217,3,66.7
151,3/01/2018 12:35,87,95,70,252,3,66.7
152,3/01/2018 12:40,84,78,58,220,3,66.7
153,3/01/2018 12:45,81,97,57,235,3,66.7
154,3/01/2018 12:50,89,96,77,262,3,66.7
155,3/01/2018 12:55,90,94,76,260,3,66.7
156,3/01/2018 13:00,71,91,65,227,3,66.7
157,3/01/2018 13:05,83,87,68,238,3,66.7
158,3/01/2018 13:10,80,93,61,234,3,66.7
159,3/01/2018 13:15,79,98,61,238,3,66.7
160,3/01/2018 13:20,81,93,57,231,3,66.7
161,3/01/2018 13:25,84,98,68,250,3,66.7
162,3/01/2018 13:30,71,109,60,240,3,66.7
163,3/01/2018 13:35,66,103,58,227,3,66.7
164,3/01/2018 13:40,91,107,78,276,3,66.7
165,3/01/2018 13:45,90,101,72,263,3,66.7
166,3/01/2018 13:50,93,109,69,271,3,66.7
167,3/01/2018 13:55,84,95,77,256,3,66.7
168,3/01/2018 14:00,81,98,84,263,3,66.7
169,3/01/2018 14:05,87,83,68,238,3,66.7
170,3/01/2018 14:10,98,84,78,260,3,66.7
171,3/01/2018 14:15,78,102,78,258,3,66.7
172,3/01/2018 14:20,76,88,67,231,3,66.7
173,3/01/2018 14:25,86,88,64,238,3,66.7
174,3/01/2018 14:30,76,98,61,235,3,66.7
175,3/01/2018 14:35,88,91,49,228,3,66.7
176,3/01/2018 14:40,82,84,63,229,3,66.7
177,3/01/2018 14:45,84,71,68,223,3,66.7
178,3/01/2018 14:50,68,68,71,207,3,66.7
179,3/01/2018 14:55,81,75,71,227,3,66.7
180,3/01/2018 15:00,95,79,74,248,3,66.7
181,3/01/2018 15:05,99,58,47,204,3,66.7
182,3/01/2018 15:10,88,68,70,226,3,66.7
183,3/01/2018 15:15,96,63,64,223,3,66.7
184,3/01/2018 15:20,101,71,62,234,3,66.7
185,3/01/2018 15:25,99,72,73,244,3,66.7
186,3/01/2018 15:30,98,69,81,248,3,66.7
187,3/01/2018 15:35,100,76,76,252,3,66.7
188,3/01/2018 15:40,92,82,83,257,3,66.7
189,3/01/2018 15:45,90,49,52,191,3,66.7
190,3/01/2018 15:50,87,58,52,197,3,66.7
191,3/01/2018 15:55,96,67,57,220,3,66.7
192,3/01/2018 16:00,96,55,56,207,3,66.7
193,3/01/2018 16:05,100,74,69,243,3,66.7
194,3/01/2018 16:10,97,58,65,220,3,66.7
195,3/01/2018 16:15,105,55,69,229,3,66.7
196,3/01/2018 16:20,88,56,65,209,3,66.7
197,3/01/2018 16:25,90,55,39,184,3,66.7
198,3/01/2018 16:30,93,48,63,204,3,66.7
199,3/01/2018 16:35,84,44,31,159,3,66.7
200,3/01/2018 16:40,100,53,43,196,3,66.7
201,3/01/2018 16:45,92,70,74,236,3,66.7
202,3/01/2018 16:50,96,85,72,253,3,66.7
203,3/01/2018 16:55,97,71,56,224,3,66.7
204,3/01/2018 17:00,88,71,50,209,3,66.7
205,3/01/2018 17:05,92,53,57,202,3,66.7
206,3/01/2018 17:10,93,61,53,207,3,66.7
207,3/01/2018 17:15,92,70,57,219,3,66.7
208,3/01/2018 17:20,99,61,47,207,3,66.7
209,3/01/2018 17:25,97,51,43,191,3,66.7
210,3/01/2018 17:30,93,64,61,218,3,66.7
211,3/01/2018 17:35,101,51,51,203,3,66.7
212,3/01/2018 17:40,91,58,56,205,3,66.7
213,3/01/2018 17:45,81,55,45,181,3,66.7
214,3/01/2018 17:50,87,59,50,196,3,66.7
215,3/01/2018 17:55,98,53,48,199,3,66.7
216,3/01/2018 18:00,89,69,69,227,3,66.7
217,3/01/2018 18:05,85,59,56,200,3,66.7
218,3/01/2018 18:10,80,59,73,212,3,66.7
219,3/01/2018 18:15,85,59,49,193,3,66.7
220,3/01/2018 18:20,76,66,66,208,3,66.7
221,3/01/2018 18:25,94,56,44,194,3,66.7
222,3/01/2018 18:30,93,65,57,215,3,66.7
223,3/01/2018 18:35,88,56,50,194,3,66.7
224,3/01/2018 18:40,88,68,59,215,3,66.7
225,3/01/2018 18:45,78,69,59,206,3,66.7
226,3/01/2018 18:50,75,68,57,200,3,66.7
227,3/01/2018 18:55,79,75,76,230,3,66.7
228,3/01/2018 19:00,82,76,60,218,3,66.7
229,3/01/2018 19:05,66,91,49,206,3,66.7
230,3/01/2018 19:10,96,77,57,230,3,66.7
231,3/01/2018 19:15,81,83,52,216,3,66.7
232,3/01/2018 19:20,78,87,48,213,3,66.7
233,3/01/2018 19:25,79,74,48,201,3,66.7
234,3/01/2018 19:30,86,90,67,243,3,66.7
235,3/01/2018 19:35,95,103,67,265,3,66.7
236,3/01/2018 19:40,79,92,58,229,3,66.7
237,3/01/2018 19:45,92,103,65,260,3,66.7
238,3/01/2018 19:50,86,101,64,251,3,66.7
239,3/01/2018 19:55,81,97,60,238,3,66.7
240,3/01/2018 20:00,87,95,68,250,3,66.7
241,3/01/2018 20:05,84,100,67,251,3,66.7
242,3/01/2018 20:10,88,95,64,247,3,66.7
243,3/01/2018 20:15,90,99,59,248,3,66.7
244,3/01/2018 20:20,77,100,67,244,3,0.0
245,3/01/2018 20:25,77,104,68,249,3,0.0
246,3/01/2018 20:30,74,103,72,249,3,0.0
247,3/01/2018 20:35,72,96,66,234,3,0.0
248,3/01/2018 20:40,71,97,62,230,3,0.0
249,3/01/2018 20:45,70,102,62,234,3,0.0
250,3/01/2018 20:50,79,102,68,249,3,66.7
251,3/01/2018 20:55,72,106,70,248,3,66.7
252,3/01/2018 21:00,75,98,66,239,3,66.7
253,3/01/2018 21:05,80,89,55,224,3,66.7
254,3/01/2018 21:10,69,97,61,227,3,66.7
255,3/01/2018 21:15,74,94,60,228,3,66.7
256,3/01/2018 21:20,76,95,63,234,3,66.7
257,3/01/2018 21:25,72,106,75,253,3,66.7
258,3/01/2018 21:30,70,101,68,239,3,0.0
259,3/01/2018 21:35,72,85,60,217,3,66.7
260,3/01/2018 21:40,75,95,56,226,3,66.7
261,3/01/2018 21:45,74,96,67,237,3,66.7
262,3/01/2018 21:50,75,89,63,227,3,66.7
263,3/01/2018 21:55,76,105,64,245,3,66.7
264,3/01/2018 22:00,59,102,59,220,3,66.7
265,3/01/2018 22:05,72,97,57,226,3,66.7
266,3/01/2018 22:10,76,102,63,241,3,66.7
267,3/01/2018 22:15,78,103,60,241,3,66.7
268,3/01/2018 22:20,68,91,64,223,3,66.7
269,3/01/2018 22:25,69,91,58,218,3,66.7
270,3/01/2018 22:30,67,98,62,227,3,66.7
271,3/01/2018 22:35,62,85,60,207,3,66.7
272,3/01/2018 22:40,69,71,47,187,3,66.7
273,3/01/2018 22:45,65,82,54,201,3,66.7
274,3/01/2018 22:50,54,92,52,198,3,66.7
275,3/01/2018 22:55,61,87,53,201,3,66.7
276,3/01/2018 23:00,61,82,40,183,3,66.7
277,3/01/2018 23:05,63,75,51,189,3,66.7
278,3/01/2018 23:10,57,84,60,201,3,66.7
279,3/01/2018 23:15,55,67,37,159,3,66.7
280,3/01/2018 23:20,49,70,47,166,3,66.7
281,3/01/2018 23:25,52,73,39,164,3,66.7
282,3/01/2018 23:30,60,71,40,171,3,66.7
283,3/01/2018 23:35,58,59,41,158,3,66.7
284,3/01/2018 23:40,48,73,37,158,3,66.7
285,3/01/2018 23:45,44,61,37,142,3,66.7
286,3/01/2018 23:50,57,72,40,169,3,66.7
287,3/01/2018 23:55,45,70,30,145,3,66.7
288,3/02/2018 0:00,43,66,28,137,3,66.7
289,3/02/2018 0:05,46,69,40,155,3,66.7
290,3/02/2018 0:10,47,82,37,166,3,66.7
291,3/02/2018 0:15,37,64,29,130,3,66.7
292,3/02/2018 0:20,50,57,31,138,3,66.7
293,3/02/2018 0:25,47,60,27,134,3,66.7
294,3/02/2018 0:30,39,73,31,143,3,66.7
295,3/02/2018 0:35,37,51,28,116,3,66.7
296,3/02/2018 0:40,41,59,32,132,3,66.7
297,3/02/2018 0:45,44,47,40,131,3,66.7
298,3/02/2018 0:50,40,51,33,124,3,66.7
299,3/02/2018 0:55,37,42,22,101,3,66.7
300,3/02/2018 1:00,31,45,20,96,3,66.7
301,3/02/2018 1:05,28,44,15,87,3,66.7
302,3/02/2018 1:10,35,48,26,109,3,66.7
303,3/02/2018 1:15,33,42,22,97,3,66.7
304,3/02/2018 1:20,36,41,18,95,3,66.7
305,3/02/2018 1:25,26,39,24,89,3,66.7
306,3/02/2018 1:30,28,23,19,70,3,66.7
307,3/02/2018 1:35,33,44,22,99,3,66.7
308,3/02/2018 1:40,40,54,27,121,3,66.7
309,3/02/2018 1:45,33,38,27,98,3,66.7
310,3/02/2018 1:50,33,38,23,94,3,66.7
311,3/02/2018 1:55,25,34,13,72,3,66.7
312,3/02/2018 2:00,23,32,11,66,3,66.7
313,3/02/2018 2:05,28,30,15,73,3,66.7
314,3/02/2018 2:10,29,39,17,85,3,66.7
315,3/02/2018 2:15,21,23,11,55,3,66.7
316,3/02/2018 2:20,29,30,19,78,3,66.7
317,3/02/2018 2:25,34,40,21,95,3,66.7
318,3/02/2018 2:30,26,23,12,61,3,66.7
319,3/02/2018 2:35,21,26,14,61,3,66.7
320,3/02/2018 2:40,20,36,14,70,3,66.7
321,3/02/2018 2:45,28,36,21,85,3,66.7
322,3/02/2018 2:50,24,32,8,64,3,66.7
323,3/02/2018 2:55,18,24,10,52,3,66.7
324,3/02/2018 3:00,27,30,12,69,3,66.7
325,3/02/2018 3:05,25,25,17,67,3,66.7
326,3/02/2018 3:10,21,23,9,53,3,66.7
327,3/02/2018 3:15,29,25,3,57,3,66.7
328,3/02/2018 3:20,16,18,6,40,3,66.7
329,3/02/2018 3:25,16,14,7,37,3,66.7
330,3/02/2018 3:30,24,24,11,59,3,66.7
331,3/02/2018 3:35,25,23,11,59,3,66.7
332,3/02/2018 3:40,22,25,19,66,3,66.7
333,3/02/2018 3:45,22,19,11,52,3,66.7
334,3/02/2018 3:50,19,24,12,55,3,66.7
335,3/02/2018 3:55,24,25,8,57,3,66.7
336,3/02/2018 4:00,25,34,29,88,3,0.0
337,3/02/2018 4:05,27,35,30,92,3,0.0
338,3/02/2018 4:10,28,37,32,97,3,0.0
339,3/02/2018 4:15,31,40,34,105,3,0.0
340,3/02/2018 4:20,31,40,34,105,3,0.0
341,3/02/2018 4:25,32,40,34,106,3,0.0
342,3/02/2018 4:30,33,41,36,110,3,0.0
343,3/02/2018 4:35,42,50,43,135,3,0.0
344,3/02/2018 4:40,40,47,41,128,3,0.0
345,3/02/2018 4:45,46,53,46,145,3,0.0
346,3/02/2018 4:50,43,51,44,138,3,0.0
347,3/02/2018 4:55,47,54,47,148,3,0.0
348,3/02/2018 5:00,43,50,43,136,3,0.0
349,3/02/2018 5:05,39,47,40,126,3,0.0
350,3/02/2018 5:10,51,58,51,160,3,0.0
351,3/02/2018 5:15,53,59,52,164,3,0.0
352,3/02/2018 5:20,53,59,52,164,3,0.0
353,3/02/2018 5:25,59,65,57,181,3,0.0
354,3/02/2018 5:30,54,61,53,168,3,0.0
355,3/02/2018 5:35,61,66,58,185,3,0.0
356,3/02/2018 5:40,69,74,65,208,3,0.0
357,3/02/2018 5:45,68,73,64,205,3,0.0
358,3/02/2018 5:50,54,60,53,167,3,0.0
359,3/02/2018 5:55,57,63,55,175,3,0.0
360,3/02/2018 6:00,53,60,52,165,3,0.0
361,3/02/2018 6:05,58,65,56,179,3,0.0
362,3/02/2018 6:10,63,69,60,192,3,0.0
363,3/02/2018 6:15,68,73,64,205,3,0.0
364,3/02/2018 6:20,71,76,67,214,3,0.0
365,3/02/2018 6:25,68,73,64,205,3,0.0
366,3/02/2018 6:30,73,77,68,218,3,0.0
367,3/02/2018 6:35,69,74,65,208,3,0.0
368,3/02/2018 6:40,72,93,51,216,3,66.7
369,3/02/2018 6:45,70,84,68,222,3,66.7
370,3/02/2018 6:50,66,100,51,217,3,66.7
371,3/02/2018 6:55,67,92,58,217,3,66.7
372,3/02/2018 7:00,62,91,57,210,3,66.7
373,3/02/2018 7:05,71,87,55,213,3,66.7
374,3/02/2018 7:10,75,86,66,227,3,66.7
375,3/02/2018 7:15,71,93,57,221,3,66.7
376,3/02/2018 7:20,68,99,58,225,3,66.7
377,3/02/2018 7:25,75,102,68,245,3,66.7
378,3/02/2018 7:30,79,89,63,231,3,66.7
379,3/02/2018 7:35,79,98,62,239,3,66.7
380,3/02/2018 7:40,78,90,10,178,3,66.7
381,3/02/2018 7:45,58,90,55,203,3,66.7
382,3/02/2018 7:50,85,88,77,250,3,0.0
383,3/02/2018 7:55,70,75,66,211,3,0.0
384,3/02/2018 8:00,82,86,75,243,3,0.0
385,3/02/2018 8:05,71,76,66,213,3,0.0
386,3/02/2018 8:10,80,84,73,237,3,0.0
387,3/02/2018 8:15,87,91,80,258,3,0.0
388,3/02/2018 8:20,80,85,74,239,3,0.0
389,3/02/2018 8:25,88,91,80,259,3,0.0
390,3/02/2018 8:30,82,86,75,243,3,0.0
391,3/02/2018 8:35,82,85,75,242,3,0.0
392,3/02/2018 8:40,79,83,73,235,3,0.0
393,3/02/2018 8:45,73,95,60,228,3,66.7
394,3/02/2018 8:50,68,96,64,228,3,66.7
395,3/02/2018 8:55,75,97,50,222,3,66.7
396,3/02/2018 9:00,71,86,48,205,3,66.7
397,3/02/2018 9:05,68,76,54,198,3,66.7
398,3/02/2018 9:10,75,93,55,223,3,66.7
399,3/02/2018 9:15,66,82,57,205,3,66.7
400,3/02/2018 9:20,77,98,69,244,3,66.7
401,3/02/2018 9:25,67,96,53,216,3,66.7
402,3/02/2018 9:30,70,92,53,215,3,66.7
403,3/02/2018 9:35,72,85,58,215,3,66.7
404,3/02/2018 9:40,70,79,53,202,3,66.7
405,3/02/2018 9:45,72,88,55,215,3,66.7
406,3/02/2018 9:50,82,87,59,228,3,66.7
407,3/02/2018 9:55,71,86,58,215,3,66.7
408,3/02/2018 10:00,62,78,54,194,3,66.7
409,3/02/2018 10:05,72,94,58,224,3,66.7
410,3/02/2018 10:10,71,89,59,219,3,66.7
411,3/02/2018 10:15,77,93,59,229,3,66.7
412,3/02/2018 10:20,72,88,59,219,3,66.7
413,3/02/2018 10:25,59,101,47,207,3,66.7
414,3/02/2018 10:30,76,80,53,209,3,66.7
415,3/02/2018 10:35,72,86,53,211,3,66.7
416,3/02/2018 10:40,75,89,59,223,3,66.7
417,3/02/2018 10:45,71,82,61,214,3,66.7
418,3/02/2018 10:50,70,93,57,220,3,66.7
419,3/02/2018 10:55,61,80,51,192,3,66.7
420,3/02/2018 11:00,71,77,59,207,3,66.7
421,3/02/2018 11:05,61,85,49,195,3,66.7
422,3/02/2018 11:10,71,85,50,206,3,66.7
423,3/02/2018 11:15,65,86,50,201,3,66.7
424,3/02/2018 11:20,70,92,52,214,3,66.7
425,3/02/2018 11:25,72,90,53,215,3,66.7
426,3/02/2018 11:30,78,96,48,222,3,66.7
427,3/02/2018 11:35,85,96,51,232,3,66.7
428,3/02/2018 11:40,72,84,55,211,3,66.7
429,3/02/2018 11:45,71,88,52,211,3,66.7
430,3/02/2018 11:50,76,96,55,227,3,66.7
431,3/02/2018 11:55,65,84,49,198,3,66.7
432,3/02/2018 12:00,77,74,55,206,3,66.7
433,3/02/2018 12:05,84,97,74,255,3,66.7
434,3/02/2018 12:10,84,94,63,241,3,66.7
435,3/02/2018 12:15,78,86,61,225,3,66.7
436,3/02/2018 12:20,68,87,52,207,3,66.7
437,3/02/2018 12:25,71,76,51,198,3,66.7
438,3/02/2018 12:30,70,78,50,198,3,66.7
439,3/02/2018 12:35,63,87,52,202,3,66.7
440,3/02/2018 12:40,78,91,55,224,3,66.7
441,3/02/2018 12:45,76,81,56,213,3,66.7
442,3/02/2018 12:50,70,89,60,219,3,66.7
443,3/02/2018 12:55,80,88,64,232,3,66.7
444,3/02/2018 13:00,75,78,57,210,3,66.7
445,3/02/2018 13:05,91,82,63,236,3,66.7
446,3/02/2018 13:10,85,90,62,237,3,66.7
447,3/02/2018 13:15,71,93,65,229,3,66.7
448,3/02/2018 13:20,75,96,52,223,3,66.7
449,3/02/2018 13:25,64,79,55,198,3,66.7
450,3/02/2018 13:30,73,81,60,214,3,66.7
451,3/02/2018 13:35,65,81,54,200,3,66.7
452,3/02/2018 13:40,62,75,64,201,3,66.7
453,3/02/2018 13:45,66,78,39,183,3,66.7
454,3/02/2018 13:50,80,91,57,228,3,66.7
455,3/02/2018 13:55,85,77,52,214,3,66.7
456,3/02/2018 14:00,74,72,53,199,3,66.7
457,3/02/2018 14:05,78,77,57,212,3,66.7
458,3/02/2018 14:10,63,72,53,188,3,66.7
459,3/02/2018 14:15,68,75,46,189,3,66.7
460,3/02/2018 14:20,73,76,46,195,3,66.7
461,3/02/2018 14:25,73,84,58,215,3,66.7
462,3/02/2018 14:30,74,94,49,217,3,66.7
463,3/02/2018 14:35,65,113,61,239,3,66.7
464,3/02/2018 14:40,95,82,72,249,3,66.7
465,3/02/2018 14:45,81,71,63,215,3,66.7
466,3/02/2018 14:50,99,78,74,251,3,66.7
467,3/02/2018 14:55,75,83,73,231,3,66.7
468,3/02/2018 15:00,72,81,64,217,3,66.7
469,3/02/2018 15:05,86,80,80,246,3,66.7
470,3/02/2018 15:10,84,95,77,256,3,66.7
471,3/02/2018 15:15,90,90,73,253,3,66.7
472,3/02/2018 15:20,88,77,53,218,3,66.7
473,3/02/2018 15:25,87,85,82,254,3,66.7
474,3/02/2018 15:30,89,71,77,237,3,66.7
475,3/02/2018 15:35,87,84,67,238,3,66.7
476,3/02/2018 15:40,89,71,38,198,3,66.7
477,3/02/2018 15:45,76,73,42,191,3,66.7
478,3/02/2018 15:50,81,65,44,190,3,66.7
479,3/02/2018 15:55,78,70,44,192,3,66.7
480,3/02/2018 16:00,77,78,46,201,3,66.7
481,3/02/2018 16:05,77,98,67,242,3,66.7
482,3/02/2018 16:10,82,71,68,221,3,66.7
483,3/02/2018 16:15,81,76,64,221,3,66.7
484,3/02/2018 16:20,90,88,77,255,3,66.7
485,3/02/2018 16:25,64,85,64,213,3,66.7
486,3/02/2018 16:30,77,78,61,216,3,66.7
487,3/02/2018 16:35,63,58,35,156,3,66.7
488,3/02/2018 16:40,72,76,60,208,3,66.7
489,3/02/2018 16:45,65,62,44,171,3,66.7
490,3/02/2018 16:50,71,69,44,184,3,66.7
491,3/02/2018 16:55,75,61,42,178,3,66.7
492,3/02/2018 17:00,62,50,38,150,3,66.7
493,3/02/2018 17:05,67,71,57,195,3,66.7
494,3/02/2018 17:10,73,72,67,212,3,66.7
495,3/02/2018 17:15,103,56,50,209,3,66.7
496,3/02/2018 17:20,75,53,46,174,3,66.7
497,3/02/2018 17:25,82,70,49,201,3,66.7
498,3/02/2018 17:30,73,59,40,172,3,66.7
499,3/02/2018 17:35,71,74,39,184,3,66.7
500,3/02/2018 17:40,80,75,48,203,3,66.7
501,3/02/2018 17:45,77,73,42,192,3,66.7
502,3/02/2018 17:50,88,59,40,187,3,66.7
503,3/02/2018 17:55,84,61,54,199,3,66.7
504,3/02/2018 18:00,91,67,46,204,3,66.7
505,3/02/2018 18:05,70,64,44,178,3,66.7
506,3/02/2018 18:10,67,89,70,226,3,66.7
507,3/02/2018 18:15,70,88,63,221,3,66.7
508,3/02/2018 18:20,83,83,71,237,3,66.7
509,3/02/2018 18:25,77,69,49,195,3,66.7
510,3/02/2018 18:30,82,51,44,177,3,66.7
511,3/02/2018 18:35,65,55,43,163,3,66.7
512,3/02/2018 18:40,74,57,33,164,3,66.7
513,3/02/2018 18:45,83,80,60,223,3,66.7
514,3/02/2018 18:50,83,87,72,242,3,66.7
515,3/02/2018 18:55,84,59,52,195,3,66.7
516,3/02/2018 19:00,75,76,53,204,3,66.7
517,3/02/2018 19:05,78,69,35,182,3,66.7
518,3/02/2018 19:10,83,78,44,205,3,66.7
519,3/02/2018 19:15,98,78,47,223,3,66.7
520,3/02/2018 19:20,89,87,46,222,3,66.7
521,3/02/2018 19:25,74,90,46,210,3,66.7
522,3/02/2018 19:30,90,81,44,215,3,66.7
523,3/02/2018 19:35,85,85,46,216,3,66.7
524,3/02/2018 19:40,94,100,54,248,3,66.7
525,3/02/2018 19:45,103,87,62,252,3,66.7
526,3/02/2018 19:50,93,101,73,267,3,66.7
527,3/02/2018 19:55,77,97,68,242,3,66.7
528,3/02/2018 20:00,76,96,70,242,3,66.7
529,3/02/2018 20:05,83,78,51,212,3,66.7
530,3/02/2018 20:10,86,102,70,258,3,66.7
531,3/02/2018 20:15,81,91,57,229,3,66.7
532,3/02/2018 20:20,73,88,66,227,3,66.7
533,3/02/2018 20:25,67,61,38,166,3,66.7
534,3/02/2018 20:30,86,95,63,244,3,66.7
535,3/02/2018 20:35,77,94,60,231,3,66.7
536,3/02/2018 20:40,87,103,64,254,3,66.7
537,3/02/2018 20:45,76,94,50,220,3,66.7
538,3/02/2018 20:50,80,93,63,236,3,66.7
539,3/02/2018 20:55,63,74,61,198,3,66.7
540,3/02/2018 21:00,65,86,41,192,3,66.7
541,3/02/2018 21:05,69,79,54,202,3,66.7
542,3/02/2018 21:10,60,90,46,196,3,66.7
543,3/02/2018 21:15,63,96,49,208,3,66.7
544,3/02/2018 21:20,71,96,56,223,3,66.7
545,3/02/2018 21:25,71,108,56,235,3,66.7
546,3/02/2018 21:30,71,95,56,222,3,66.7
547,3/02/2018 21:35,73,110,56,239,3,66.7
548,3/02/2018 21:40,76,100,63,239,3,66.7
549,3/02/2018 21:45,81,105,56,242,3,66.7
550,3/02/2018 21:50,72,89,55,216,3,66.7
551,3/02/2018 21:55,63,89,50,202,3,66.7
552,3/02/2018 22:00,73,90,60,223,3,66.7
553,3/02/2018 22:05,78,112,56,246,3,66.7
554,3/02/2018 22:10,65,84,57,206,3,66.7
555,3/02/2018 22:15,79,106,72,257,3,66.7
556,3/02/2018 22:20,75,99,53,227,3,66.7
557,3/02/2018 22:25,63,85,62,210,3,66.7
558,3/02/2018 22:30,62,89,50,201,3,66.7
559,3/02/2018 22:35,74,83,53,210,3,66.7
560,3/02/2018 22:40,74,86,54,214,3,66.7
561,3/02/2018 22:45,62,95,51,208,3,66.7
562,3/02/2018 22:50,65,95,55,215,3,66.7
563,3/02/2018 22:55,68,91,56,215,3,66.7
564,3/02/2018 23:00,63,77,51,191,3,66.7
565,3/02/2018 23:05,70,94,64,228,3,66.7
566,3/02/2018 23:10,80,107,60,247,3,66.7
567,3/02/2018 23:15,61,103,62,226,3,66.7
568,3/02/2018 23:20,72,105,75,252,3,66.7
569,3/02/2018 23:25,66,102,50,218,3,66.7
570,3/02/2018 23:30,71,121,63,255,3,66.7
571,3/02/2018 23:35,69,117,72,258,3,66.7
572,3/02/2018 23:40,84,111,71,266,3,66.7
573,3/02/2018 23:45,86,113,89,288,3,66.7
574,3/02/2018 23:50,77,131,80,288,3,66.7
575,3/02/2018 23:55,43,83,43,169,3,66.7
576,3/03/2018 0:00,49,72,44,165,3,66.7
577,3/03/2018 0:05,49,70,48,167,3,66.7
578,3/03/2018 0:10,61,76,46,183,3,66.7
579,3/03/2018 0:15,51,69,45,165,3,66.7
580,3/03/2018 0:20,48,68,36,152,3,66.7
581,3/03/2018 0:25,45,65,34,144,3,66.7
582,3/03/2018 0:30,47,72,39,158,3,66.7
583,3/03/2018 0:35,52,81,36,169,3,66.7
584,3/03/2018 0:40,43,63,37,143,3,66.7
585,3/03/2018 0:45,49,57,33,139,3,66.7
586,3/03/2018 0:50,42,69,35,146,3,66.7
587,3/03/2018 0:55,40,42,20,102,3,66.7
588,3/03/2018 1:00,39,52,34,125,3,66.7
589,3/03/2018 1:05,45,50,21,116,3,66.7
590,3/03/2018 1:10,35,58,28,121,3,66.7
591,3/03/2018 1:15,48,41,35,124,3,66.7
592,3/03/2018 1:20,42,49,30,121,3,66.7
593,3/03/2018 1:25,27,50,18,95,3,66.7
594,3/03/2018 1:30,36,48,23,107,3,66.7
595,3/03/2018 1:35,28,37,23,88,3,66.7
596,3/03/2018 1:40,39,50,28,117,3,66.7
597,3/03/2018 1:45,36,41,31,108,3,66.7
598,3/03/2018 1:50,27,39,20,86,3,66.7
599,3/03/2018 1:55,31,43,23,97,3,66.7
600,3/03/2018 2:00,34,34,20,88,3,66.7
601,3/03/2018 2:05,31,42,21,94,3,66.7
602,3/03/2018 2:10,32,37,19,88,3,66.7
603,3/03/2018 2:15,39,47,27,113,3,66.7
604,3/03/2018 2:20,38,47,27,112,3,66.7
605,3/03/2018 2:25,24,39,18,81,3,66.7
606,3/03/2018 2:30,32,40,16,88,3,66.7
607,3/03/2018 2:35,29,32,18,79,3,66.7
608,3/03/2018 2:40,36,34,23,93,3,66.7
609,3/03/2018 2:45,32,29,22,83,3,66.7
610,3/03/2018 2:50,32,36,14,82,3,66.7
611,3/03/2018 2:55,23,29,14,66,3,66.7
612,3/03/2018 3:00,29,30,23,82,3,66.7
613,3/03/2018 3:05,22,18,14,54,3,66.7
614,3/03/2018 3:10,24,30,15,69,3,66.7
615,3/03/2018 3:15,31,18,16,65,3,66.7
616,3/03/2018 3:20,22,19,9,50,3,66.7
617,3/03/2018 3:25,25,19,12,56,3,66.7
618,3/03/2018 3:30,28,28,17,73,3,66.7
619,3/03/2018 3:35,30,17,12,59,3,66.7
620,3/03/2018 3:40,24,19,14,57,3,66.7
621,3/03/2018 3:45,24,25,10,59,3,66.7
622,3/03/2018 3:50,23,27,10,60,3,66.7
623,3/03/2018 3:55,16,12,10,38,3,66.7
624,3/03/2018 4:00,25,26,12,63,3,66.7
625,3/03/2018 4:05,33,42,36,111,3,0.0
626,3/03/2018 4:10,29,37,32,98,3,0.0
627,3/03/2018 4:15,23,32,28,83,3,0.0
628,3/03/2018 4:20,37,45,39,121,3,0.0
629,3/03/2018 4:25,32,40,35,107,3,0.0
630,3/03/2018 4:30,34,42,36,112,3,0.0
631,3/03/2018 4:35,32,41,35,108,3,0.0
632,3/03/2018 4:40,25,23,18,66,3,66.7
633,3/03/2018 4:45,26,32,10,68,3,66.7
634,3/03/2018 4:50,29,30,12,71,3,66.7
635,3/03/2018 4:55,25,43,27,95,3,66.7
636,3/03/2018 5:00,31,40,34,105,3,0.0
637,3/03/2018 5:05,28,10,10,48,3,66.7
638,3/03/2018 5:10,32,40,20,92,3,66.7
639,3/03/2018 5:15,32,33,22,87,3,66.7
640,3/03/2018 5:20,27,30,15,72,3,66.7
641,3/03/2018 5:25,37,45,39,121,3,0.0
642,3/03/2018 5:30,36,34,18,88,3,66.7
643,3/03/2018 5:35,35,39,28,102,3,66.7
644,3/03/2018 5:40,36,38,19,93,3,66.7
645,3/03/2018 5:45,40,48,41,129,3,0.0
646,3/03/2018 5:50,45,40,30,115,3,66.7
647,3/03/2018 5:55,40,46,27,113,3,66.7
648,3/03/2018 6:00,32,38,22,92,3,66.7
649,3/03/2018 6:05,36,47,23,106,3,66.7
650,3/03/2018 6:10,45,60,35,140,3,66.7
651,3/03/2018 6:15,47,56,41,144,3,66.7
652,3/03/2018 6:20,47,54,37,138,3,66.7
653,3/03/2018 6:25,47,54,27,128,3,66.7
654,3/03/2018 6:30,48,48,38,134,3,66.7
655,3/03/2018 6:35,47,54,28,129,3,66.7
656,3/03/2018 6:40,50,56,35,141,3,66.7
657,3/03/2018 6:45,49,65,47,161,3,66.7
658,3/03/2018 6:50,51,50,40,141,3,66.7
659,3/03/2018 6:55,60,70,55,185,3,66.7
660,3/03/2018 7:00,58,64,55,177,3,0.0
661,3/03/2018 7:05,57,63,55,175,3,0.0
662,3/03/2018 7:10,58,65,56,179,3,0.0
663,3/03/2018 7:15,58,65,56,179,3,0.0
664,3/03/2018 7:20,63,69,60,192,3,0.0
665,3/03/2018 7:25,60,65,57,182,3,0.0
666,3/03/2018 7:30,64,70,61,195,3,0.0
667,3/03/2018 7:35,64,69,61,194,3,0.0
668,3/03/2018 7:40,49,90,40,179,3,66.7
669,3/03/2018 7:45,78,88,51,217,3,66.7
670,3/03/2018 7:50,69,84,58,211,3,66.7
671,3/03/2018 7:55,61,70,43,174,3,66.7
672,3/03/2018 8:00,59,78,45,182,3,66.7
673,3/03/2018 8:05,48,73,42,163,3,66.7
674,3/03/2018 8:10,63,86,51,200,3,66.7
675,3/03/2018 8:15,72,91,49,212,3,66.7
676,3/03/2018 8:20,74,84,60,218,3,66.7
677,3/03/2018 8:25,64,93,44,201,3,66.7
678,3/03/2018 8:30,68,80,54,202,3,66.7
679,3/03/2018 8:35,68,88,65,221,3,66.7
680,3/03/2018 8:40,65,74,46,185,3,66.7
681,3/03/2018 8:45,80,86,60,226,3,66.7
682,3/03/2018 8:50,68,79,46,193,3,66.7
683,3/03/2018 8:55,67,74,48,189,3,66.7
684,3/03/2018 9:00,71,74,55,200,3,66.7
685,3/03/2018 9:05,59,82,57,198,3,66.7
686,3/03/2018 9:10,76,87,59,222,3,66.7
687,3/03/2018 9:15,68,105,65,238,3,66.7
688,3/03/2018 9:20,81,104,70,255,3,66.7
689,3/03/2018 9:25,78,105,62,245,3,66.7
690,3/03/2018 9:30,80,100,56,236,3,66.7
691,3/03/2018 9:35,81,84,57,222,3,66.7
692,3/03/2018 9:40,79,88,66,233,3,66.7
693,3/03/2018 9:45,69,71,36,176,3,66.7
694,3/03/2018 9:50,79,90,50,219,3,66.7
695,3/03/2018 9:55,100,102,90,292,3,0.0
696,3/03/2018 10:00,83,86,76,245,3,0.0
697,3/03/2018 10:05,78,82,72,232,3,0.0
698,3/03/2018 10:10,65,86,40,191,3,66.7
699,3/03/2018 10:15,81,85,74,240,3,0.0
700,3/03/2018 10:20,95,98,86,279,3,0.0
701,3/03/2018 10:25,83,86,76,245,3,0.0
702,3/03/2018 10:30,79,83,73,235,3,0.0
703,3/03/2018 10:35,89,93,81,263,3,0.0
704,3/03/2018 10:40,65,71,62,198,3,0.0
705,3/03/2018 10:45,102,104,91,297,3,0.0
706,3/03/2018 10:50,88,92,80,260,3,0.0
707,3/03/2018 10:55,91,94,82,267,3,0.0
708,3/03/2018 11:00,92,95,83,270,3,0.0
709,3/03/2018 11:05,77,82,71,230,3,0.0
710,3/03/2018 11:10,75,80,70,225,3,0.0
711,3/03/2018 11:15,77,82,57,216,3,66.7
712,3/03/2018 11:20,81,94,70,245,3,66.7
713,3/03/2018 11:25,69,90,43,202,3,66.7
714,3/03/2018 11:30,95,91,71,257,3,66.7
715,3/03/2018 11:35,94,95,73,262,3,66.7
716,3/03/2018 11:40,77,98,69,244,3,66.7
717,3/03/2018 11:45,86,100,79,265,3,66.7
718,3/03/2018 11:50,96,93,60,249,3,66.7
719,3/03/2018 11:55,81,105,65,251,3,66.7
720,3/03/2018 12:00,90,95,71,256,3,66.7
721,3/03/2018 12:05,93,95,73,261,3,66.7
722,3/03/2018 12:10,86,113,59,258,3,66.7
723,3/03/2018 12:15,95,88,66,249,3,66.7
724,3/03/2018 12:20,85,108,66,259,3,66.7
725,3/03/2018 12:25,84,102,73,259,3,66.7
726,3/03/2018 12:30,85,100,62,247,3,66.7
727,3/03/2018 12:35,101,112,73,286,3,66.7
728,3/03/2018 12:40,75,78,64,217,3,66.7
729,3/03/2018 12:45,79,114,59,252,3,66.7
730,3/03/2018 12:50,83,91,58,232,3,66.7
731,3/03/2018 12:55,89,98,66,253,3,66.7
732,3/03/2018 13:00,95,103,81,279,3,66.7
733,3/03/2018 13:05,81,92,65,238,3,66.7
734,3/03/2018 13:10,90,99,64,253,3,66.7
735,3/03/2018 13:15,80,113,76,269,3,66.7
736,3/03/2018 13:20,86,92,80,258,3,66.7
737,3/03/2018 13:25,77,89,58,224,3,66.7
738,3/03/2018 13:30,83,108,69,260,3,66.7
739,3/03/2018 13:35,97,104,64,265,3,66.7
740,3/03/2018 13:40,80,104,76,260,3,66.7
741,3/03/2018 13:45,75,97,65,237,3,66.7
742,3/03/2018 13:50,101,121,76,298,3,66.7
743,3/03/2018 13:55,93,102,70,265,3,66.7
744,3/03/2018 14:00,87,94,65,246,3,66.7
745,3/03/2018 14:05,85,94,66,245,3,66.7
746,3/03/2018 14:10,75,98,68,241,3,66.7
747,3/03/2018 14:15,95,94,76,265,3,66.7
748,3/03/2018 14:20,100,98,68,266,3,66.7
749,3/03/2018 14:25,86,107,78,271,3,66.7
750,3/03/2018 14:30,87,97,69,253,3,66.7
751,3/03/2018 14:35,98,88,67,253,3,66.7
752,3/03/2018 14:40,94,92,77,263,3,66.7
753,3/03/2018 14:45,84,86,69,239,3,66.7
754,3/03/2018 14:50,90,98,72,260,3,66.7
755,3/03/2018 14:55,90,108,66,264,3,66.7
756,3/03/2018 15:00,95,106,79,280,3,66.7
757,3/03/2018 15:05,95,98,70,263,3,66.7
758,3/03/2018 15:10,78,94,60,232,3,66.7
759,3/03/2018 15:15,88,91,68,247,3,66.7
760,3/03/2018 15:20,83,89,65,237,3,66.7
761,3/03/2018 15:25,104,91,75,270,3,66.7
762,3/03/2018 15:30,83,96,64,243,3,66.7
763,3/03/2018 15:35,93,94,78,265,3,66.7
764,3/03/2018 15:40,96,102,74,272,3,66.7
765,3/03/2018 15:45,96,88,58,242,3,66.7
766,3/03/2018 15:50,93,98,75,266,3,66.7
767,3/03/2018 15:55,99,91,76,266,3,66.7
768,3/03/2018 16:00,89,90,68,247,3,66.7
769,3/03/2018 16:05,82,93,63,238,3,66.7
770,3/03/2018 16:10,93,98,68,259,3,66.7
771,3/03/2018 16:15,92,98,70,260,3,66.7
772,3/03/2018 16:20,93,102,65,260,3,66.7
773,3/03/2018 16:25,88,96,73,257,3,66.7
774,3/03/2018 16:30,82,92,65,239,3,66.7
775,3/03/2018 16:35,98,112,80,290,3,66.7
776,3/03/2018 16:40,90,98,65,253,3,66.7
777,3/03/2018 16:45,81,98,75,254,3,66.7
778,3/03/2018 16:50,87,108,72,267,3,66.7
779,3/03/2018 16:55,86,111,63,260,3,66.7
780,3/03/2018 17:00,61,105,64,230,3,66.7
781,3/03/2018 17:05,86,108,77,271,3,66.7
782,3/03/2018 17:10,91,113,73,277,3,66.7
783,3/03/2018 17:15,84,104,73,261,3,66.7
784,3/03/2018 17:20,82,97,81,260,3,66.7
785,3/03/2018 17:25,84,98,71,253,3,66.7
786,3/03/2018 17:30,85,103,70,258,3,66.7
787,3/03/2018 17:35,81,103,69,253,3,66.7
788,3/03/2018 17:40,78,93,81,252,3,66.7
789,3/03/2018 17:45,87,102,76,265,3,66.7
790,3/03/2018 17:50,82,100,63,245,3,66.7
791,3/03/2018 17:55,79,96,73,248,3,66.7
792,3/03/2018 18:00,81,82,61,224,3,66.7
793,3/03/2018 18:05,86,95,68,249,3,66.7
794,3/03/2018 18:10,90,106,64,260,3,66.7
795,3/03/2018 18:15,82,94,71,247,3,66.7
796,3/03/2018 18:20,85,96,67,248,3,66.7
797,3/03/2018 18:25,79,90,59,228,3,66.7
798,3/03/2018 18:30,79,95,65,239,3,66.7
799,3/03/2018 18:35,90,97,59,246,3,66.7
800,3/03/2018 18:40,76,97,63,236,3,66.7
801,3/03/2018 18:45,83,94,64,241,3,66.7
802,3/03/2018 18:50,85,103,67,255,3,66.7
803,3/03/2018 18:55,85,82,57,224,3,66.7
804,3/03/2018 19:00,76,98,63,237,3,66.7
805,3/03/2018 19:05,71,93,67,231,3,66.7
806,3/03/2018 19:10,75,79,56,210,3,66.7
807,3/03/2018 19:15,86,98,69,253,3,66.7
808,3/03/2018 19:20,77,87,59,223,3,66.7
809,3/03/2018 19:25,77,91,66,234,3,66.7
810,3/03/2018 19:30,82,94,61,237,3,66.7
811,3/03/2018 19:35,69,81,70,220,3,66.7
812,3/03/2018 19:40,71,89,59,219,3,66.7
813,3/03/2018 19:45,71,95,66,232,3,66.7
814,3/03/2018 19:50,66,87,60,213,3,66.7
815,3/03/2018 19:55,66,76,45,187,3,66.7
816,3/03/2018 20:00,63,95,53,211,3,66.7
817,3/03/2018 20:05,60,86,57,203,3,66.7
818,3/03/2018 20:10,75,79,66,220,3,66.7
819,3/03/2018 20:15,76,91,60,227,3,66.7
820,3/03/2018 20:20,71,87,67,225,3,66.7
821,3/03/2018 20:25,60,77,58,195,3,66.7
822,3/03/2018 20:30,58,69,50,177,3,66.7
823,3/03/2018 20:35,66,77,51,194,3,66.7
824,3/03/2018 20:40,73,70,54,197,3,66.7
825,3/03/2018 20:45,65,88,56,209,3,66.7
826,3/03/2018 20:50,64,94,53,211,3,66.7
827,3/03/2018 20:55,66,92,50,208,3,66.7
828,3/03/2018 21:00,66,73,52,191,3,66.7
829,3/03/2018 21:05,70,94,58,222,3,66.7
830,3/03/2018 21:10,68,78,50,196,3,66.7
831,3/03/2018 21:15,72,100,58,230,3,66.7
832,3/03/2018 21:20,70,101,66,237,3,66.7
833,3/03/2018 21:25,71,97,73,241,3,66.7
834,3/03/2018 21:30,78,96,60,234,3,66.7
835,3/03/2018 21:35,72,84,57,213,3,66.7
836,3/03/2018 21:40,71,91,51,213,3,66.7
837,3/03/2018 21:45,56,97,54,207,3,66.7
838,3/03/2018 21:50,68,101,71,240,3,66.7
839,3/03/2018 21:55,54,79,50,183,3,66.7
840,3/03/2018 22:00,66,86,58,210,3,66.7
841,3/03/2018 22:05,68,101,61,230,3,66.7
842,3/03/2018 22:10,67,90,60,217,3,66.7
843,3/03/2018 22:15,67,92,57,216,3,66.7
844,3/03/2018 22:20,69,91,68,228,3,66.7
845,3/03/2018 22:25,72,92,61,225,3,66.7
846,3/03/2018 22:30,77,87,62,226,3,66.7
847,3/03/2018 22:35,63,79,52,194,3,66.7
848,3/03/2018 22:40,65,72,43,180,3,66.7
849,3/03/2018 22:45,61,91,61,213,3,66.7
850,3/03/2018 22:50,66,92,51,209,3,66.7
851,3/03/2018 22:55,62,89,56,207,3,66.7
852,3/03/2018 23:00,53,90,49,192,3,66.7
853,3/03/2018 23:05,58,79,39,176,3,66.7
854,3/03/2018 23:10,67,68,42,177,3,66.7
855,3/03/2018 23:15,53,80,44,177,3,66.7
856,3/03/2018 23:20,63,92,49,204,3,66.7
857,3/03/2018 23:25,55,84,56,195,3,66.7
858,3/03/2018 23:30,60,90,63,213,3,66.7
859,3/03/2018 23:35,67,91,67,225,3,66.7
860,3/03/2018 23:40,65,103,63,231,3,66.7
861,3/03/2018 23:45,65,102,60,227,3,66.7
862,3/03/2018 23:50,66,73,51,190,3,66.7
863,3/03/2018 23:55,55,75,50,180,3,66.7
864,3/04/2018 0:00,56,68,39,163,3,66.7
865,3/04/2018 0:05,62,73,48,183,3,66.7
866,3/04/2018 0:10,43,57,39,139,3,66.7
867,3/04/2018 0:15,50,66,35,151,3,66.7
868,3/04/2018 0:20,50,56,39,145,3,66.7
869,3/04/2018 0:25,43,67,30,140,3,66.7
870,3/04/2018 0:30,46,62,34,142,3,66.7
871,3/04/2018 0:35,51,62,40,153,3,66.7
872,3/04/2018 0:40,38,60,22,120,3,66.7
873,3/04/2018 0:45,35,61,33,129,3,66.7
874,3/04/2018 0:50,41,50,40,131,3,66.7
875,3/04/2018 0:55,44,52,45,141,3,0.0
876,3/04/2018 1:00,44,51,44,139,3,0.0
877,3/04/2018 1:05,43,50,44,137,3,0.0
878,3/04/2018 1:10,39,47,40,126,3,0.0
879,3/04/2018 1:15,46,53,46,145,3,0.0
880,3/04/2018 1:20,46,53,46,145,3,0.0
881,3/04/2018 1:25,35,43,37,115,3,0.0
882,3/04/2018 1:30,34,42,36,112,3,0.0
883,3/04/2018 1:35,33,42,36,111,3,0.0
884,3/04/2018 1:40,40,48,42,130,3,0.0
885,3/04/2018 1:45,41,49,42,132,3,0.0
886,3/04/2018 1:50,38,46,40,124,3,0.0
887,3/04/2018 1:55,36,44,38,118,3,0.0
888,3/04/2018 2:00,37,45,39,121,3,0.0
889,3/04/2018 2:05,35,44,38,117,3,0.0
890,3/04/2018 2:10,35,43,37,115,3,0.0
891,3/04/2018 2:15,34,42,36,112,3,0.0
892,3/04/2018 2:20,34,43,37,114,3,0.0
893,3/04/2018 2:25,35,43,37,115,3,0.0
894,3/04/2018 2:30,31,40,34,105,3,0.0
895,3/04/2018 2:35,28,37,32,97,3,0.0
896,3/04/2018 2:40,34,42,36,112,3,0.0
897,3/04/2018 2:45,30,38,33,101,3,0.0
898,3/04/2018 2:50,33,42,36,111,3,0.0
899,3/04/2018 2:55,28,36,31,95,3,0.0
900,3/04/2018 3:00,28,36,31,95,3,0.0
901,3/04/2018 3:05,28,36,31,95,3,0.0
902,3/04/2018 3:10,23,32,28,83,3,0.0
903,3/04/2018 3:15,25,34,29,88,3,0.0
904,3/04/2018 3:20,30,39,33,102,3,0.0
905,3/04/2018 3:25,24,33,28,85,3,0.0
906,3/04/2018 3:30,24,33,28,85,3,0.0
907,3/04/2018 3:35,23,32,28,83,3,0.0
908,3/04/2018 3:40,28,36,31,95,3,0.0
909,3/04/2018 3:45,28,36,31,95,3,0.0
910,3/04/2018 3:50,25,34,29,88,3,0.0
911,3/04/2018 3:55,26,35,30,91,3,0.0
912,3/04/2018 4:00,21,31,26,78,3,0.0
913,3/04/2018 4:05,24,13,18,55,3,66.7
914,3/04/2018 4:10,25,34,29,88,3,0.0
915,3/04/2018 4:15,29,37,32,98,3,0.0
916,3/04/2018 4:20,27,36,31,94,3,0.0
917,3/04/2018 4:25,25,34,29,88,3,0.0
918,3/04/2018 4:30,26,35,30,91,3,0.0
919,3/04/2018 4:35,25,34,29,88,3,0.0
920,3/04/2018 4:40,31,40,34,105,3,0.0
921,3/04/2018 4:45,31,39,34,104,3,0.0
922,3/04/2018 4:50,30,39,33,102,3,0.0
923,3/04/2018 4:55,34,42,36,112,3,0.0
924,3/04/2018 5:00,26,35,30,91,3,0.0
925,3/04/2018 5:05,33,41,35,109,3,0.0
926,3/04/2018 5:10,31,40,34,105,3,0.0
927,3/04/2018 5:15,34,42,36,112,3,0.0
928,3/04/2018 5:20,31,39,34,104,3,0.0
929,3/04/2018 5:25,33,41,35,109,3,0.0
930,3/04/2018 5:30,29,38,32,99,3,0.0
931,3/04/2018 5:35,31,39,34,104,3,0.0
932,3/04/2018 5:40,38,46,40,124,3,0.0
933,3/04/2018 5:45,39,47,41,127,3,0.0
934,3/04/2018 5:50,35,44,38,117,3,0.0
935,3/04/2018 5:55,28,36,31,95,3,0.0
936,3/04/2018 6:00,33,42,36,111,3,0.0
937,3/04/2018 6:05,40,48,41,129,3,0.0
938,3/04/2018 6:10,38,46,40,124,3,0.0
939,3/04/2018 6:15,39,47,41,127,3,0.0
940,3/04/2018 6:20,38,46,40,124,3,0.0
941,3/04/2018 6:25,46,53,46,145,3,0.0
942,3/04/2018 6:30,33,42,36,111,3,0.0
943,3/04/2018 6:35,48,55,48,151,3,0.0
944,3/04/2018 6:40,48,55,48,151,3,0.0
945,3/04/2018 6:45,44,52,45,141,3,0.0
946,3/04/2018 6:50,46,53,46,145,3,0.0
947,3/04/2018 6:55,50,57,49,156,3,0.0
948,3/04/2018 7:00,45,52,45,142,3,0.0
949,3/04/2018 7:05,46,53,46,145,3,0.0
950,3/04/2018 7:10,47,54,47,148,3,0.0
951,3/04/2018 7:15,56,62,54,172,3,0.0
952,3/04/2018 7:20,55,61,53,169,3,0.0
953,3/04/2018 7:25,58,64,56,178,3,0.0
954,3/04/2018 7:30,47,54,47,148,3,0.0
955,3/04/2018 7:35,50,57,50,157,3,0.0
956,3/04/2018 7:40,68,73,64,205,3,0.0
957,3/04/2018 7:45,58,64,56,178,3,0.0
958,3/04/2018 7:50,54,61,53,168,3,0.0
959,3/04/2018 7:55,60,66,58,184,3,0.0
960,3/04/2018 8:00,61,67,58,186,3,0.0
961,3/04/2018 8:05,53,60,52,165,3,0.0
962,3/04/2018 8:10,54,60,52,166,3,0.0
963,3/04/2018 8:15,54,60,52,166,3,0.0
964,3/04/2018 8:20,50,57,49,156,3,0.0
965,3/04/2018 8:25,51,58,50,159,3,0.0
966,3/04/2018 8:30,59,65,57,181,3,0.0
967,3/04/2018 8:35,63,68,60,191,3,0.0
968,3/04/2018 8:40,59,65,57,181,3,0.0
969,3/04/2018 8:45,58,10,10,78,3,66.7
970,3/04/2018 8:50,64,70,61,195,3,0.0
971,3/04/2018 8:55,60,66,57,183,3,0.0
972,3/04/2018 9:00,62,68,59,189,3,0.0
973,3/04/2018 9:05,67,72,63,202,3,0.0
974,3/04/2018 9:10,60,50,33,143,3,66.7
975,3/04/2018 9:15,61,90,51,202,3,66.7
976,3/04/2018 9:20,62,98,62,222,3,66.7
977,3/04/2018 9:25,69,74,65,208,3,0.0
978,3/04/2018 9:30,62,73,39,174,3,66.7
979,3/04/2018 9:35,66,82,49,197,3,66.7
980,3/04/2018 9:40,71,90,65,226,3,66.7
981,3/04/2018 9:45,70,89,73,232,3,66.7
982,3/04/2018 9:50,73,81,59,213,3,66.7
983,3/04/2018 9:55,78,101,62,241,3,66.7
984,3/04/2018 10:00,59,88,46,193,3,66.7
985,3/04/2018 10:05,80,87,53,220,3,66.7
986,3/04/2018 10:10,68,91,54,213,3,66.7
987,3/04/2018 10:15,80,100,58,238,3,66.7
988,3/04/2018 10:20,65,91,62,218,3,66.7
989,3/04/2018 10:25,83,91,73,247,3,66.7
990,3/04/2018 10:30,81,92,57,230,3,66.7
991,3/04/2018 10:35,77,86,58,221,3,66.7
992,3/04/2018 10:40,80,96,63,239,3,66.7
993,3/04/2018 10:45,86,104,76,266,3,66.7
994,3/04/2018 10:50,79,95,56,230,3,66.7
995,3/04/2018 10:55,78,91,66,235,3,66.7
996,3/04/2018 11:00,75,97,57,229,3,66.7
997,3/04/2018 11:05,79,87,66,232,3,66.7
998,3/04/2018 11:10,84,89,66,239,3,66.7
999,3/04/2018 11:15,84,105,63,252,3,66.7
1000,3/04/2018 11:20,89,92,72,253,3,66.7
1001,3/04/2018 11:25,80,117,71,268,3,66.7
1002,3/04/2018 11:30,86,92,71,249,3,66.7
1003,3/04/2018 11:35,84,99,63,246,3,66.7
1004,3/04/2018 11:40,72,95,49,216,3,66.7
1005,3/04/2018 11:45,80,92,67,239,3,66.7
1006,3/04/2018 11:50,82,97,63,242,3,66.7
1007,3/04/2018 11:55,80,92,64,236,3,66.7
1008,3/04/2018 12:00,72,112,65,249,3,66.7
1009,3/04/2018 12:05,87,106,69,262,3,66.7
1010,3/04/2018 12:10,83,104,63,250,3,66.7
1011,3/04/2018 12:15,82,103,72,257,3,66.7
1012,3/04/2018 12:20,87,103,55,245,3,66.7
1013,3/04/2018 12:25,76,95,61,232,3,66.7
1014,3/04/2018 12:30,80,107,67,254,3,66.7
1015,3/04/2018 12:35,80,88,70,238,3,66.7
1016,3/04/2018 12:40,83,94,70,247,3,66.7
1017,3/04/2018 12:45,79,97,56,232,3,66.7
1018,3/04/2018 12:50,97,91,69,257,3,66.7
1019,3/04/2018 12:55,89,105,64,258,3,66.7
1020,3/04/2018 13:00,91,103,68,262,3,66.7
1021,3/04/2018 13:05,88,98,73,259,3,66.7
1022,3/04/2018 13:10,79,87,66,232,3,66.7
1023,3/04/2018 13:15,84,105,68,257,3,66.7
1024,3/04/2018 13:20,89,99,69,257,3,66.7
1025,3/04/2018 13:25,82,108,63,253,3,66.7
1026,3/04/2018 13:30,73,89,51,213,3,66.7
1027,3/04/2018 13:35,86,102,78,266,3,66.7
1028,3/04/2018 13:40,83,95,61,239,3,66.7
1029,3/04/2018 13:45,84,76,61,221,3,66.7
1030,3/04/2018 13:50,88,96,66,250,3,66.7
1031,3/04/2018 13:55,85,93,59,237,3,66.7
1032,3/04/2018 14:00,90,90,65,245,3,66.7
1033,3/04/2018 14:05,79,86,68,233,3,66.7
1034,3/04/2018 14:10,99,98,69,266,3,66.7
1035,3/04/2018 14:15,91,83,69,243,3,66.7
1036,3/04/2018 14:20,103,105,77,285,3,66.7
1037,3/04/2018 14:25,83,108,68,259,3,66.7
1038,3/04/2018 14:30,97,92,74,263,3,66.7
1039,3/04/2018 14:35,81,88,66,235,3,66.7
1040,3/04/2018 14:40,80,109,70,259,3,66.7
1041,3/04/2018 14:45,79,93,66,238,3,66.7
1042,3/04/2018 14:50,84,95,61,240,3,66.7
1043,3/04/2018 14:55,83,91,61,235,3,66.7
1044,3/04/2018 15:00,96,84,76,256,3,66.7
1045,3/04/2018 15:05,78,93,57,228,3,66.7
1046,3/04/2018 15:10,74,92,61,227,3,66.7
1047,3/04/2018 15:15,84,100,63,247,3,66.7
1048,3/04/2018 15:20,78,100,69,247,3,66.7
1049,3/04/2018 15:25,96,91,69,256,3,66.7
1050,3/04/2018 15:30,84,114,66,264,3,66.7
1051,3/04/2018 15:35,83,101,63,247,3,66.7
1052,3/04/2018 15:40,78,103,78,259,3,66.7
1053,3/04/2018 15:45,86,106,67,259,3,66.7
1054,3/04/2018 15:50,94,90,73,257,3,66.7
1055,3/04/2018 15:55,82,93,74,249,3,66.7
1056,3/04/2018 16:00,82,98,68,248,3,66.7
1057,3/04/2018 16:05,83,97,74,254,3,66.7
1058,3/04/2018 16:10,80,96,71,247,3,66.7
1059,3/04/2018 16:15,84,93,74,251,3,66.7
1060,3/04/2018 16:20,87,94,69,250,3,66.7
1061,3/04/2018 16:25,73,87,66,226,3,66.7
1062,3/04/2018 16:30,76,106,58,240,3,66.7
1063,3/04/2018 16:35,83,98,65,246,3,66.7
1064,3/04/2018 16:40,69,103,62,234,3,66.7
1065,3/04/2018 16:45,76,108,71,255,3,66.7
1066,3/04/2018 16:50,86,97,72,255,3,66.7
1067,3/04/2018 16:55,78,93,63,234,3,66.7
1068,3/04/2018 17:00,90,100,73,263,3,66.7
1069,3/04/2018 17:05,79,107,81,267,3,66.7
1070,3/04/2018 17:10,79,89,79,247,3,66.7
1071,3/04/2018 17:15,81,99,60,240,3,66.7
1072,3/04/2018 17:20,85,89,78,252,3,0.0
1073,3/04/2018 17:25,96,98,86,280,3,0.0
1074,3/04/2018 17:30,94,97,85,276,3,0.0
1075,3/04/2018 17:35,88,91,80,259,3,0.0
1076,3/04/2018 17:40,91,94,83,268,3,0.0
1077,3/04/2018 17:45,88,87,64,239,3,66.7
1078,3/04/2018 17:50,81,89,74,244,3,66.7
1079,3/04/2018 17:55,83,89,70,242,3,66.7
1080,3/04/2018 18:00,78,101,58,237,3,66.7
1081,3/04/2018 18:05,88,89,76,253,3,66.7
1082,3/04/2018 18:10,86,90,63,239,3,66.7
1083,3/04/2018 18:15,84,92,64,240,3,66.7
1084,3/04/2018 18:20,79,102,54,235,3,66.7
1085,3/04/2018 18:25,76,97,67,240,3,66.7
1086,3/04/2018 18:30,75,97,59,231,3,66.7
1087,3/04/2018 18:35,88,98,67,253,3,66.7
1088,3/04/2018 18:40,75,97,59,231,3,66.7
1089,3/04/2018 18:45,86,115,72,273,3,66.7
1090,3/04/2018 18:50,80,104,68,252,3,66.7
1091,3/04/2018 18:55,75,98,56,229,3,66.7
1092,3/04/2018 19:00,78,87,59,224,3,66.7
1093,3/04/2018 19:05,68,88,57,213,3,66.7
1094,3/04/2018 19:10,72,101,71,244,3,66.7
1095,3/04/2018 19:15,73,94,67,234,3,66.7
1096,3/04/2018 19:20,69,96,67,232,3,66.7
1097,3/04/2018 19:25,67,93,61,221,3,66.7
1098,3/04/2018 19:30,64,91,57,212,3,66.7
1099,3/04/2018 19:35,68,92,57,217,3,66.7
1100,3/04/2018 19:40,67,81,55,203,3,66.7
1101,3/04/2018 19:45,70,88,61,219,3,66.7
1102,3/04/2018 19:50,75,88,60,223,3,66.7
1103,3/04/2018 19:55,62,88,65,215,3,66.7
1104,3/04/2018 20:00,73,83,50,206,3,66.7
1105,3/04/2018 20:05,58,86,59,203,3,66.7
1106,3/04/2018 20:10,52,79,48,179,3,66.7
1107,3/04/2018 20:15,58,91,46,195,3,66.7
1108,3/04/2018 20:20,59,89,58,206,3,66.7
1109,3/04/2018 20:25,60,90,50,200,3,66.7
1110,3/04/2018 20:30,62,90,56,208,3,66.7
1111,3/04/2018 20:35,60,78,47,185,3,66.7
1112,3/04/2018 20:40,61,84,48,193,3,66.7
1113,3/04/2018 20:45,62,95,52,209,3,66.7
1114,3/04/2018 20:50,73,96,63,232,3,66.7
1115,3/04/2018 20:55,60,88,45,193,3,66.7
1116,3/04/2018 21:00,62,98,56,216,3,66.7
1117,3/04/2018 21:05,64,78,50,192,3,66.7
1118,3/04/2018 21:10,75,79,69,223,3,0.0
1119,3/04/2018 21:15,60,70,60,190,3,66.7
1120,3/04/2018 21:20,72,81,62,215,3,66.7
1121,3/04/2018 21:25,63,96,66,225,3,66.7
1122,3/04/2018 21:30,66,71,62,199,3,0.0
1123,3/04/2018 21:35,61,96,64,221,3,66.7
1124,3/04/2018 21:40,54,81,43,178,3,66.7
1125,3/04/2018 21:45,68,85,43,196,3,66.7
1126,3/04/2018 21:50,60,91,57,208,3,66.7
1127,3/04/2018 21:55,47,86,51,184,3,66.7
1128,3/04/2018 22:00,51,83,51,185,3,66.7
1129,3/04/2018 22:05,47,81,47,175,3,66.7
1130,3/04/2018 22:10,57,76,47,180,3,66.7
1131,3/04/2018 22:15,68,84,51,203,3,66.7
1132,3/04/2018 22:20,62,80,48,190,3,66.7
1133,3/04/2018 22:25,52,75,41,168,3,66.7
1134,3/04/2018 22:30,61,90,60,211,3,66.7
1135,3/04/2018 22:35,67,72,63,202,3,0.0
1136,3/04/2018 22:40,57,70,53,180,3,66.7
1137,3/04/2018 22:45,56,70,40,166,3,66.7
1138,3/04/2018 22:50,57,63,55,175,3,0.0
1139,3/04/2018 22:55,55,30,33,118,3,66.7
1140,3/04/2018 23:00,45,79,39,163,3,66.7
1141,3/04/2018 23:05,55,72,56,183,3,66.7
1142,3/04/2018 23:10,59,65,45,169,3,66.7
1143,3/04/2018 23:15,52,70,41,163,3,66.7
1144,3/04/2018 23:20,43,73,41,157,3,66.7
1145,3/04/2018 23:25,55,80,58,193,3,66.7
1146,3/04/2018 23:30,47,72,39,158,3,66.7
1147,3/04/2018 23:35,48,66,35,149,3,66.7
1148,3/04/2018 23:40,48,65,39,152,3,66.7
1149,3/04/2018 23:45,42,74,27,143,3,66.7
1150,3/04/2018 23:50,45,54,42,141,3,66.7
1151,3/04/2018 23:55,45,54,32,131,3,66.7
1152,3/05/2018 0:00,44,60,33,137,3,66.7
1153,3/05/2018 0:05,40,43,27,110,3,66.7
1154,3/05/2018 0:10,42,54,28,124,3,66.7
1155,3/05/2018 0:15,37,57,33,127,3,66.7
1156,3/05/2018 0:20,36,48,21,105,3,66.7
1157,3/05/2018 0:25,38,51,34,123,3,66.7
1158,3/05/2018 0:30,37,53,24,114,3,66.7
1159,3/05/2018 0:35,39,64,23,126,3,66.7
1160,3/05/2018 0:40,32,44,25,101,3,66.7
1161,3/05/2018 0:45,44,47,33,124,3,66.7
1162,3/05/2018 0:50,38,44,24,106,3,66.7
1163,3/05/2018 0:55,32,43,13,88,3,66.7
1164,3/05/2018 1:00,29,51,30,110,3,66.7
1165,3/05/2018 1:05,30,41,14,85,3,66.7
1166,3/05/2018 1:10,30,51,28,109,3,66.7
1167,3/05/2018 1:15,31,28,21,80,3,66.7
1168,3/05/2018 1:20,33,44,19,96,3,66.7
1169,3/05/2018 1:25,30,31,19,80,3,66.7
1170,3/05/2018 1:30,34,42,36,112,3,0.0
1171,3/05/2018 1:35,32,40,35,107,3,0.0
1172,3/05/2018 1:40,26,35,30,91,3,0.0
1173,3/05/2018 1:45,33,42,36,111,3,0.0
1174,3/05/2018 1:50,26,35,30,91,3,0.0
1175,3/05/2018 1:55,27,36,31,94,3,0.0
1176,3/05/2018 2:00,26,35,30,91,3,0.0
1177,3/05/2018 2:05,25,34,29,88,3,0.0
1178,3/05/2018 2:10,28,37,32,97,3,0.0
1179,3/05/2018 2:15,25,34,29,88,3,0.0
1180,3/05/2018 2:20,28,37,32,97,3,0.0
1181,3/05/2018 2:25,26,35,30,91,3,0.0
1182,3/05/2018 2:30,24,33,28,85,3,0.0
1183,3/05/2018 2:35,21,24,2,47,3,66.7
1184,3/05/2018 2:40,18,13,6,37,3,66.7
1185,3/05/2018 2:45,26,21,13,60,3,66.7
1186,3/05/2018 2:50,22,20,11,53,3,66.7
1187,3/05/2018 2:55,17,21,11,49,3,66.7
1188,3/05/2018 3:00,25,12,15,52,3,66.7
1189,3/05/2018 3:05,22,25,13,60,3,66.7
1190,3/05/2018 3:10,18,10,7,35,3,66.7
1191,3/05/2018 3:15,19,22,8,49,3,66.7
1192,3/05/2018 3:20,20,13,8,41,3,66.7
1193,3/05/2018 3:25,18,13,6,37,3,66.7
1194,3/05/2018 3:30,24,22,11,57,3,66.7
1195,3/05/2018 3:35,20,12,10,42,3,66.7
1196,3/05/2018 3:40,19,27,8,54,3,66.7
1197,3/05/2018 3:45,23,22,15,60,3,66.7
1198,3/05/2018 3:50,22,16,13,51,3,66.7
1199,3/05/2018 3:55,20,23,8,51,3,66.7
1200,3/05/2018 4:00,20,26,10,56,3,66.7
1201,3/05/2018 4:05,22,26,13,61,3,66.7
1202,3/05/2018 4:10,20,29,8,57,3,66.7
1203,3/05/2018 4:15,18,24,13,55,3,66.7
1204,3/05/2018 4:20,30,30,14,74,3,66.7
1205,3/05/2018 4:25,26,33,17,76,3,66.7
1206,3/05/2018 4:30,36,44,38,118,3,0.0
1207,3/05/2018 4:35,45,52,45,142,3,0.0
1208,3/05/2018 4:40,41,49,42,132,3,0.0
1209,3/05/2018 4:45,44,51,45,140,3,0.0
1210,3/05/2018 4:50,40,47,41,128,3,0.0
1211,3/05/2018 4:55,46,53,46,145,3,0.0
1212,3/05/2018 5:00,39,47,40,126,3,0.0
1213,3/05/2018 5:05,50,57,50,157,3,0.0
1214,3/05/2018 5:10,48,55,47,150,3,0.0
1215,3/05/2018 5:15,59,65,57,181,3,0.0
1216,3/05/2018 5:20,57,30,15,102,3,66.7
1217,3/05/2018 5:25,36,60,23,119,3,66.7
1218,3/05/2018 5:30,60,66,58,184,3,0.0
1219,3/05/2018 5:35,55,62,54,171,3,0.0
1220,3/05/2018 5:40,43,57,20,120,3,66.7
1221,3/05/2018 5:45,51,56,29,136,3,66.7
1222,3/05/2018 5:50,50,69,32,151,3,66.7
1223,3/05/2018 5:55,48,73,36,157,3,66.7
1224,3/05/2018 6:00,50,56,36,142,3,66.7
1225,3/05/2018 6:05,55,59,39,153,3,66.7
1226,3/05/2018 6:10,62,80,50,192,3,66.7
1227,3/05/2018 6:15,70,75,66,211,3,0.0
1228,3/05/2018 6:20,68,68,39,175,3,66.7
1229,3/05/2018 6:25,52,78,43,173,3,66.7
1230,3/05/2018 6:30,61,80,40,181,3,66.7
1231,3/05/2018 6:35,68,73,64,205,3,0.0
1232,3/05/2018 6:40,79,83,73,235,3,0.0
1233,3/05/2018 6:45,86,90,79,255,3,0.0
1234,3/05/2018 6:50,79,84,73,236,3,0.0
1235,3/05/2018 6:55,60,40,50,150,3,66.7
1236,3/05/2018 7:00,63,78,43,184,3,66.7
1237,3/05/2018 7:05,75,93,63,231,3,66.7
1238,3/05/2018 7:10,80,120,50,250,3,66.7
1239,3/05/2018 7:15,85,89,78,252,3,0.0
1240,3/05/2018 7:20,89,93,81,263,3,0.0
1241,3/05/2018 7:25,93,96,84,273,3,0.0
1242,3/05/2018 7:30,83,87,76,246,3,0.0
1243,3/05/2018 7:35,81,85,74,240,3,0.0
1244,3/05/2018 7:40,81,85,75,241,3,0.0
1245,3/05/2018 7:45,80,84,73,237,3,0.0
1246,3/05/2018 7:50,82,86,75,243,3,0.0
1247,3/05/2018 7:55,77,81,71,229,3,0.0
1248,3/05/2018 8:00,73,78,68,219,3,0.0
1249,3/05/2018 8:05,86,89,79,254,3,0.0
1250,3/05/2018 8:10,100,103,90,293,3,0.0
1251,3/05/2018 8:15,82,86,76,244,3,0.0
1252,3/05/2018 8:20,93,96,84,273,3,0.0
1253,3/05/2018 8:25,86,90,79,255,3,0.0
1254,3/05/2018 8:30,95,97,86,278,3,0.0
1255,3/05/2018 8:35,91,95,83,269,3,0.0
1256,3/05/2018 8:40,85,89,78,252,3,0.0
1257,3/05/2018 8:45,85,89,78,252,3,0.0
1258,3/05/2018 8:50,89,93,81,263,3,0.0
1259,3/05/2018 8:55,85,88,78,251,3,0.0
1260,3/05/2018 9:00,78,82,72,232,3,0.0
1261,3/05/2018 9:05,81,85,75,241,3,0.0
1262,3/05/2018 9:10,85,89,78,252,3,0.0
1263,3/05/2018 9:15,81,85,75,241,3,0.0
1264,3/05/2018 9:20,83,86,76,245,3,0.0
1265,3/05/2018 9:25,70,75,65,210,3,0.0
1266,3/05/2018 9:30,85,89,78,252,3,0.0
1267,3/05/2018 9:35,86,89,78,253,3,0.0
1268,3/05/2018 9:40,91,94,83,268,3,0.0
1269,3/05/2018 9:45,74,78,69,221,3,0.0
1270,3/05/2018 9:50,51,58,50,159,3,0.0
1271,3/05/2018 9:55,85,89,78,252,3,0.0
1272,3/05/2018 10:00,94,97,85,276,3,0.0
1273,3/05/2018 10:05,86,90,79,255,3,0.0
1274,3/05/2018 10:10,74,79,69,222,3,0.0
1275,3/05/2018 10:15,70,75,66,211,3,0.0
1276,3/05/2018 10:20,84,88,77,249,3,0.0
1277,3/05/2018 10:25,80,84,74,238,3,0.0
1278,3/05/2018 10:30,80,84,73,237,3,0.0
1279,3/05/2018 10:35,76,81,71,228,3,0.0
1280,3/05/2018 10:40,80,84,73,237,3,0.0
1281,3/05/2018 10:45,78,82,72,232,3,0.0
1282,3/05/2018 10:50,81,85,75,241,3,0.0
1283,3/05/2018 10:55,88,91,80,259,3,0.0
1284,3/05/2018 11:00,84,87,77,248,3,0.0
1285,3/05/2018 11:05,80,75,75,230,3,66.7
1286,3/05/2018 11:10,79,101,56,236,3,66.7
1287,3/05/2018 11:15,69,93,56,218,3,66.7
1288,3/05/2018 11:20,85,95,68,248,3,66.7
1289,3/05/2018 11:25,69,90,45,204,3,66.7
1290,3/05/2018 11:30,74,95,48,217,3,66.7
1291,3/05/2018 11:35,70,99,48,217,3,66.7
1292,3/05/2018 11:40,80,102,59,241,3,66.7
1293,3/05/2018 11:45,85,99,66,250,3,66.7
1294,3/05/2018 11:50,79,93,66,238,3,66.7
1295,3/05/2018 11:55,81,101,56,238,3,66.7
1296,3/05/2018 12:00,85,101,76,262,3,66.7
1297,3/05/2018 12:05,81,96,69,246,3,66.7
1298,3/05/2018 12:10,90,101,72,263,3,66.7
1299,3/05/2018 12:15,81,105,54,240,3,66.7
1300,3/05/2018 12:20,91,92,71,254,3,66.7
1301,3/05/2018 12:25,65,88,44,197,3,66.7
1302,3/05/2018 12:30,83,76,58,217,3,66.7
1303,3/05/2018 12:35,83,101,64,248,3,66.7
1304,3/05/2018 12:40,76,76,55,207,3,66.7
1305,3/05/2018 12:45,83,81,64,228,3,66.7
1306,3/05/2018 12:50,83,112,70,265,3,66.7
1307,3/05/2018 12:55,83,74,57,214,3,66.7
1308,3/05/2018 13:00,64,70,45,179,3,66.7
1309,3/05/2018 13:05,80,105,67,252,3,66.7
1310,3/05/2018 13:10,79,84,60,223,3,66.7
1311,3/05/2018 13:15,81,88,64,233,3,66.7
1312,3/05/2018 13:20,83,104,74,261,3,66.7
1313,3/05/2018 13:25,84,98,56,238,3,66.7
1314,3/05/2018 13:30,72,89,60,221,3,66.7
1315,3/05/2018 13:35,90,90,58,238,3,66.7
1316,3/05/2018 13:40,82,86,69,237,3,66.7
1317,3/05/2018 13:45,76,89,64,229,3,66.7
1318,3/05/2018 13:50,90,96,63,249,3,66.7
1319,3/05/2018 13:55,84,97,64,245,3,66.7
1320,3/05/2018 14:00,84,68,71,223,3,66.7
1321,3/05/2018 14:05,71,69,52,192,3,66.7
1322,3/05/2018 14:10,81,64,40,185,3,66.7
1323,3/05/2018 14:15,101,70,61,232,3,66.7
1324,3/05/2018 14:20,103,98,92,293,3,66.7
1325,3/05/2018 14:25,92,91,95,278,3,66.7
1326,3/05/2018 14:30,83,83,82,248,3,66.7
1327,3/05/2018 14:35,61,90,63,214,3,66.7
1328,3/05/2018 14:40,83,86,71,240,3,66.7
1329,3/05/2018 14:45,89,98,83,270,3,66.7
1330,3/05/2018 14:50,92,80,67,239,3,66.7
1331,3/05/2018 14:55,70,69,60,199,3,66.7
1332,3/05/2018 15:00,88,70,56,214,3,66.7
1333,3/05/2018 15:05,92,81,84,257,3,66.7
1334,3/05/2018 15:10,102,83,85,270,3,66.7
1335,3/05/2018 15:15,91,73,59,223,3,66.7
1336,3/05/2018 15:20,87,87,90,264,3,66.7
1337,3/05/2018 15:25,93,62,68,223,3,66.7
1338,3/05/2018 15:30,89,69,63,221,3,66.7
1339,3/05/2018 15:35,92,79,66,237,3,66.7
1340,3/05/2018 15:40,95,73,58,226,3,66.7
1341,3/05/2018 15:45,87,88,75,250,3,66.7
1342,3/05/2018 15:50,98,66,62,226,3,66.7
1343,3/05/2018 15:55,86,69,64,219,3,66.7
1344,3/05/2018 16:00,93,38,31,162,3,66.7
1345,3/05/2018 16:05,104,46,42,192,3,66.7
1346,3/05/2018 16:10,91,24,39,154,3,66.7
1347,3/05/2018 16:15,90,28,26,144,3,66.7
1348,3/05/2018 16:20,57,45,38,140,3,66.7
1349,3/05/2018 16:25,73,68,76,217,3,66.7
1350,3/05/2018 16:30,95,67,71,233,3,66.7
1351,3/05/2018 16:35,105,80,78,263,3,66.7
1352,3/05/2018 16:40,83,97,86,266,3,66.7
1353,3/05/2018 16:45,94,60,66,220,3,66.7
1354,3/05/2018 16:50,92,57,56,205,3,66.7
1355,3/05/2018 16:55,99,75,71,245,3,66.7
1356,3/05/2018 17:00,101,70,48,219,3,66.7
1357,3/05/2018 17:05,78,74,58,210,3,66.7
1358,3/05/2018 17:10,86,85,62,233,3,66.7
1359,3/05/2018 17:15,101,86,69,256,3,66.7
1360,3/05/2018 17:20,89,63,52,204,3,66.7
1361,3/05/2018 17:25,84,57,61,202,3,66.7
1362,3/05/2018 17:30,89,54,47,190,3,66.7
1363,3/05/2018 17:35,74,63,60,197,3,66.7
1364,3/05/2018 17:40,87,57,51,195,3,66.7
1365,3/05/2018 17:45,92,74,63,229,3,66.7
1366,3/05/2018 17:50,94,69,61,224,3,66.7
1367,3/05/2018 17:55,82,72,85,239,3,66.7
1368,3/05/2018 18:00,85,79,88,252,3,66.7
1369,3/05/2018 18:05,85,70,65,220,3,66.7
1370,3/05/2018 18:10,91,59,51,201,3,66.7
1371,3/05/2018 18:15,93,69,76,238,3,66.7
1372,3/05/2018 18:20,88,62,54,204,3,66.7
1373,3/05/2018 18:25,88,77,72,237,3,66.7
1374,3/05/2018 18:30,85,66,74,225,3,66.7
1375,3/05/2018 18:35,81,68,84,233,3,66.7
1376,3/05/2018 18:40,81,77,62,220,3,66.7
1377,3/05/2018 18:45,62,66,46,174,3,66.7
1378,3/05/2018 18:50,80,77,61,218,3,66.7
1379,3/05/2018 18:55,77,99,63,239,3,66.7
1380,3/05/2018 19:00,94,86,79,259,3,66.7
1381,3/05/2018 19:05,81,90,56,227,3,66.7
1382,3/05/2018 19:10,89,75,50,214,3,66.7
1383,3/05/2018 19:15,93,96,65,254,3,66.7
1384,3/05/2018 19:20,88,101,70,259,3,66.7
1385,3/05/2018 19:25,67,86,52,205,3,66.7
1386,3/05/2018 19:30,79,95,66,240,3,66.7
1387,3/05/2018 19:35,75,90,54,219,3,66.7
1388,3/05/2018 19:40,86,94,57,237,3,66.7
1389,3/05/2018 19:45,99,101,67,267,3,66.7
1390,3/05/2018 19:50,76,86,60,222,3,66.7
1391,3/05/2018 19:55,85,95,62,242,3,66.7
1392,3/05/2018 20:00,87,98,71,256,3,66.7
1393,3/05/2018 20:05,83,94,61,238,3,66.7
1394,3/05/2018 20:10,78,77,63,218,3,66.7
1395,3/05/2018 20:15,87,94,65,246,3,66.7
1396,3/05/2018 20:20,88,90,69,247,3,66.7
1397,3/05/2018 20:25,79,91,66,236,3,66.7
1398,3/05/2018 20:30,73,95,65,233,3,66.7
1399,3/05/2018 20:35,77,90,56,223,3,66.7
1400,3/05/2018 20:40,74,96,53,223,3,66.7
1401,3/05/2018 20:45,68,85,37,190,3,66.7
1402,3/05/2018 20:50,75,93,66,234,3,66.7
1403,3/05/2018 20:55,69,87,50,206,3,66.7
1404,3/05/2018 21:00,70,96,53,219,3,66.7
1405,3/05/2018 21:05,70,98,60,228,3,66.7
1406,3/05/2018 21:10,70,104,58,232,3,66.7
1407,3/05/2018 21:15,68,103,55,226,3,66.7
1408,3/05/2018 21:20,76,99,52,227,3,66.7
1409,3/05/2018 21:25,70,111,68,249,3,66.7
1410,3/05/2018 21:30,66,81,50,197,3,66.7
1411,3/05/2018 21:35,66,104,53,223,3,66.7
1412,3/05/2018 21:40,66,77,44,187,3,66.7
1413,3/05/2018 21:45,55,90,53,198,3,66.7
1414,3/05/2018 21:50,61,79,41,181,3,66.7
1415,3/05/2018 21:55,64,89,63,216,3,66.7
1416,3/05/2018 22:00,64,83,45,192,3,66.7
1417,3/05/2018 22:05,62,88,49,199,3,66.7
1418,3/05/2018 22:10,75,93,58,226,3,66.7
1419,3/05/2018 22:15,62,93,54,209,3,66.7
1420,3/05/2018 22:20,69,87,56,212,3,66.7
1421,3/05/2018 22:25,76,83,59,218,3,66.7
1422,3/05/2018 22:30,55,83,58,196,3,66.7
1423,3/05/2018 22:35,61,77,58,196,3,66.7
1424,3/05/2018 22:40,57,85,36,178,3,66.7
1425,3/05/2018 22:45,65,83,55,203,3,66.7
1426,3/05/2018 22:50,49,72,43,164,3,66.7
1427,3/05/2018 22:55,51,77,42,170,3,66.7
1428,3/05/2018 23:00,44,78,37,159,3,66.7
1429,3/05/2018 23:05,45,75,46,166,3,66.7
1430,3/05/2018 23:10,54,64,32,150,3,66.7
1431,3/05/2018 23:15,34,69,25,128,3,66.7
1432,3/05/2018 23:20,49,71,38,158,3,66.7
1433,3/05/2018 23:25,42,78,38,158,3,66.7
1434,3/05/2018 23:30,38,60,26,124,3,66.7
1435,3/05/2018 23:35,37,61,36,134,3,66.7
1436,3/05/2018 23:40,46,69,30,145,3,66.7
1437,3/05/2018 23:45,37,55,38,130,3,66.7
1438,3/05/2018 23:50,39,58,34,131,3,66.7
1439,3/05/2018 23:55,42,58,29,129,3,66.7
1440,3/06/2018 0:00,38,57,31,126,3,66.7
1441,3/06/2018 0:05,41,54,21,116,3,66.7
1442,3/06/2018 0:10,27,58,22,107,3,66.7
1443,3/06/2018 0:15,36,57,30,123,3,66.7
1444,3/06/2018 0:20,35,51,19,105,3,66.7
1445,3/06/2018 0:25,39,63,29,131,3,66.7
1446,3/06/2018 0:30,34,65,28,127,3,66.7
1447,3/06/2018 0:35,31,53,21,105,3,66.7
1448,3/06/2018 0:40,28,48,22,98,3,66.7
1449,3/06/2018 0:45,40,54,22,116,3,66.7
1450,3/06/2018 0:50,30,42,23,95,3,66.7
1451,3/06/2018 0:55,30,42,17,89,3,66.7
1452,3/06/2018 1:00,28,29,18,75,3,66.7
1453,3/06/2018 1:05,26,33,17,76,3,66.7
1454,3/06/2018 1:10,28,38,23,89,3,66.7
1455,3/06/2018 1:15,28,39,20,87,3,66.7
1456,3/06/2018 1:20,28,37,32,97,3,0.0
1457,3/06/2018 1:25,28,37,32,97,3,0.0
1458,3/06/2018 1:30,28,37,32,97,3,0.0
1459,3/06/2018 1:35,19,0,10,29,3,66.7
1460,3/06/2018 1:40,28,31,11,70,3,66.7
1461,3/06/2018 1:45,24,34,15,73,3,66.7
1462,3/06/2018 1:50,23,32,14,69,3,66.7
1463,3/06/2018 1:55,31,23,14,68,3,66.7
1464,3/06/2018 2:00,11,33,13,57,3,66.7
1465,3/06/2018 2:05,20,2,2,24,3,66.7
1466,3/06/2018 2:10,16,9,6,31,3,66.7
1467,3/06/2018 2:15,20,11,4,35,3,66.7
1468,3/06/2018 2:20,16,13,7,36,3,66.7
1469,3/06/2018 2:25,39,67,22,128,3,66.7
1470,3/06/2018 2:30,41,50,30,121,3,66.7
1471,3/06/2018 2:35,17,19,8,44,3,66.7
1472,3/06/2018 2:40,23,27,12,62,3,66.7
1473,3/06/2018 2:45,29,21,16,66,3,66.7
1474,3/06/2018 2:50,26,29,16,71,3,66.7
1475,3/06/2018 2:55,19,15,9,43,3,66.7
1476,3/06/2018 3:00,22,16,10,48,3,66.7
1477,3/06/2018 3:05,25,26,12,63,3,66.7
1478,3/06/2018 3:10,17,27,7,51,3,66.7
1479,3/06/2018 3:15,20,10,9,39,3,66.7
1480,3/06/2018 3:20,20,20,11,51,3,66.7
1481,3/06/2018 3:25,22,15,11,48,3,66.7
1482,3/06/2018 3:30,25,28,14,67,3,66.7
1483,3/06/2018 3:35,22,20,10,52,3,66.7
1484,3/06/2018 3:40,19,22,9,50,3,66.7
1485,3/06/2018 3:45,28,28,23,79,3,66.7
1486,3/06/2018 3:50,32,40,35,107,3,0.0
1487,3/06/2018 3:55,28,37,32,97,3,0.0
1488,3/06/2018 4:00,23,32,28,83,3,0.0
1489,3/06/2018 4:05,29,37,32,98,3,0.0
1490,3/06/2018 4:10,27,36,31,94,3,0.0
1491,3/06/2018 4:15,25,16,12,53,3,66.7
1492,3/06/2018 4:20,21,45,20,86,3,66.7
1493,3/06/2018 4:25,30,39,34,103,3,0.0
1494,3/06/2018 4:30,39,47,41,127,3,0.0
1495,3/06/2018 4:35,45,52,45,142,3,0.0
1496,3/06/2018 4:40,43,50,43,136,3,0.0
1497,3/06/2018 4:45,46,54,47,147,3,0.0
1498,3/06/2018 4:50,30,34,12,76,3,66.7
1499,3/06/2018 4:55,37,43,18,98,3,66.7
1500,3/06/2018 5:00,42,49,43,134,3,0.0
1501,3/06/2018 5:05,49,56,49,154,3,0.0
1502,3/06/2018 5:10,57,63,55,175,3,0.0
1503,3/06/2018 5:15,55,61,53,169,3,0.0
1504,3/06/2018 5:20,58,64,56,178,3,0.0
1505,3/06/2018 5:25,57,10,10,77,3,66.7
1506,3/06/2018 5:30,61,67,58,186,3,0.0
1507,3/06/2018 5:35,58,64,56,178,3,0.0
1508,3/06/2018 5:40,72,77,67,216,3,0.0
1509,3/06/2018 5:45,55,58,43,156,3,66.7
1510,3/06/2018 5:50,65,71,62,198,3,0.0
1511,3/06/2018 5:55,65,70,61,196,3,0.0
1512,3/06/2018 6:00,56,62,54,172,3,0.0
1513,3/06/2018 6:05,68,73,64,205,3,0.0
1514,3/06/2018 6:10,71,76,67,214,3,0.0
1515,3/06/2018 6:15,69,74,65,208,3,0.0
1516,3/06/2018 6:20,55,84,36,175,3,66.7
1517,3/06/2018 6:25,55,79,40,174,3,66.7
1518,3/06/2018 6:30,52,77,41,170,3,66.7
1519,3/06/2018 6:35,74,74,53,201,3,66.7
1520,3/06/2018 6:40,69,108,51,228,3,66.7
1521,3/06/2018 6:45,66,91,45,202,3,66.7
1522,3/06/2018 6:50,71,86,45,202,3,66.7
1523,3/06/2018 6:55,63,98,59,220,3,66.7
1524,3/06/2018 7:00,66,96,61,223,3,66.7
1525,3/06/2018 7:05,70,105,53,228,3,66.7
1526,3/06/2018 7:10,72,89,62,223,3,66.7
1527,3/06/2018 7:15,91,122,68,281,3,66.7
1528,3/06/2018 7:20,79,118,74,271,3,66.7
1529,3/06/2018 7:25,79,109,63,251,3,66.7
1530,3/06/2018 7:30,87,102,83,272,3,66.7
1531,3/06/2018 7:35,75,99,57,231,3,66.7
1532,3/06/2018 7:40,85,102,58,245,3,66.7
1533,3/06/2018 7:45,80,98,63,241,3,66.7
1534,3/06/2018 7:50,83,104,66,253,3,66.7
1535,3/06/2018 7:55,71,98,53,222,3,66.7
1536,3/06/2018 8:00,74,100,58,232,3,66.7
1537,3/06/2018 8:05,70,92,51,213,3,66.7
1538,3/06/2018 8:10,79,83,65,227,3,66.7
1539,3/06/2018 8:15,86,89,58,233,3,66.7
1540,3/06/2018 8:20,87,97,61,245,3,66.7
1541,3/06/2018 8:25,85,98,60,243,3,66.7
1542,3/06/2018 8:30,86,85,63,234,3,66.7
1543,3/06/2018 8:35,85,84,57,226,3,66.7
1544,3/06/2018 8:40,63,92,46,201,3,66.7
1545,3/06/2018 8:45,77,88,69,234,3,66.7
1546,3/06/2018 8:50,69,91,65,225,3,66.7
1547,3/06/2018 8:55,77,83,62,222,3,66.7
1548,3/06/2018 9:00,72,82,61,215,3,66.7
1549,3/06/2018 9:05,67,82,56,205,3,66.7
1550,3/06/2018 9:10,69,87,47,203,3,66.7
1551,3/06/2018 9:15,45,50,35,130,3,66.7
1552,3/06/2018 9:20,81,92,67,240,3,66.7
1553,3/06/2018 9:25,79,96,57,232,3,66.7
1554,3/06/2018 9:30,79,102,48,229,3,66.7
1555,3/06/2018 9:35,81,102,57,240,3,66.7
1556,3/06/2018 9:40,85,96,54,235,3,66.7
1557,3/06/2018 9:45,68,91,47,206,3,66.7
1558,3/06/2018 9:50,77,89,59,225,3,66.7
1559,3/06/2018 9:55,81,88,64,233,3,66.7
1560,3/06/2018 10:00,66,104,55,225,3,66.7
1561,3/06/2018 10:05,55,82,49,186,3,66.7
1562,3/06/2018 10:10,72,78,59,209,3,66.7
1563,3/06/2018 10:15,66,83,49,198,3,66.7
1564,3/06/2018 10:20,68,88,58,214,3,66.7
1565,3/06/2018 10:25,68,85,43,196,3,66.7
1566,3/06/2018 10:30,66,85,52,203,3,66.7
1567,3/06/2018 10:35,71,93,56,220,3,66.7
1568,3/06/2018 10:40,67,80,49,196,3,66.7
1569,3/06/2018 10:45,81,109,67,257,3,66.7
1570,3/06/2018 10:50,78,81,49,208,3,66.7
1571,3/06/2018 10:55,73,84,51,208,3,66.7
1572,3/06/2018 11:00,73,94,53,220,3,66.7
1573,3/06/2018 11:05,74,91,50,215,3,66.7
1574,3/06/2018 11:10,83,88,56,227,3,66.7
1575,3/06/2018 11:15,93,113,64,270,3,66.7
1576,3/06/2018 11:20,81,105,56,242,3,66.7
1577,3/06/2018 11:25,80,96,54,230,3,66.7
1578,3/06/2018 11:30,79,106,57,242,3,66.7
1579,3/06/2018 11:35,85,102,57,244,3,66.7
1580,3/06/2018 11:40,82,89,58,229,3,66.7
1581,3/06/2018 11:45,82,92,59,233,3,66.7
1582,3/06/2018 11:50,89,104,68,261,3,66.7
1583,3/06/2018 11:55,71,89,45,205,3,66.7
1584,3/06/2018 12:00,66,81,50,197,3,66.7
1585,3/06/2018 12:05,84,80,65,229,3,66.7
1586,3/06/2018 12:10,84,79,54,217,3,66.7
1587,3/06/2018 12:15,88,94,64,246,3,66.7
1588,3/06/2018 12:20,79,95,50,224,3,66.7
1589,3/06/2018 12:25,92,97,72,261,3,66.7
1590,3/06/2018 12:30,86,87,61,234,3,66.7
1591,3/06/2018 12:35,81,102,67,250,3,66.7
1592,3/06/2018 12:40,84,90,64,238,3,66.7
1593,3/06/2018 12:45,79,101,62,242,3,66.7
1594,3/06/2018 12:50,89,109,72,270,3,66.7
1595,3/06/2018 12:55,90,88,71,249,3,66.7
1596,3/06/2018 13:00,90,103,69,262,3,66.7
1597,3/06/2018 13:05,78,107,69,254,3,66.7
1598,3/06/2018 13:10,89,103,65,257,3,66.7
1599,3/06/2018 13:15,91,106,68,265,3,66.7
1600,3/06/2018 13:20,93,88,62,243,3,66.7
1601,3/06/2018 13:25,74,95,60,229,3,66.7
1602,3/06/2018 13:30,93,101,63,257,3,66.7
1603,3/06/2018 13:35,85,96,61,242,3,66.7
1604,3/06/2018 13:40,71,92,55,218,3,66.7
1605,3/06/2018 13:45,87,89,58,234,3,66.7
1606,3/06/2018 13:50,88,97,69,254,3,66.7
1607,3/06/2018 13:55,96,104,60,260,3,66.7
1608,3/06/2018 14:00,81,99,59,239,3,66.7
1609,3/06/2018 14:05,68,78,50,196,3,66.7
1610,3/06/2018 14:10,83,86,69,238,3,66.7
1611,3/06/2018 14:15,108,100,75,283,3,66.7
1612,3/06/2018 14:20,80,100,69,249,3,66.7
1613,3/06/2018 14:25,81,91,64,236,3,66.7
1614,3/06/2018 14:30,79,96,74,249,3,66.7
1615,3/06/2018 14:35,85,86,66,237,3,66.7
1616,3/06/2018 14:40,91,104,81,276,3,66.7
1617,3/06/2018 14:45,93,98,57,248,3,66.7
1618,3/06/2018 14:50,94,93,84,271,3,66.7
1619,3/06/2018 14:55,74,85,71,230,3,66.7
1620,3/06/2018 15:00,84,73,70,227,3,66.7
1621,3/06/2018 15:05,78,61,81,220,3,66.7
1622,3/06/2018 15:10,95,71,62,228,3,66.7
1623,3/06/2018 15:15,103,65,66,234,3,66.7
1624,3/06/2018 15:20,100,66,69,235,3,66.7
1625,3/06/2018 15:25,99,52,45,196,3,66.7
1626,3/06/2018 15:30,86,78,70,234,3,66.7
1627,3/06/2018 15:35,88,69,76,233,3,66.7
1628,3/06/2018 15:40,86,86,89,261,3,66.7
1629,3/06/2018 15:45,89,85,62,236,3,66.7
1630,3/06/2018 15:50,79,72,61,212,3,66.7
1631,3/06/2018 15:55,87,76,71,234,3,66.7
1632,3/06/2018 16:00,89,73,76,238,3,66.7
1633,3/06/2018 16:05,71,60,57,188,3,66.7
1634,3/06/2018 16:10,90,68,70,228,3,66.7
1635,3/06/2018 16:15,83,81,71,235,3,66.7
1636,3/06/2018 16:20,91,74,71,236,3,66.7
1637,3/06/2018 16:25,87,69,48,204,3,66.7
1638,3/06/2018 16:30,107,66,60,233,3,66.7
1639,3/06/2018 16:35,99,92,79,270,3,66.7
1640,3/06/2018 16:40,96,73,61,230,3,66.7
1641,3/06/2018 16:45,88,75,59,222,3,66.7
1642,3/06/2018 16:50,86,65,60,211,3,66.7
1643,3/06/2018 16:55,95,63,52,210,3,66.7
1644,3/06/2018 17:00,95,57,54,206,3,66.7
1645,3/06/2018 17:05,85,56,37,178,3,66.7
1646,3/06/2018 17:10,93,53,44,190,3,66.7
1647,3/06/2018 17:15,98,58,49,205,3,66.7
1648,3/06/2018 17:20,99,53,39,191,3,66.7
1649,3/06/2018 17:25,88,56,54,198,3,66.7
1650,3/06/2018 17:30,94,65,67,226,3,66.7
1651,3/06/2018 17:35,91,58,53,202,3,66.7
1652,3/06/2018 17:40,81,61,68,210,3,66.7
1653,3/06/2018 17:45,73,49,48,170,3,66.7
1654,3/06/2018 17:50,66,75,68,209,3,66.7
1655,3/06/2018 17:55,78,62,70,210,3,66.7
1656,3/06/2018 18:00,82,57,57,196,3,66.7
1657,3/06/2018 18:05,100,68,60,228,3,66.7
1658,3/06/2018 18:10,103,65,59,227,3,66.7
1659,3/06/2018 18:15,89,60,52,201,3,66.7
1660,3/06/2018 18:20,81,80,70,231,3,66.7
1661,3/06/2018 18:25,81,66,53,200,3,66.7
1662,3/06/2018 18:30,80,58,54,192,3,66.7
1663,3/06/2018 18:35,86,82,66,234,3,66.7
1664,3/06/2018 18:40,90,76,78,244,3,66.7
1665,3/06/2018 18:45,87,80,65,232,3,66.7
1666,3/06/2018 18:50,95,92,47,234,3,66.7
1667,3/06/2018 18:55,91,86,55,232,3,66.7
1668,3/06/2018 19:00,79,108,72,259,3,66.7
1669,3/06/2018 19:05,86,102,66,254,3,66.7
1670,3/06/2018 19:10,89,99,68,256,3,66.7
1671,3/06/2018 19:15,94,105,68,267,3,66.7
1672,3/06/2018 19:20,87,98,82,267,3,66.7
1673,3/06/2018 19:25,83,96,60,239,3,66.7
1674,3/06/2018 19:30,83,89,55,227,3,66.7
1675,3/06/2018 19:35,72,86,53,211,3,66.7
1676,3/06/2018 19:40,83,81,55,219,3,66.7
1677,3/06/2018 19:45,82,92,52,226,3,66.7
1678,3/06/2018 19:50,86,82,57,225,3,66.7
1679,3/06/2018 19:55,66,82,47,195,3,66.7
1680,3/06/2018 20:00,70,83,45,198,3,66.7
1681,3/06/2018 20:05,69,97,48,214,3,66.7
1682,3/06/2018 20:10,84,112,65,261,3,66.7
1683,3/06/2018 20:15,85,97,65,247,3,66.7
1684,3/06/2018 20:20,88,118,77,283,3,66.7
1685,3/06/2018 20:25,84,97,67,248,3,66.7
1686,3/06/2018 20:30,85,108,62,255,3,66.7
1687,3/06/2018 20:35,72,86,65,223,3,66.7
1688,3/06/2018 20:40,83,91,63,237,3,66.7
1689,3/06/2018 20:45,67,101,63,231,3,66.7
1690,3/06/2018 20:50,75,87,66,228,3,66.7
1691,3/06/2018 20:55,76,95,59,230,3,66.7
1692,3/06/2018 21:00,71,93,62,226,3,66.7
1693,3/06/2018 21:05,67,90,57,214,3,66.7
1694,3/06/2018 21:10,81,103,69,253,3,66.7
1695,3/06/2018 21:15,80,105,75,260,3,66.7
1696,3/06/2018 21:20,86,95,56,237,3,66.7
1697,3/06/2018 21:25,69,106,70,245,3,66.7
1698,3/06/2018 21:30,73,102,76,251,3,66.7
1699,3/06/2018 21:35,68,86,52,206,3,66.7
1700,3/06/2018 21:40,74,99,62,235,3,66.7
1701,3/06/2018 21:45,72,103,55,230,3,66.7
1702,3/06/2018 21:50,71,101,61,233,3,66.7
1703,3/06/2018 21:55,57,84,37,178,3,66.7
1704,3/06/2018 22:00,62,80,59,201,3,66.7
1705,3/06/2018 22:05,58,87,47,192,3,66.7
1706,3/06/2018 22:10,59,91,46,196,3,66.7
1707,3/06/2018 22:15,75,96,56,227,3,66.7
1708,3/06/2018 22:20,61,94,64,219,3,66.7
1709,3/06/2018 22:25,65,96,64,225,3,66.7
1710,3/06/2018 22:30,62,90,58,210,3,66.7
1711,3/06/2018 22:35,60,85,54,199,3,66.7
1712,3/06/2018 22:40,60,80,46,186,3,66.7
1713,3/06/2018 22:45,62,85,58,205,3,66.7
1714,3/06/2018 22:50,54,75,59,188,3,66.7
1715,3/06/2018 22:55,63,95,54,212,3,66.7
1716,3/06/2018 23:00,60,71,37,168,3,66.7
1717,3/06/2018 23:05,38,51,26,115,3,66.7
1718,3/06/2018 23:10,51,76,46,173,3,66.7
1719,3/06/2018 23:15,59,75,45,179,3,66.7
1720,3/06/2018 23:20,49,56,32,137,3,66.7
1721,3/06/2018 23:25,51,58,32,141,3,66.7
1722,3/06/2018 23:30,50,59,33,142,3,66.7
1723,3/06/2018 23:35,47,63,26,136,3,66.7
1724,3/06/2018 23:40,55,62,37,154,3,66.7
1725,3/06/2018 23:45,49,62,36,147,3,66.7
1726,3/06/2018 23:50,40,64,31,135,3,66.7
1727,3/06/2018 23:55,39,56,25,120,3,66.7
1728,3/07/2018 0:00,40,46,33,119,3,66.7
1729,3/07/2018 0:05,43,57,31,131,3,66.7
1730,3/07/2018 0:10,44,67,33,144,3,66.7
1731,3/07/2018 0:15,44,60,39,143,3,66.7
1732,3/07/2018 0:20,43,51,33,127,3,66.7
1733,3/07/2018 0:25,42,45,31,118,3,66.7
1734,3/07/2018 0:30,39,58,22,119,3,66.7
1735,3/07/2018 0:35,34,53,26,113,3,66.7
1736,3/07/2018 0:40,38,65,31,134,3,66.7
1737,3/07/2018 0:45,38,46,21,105,3,66.7
1738,3/07/2018 0:50,29,39,27,95,3,66.7
1739,3/07/2018 0:55,32,41,26,99,3,66.7
1740,3/07/2018 1:00,28,26,19,73,3,66.7
1741,3/07/2018 1:05,29,38,14,81,3,66.7
1742,3/07/2018 1:10,38,50,24,112,3,66.7
1743,3/07/2018 1:15,36,36,25,97,3,66.7
1744,3/07/2018 1:20,29,32,15,76,3,66.7
1745,3/07/2018 1:25,28,43,16,87,3,66.7
1746,3/07/2018 1:30,25,32,13,70,3,66.7
1747,3/07/2018 1:35,28,24,17,69,3,66.7
1748,3/07/2018 1:40,31,46,19,96,3,66.7
1749,3/07/2018 1:45,36,39,24,99,3,66.7
1750,3/07/2018 1:50,31,35,18,84,3,66.7
1751,3/07/2018 1:55,40,48,41,129,3,0.0
1752,3/07/2018 2:00,31,39,34,104,3,0.0
1753,3/07/2018 2:05,29,38,32,99,3,0.0
1754,3/07/2018 2:10,34,27,17,78,3,66.7
1755,3/07/2018 2:15,33,30,19,82,3,66.7
1756,3/07/2018 2:20,24,27,14,65,3,66.7
1757,3/07/2018 2:25,22,32,11,65,3,66.7
1758,3/07/2018 2:30,22,23,15,60,3,66.7
1759,3/07/2018 2:35,25,20,9,54,3,66.7
1760,3/07/2018 2:40,27,33,20,80,3,66.7
1761,3/07/2018 2:45,23,26,13,62,3,66.7
1762,3/07/2018 2:50,21,30,10,61,3,66.7
1763,3/07/2018 2:55,26,35,30,91,3,0.0
1764,3/07/2018 3:00,24,33,28,85,3,0.0
1765,3/07/2018 3:05,26,35,30,91,3,0.0
1766,3/07/2018 3:10,26,23,7,56,3,66.7
1767,3/07/2018 3:15,23,20,11,54,3,66.7
1768,3/07/2018 3:20,25,20,14,59,3,66.7
1769,3/07/2018 3:25,21,20,12,53,3,66.7
1770,3/07/2018 3:30,23,21,11,55,3,66.7
1771,3/07/2018 3:35,32,29,21,82,3,66.7
1772,3/07/2018 3:40,30,24,17,71,3,66.7
1773,3/07/2018 3:45,23,20,12,55,3,66.7
1774,3/07/2018 3:50,27,36,31,94,3,0.0
1775,3/07/2018 3:55,29,38,33,100,3,0.0
1776,3/07/2018 4:00,29,38,32,99,3,0.0
1777,3/07/2018 4:05,32,40,34,106,3,0.0
1778,3/07/2018 4:10,29,38,32,99,3,0.0
1779,3/07/2018 4:15,31,39,34,104,3,0.0
1780,3/07/2018 4:20,31,39,34,104,3,0.0
1781,3/07/2018 4:25,35,43,38,116,3,0.0
1782,3/07/2018 4:30,36,44,38,118,3,0.0
1783,3/07/2018 4:35,38,46,39,123,3,0.0
1784,3/07/2018 4:40,31,20,10,61,3,66.7
1785,3/07/2018 4:45,29,47,15,91,3,66.7
1786,3/07/2018 4:50,37,43,23,103,3,66.7
1787,3/07/2018 4:55,32,48,22,102,3,66.7
1788,3/07/2018 5:00,27,40,18,85,3,66.7
1789,3/07/2018 5:05,33,38,16,87,3,66.7
1790,3/07/2018 5:10,49,42,25,116,3,66.7
1791,3/07/2018 5:15,42,57,31,130,3,66.7
1792,3/07/2018 5:20,37,50,23,110,3,66.7
1793,3/07/2018 5:25,38,54,25,117,3,66.7
1794,3/07/2018 5:30,48,58,40,146,3,66.7
1795,3/07/2018 5:35,65,70,61,196,3,0.0
1796,3/07/2018 5:40,70,75,66,211,3,0.0
1797,3/07/2018 5:45,77,82,72,231,3,0.0
1798,3/07/2018 5:50,64,70,61,195,3,0.0
1799,3/07/2018 5:55,47,59,40,146,3,66.7
1800,3/07/2018 6:00,48,51,37,136,3,66.7
1801,3/07/2018 6:05,57,70,49,176,3,66.7
1802,3/07/2018 6:10,60,78,39,177,3,66.7
1803,3/07/2018 6:15,67,90,51,208,3,66.7
1804,3/07/2018 6:20,66,91,52,209,3,66.7
1805,3/07/2018 6:25,57,84,51,192,3,66.7
1806,3/07/2018 6:30,66,94,46,206,3,66.7
1807,3/07/2018 6:35,57,94,50,201,3,66.7
1808,3/07/2018 6:40,79,97,65,241,3,66.7
1809,3/07/2018 6:45,85,101,59,245,3,66.7
1810,3/07/2018 6:50,82,97,63,242,3,66.7
1811,3/07/2018 6:55,73,91,56,220,3,66.7
1812,3/07/2018 7:00,72,95,64,231,3,66.7
1813,3/07/2018 7:05,77,99,58,234,3,66.7
1814,3/07/2018 7:10,66,102,62,230,3,66.7
1815,3/07/2018 7:15,94,99,60,253,3,66.7
1816,3/07/2018 7:20,82,113,68,263,3,66.7
1817,3/07/2018 7:25,80,114,64,258,3,66.7
1818,3/07/2018 7:30,79,92,67,238,3,66.7
1819,3/07/2018 7:35,84,106,65,255,3,66.7
1820,3/07/2018 7:40,71,106,50,227,3,66.7
1821,3/07/2018 7:45,82,109,65,256,3,66.7
1822,3/07/2018 7:50,75,106,66,247,3,66.7
1823,3/07/2018 7:55,72,101,68,241,3,66.7
1824,3/07/2018 8:00,73,97,56,226,3,66.7
1825,3/07/2018 8:05,88,96,65,249,3,66.7
1826,3/07/2018 8:10,85,105,67,257,3,66.7
1827,3/07/2018 8:15,95,102,71,268,3,66.7
1828,3/07/2018 8:20,88,102,67,257,3,66.7
1829,3/07/2018 8:25,76,89,57,222,3,66.7
1830,3/07/2018 8:30,93,105,60,258,3,66.7
1831,3/07/2018 8:35,76,88,57,221,3,66.7
1832,3/07/2018 8:40,80,94,51,225,3,66.7
1833,3/07/2018 8:45,72,98,65,235,3,66.7
1834,3/07/2018 8:50,91,93,65,249,3,66.7
1835,3/07/2018 8:55,66,100,59,225,3,66.7
1836,3/07/2018 9:00,66,94,51,211,3,66.7
1837,3/07/2018 9:05,66,75,47,188,3,66.7
1838,3/07/2018 9:10,70,103,73,246,3,66.7
1839,3/07/2018 9:15,135,103,60,298,3,0.0
1840,3/07/2018 9:20,74,88,64,226,3,66.7
1841,3/07/2018 9:25,81,108,59,248,3,66.7
1842,3/07/2018 9:30,72,99,54,225,3,66.7
1843,3/07/2018 9:35,68,77,45,190,3,66.7
1844,3/07/2018 9:40,74,94,54,222,3,66.7
1845,3/07/2018 9:45,65,93,50,208,3,66.7
1846,3/07/2018 9:50,70,94,46,210,3,66.7
1847,3/07/2018 9:55,72,82,55,209,3,66.7
1848,3/07/2018 10:00,65,94,41,200,3,66.7
1849,3/07/2018 10:05,80,94,60,234,3,66.7
1850,3/07/2018 10:10,75,92,54,221,3,66.7
1851,3/07/2018 10:15,80,95,62,237,3,66.7
1852,3/07/2018 10:20,70,89,52,211,3,66.7
1853,3/07/2018 10:25,72,92,54,218,3,66.7
1854,3/07/2018 10:30,81,99,72,252,3,66.7
1855,3/07/2018 10:35,72,85,48,205,3,66.7
1856,3/07/2018 10:40,80,97,64,241,3,66.7
1857,3/07/2018 10:45,82,90,71,243,3,66.7
1858,3/07/2018 10:50,78,98,66,242,3,66.7
1859,3/07/2018 10:55,71,95,64,230,3,66.7
1860,3/07/2018 11:00,70,90,65,225,3,66.7
1861,3/07/2018 11:05,71,96,63,230,3,66.7
1862,3/07/2018 11:10,81,116,65,262,3,66.7
1863,3/07/2018 11:15,79,98,65,242,3,66.7
1864,3/07/2018 11:20,71,100,60,231,3,66.7
1865,3/07/2018 11:25,83,99,60,242,3,66.7
1866,3/07/2018 11:30,80,94,58,232,3,66.7
1867,3/07/2018 11:35,76,95,59,230,3,66.7
1868,3/07/2018 11:40,85,96,56,237,3,66.7
1869,3/07/2018 11:45,83,92,54,229,3,66.7
1870,3/07/2018 11:50,81,84,58,223,3,66.7
1871,3/07/2018 11:55,85,93,73,251,3,66.7
0,3/07/2018 11:00,70,90,65,225,3,66.7
1,3/07/2018 11:05,71,96,63,230,3,66.7
2,3/07/2018 11:10,81,116,65,262,3,66.7
3,3/07/2018 11:15,79,98,65,242,3,66.7
4,3/07/2018 11:20,71,100,60,231,3,66.7
5,3/07/2018 11:25,83,99,60,242,3,66.7
6,3/07/2018 11:30,80,94,58,232,3,66.7
7,3/07/2018 11:35,76,95,59,230,3,66.7
8,3/07/2018 11:40,85,96,56,237,3,66.7
9,3/07/2018 11:45,83,92,54,229,3,66.7
10,3/07/2018 11:50,81,84,58,223,3,66.7
11,3/07/2018 11:55,85,93,73,251,3,66.7
12,3/07/2018 12:00,90,109,56,255,3,66.7
13,3/07/2018 12:05,83,91,60,234,3,66.7
14,3/07/2018 12:10,85,87,68,240,3,66.7
15,3/07/2018 12:15,77,71,53,201,3,66.7
16,3/07/2018 12:20,97,84,69,250,3,66.7
17,3/07/2018 12:25,80,84,62,226,3,66.7
18,3/07/2018 12:30,73,89,50,212,3,66.7
19,3/07/2018 12:35,79,85,69,233,3,66.7
20,3/07/2018 12:40,72,85,59,216,3,66.7
21,3/07/2018 12:45,92,90,70,252,3,66.7
22,3/07/2018 12:50,73,86,54,213,3,66.7
23,3/07/2018 12:55,102,95,71,268,3,66.7
24,3/07/2018 13:00,79,102,51,232,3,66.7
25,3/07/2018 13:05,80,105,73,258,3,66.7
26,3/07/2018 13:10,97,101,66,264,3,66.7
27,3/07/2018 13:15,96,102,70,268,3,66.7
28,3/07/2018 13:20,78,93,58,229,3,66.7
29,3/07/2018 13:25,87,99,60,246,3,66.7
30,3/07/2018 13:30,88,101,64,253,3,66.7
31,3/07/2018 13:35,82,96,71,249,3,66.7
32,3/07/2018 13:40,85,103,58,246,3,66.7
33,3/07/2018 13:45,86,96,59,241,3,66.7
34,3/07/2018 13:50,73,86,56,215,3,66.7
35,3/07/2018 13:55,58,53,39,150,3,66.7
36,3/07/2018 14:00,69,82,61,212,3,66.7
37,3/07/2018 14:05,69,82,55,206,3,66.7
38,3/07/2018 14:10,76,102,64,242,3,66.7
39,3/07/2018 14:15,88,88,62,238,3,66.7
40,3/07/2018 14:20,84,108,65,257,3,66.7
41,3/07/2018 14:25,85,103,73,261,3,66.7
42,3/07/2018 14:30,89,92,77,258,3,66.7
43,3/07/2018 14:35,99,104,75,278,3,66.7
44,3/07/2018 14:40,89,109,72,270,3,66.7
45,3/07/2018 14:45,98,103,70,271,3,66.7
46,3/07/2018 14:50,89,94,72,255,3,66.7
47,3/07/2018 14:55,84,89,75,248,3,66.7
48,3/07/2018 15:00,81,80,78,239,3,66.7
49,3/07/2018 15:05,89,65,54,208,3,66.7
50,3/07/2018 15:10,96,95,83,274,3,66.7
51,3/07/2018 15:15,94,77,76,247,3,66.7
52,3/07/2018 15:20,99,61,54,214,3,66.7
53,3/07/2018 15:25,101,75,72,248,3,66.7
54,3/07/2018 15:30,96,78,69,243,3,66.7
55,3/07/2018 15:35,91,96,88,275,3,66.7
56,3/07/2018 15:40,88,88,91,267,3,66.7
57,3/07/2018 15:45,90,81,78,249,3,66.7
58,3/07/2018 15:50,89,79,71,239,3,66.7
59,3/07/2018 15:55,96,83,59,238,3,66.7
60,3/07/2018 16:00,83,70,76,229,3,66.7
61,3/07/2018 16:05,96,71,76,243,3,66.7
62,3/07/2018 16:10,91,90,68,249,3,66.7
63,3/07/2018 16:15,94,85,57,236,3,66.7
64,3/07/2018 16:20,86,64,48,198,3,66.7
65,3/07/2018 16:25,73,61,76,210,3,66.7
66,3/07/2018 16:30,91,59,66,216,3,66.7
67,3/07/2018 16:35,88,68,64,220,3,66.7
68,3/07/2018 16:40,98,78,70,246,3,66.7
69,3/07/2018 16:45,86,77,66,229,3,66.7
70,3/07/2018 16:50,91,70,73,234,3,66.7
71,3/07/2018 16:55,88,81,67,236,3,66.7
72,3/07/2018 17:00,84,72,79,235,3,66.7
73,3/07/2018 17:05,101,86,84,271,3,66.7
74,3/07/2018 17:10,79,69,65,213,3,66.7
75,3/07/2018 17:15,96,85,78,259,3,66.7
76,3/07/2018 17:20,98,67,74,239,3,66.7
77,3/07/2018 17:25,89,49,47,185,3,66.7
78,3/07/2018 17:30,108,78,65,251,3,66.7
79,3/07/2018 17:35,98,69,65,232,3,66.7
80,3/07/2018 17:40,88,54,47,189,3,66.7
81,3/07/2018 17:45,98,60,40,198,3,66.7
82,3/07/2018 17:50,86,54,53,193,3,66.7
83,3/07/2018 17:55,86,57,48,191,3,66.7
84,3/07/2018 18:00,97,57,51,205,3,66.7
85,3/07/2018 18:05,97,50,46,193,3,66.7
86,3/07/2018 18:10,87,59,60,206,3,66.7
87,3/07/2018 18:15,87,64,71,222,3,66.7
88,3/07/2018 18:20,83,54,63,200,3,66.7
89,3/07/2018 18:25,90,52,59,201,3,66.7
90,3/07/2018 18:30,87,62,57,206,3,66.7
91,3/07/2018 18:35,91,53,55,199,3,66.7
92,3/07/2018 18:40,91,64,45,200,3,66.7
93,3/07/2018 18:45,86,69,61,216,3,66.7
94,3/07/2018 18:50,92,75,43,210,3,66.7
95,3/07/2018 18:55,81,72,50,203,3,66.7
96,3/07/2018 19:00,76,74,58,208,3,66.7
97,3/07/2018 19:05,72,93,73,238,3,66.7
98,3/07/2018 19:10,77,69,64,210,3,66.7
99,3/07/2018 19:15,85,78,71,234,3,66.7
100,3/07/2018 19:20,84,83,64,231,3,66.7
101,3/07/2018 19:25,76,71,52,199,3,66.7
102,3/07/2018 19:30,80,86,56,222,3,66.7
103,3/07/2018 19:35,58,85,48,191,3,66.7
104,3/07/2018 19:40,86,90,67,243,3,66.7
105,3/07/2018 19:45,87,96,63,246,3,66.7
106,3/07/2018 19:50,95,99,72,266,3,66.7
107,3/07/2018 19:55,81,91,58,230,3,66.7
108,3/07/2018 20:00,86,103,63,252,3,66.7
109,3/07/2018 20:05,84,80,56,220,3,66.7
110,3/07/2018 20:10,78,93,61,232,3,66.7
111,3/07/2018 20:15,85,85,63,233,3,66.7
112,3/07/2018 20:20,64,80,44,188,3,66.7
113,3/07/2018 20:25,81,101,64,246,3,66.7
114,3/07/2018 20:30,86,102,59,247,3,66.7
115,3/07/2018 20:35,99,106,67,272,3,66.7
116,3/07/2018 20:40,78,109,75,262,3,66.7
117,3/07/2018 20:45,85,99,58,242,3,66.7
118,3/07/2018 20:50,83,95,70,248,3,66.7
119,3/07/2018 20:55,83,94,74,251,3,66.7
120,3/07/2018 21:00,83,92,58,233,3,66.7
121,3/07/2018 21:05,84,82,61,227,3,66.7
122,3/07/2018 21:10,84,95,63,242,3,66.7
123,3/07/2018 21:15,73,104,70,247,3,66.7
124,3/07/2018 21:20,71,83,51,205,3,66.7
125,3/07/2018 21:25,78,96,61,235,3,66.7
126,3/07/2018 21:30,72,78,57,207,3,66.7
127,3/07/2018 21:35,67,97,70,234,3,66.7
128,3/07/2018 21:40,72,84,58,214,3,66.7
129,3/07/2018 21:45,65,107,59,231,3,66.7
130,3/07/2018 21:50,59,90,61,210,3,66.7
131,3/07/2018 21:55,59,104,46,209,3,66.7
132,3/07/2018 22:00,66,97,60,223,3,66.7
133,3/07/2018 22:05,69,95,61,225,3,66.7
134,3/07/2018 22:10,70,93,46,209,3,66.7
135,3/07/2018 22:15,80,101,69,250,3,66.7
136,3/07/2018 22:20,76,87,51,214,3,66.7
137,3/07/2018 22:25,62,96,61,219,3,66.7
138,3/07/2018 22:30,65,81,51,197,3,66.7
139,3/07/2018 22:35,67,88,52,207,3,66.7
140,3/07/2018 22:40,65,93,68,226,3,66.7
141,3/07/2018 22:45,61,93,62,216,3,66.7
142,3/07/2018 22:50,64,84,52,200,3,66.7
143,3/07/2018 22:55,57,84,56,197,3,66.7
144,3/07/2018 23:00,59,79,49,187,3,66.7
145,3/07/2018 23:05,50,70,32,152,3,66.7
146,3/07/2018 23:10,54,83,47,184,3,66.7
147,3/07/2018 23:15,54,71,42,167,3,66.7
148,3/07/2018 23:20,55,70,42,167,3,66.7
149,3/07/2018 23:25,62,75,48,185,3,66.7
150,3/07/2018 23:30,42,70,39,151,3,66.7
151,3/07/2018 23:35,53,62,36,151,3,66.7
152,3/07/2018 23:40,43,55,30,128,3,66.7
153,3/07/2018 23:45,45,64,45,154,3,66.7
154,3/07/2018 23:50,42,50,31,123,3,66.7
155,3/07/2018 23:55,44,57,32,133,3,66.7
156,3/08/2018 0:00,43,52,35,130,3,66.7
157,3/08/2018 0:05,43,60,29,132,3,66.7
158,3/08/2018 0:10,48,64,25,137,3,66.7
159,3/08/2018 0:15,39,60,36,135,3,66.7
160,3/08/2018 0:20,43,58,26,127,3,66.7
161,3/08/2018 0:25,39,62,39,140,3,66.7
162,3/08/2018 0:30,42,55,29,126,3,66.7
163,3/08/2018 0:35,41,61,31,133,3,66.7
164,3/08/2018 0:40,34,52,31,117,3,66.7
165,3/08/2018 0:45,42,46,19,107,3,66.7
166,3/08/2018 0:50,38,44,26,108,3,66.7
167,3/08/2018 0:55,34,48,18,100,3,66.7
168,3/08/2018 1:00,28,44,18,90,3,66.7
169,3/08/2018 1:05,34,38,17,89,3,66.7
170,3/08/2018 1:10,35,47,25,107,3,66.7
171,3/08/2018 1:15,41,43,29,113,3,66.7
172,3/08/2018 1:20,29,43,20,92,3,66.7
173,3/08/2018 1:25,31,40,22,93,3,66.7
174,3/08/2018 1:30,25,37,17,79,3,66.7
175,3/08/2018 1:35,36,43,28,107,3,66.7
176,3/08/2018 1:40,32,41,24,97,3,66.7
177,3/08/2018 1:45,28,38,16,82,3,66.7
178,3/08/2018 1:50,32,36,21,89,3,66.7
179,3/08/2018 1:55,21,34,20,75,3,66.7
180,3/08/2018 2:00,27,32,18,77,3,66.7
181,3/08/2018 2:05,29,37,16,82,3,66.7
182,3/08/2018 2:10,26,31,15,72,3,66.7
183,3/08/2018 2:15,24,28,16,68,3,66.7
184,3/08/2018 2:20,31,22,15,68,3,66.7
185,3/08/2018 2:25,29,38,19,86,3,66.7
186,3/08/2018 2:30,29,28,9,66,3,66.7
187,3/08/2018 2:35,24,19,12,55,3,66.7
188,3/08/2018 2:40,32,35,16,83,3,66.7
189,3/08/2018 2:45,31,30,18,79,3,66.7
190,3/08/2018 2:50,19,26,8,53,3,66.7
191,3/08/2018 2:55,24,26,15,65,3,66.7
192,3/08/2018 3:00,20,25,11,56,3,66.7
193,3/08/2018 3:05,21,17,13,51,3,66.7
194,3/08/2018 3:10,26,19,17,62,3,66.7
195,3/08/2018 3:15,30,21,13,64,3,66.7
196,3/08/2018 3:20,21,17,13,51,3,66.7
197,3/08/2018 3:25,24,16,12,52,3,66.7
198,3/08/2018 3:30,23,23,14,60,3,66.7
199,3/08/2018 3:35,20,22,12,54,3,66.7
200,3/08/2018 3:40,27,22,14,63,3,66.7
201,3/08/2018 3:45,24,20,16,60,3,66.7
202,3/08/2018 3:50,22,18,14,54,3,66.7
203,3/08/2018 3:55,24,22,11,57,3,66.7
204,3/08/2018 4:00,26,22,19,67,3,66.7
205,3/08/2018 4:05,23,27,12,62,3,66.7
206,3/08/2018 4:10,25,35,13,73,3,66.7
207,3/08/2018 4:15,24,32,12,68,3,66.7
208,3/08/2018 4:20,29,33,14,76,3,66.7
209,3/08/2018 4:25,26,33,19,78,3,66.7
210,3/08/2018 4:30,35,42,19,96,3,66.7
211,3/08/2018 4:35,27,30,19,76,3,66.7
212,3/08/2018 4:40,27,39,18,84,3,66.7
213,3/08/2018 4:45,40,44,20,104,3,66.7
214,3/08/2018 4:50,33,34,21,88,3,66.7
215,3/08/2018 4:55,47,49,21,117,3,66.7
216,3/08/2018 5:00,34,43,26,103,3,66.7
217,3/08/2018 5:05,35,42,18,95,3,66.7
218,3/08/2018 5:10,41,46,21,108,3,66.7
219,3/08/2018 5:15,47,62,25,134,3,66.7
220,3/08/2018 5:20,40,61,28,129,3,66.7
221,3/08/2018 5:25,56,56,33,145,3,66.7
222,3/08/2018 5:30,40,52,27,119,3,66.7
223,3/08/2018 5:35,55,74,44,173,3,66.7
224,3/08/2018 5:40,49,66,37,152,3,66.7
225,3/08/2018 5:45,45,73,19,137,3,66.7
226,3/08/2018 5:50,48,58,31,137,3,66.7
227,3/08/2018 5:55,58,67,41,166,3,66.7
228,3/08/2018 6:00,55,65,36,156,3,66.7
229,3/08/2018 6:05,57,69,37,163,3,66.7
230,3/08/2018 6:10,65,76,48,189,3,66.7
231,3/08/2018 6:15,71,77,53,201,3,66.7
232,3/08/2018 6:20,65,80,41,186,3,66.7
233,3/08/2018 6:25,67,74,43,184,3,66.7
234,3/08/2018 6:30,60,82,51,193,3,66.7
235,3/08/2018 6:35,69,103,55,227,3,66.7
236,3/08/2018 6:40,79,103,58,240,3,66.7
237,3/08/2018 6:45,74,94,59,227,3,66.7
238,3/08/2018 6:50,78,107,61,246,3,66.7
239,3/08/2018 6:55,73,81,64,218,3,66.7
240,3/08/2018 7:00,68,94,57,219,3,66.7
241,3/08/2018 7:05,70,105,55,230,3,66.7
242,3/08/2018 7:10,81,111,76,268,3,66.7
243,3/08/2018 7:15,86,117,75,278,3,66.7
244,3/08/2018 7:20,75,103,68,246,3,66.7
245,3/08/2018 7:25,91,77,71,239,3,66.7
246,3/08/2018 7:30,81,106,66,253,3,66.7
247,3/08/2018 7:35,70,110,56,236,3,66.7
248,3/08/2018 7:40,75,93,56,224,3,66.7
249,3/08/2018 7:45,82,111,64,257,3,66.7
250,3/08/2018 7:50,75,96,66,237,3,66.7
251,3/08/2018 7:55,85,117,69,271,3,66.7
252,3/08/2018 8:00,88,96,56,240,3,66.7
253,3/08/2018 8:05,83,100,70,253,3,66.7
254,3/08/2018 8:10,74,100,63,237,3,66.7
255,3/08/2018 8:15,83,113,64,260,3,66.7
256,3/08/2018 8:20,74,96,57,227,3,66.7
257,3/08/2018 8:25,91,102,75,268,3,66.7
258,3/08/2018 8:30,83,100,63,246,3,66.7
259,3/08/2018 8:35,86,111,69,266,3,66.7
260,3/08/2018 8:40,71,104,61,236,3,66.7
261,3/08/2018 8:45,82,106,55,243,3,66.7
262,3/08/2018 8:50,81,102,58,241,3,66.7
263,3/08/2018 8:55,72,90,50,212,3,66.7
264,3/08/2018 9:00,93,102,61,256,3,66.7
265,3/08/2018 9:05,72,89,51,212,3,66.7
266,3/08/2018 9:10,69,90,51,210,3,66.7
267,3/08/2018 9:15,83,95,61,239,3,66.7
268,3/08/2018 9:20,81,97,66,244,3,66.7
269,3/08/2018 9:25,67,104,56,227,3,66.7
270,3/08/2018 9:30,75,107,58,240,3,66.7
271,3/08/2018 9:35,85,91,51,227,3,66.7
272,3/08/2018 9:40,80,93,63,236,3,66.7
273,3/08/2018 9:45,84,107,66,257,3,66.7
274,3/08/2018 9:50,84,96,69,249,3,66.7
275,3/08/2018 9:55,62,99,59,220,3,66.7
276,3/08/2018 10:00,80,99,69,248,3,66.7
277,3/08/2018 10:05,70,102,51,223,3,66.7
278,3/08/2018 10:10,81,90,53,224,3,66.7
279,3/08/2018 10:15,63,98,45,206,3,66.7
280,3/08/2018 10:20,66,83,54,203,3,66.7
281,3/08/2018 10:25,87,94,73,254,3,66.7
282,3/08/2018 10:30,74,82,59,215,3,66.7
283,3/08/2018 10:35,80,96,62,238,3,66.7
284,3/08/2018 10:40,88,102,65,255,3,66.7
285,3/08/2018 10:45,83,111,76,270,3,66.7
286,3/08/2018 10:50,82,107,60,249,3,66.7
287,3/08/2018 10:55,78,102,63,243,3,66.7
288,3/08/2018 11:00,79,101,63,243,3,66.7
289,3/08/2018 11:05,79,86,65,230,3,66.7
290,3/08/2018 11:10,71,94,51,216,3,66.7
291,3/08/2018 11:15,79,97,61,237,3,66.7
292,3/08/2018 11:20,82,102,63,247,3,66.7
293,3/08/2018 11:25,88,101,67,256,3,66.7
294,3/08/2018 11:30,77,99,66,242,3,66.7
295,3/08/2018 11:35,93,102,66,261,3,66.7
296,3/08/2018 11:40,84,104,67,255,3,66.7
297,3/08/2018 11:45,84,93,64,241,3,66.7
298,3/08/2018 11:50,79,94,71,244,3,66.7
299,3/08/2018 11:55,80,98,54,232,3,66.7
300,3/08/2018 12:00,91,99,54,244,3,66.7
301,3/08/2018 12:05,100,95,70,265,3,66.7
302,3/08/2018 12:10,70,92,67,229,3,66.7
303,3/08/2018 12:15,86,98,65,249,3,66.7
304,3/08/2018 12:20,87,86,59,232,3,66.7
305,3/08/2018 12:25,87,95,65,247,3,66.7
306,3/08/2018 12:30,88,110,71,269,3,66.7
307,3/08/2018 12:35,89,103,64,256,3,66.7
308,3/08/2018 12:40,91,95,66,252,3,66.7
309,3/08/2018 12:45,91,122,78,291,3,66.7
310,3/08/2018 12:50,75,93,70,238,3,66.7
311,3/08/2018 12:55,76,98,63,237,3,66.7
312,3/08/2018 13:00,79,85,63,227,3,66.7
313,3/08/2018 13:05,76,97,59,232,3,66.7
314,3/08/2018 13:10,96,92,60,248,3,66.7
315,3/08/2018 13:15,91,89,76,256,3,66.7
316,3/08/2018 13:20,78,88,73,239,3,66.7
317,3/08/2018 13:25,75,97,68,240,3,66.7
318,3/08/2018 13:30,79,101,57,237,3,66.7
319,3/08/2018 13:35,79,102,65,246,3,66.7
320,3/08/2018 13:40,89,94,64,247,3,66.7
321,3/08/2018 13:45,74,112,59,245,3,66.7
322,3/08/2018 13:50,97,107,72,276,3,66.7
323,3/08/2018 13:55,91,96,67,254,3,66.7
324,3/08/2018 14:00,101,117,84,302,3,66.7
325,3/08/2018 14:05,84,97,64,245,3,66.7
326,3/08/2018 14:10,79,85,74,238,3,66.7
327,3/08/2018 14:15,86,87,67,240,3,66.7
328,3/08/2018 14:20,85,83,65,233,3,66.7
329,3/08/2018 14:25,93,95,58,246,3,66.7
330,3/08/2018 14:30,86,76,51,213,3,66.7
331,3/08/2018 14:35,82,93,53,228,3,66.7
332,3/08/2018 14:40,81,84,61,226,3,66.7
333,3/08/2018 14:45,97,100,57,254,3,66.7
334,3/08/2018 14:50,86,89,77,252,3,66.7
335,3/08/2018 14:55,91,59,46,196,3,66.7
336,3/08/2018 15:00,93,77,56,226,3,66.7
337,3/08/2018 15:05,90,92,73,255,3,66.7
338,3/08/2018 15:10,104,61,62,227,3,66.7
339,3/08/2018 15:15,89,75,67,231,3,66.7
340,3/08/2018 15:20,86,73,72,231,3,66.7
341,3/08/2018 15:25,76,79,77,232,3,66.7
342,3/08/2018 15:30,81,52,54,187,3,66.7
343,3/08/2018 15:35,86,67,49,202,3,66.7
344,3/08/2018 15:40,85,63,51,199,3,66.7
345,3/08/2018 15:45,86,76,61,223,3,66.7
346,3/08/2018 15:50,86,73,53,212,3,66.7
347,3/08/2018 15:55,102,59,46,207,3,66.7
348,3/08/2018 16:00,105,55,67,227,3,66.7
349,3/08/2018 16:05,99,57,57,213,3,66.7
350,3/08/2018 16:10,96,68,63,227,3,66.7
351,3/08/2018 16:15,83,57,62,202,3,66.7
352,3/08/2018 16:20,89,60,52,201,3,66.7
353,3/08/2018 16:25,89,71,62,222,3,66.7
354,3/08/2018 16:30,87,51,30,168,3,66.7
355,3/08/2018 16:35,86,58,46,190,3,66.7
356,3/08/2018 16:40,76,55,50,181,3,66.7
357,3/08/2018 16:45,90,51,63,204,3,66.7
358,3/08/2018 16:50,96,56,46,198,3,66.7
359,3/08/2018 16:55,95,63,64,222,3,66.7
360,3/08/2018 17:00,93,51,41,185,3,66.7
361,3/08/2018 17:05,109,37,47,193,3,66.7
362,3/08/2018 17:10,105,65,59,229,3,66.7
363,3/08/2018 17:15,102,72,59,233,3,66.7
364,3/08/2018 17:20,100,69,62,231,3,66.7
365,3/08/2018 17:25,95,74,43,212,3,66.7
366,3/08/2018 17:30,101,62,36,199,3,66.7
367,3/08/2018 17:35,106,65,50,221,3,66.7
368,3/08/2018 17:40,102,77,64,243,3,66.7
369,3/08/2018 17:45,102,66,67,235,3,66.7
370,3/08/2018 17:50,98,67,55,220,3,66.7
371,3/08/2018 17:55,92,47,47,186,3,66.7
372,3/08/2018 18:00,97,55,45,197,3,66.7
373,3/08/2018 18:05,90,53,44,187,3,66.7
374,3/08/2018 18:10,89,69,49,207,3,66.7
375,3/08/2018 18:15,88,60,55,203,3,66.7
376,3/08/2018 18:20,73,60,42,175,3,66.7
377,3/08/2018 18:25,86,59,48,193,3,66.7
378,3/08/2018 18:30,75,62,51,188,3,66.7
379,3/08/2018 18:35,86,60,64,210,3,66.7
380,3/08/2018 18:40,78,58,48,184,3,66.7
381,3/08/2018 18:45,77,76,78,231,3,66.7
382,3/08/2018 18:50,88,65,61,214,3,66.7
383,3/08/2018 18:55,79,53,52,184,3,66.7
384,3/08/2018 19:00,84,72,61,217,3,66.7
385,3/08/2018 19:05,74,76,60,210,3,66.7
386,3/08/2018 19:10,80,74,65,219,3,66.7
387,3/08/2018 19:15,76,73,50,199,3,66.7
388,3/08/2018 19:20,87,69,49,205,3,66.7
389,3/08/2018 19:25,88,83,62,233,3,66.7
390,3/08/2018 19:30,89,80,65,234,3,66.7
391,3/08/2018 19:35,79,93,51,223,3,66.7
392,3/08/2018 19:40,79,90,55,224,3,66.7
393,3/08/2018 19:45,80,100,46,226,3,66.7
394,3/08/2018 19:50,78,85,48,211,3,66.7
395,3/08/2018 19:55,75,86,51,212,3,66.7
396,3/08/2018 20:00,82,102,52,236,3,66.7
397,3/08/2018 20:05,71,93,60,224,3,66.7
398,3/08/2018 20:10,83,89,59,231,3,66.7
399,3/08/2018 20:15,76,97,60,233,3,66.7
400,3/08/2018 20:20,82,101,58,241,3,66.7
401,3/08/2018 20:25,85,97,61,243,3,66.7
402,3/08/2018 20:30,71,92,51,214,3,66.7
403,3/08/2018 20:35,82,90,58,230,3,66.7
404,3/08/2018 20:40,92,92,63,247,3,66.7
405,3/08/2018 20:45,95,102,64,261,3,66.7
406,3/08/2018 20:50,73,102,72,247,3,66.7
407,3/08/2018 20:55,86,101,61,248,3,66.7
408,3/08/2018 21:00,75,107,53,235,3,66.7
409,3/08/2018 21:05,71,102,57,230,3,66.7
410,3/08/2018 21:10,80,91,58,229,3,66.7
411,3/08/2018 21:15,81,95,73,249,3,66.7
412,3/08/2018 21:20,62,96,65,223,3,66.7
413,3/08/2018 21:25,76,107,68,251,3,66.7
414,3/08/2018 21:30,63,114,64,241,3,66.7
415,3/08/2018 21:35,75,87,54,216,3,66.7
416,3/08/2018 21:40,73,97,67,237,3,66.7
417,3/08/2018 21:45,69,96,59,224,3,66.7
418,3/08/2018 21:50,77,98,65,240,3,66.7
419,3/08/2018 21:55,75,102,66,243,3,66.7
420,3/08/2018 22:00,71,103,54,228,3,66.7
421,3/08/2018 22:05,78,99,55,232,3,66.7
422,3/08/2018 22:10,64,103,54,221,3,66.7
423,3/08/2018 22:15,78,91,62,231,3,66.7
424,3/08/2018 22:20,76,97,56,229,3,66.7
425,3/08/2018 22:25,69,90,51,210,3,66.7
426,3/08/2018 22:30,75,87,58,220,3,66.7
427,3/08/2018 22:35,64,81,48,193,3,66.7
428,3/08/2018 22:40,62,89,58,209,3,66.7
429,3/08/2018 22:45,64,91,67,222,3,66.7
430,3/08/2018 22:50,55,80,48,183,3,66.7
431,3/08/2018 22:55,59,86,60,205,3,66.7
432,3/08/2018 23:00,55,88,40,183,3,66.7
433,3/08/2018 23:05,67,83,40,190,3,66.7
434,3/08/2018 23:10,53,88,52,193,3,66.7
435,3/08/2018 23:15,56,99,52,207,3,66.7
436,3/08/2018 23:20,55,63,44,162,3,66.7
437,3/08/2018 23:25,60,86,50,196,3,66.7
438,3/08/2018 23:30,60,75,47,182,3,66.7
439,3/08/2018 23:35,44,77,37,158,3,66.7
440,3/08/2018 23:40,58,71,39,168,3,66.7
441,3/08/2018 23:45,59,74,47,180,3,66.7
442,3/08/2018 23:50,43,65,34,142,3,66.7
443,3/08/2018 23:55,50,53,41,144,3,66.7
444,3/09/2018 0:00,45,58,37,140,3,66.7
445,3/09/2018 0:05,47,54,41,142,3,66.7
446,3/09/2018 0:10,44,58,29,131,3,66.7
447,3/09/2018 0:15,46,75,34,155,3,66.7
448,3/09/2018 0:20,52,57,30,139,3,66.7
449,3/09/2018 0:25,47,59,33,139,3,66.7
450,3/09/2018 0:30,33,62,33,128,3,66.7
451,3/09/2018 0:35,50,60,34,144,3,66.7
452,3/09/2018 0:40,39,62,31,132,3,66.7
453,3/09/2018 0:45,42,60,34,136,3,66.7
454,3/09/2018 0:50,35,52,23,110,3,66.7
455,3/09/2018 0:55,38,50,28,116,3,66.7
456,3/09/2018 1:00,29,40,19,88,3,66.7
457,3/09/2018 1:05,34,38,18,90,3,66.7
458,3/09/2018 1:10,34,47,21,102,3,66.7
459,3/09/2018 1:15,32,44,22,98,3,66.7
460,3/09/2018 1:20,31,36,15,82,3,66.7
461,3/09/2018 1:25,34,45,20,99,3,66.7
462,3/09/2018 1:30,28,29,21,78,3,66.7
463,3/09/2018 1:35,29,20,20,69,3,66.7
464,3/09/2018 1:40,35,43,37,115,3,0.0
465,3/09/2018 1:45,42,50,43,135,3,0.0
466,3/09/2018 1:50,39,47,40,126,3,0.0
467,3/09/2018 1:55,32,41,35,108,3,0.0
468,3/09/2018 2:00,34,43,37,114,3,0.0
469,3/09/2018 2:05,29,36,17,82,3,66.7
470,3/09/2018 2:10,31,25,19,75,3,66.7
471,3/09/2018 2:15,27,40,19,86,3,66.7
472,3/09/2018 2:20,22,28,13,63,3,66.7
473,3/09/2018 2:25,41,48,42,131,3,0.0
474,3/09/2018 2:30,28,37,32,97,3,0.0
475,3/09/2018 2:35,38,46,40,124,3,0.0
476,3/09/2018 2:40,32,41,35,108,3,0.0
477,3/09/2018 2:45,31,40,34,105,3,0.0
478,3/09/2018 2:50,34,42,36,112,3,0.0
479,3/09/2018 2:55,29,38,32,99,3,0.0
480,3/09/2018 3:00,27,36,31,94,3,0.0
481,3/09/2018 3:05,29,38,33,100,3,0.0
482,3/09/2018 3:10,34,43,37,114,3,0.0
483,3/09/2018 3:15,30,39,33,102,3,0.0
484,3/09/2018 3:20,27,36,31,94,3,0.0
485,3/09/2018 3:25,29,37,32,98,3,0.0
486,3/09/2018 3:30,31,40,34,105,3,0.0
487,3/09/2018 3:35,38,46,40,124,3,0.0
488,3/09/2018 3:40,29,37,32,98,3,0.0
489,3/09/2018 3:45,28,36,31,95,3,0.0
490,3/09/2018 3:50,29,37,32,98,3,0.0
491,3/09/2018 3:55,32,40,35,107,3,0.0
492,3/09/2018 4:00,31,40,34,105,3,0.0
493,3/09/2018 4:05,30,39,33,102,3,0.0
494,3/09/2018 4:10,32,34,20,86,3,66.7
495,3/09/2018 4:15,27,40,17,84,3,66.7
496,3/09/2018 4:20,40,48,41,129,3,0.0
497,3/09/2018 4:25,37,45,39,121,3,0.0
498,3/09/2018 4:30,36,44,38,118,3,0.0
499,3/09/2018 4:35,43,50,43,136,3,0.0
500,3/09/2018 4:40,49,56,48,153,3,0.0
501,3/09/2018 4:45,44,51,44,139,3,0.0
502,3/09/2018 4:50,46,53,46,145,3,0.0
503,3/09/2018 4:55,45,52,45,142,3,0.0
504,3/09/2018 5:00,40,47,41,128,3,0.0
505,3/09/2018 5:05,49,56,49,154,3,0.0
506,3/09/2018 5:10,61,67,58,186,3,0.0
507,3/09/2018 5:15,54,60,53,167,3,0.0
508,3/09/2018 5:20,50,57,50,157,3,0.0
509,3/09/2018 5:25,71,76,66,213,3,0.0
510,3/09/2018 5:30,49,68,40,157,3,66.7
511,3/09/2018 5:35,48,61,29,138,3,66.7
512,3/09/2018 5:40,40,59,29,128,3,66.7
513,3/09/2018 5:45,55,64,32,151,3,66.7
514,3/09/2018 5:50,55,61,38,154,3,66.7
515,3/09/2018 5:55,52,59,51,162,3,0.0
516,3/09/2018 6:00,58,64,56,178,3,0.0
517,3/09/2018 6:05,61,67,59,187,3,0.0
518,3/09/2018 6:10,62,53,23,138,3,66.7
519,3/09/2018 6:15,65,71,62,198,3,0.0
520,3/09/2018 6:20,68,73,64,205,3,0.0
521,3/09/2018 6:25,70,75,65,210,3,0.0
522,3/09/2018 6:30,71,76,66,213,3,0.0
523,3/09/2018 6:35,75,80,70,225,3,0.0
524,3/09/2018 6:40,81,85,75,241,3,0.0
525,3/09/2018 6:45,85,89,78,252,3,0.0
526,3/09/2018 6:50,83,87,77,247,3,0.0
527,3/09/2018 6:55,88,91,80,259,3,0.0
528,3/09/2018 7:00,80,84,74,238,3,0.0
529,3/09/2018 7:05,85,89,78,252,3,0.0
530,3/09/2018 7:10,80,84,73,237,3,0.0
531,3/09/2018 7:15,87,90,79,256,3,0.0
532,3/09/2018 7:20,96,98,86,280,3,0.0
533,3/09/2018 7:25,98,100,88,286,3,0.0
534,3/09/2018 7:30,90,94,82,266,3,0.0
535,3/09/2018 7:35,79,83,73,235,3,0.0
536,3/09/2018 7:40,86,90,79,255,3,0.0
537,3/09/2018 7:45,88,91,80,259,3,0.0
538,3/09/2018 7:50,82,86,75,243,3,0.0
539,3/09/2018 7:55,95,98,86,279,3,0.0
540,3/09/2018 8:00,85,89,78,252,3,0.0
541,3/09/2018 8:05,89,93,81,263,3,0.0
542,3/09/2018 8:10,94,97,86,277,3,0.0
543,3/09/2018 8:15,83,87,76,246,3,0.0
544,3/09/2018 8:20,99,101,89,289,3,0.0
545,3/09/2018 8:25,91,94,83,268,3,0.0
546,3/09/2018 8:30,90,93,82,265,3,0.0
547,3/09/2018 8:35,90,93,82,265,3,0.0
548,3/09/2018 8:40,84,88,77,249,3,0.0
549,3/09/2018 8:45,94,97,85,276,3,0.0
550,3/09/2018 8:50,89,92,81,262,3,0.0
551,3/09/2018 8:55,84,88,77,249,3,0.0
552,3/09/2018 9:00,90,94,82,266,3,0.0
553,3/09/2018 9:05,73,77,68,218,3,0.0
554,3/09/2018 9:10,80,84,73,237,3,0.0
555,3/09/2018 9:15,79,83,73,235,3,0.0
556,3/09/2018 9:20,85,88,78,251,3,0.0
557,3/09/2018 9:25,74,79,69,222,3,0.0
558,3/09/2018 9:30,76,80,70,226,3,0.0
559,3/09/2018 9:35,79,84,73,236,3,0.0
560,3/09/2018 9:40,85,88,77,250,3,0.0
561,3/09/2018 9:45,72,77,67,216,3,0.0
562,3/09/2018 9:50,87,90,79,256,3,0.0
563,3/09/2018 9:55,89,92,81,262,3,0.0
564,3/09/2018 10:00,85,89,78,252,3,0.0
565,3/09/2018 10:05,74,79,69,222,3,0.0
566,3/09/2018 10:10,85,88,77,250,3,0.0
567,3/09/2018 10:15,88,91,80,259,3,0.0
568,3/09/2018 10:20,86,90,79,255,3,0.0
569,3/09/2018 10:25,82,86,75,243,3,0.0
570,3/09/2018 10:30,79,83,73,235,3,0.0
571,3/09/2018 10:35,99,101,89,289,3,0.0
572,3/09/2018 10:40,86,89,78,253,3,0.0
573,3/09/2018 10:45,84,87,77,248,3,0.0
574,3/09/2018 10:50,66,60,20,146,3,66.7
575,3/09/2018 10:55,56,91,57,204,3,66.7
576,3/09/2018 11:00,87,96,60,243,3,66.7
577,3/09/2018 11:05,79,93,58,230,3,66.7
578,3/09/2018 11:10,71,79,46,196,3,66.7
579,3/09/2018 11:15,78,82,52,212,3,66.7
580,3/09/2018 11:20,78,88,53,219,3,66.7
581,3/09/2018 11:25,65,83,53,201,3,66.7
582,3/09/2018 11:30,67,87,50,204,3,66.7
583,3/09/2018 11:35,80,84,52,216,3,66.7
584,3/09/2018 11:40,94,92,56,242,3,66.7
585,3/09/2018 11:45,83,94,68,245,3,66.7
586,3/09/2018 11:50,82,95,55,232,3,66.7
587,3/09/2018 11:55,83,92,59,234,3,66.7
588,3/09/2018 12:00,86,104,75,265,3,66.7
589,3/09/2018 12:05,88,105,68,261,3,66.7
590,3/09/2018 12:10,73,101,52,226,3,66.7
591,3/09/2018 12:15,96,99,64,259,3,66.7
592,3/09/2018 12:20,93,93,58,244,3,66.7
593,3/09/2018 12:25,62,78,52,192,3,66.7
594,3/09/2018 12:30,66,76,47,189,3,66.7
595,3/09/2018 12:35,72,79,42,193,3,66.7
596,3/09/2018 12:40,77,100,66,243,3,66.7
597,3/09/2018 12:45,80,88,51,219,3,66.7
598,3/09/2018 12:50,84,95,74,253,3,66.7
599,3/09/2018 12:55,87,96,64,247,3,66.7
600,3/09/2018 13:00,82,120,69,271,3,66.7
601,3/09/2018 13:05,72,91,57,220,3,66.7
602,3/09/2018 13:10,81,94,69,244,3,66.7
603,3/09/2018 13:15,92,107,62,261,3,66.7
604,3/09/2018 13:20,85,91,68,244,3,66.7
605,3/09/2018 13:25,77,95,65,237,3,66.7
606,3/09/2018 13:30,84,94,63,241,3,66.7
607,3/09/2018 13:35,72,87,57,216,3,66.7
608,3/09/2018 13:40,76,86,59,221,3,66.7
609,3/09/2018 13:45,91,88,59,238,3,66.7
610,3/09/2018 13:50,104,101,72,277,3,66.7
611,3/09/2018 13:55,76,108,66,250,3,66.7
612,3/09/2018 14:00,86,105,64,255,3,66.7
613,3/09/2018 14:05,78,97,53,228,3,66.7
614,3/09/2018 14:10,92,82,51,225,3,66.7
615,3/09/2018 14:15,101,94,58,253,3,66.7
616,3/09/2018 14:20,99,101,71,271,3,66.7
617,3/09/2018 14:25,95,97,53,245,3,66.7
618,3/09/2018 14:30,87,90,66,243,3,66.7
619,3/09/2018 14:35,95,99,53,247,3,66.7
620,3/09/2018 14:40,98,87,64,249,3,66.7
621,3/09/2018 14:45,92,62,71,225,3,66.7
622,3/09/2018 14:50,73,55,39,167,3,66.7
623,3/09/2018 14:55,92,82,95,269,3,66.7
624,3/09/2018 15:00,99,79,78,256,3,66.7
625,3/09/2018 15:05,86,53,50,189,3,66.7
626,3/09/2018 15:10,106,91,74,271,3,66.7
627,3/09/2018 15:15,89,77,69,235,3,66.7
628,3/09/2018 15:20,89,77,59,225,3,66.7
629,3/09/2018 15:25,78,83,62,223,3,66.7
630,3/09/2018 15:30,102,60,66,228,3,66.7
631,3/09/2018 15:35,91,58,64,213,3,66.7
632,3/09/2018 15:40,88,64,60,212,3,66.7
633,3/09/2018 15:45,105,50,54,209,3,66.7
634,3/09/2018 15:50,90,70,64,224,3,66.7
635,3/09/2018 15:55,104,63,59,226,3,66.7
636,3/09/2018 16:00,101,59,62,222,3,66.7
637,3/09/2018 16:05,101,70,74,245,3,66.7
638,3/09/2018 16:10,90,57,55,202,3,66.7
639,3/09/2018 16:15,97,61,54,212,3,66.7
640,3/09/2018 16:20,98,63,62,223,3,66.7
641,3/09/2018 16:25,98,69,67,234,3,66.7
642,3/09/2018 16:30,96,64,54,214,3,66.7
643,3/09/2018 16:35,90,75,62,227,3,66.7
644,3/09/2018 16:40,89,60,53,202,3,66.7
645,3/09/2018 16:45,80,81,45,206,3,66.7
646,3/09/2018 16:50,77,48,62,187,3,66.7
647,3/09/2018 16:55,82,63,71,216,3,66.7
648,3/09/2018 17:00,75,50,61,186,3,66.7
649,3/09/2018 17:05,73,56,59,188,3,66.7
650,3/09/2018 17:10,78,54,56,188,3,66.7
651,3/09/2018 17:15,77,72,60,209,3,66.7
652,3/09/2018 17:20,88,72,56,216,3,66.7
653,3/09/2018 17:25,95,59,50,204,3,66.7
654,3/09/2018 17:30,95,63,62,220,3,66.7
655,3/09/2018 17:35,83,59,61,203,3,66.7
656,3/09/2018 17:40,91,75,78,244,3,66.7
657,3/09/2018 17:45,102,70,60,232,3,66.7
658,3/09/2018 17:50,97,75,71,243,3,66.7
659,3/09/2018 17:55,105,57,49,211,3,66.7
660,3/09/2018 18:00,91,57,52,200,3,66.7
661,3/09/2018 18:05,93,54,50,197,3,66.7
662,3/09/2018 18:10,98,67,57,222,3,66.7
663,3/09/2018 18:15,81,71,62,214,3,66.7
664,3/09/2018 18:20,79,85,80,244,3,66.7
665,3/09/2018 18:25,75,69,70,214,3,66.7
666,3/09/2018 18:30,86,73,38,197,3,66.7
667,3/09/2018 18:35,90,80,51,221,3,66.7
668,3/09/2018 18:40,90,80,51,221,3,66.7
669,3/09/2018 18:45,92,79,66,237,3,66.7
670,3/09/2018 18:50,90,72,68,230,3,66.7
671,3/09/2018 18:55,70,81,60,211,3,66.7
672,3/09/2018 19:00,67,78,63,208,3,66.7
673,3/09/2018 19:05,75,81,62,218,3,66.7
674,3/09/2018 19:10,79,88,60,227,3,66.7
675,3/09/2018 19:15,92,91,58,241,3,66.7
676,3/09/2018 19:20,81,94,54,229,3,66.7
677,3/09/2018 19:25,78,82,61,221,3,66.7
678,3/09/2018 19:30,81,87,52,220,3,66.7
679,3/09/2018 19:35,77,86,63,226,3,66.7
680,3/09/2018 19:40,79,84,59,222,3,66.7
681,3/09/2018 19:45,85,98,69,252,3,66.7
682,3/09/2018 19:50,75,94,59,228,3,66.7
683,3/09/2018 19:55,70,73,49,192,3,66.7
684,3/09/2018 20:00,78,79,48,205,3,66.7
685,3/09/2018 20:05,70,89,50,209,3,66.7
686,3/09/2018 20:10,69,88,48,205,3,66.7
687,3/09/2018 20:15,76,76,56,208,3,66.7
688,3/09/2018 20:20,79,95,64,238,3,66.7
689,3/09/2018 20:25,75,84,60,219,3,66.7
690,3/09/2018 20:30,81,93,54,228,3,66.7
691,3/09/2018 20:35,69,80,61,210,3,66.7
692,3/09/2018 20:40,89,75,40,204,3,66.7
693,3/09/2018 20:45,72,87,50,209,3,66.7
694,3/09/2018 20:50,75,75,53,203,3,66.7
695,3/09/2018 20:55,68,80,42,190,3,66.7
696,3/09/2018 21:00,84,82,51,217,3,66.7
697,3/09/2018 21:05,87,87,66,240,3,66.7
698,3/09/2018 21:10,86,101,65,252,3,66.7
699,3/09/2018 21:15,76,100,66,242,3,66.7
700,3/09/2018 21:20,80,93,62,235,3,66.7
701,3/09/2018 21:25,75,97,70,242,3,66.7
702,3/09/2018 21:30,69,97,63,229,3,66.7
703,3/09/2018 21:35,74,98,67,239,3,66.7
704,3/09/2018 21:40,80,94,63,237,3,66.7
705,3/09/2018 21:45,83,97,61,241,3,66.7
706,3/09/2018 21:50,77,102,74,253,3,66.7
707,3/09/2018 21:55,66,86,60,212,3,66.7
708,3/09/2018 22:00,71,100,65,236,3,66.7
709,3/09/2018 22:05,78,90,71,239,3,66.7
710,3/09/2018 22:10,72,94,55,221,3,66.7
711,3/09/2018 22:15,83,105,70,258,3,66.7
712,3/09/2018 22:20,74,88,64,226,3,66.7
713,3/09/2018 22:25,70,90,55,215,3,66.7
714,3/09/2018 22:30,74,100,76,250,3,66.7
715,3/09/2018 22:35,75,96,52,223,3,66.7
716,3/09/2018 22:40,76,106,71,253,3,66.7
717,3/09/2018 22:45,63,75,48,186,3,66.7
718,3/09/2018 22:50,59,85,62,206,3,66.7
719,3/09/2018 22:55,70,88,56,214,3,66.7
720,3/09/2018 23:00,68,88,57,213,3,66.7
721,3/09/2018 23:05,63,86,52,201,3,66.7
722,3/09/2018 23:10,65,104,66,235,3,66.7
723,3/09/2018 23:15,66,76,51,193,3,66.7
724,3/09/2018 23:20,62,99,64,225,3,66.7
725,3/09/2018 23:25,72,91,64,227,3,66.7
726,3/09/2018 23:30,68,101,42,211,3,66.7
727,3/09/2018 23:35,55,72,47,174,3,66.7
728,3/09/2018 23:40,53,80,50,183,3,66.7
729,3/09/2018 23:45,63,76,52,191,3,66.7
730,3/09/2018 23:50,55,82,45,182,3,66.7
731,3/09/2018 23:55,54,72,47,173,3,66.7
732,3/10/2018 0:00,54,91,45,190,3,66.7
733,3/10/2018 0:05,61,66,43,170,3,66.7
734,3/10/2018 0:10,61,75,39,175,3,66.7
735,3/10/2018 0:15,51,64,49,164,3,66.7
736,3/10/2018 0:20,58,64,41,163,3,66.7
737,3/10/2018 0:25,60,68,46,174,3,66.7
738,3/10/2018 0:30,46,63,35,144,3,66.7
739,3/10/2018 0:35,70,58,38,166,3,66.7
740,3/10/2018 0:40,59,62,45,166,3,66.7
741,3/10/2018 0:45,60,69,30,159,3,66.7
742,3/10/2018 0:50,52,62,34,148,3,66.7
743,3/10/2018 0:55,50,59,38,147,3,66.7
744,3/10/2018 1:00,46,45,29,120,3,66.7
745,3/10/2018 1:05,47,57,26,130,3,66.7
746,3/10/2018 1:10,51,63,32,146,3,66.7
747,3/10/2018 1:15,46,53,30,129,3,66.7
748,3/10/2018 1:20,54,50,30,134,3,66.7
749,3/10/2018 1:25,41,53,32,126,3,66.7
750,3/10/2018 1:30,42,49,25,116,3,66.7
751,3/10/2018 1:35,43,57,28,128,3,66.7
752,3/10/2018 1:40,47,57,27,131,3,66.7
753,3/10/2018 1:45,46,51,33,130,3,66.7
754,3/10/2018 1:50,47,46,31,124,3,66.7
755,3/10/2018 1:55,35,36,34,105,3,66.7
756,3/10/2018 2:00,29,33,21,83,3,66.7
757,3/10/2018 2:05,39,38,29,106,3,66.7
758,3/10/2018 2:10,35,42,20,97,3,66.7
759,3/10/2018 2:15,45,47,31,123,3,66.7
760,3/10/2018 2:20,45,43,31,119,3,66.7
761,3/10/2018 2:25,39,44,23,106,3,66.7
762,3/10/2018 2:30,36,34,22,92,3,66.7
763,3/10/2018 2:35,34,31,14,79,3,66.7
764,3/10/2018 2:40,36,47,22,105,3,66.7
765,3/10/2018 2:45,36,30,27,93,3,66.7
766,3/10/2018 2:50,28,33,13,74,3,66.7
767,3/10/2018 2:55,30,22,14,66,3,66.7
768,3/10/2018 3:00,28,28,19,75,3,66.7
769,3/10/2018 3:05,29,30,17,76,3,66.7
770,3/10/2018 3:10,29,24,13,66,3,66.7
771,3/10/2018 3:15,31,28,23,82,3,66.7
772,3/10/2018 3:20,32,32,20,84,3,66.7
773,3/10/2018 3:25,23,18,13,54,3,66.7
774,3/10/2018 3:30,25,31,15,71,3,66.7
775,3/10/2018 3:35,27,18,16,61,3,66.7
776,3/10/2018 3:40,19,24,9,52,3,66.7
777,3/10/2018 3:45,31,32,15,78,3,66.7
778,3/10/2018 3:50,27,21,18,66,3,66.7
779,3/10/2018 3:55,20,21,10,51,3,66.7
780,3/10/2018 4:00,25,23,17,65,3,66.7
781,3/10/2018 4:05,30,34,11,75,3,66.7
782,3/10/2018 4:10,26,30,16,72,3,66.7
783,3/10/2018 4:15,28,30,13,71,3,66.7
784,3/10/2018 4:20,28,24,8,60,3,66.7
785,3/10/2018 4:25,25,21,13,59,3,66.7
786,3/10/2018 4:30,26,31,15,72,3,66.7
787,3/10/2018 4:35,36,29,14,79,3,66.7
788,3/10/2018 4:40,33,32,19,84,3,66.7
789,3/10/2018 4:45,33,32,20,85,3,66.7
790,3/10/2018 4:50,40,37,25,102,3,66.7
791,3/10/2018 4:55,35,37,14,86,3,66.7
792,3/10/2018 5:00,23,23,8,54,3,66.7
793,3/10/2018 5:05,40,38,24,102,3,66.7
794,3/10/2018 5:10,40,37,16,93,3,66.7
795,3/10/2018 5:15,38,43,24,105,3,66.7
796,3/10/2018 5:20,40,54,24,118,3,66.7
797,3/10/2018 5:25,34,35,17,86,3,66.7
798,3/10/2018 5:30,40,44,20,104,3,66.7
799,3/10/2018 5:35,41,37,19,97,3,66.7
800,3/10/2018 5:40,51,51,24,126,3,66.7
801,3/10/2018 5:45,46,51,25,122,3,66.7
802,3/10/2018 5:50,49,58,32,139,3,66.7
803,3/10/2018 5:55,44,47,31,122,3,66.7
804,3/10/2018 6:00,40,42,27,109,3,66.7
805,3/10/2018 6:05,45,47,23,115,3,66.7
806,3/10/2018 6:10,50,49,31,130,3,66.7
807,3/10/2018 6:15,47,46,22,115,3,66.7
808,3/10/2018 6:20,52,53,33,138,3,66.7
809,3/10/2018 6:25,59,66,27,152,3,66.7
810,3/10/2018 6:30,54,54,45,153,3,66.7
811,3/10/2018 6:35,51,58,31,140,3,66.7
812,3/10/2018 6:40,52,71,42,165,3,66.7
813,3/10/2018 6:45,64,79,43,186,3,66.7
814,3/10/2018 6:50,56,72,44,172,3,66.7
815,3/10/2018 6:55,63,70,43,176,3,66.7
816,3/10/2018 7:00,65,63,35,163,3,66.7
817,3/10/2018 7:05,64,83,41,188,3,66.7
818,3/10/2018 7:10,65,69,43,177,3,66.7
819,3/10/2018 7:15,75,78,49,202,3,66.7
820,3/10/2018 7:20,68,69,36,173,3,66.7
821,3/10/2018 7:25,71,82,53,206,3,66.7
822,3/10/2018 7:30,68,88,45,201,3,66.7
823,3/10/2018 7:35,76,76,49,201,3,66.7
824,3/10/2018 7:40,70,69,46,185,3,66.7
825,3/10/2018 7:45,72,92,51,215,3,66.7
826,3/10/2018 7:50,78,103,57,238,3,66.7
827,3/10/2018 7:55,63,76,48,187,3,66.7
828,3/10/2018 8:00,76,75,50,201,3,66.7
829,3/10/2018 8:05,70,89,49,208,3,66.7
830,3/10/2018 8:10,73,85,56,214,3,66.7
831,3/10/2018 8:15,73,86,46,205,3,66.7
832,3/10/2018 8:20,69,98,53,220,3,66.7
833,3/10/2018 8:25,84,90,61,235,3,66.7
834,3/10/2018 8:30,80,86,69,235,3,66.7
835,3/10/2018 8:35,77,95,57,229,3,66.7
836,3/10/2018 8:40,75,83,49,207,3,66.7
837,3/10/2018 8:45,84,110,59,253,3,66.7
838,3/10/2018 8:50,73,89,66,228,3,66.7
839,3/10/2018 8:55,72,84,50,206,3,66.7
840,3/10/2018 9:00,86,91,56,233,3,66.7
841,3/10/2018 9:05,90,94,59,243,3,66.7
842,3/10/2018 9:10,84,82,48,214,3,66.7
843,3/10/2018 9:15,83,91,56,230,3,66.7
844,3/10/2018 9:20,85,87,60,232,3,66.7
845,3/10/2018 9:25,87,98,66,251,3,66.7
846,3/10/2018 9:30,88,94,49,231,3,66.7
847,3/10/2018 9:35,90,99,63,252,3,66.7
848,3/10/2018 9:40,91,91,63,245,3,66.7
849,3/10/2018 9:45,88,97,60,245,3,66.7
850,3/10/2018 9:50,95,94,64,253,3,66.7
851,3/10/2018 9:55,89,91,63,243,3,66.7
852,3/10/2018 10:00,96,97,60,253,3,66.7
853,3/10/2018 10:05,99,91,60,250,3,66.7
854,3/10/2018 10:10,103,96,66,265,3,66.7
855,3/10/2018 10:15,89,100,62,251,3,66.7
856,3/10/2018 10:20,93,95,63,251,3,66.7
857,3/10/2018 10:25,86,84,62,232,3,66.7
858,3/10/2018 10:30,92,92,68,252,3,66.7
859,3/10/2018 10:35,108,110,70,288,3,66.7
860,3/10/2018 10:40,86,111,67,264,3,66.7
861,3/10/2018 10:45,88,99,68,255,3,66.7
862,3/10/2018 10:50,88,99,63,250,3,66.7
863,3/10/2018 10:55,85,89,64,238,3,66.7
864,3/10/2018 11:00,93,78,64,235,3,66.7
865,3/10/2018 11:05,96,99,70,265,3,66.7
866,3/10/2018 11:10,95,89,65,249,3,66.7
867,3/10/2018 11:15,98,85,49,232,3,66.7
868,3/10/2018 11:20,84,96,54,234,3,66.7
869,3/10/2018 11:25,79,88,53,220,3,66.7
870,3/10/2018 11:30,87,79,62,228,3,66.7
871,3/10/2018 11:35,77,70,49,196,3,66.7
872,3/10/2018 11:40,80,79,51,210,3,66.7
873,3/10/2018 11:45,84,91,61,236,3,66.7
874,3/10/2018 11:50,84,79,66,229,3,66.7
875,3/10/2018 11:55,79,83,68,230,3,66.7
876,3/10/2018 12:00,84,95,72,251,3,66.7
877,3/10/2018 12:05,80,79,75,234,3,66.7
878,3/10/2018 12:10,85,93,68,246,3,66.7
879,3/10/2018 12:15,87,91,64,242,3,66.7
880,3/10/2018 12:20,78,77,52,207,3,66.7
881,3/10/2018 12:25,81,82,54,217,3,66.7
882,3/10/2018 12:30,83,84,63,230,3,66.7
883,3/10/2018 12:35,85,83,71,239,3,66.7
884,3/10/2018 12:40,78,74,61,213,3,66.7
885,3/10/2018 12:45,79,95,59,233,3,66.7
886,3/10/2018 12:50,87,95,65,247,3,66.7
887,3/10/2018 12:55,82,89,65,236,3,66.7
888,3/10/2018 13:00,87,95,68,250,3,66.7
889,3/10/2018 13:05,84,98,73,255,3,66.7
890,3/10/2018 13:10,77,85,50,212,3,66.7
891,3/10/2018 13:15,84,84,63,231,3,66.7
892,3/10/2018 13:20,83,85,57,225,3,66.7
893,3/10/2018 13:25,76,82,55,213,3,66.7
894,3/10/2018 13:30,70,75,61,206,3,66.7
895,3/10/2018 13:35,73,79,51,203,3,66.7
896,3/10/2018 13:40,74,75,47,196,3,66.7
897,3/10/2018 13:45,74,81,62,217,3,66.7
898,3/10/2018 13:50,81,97,51,229,3,66.7
899,3/10/2018 13:55,93,85,74,252,3,66.7
900,3/10/2018 14:00,84,93,69,246,3,66.7
901,3/10/2018 14:05,86,101,71,258,3,66.7
902,3/10/2018 14:10,87,97,67,251,3,66.7
903,3/10/2018 14:15,91,89,58,238,3,66.7
904,3/10/2018 14:20,86,97,64,247,3,66.7
905,3/10/2018 14:25,89,93,61,243,3,66.7
906,3/10/2018 14:30,93,89,74,256,3,66.7
907,3/10/2018 14:35,89,86,70,245,3,66.7
908,3/10/2018 14:40,88,91,46,225,3,66.7
909,3/10/2018 14:45,84,84,74,242,3,66.7
910,3/10/2018 14:50,90,84,55,229,3,66.7
911,3/10/2018 14:55,86,90,61,237,3,66.7
912,3/10/2018 15:00,76,78,58,212,3,66.7
913,3/10/2018 15:05,66,78,43,187,3,66.7
914,3/10/2018 15:10,78,81,51,210,3,66.7
915,3/10/2018 15:15,74,76,55,205,3,66.7
916,3/10/2018 15:20,86,90,57,233,3,66.7
917,3/10/2018 15:25,82,75,56,213,3,66.7
918,3/10/2018 15:30,84,81,59,224,3,66.7
919,3/10/2018 15:35,84,99,71,254,3,66.7
920,3/10/2018 15:40,82,99,53,234,3,66.7
921,3/10/2018 15:45,89,105,73,267,3,66.7
922,3/10/2018 15:50,82,88,59,229,3,66.7
923,3/10/2018 15:55,92,89,62,243,3,66.7
924,3/10/2018 16:00,82,89,55,226,3,66.7
925,3/10/2018 16:05,87,96,61,244,3,66.7
926,3/10/2018 16:10,79,86,54,219,3,66.7
927,3/10/2018 16:15,71,84,55,210,3,66.7
928,3/10/2018 16:20,78,91,65,234,3,66.7
929,3/10/2018 16:25,79,87,67,233,3,66.7
930,3/10/2018 16:30,70,77,64,211,3,66.7
931,3/10/2018 16:35,63,88,55,206,3,66.7
932,3/10/2018 16:40,80,96,65,241,3,66.7
933,3/10/2018 16:45,72,81,61,214,3,66.7
934,3/10/2018 16:50,71,88,77,236,3,66.7
935,3/10/2018 16:55,79,99,76,254,3,66.7
936,3/10/2018 17:00,73,83,54,210,3,66.7
937,3/10/2018 17:05,75,79,63,217,3,66.7
938,3/10/2018 17:10,79,84,55,218,3,66.7
939,3/10/2018 17:15,75,73,47,195,3,66.7
940,3/10/2018 17:20,74,80,57,211,3,66.7
941,3/10/2018 17:25,81,80,63,224,3,66.7
942,3/10/2018 17:30,76,80,50,206,3,66.7
943,3/10/2018 17:35,76,83,63,222,3,66.7
944,3/10/2018 17:40,78,93,60,231,3,66.7
945,3/10/2018 17:45,79,86,58,223,3,66.7
946,3/10/2018 17:50,83,88,61,232,3,66.7
947,3/10/2018 17:55,79,86,60,225,3,66.7
948,3/10/2018 18:00,79,88,48,215,3,66.7
949,3/10/2018 18:05,66,76,46,188,3,66.7
950,3/10/2018 18:10,68,71,44,183,3,66.7
951,3/10/2018 18:15,77,73,53,203,3,66.7
952,3/10/2018 18:20,74,82,50,206,3,66.7
953,3/10/2018 18:25,77,84,52,213,3,66.7
954,3/10/2018 18:30,70,75,49,194,3,66.7
955,3/10/2018 18:35,77,81,62,220,3,66.7
956,3/10/2018 18:40,81,91,65,237,3,66.7
957,3/10/2018 18:45,82,85,65,232,3,66.7
958,3/10/2018 18:50,85,99,63,247,3,66.7
959,3/10/2018 18:55,71,84,62,217,3,66.7
960,3/10/2018 19:00,73,84,58,215,3,66.7
961,3/10/2018 19:05,77,78,48,203,3,66.7
962,3/10/2018 19:10,79,82,58,219,3,66.7
963,3/10/2018 19:15,82,78,49,209,3,66.7
964,3/10/2018 19:20,71,70,49,190,3,66.7
965,3/10/2018 19:25,72,73,44,189,3,66.7
966,3/10/2018 19:30,62,62,45,169,3,66.7
967,3/10/2018 19:35,61,65,42,168,3,66.7
968,3/10/2018 19:40,75,82,51,208,3,66.7
969,3/10/2018 19:45,79,85,60,224,3,66.7
970,3/10/2018 19:50,72,80,63,215,3,66.7
971,3/10/2018 19:55,79,88,60,227,3,66.7
972,3/10/2018 20:00,69,82,52,203,3,66.7
973,3/10/2018 20:05,71,88,50,209,3,66.7
974,3/10/2018 20:10,73,82,65,220,3,66.7
975,3/10/2018 20:15,70,104,61,235,3,66.7
976,3/10/2018 20:20,93,89,71,253,3,66.7
977,3/10/2018 20:25,74,88,65,227,3,66.7
978,3/10/2018 20:30,63,64,44,171,3,66.7
979,3/10/2018 20:35,84,87,65,236,3,66.7
980,3/10/2018 20:40,69,71,50,190,3,66.7
981,3/10/2018 20:45,68,90,53,211,3,66.7
982,3/10/2018 20:50,69,80,56,205,3,66.7
983,3/10/2018 20:55,64,82,49,195,3,66.7
984,3/10/2018 21:00,70,80,47,197,3,66.7
985,3/10/2018 21:05,59,67,38,164,3,66.7
986,3/10/2018 21:10,71,89,65,225,3,66.7
987,3/10/2018 21:15,74,90,59,223,3,66.7
988,3/10/2018 21:20,77,91,57,225,3,66.7
989,3/10/2018 21:25,65,71,56,192,3,66.7
990,3/10/2018 21:30,66,67,41,174,3,66.7
991,3/10/2018 21:35,68,87,49,204,3,66.7
992,3/10/2018 21:40,66,76,49,191,3,66.7
993,3/10/2018 21:45,71,80,59,210,3,66.7
994,3/10/2018 21:50,68,92,61,221,3,66.7
995,3/10/2018 21:55,66,73,46,185,3,66.7
996,3/10/2018 22:00,69,72,50,191,3,66.7
997,3/10/2018 22:05,59,85,46,190,3,66.7
998,3/10/2018 22:10,67,71,53,191,3,66.7
999,3/10/2018 22:15,59,75,49,183,3,66.7
1000,3/10/2018 22:20,74,83,54,211,3,66.7
1001,3/10/2018 22:25,70,74,44,188,3,66.7
1002,3/10/2018 22:30,67,82,49,198,3,66.7
1003,3/10/2018 22:35,68,74,37,179,3,66.7
1004,3/10/2018 22:40,63,85,43,191,3,66.7
1005,3/10/2018 22:45,64,65,38,167,3,66.7
1006,3/10/2018 22:50,67,78,48,193,3,66.7
1007,3/10/2018 22:55,73,88,58,219,3,66.7
1008,3/10/2018 23:00,68,79,55,202,3,66.7
1009,3/10/2018 23:05,64,80,51,195,3,66.7
1010,3/10/2018 23:10,67,83,56,206,3,66.7
1011,3/10/2018 23:15,70,78,52,200,3,66.7
1012,3/10/2018 23:20,58,71,45,174,3,66.7
1013,3/10/2018 23:25,59,69,43,171,3,66.7
1014,3/10/2018 23:30,53,76,40,169,3,66.7
1015,3/10/2018 23:35,62,75,41,178,3,66.7
1016,3/10/2018 23:40,62,74,49,185,3,66.7
1017,3/10/2018 23:45,56,73,36,165,3,66.7
1018,3/10/2018 23:50,57,73,44,174,3,66.7
1019,3/10/2018 23:55,45,71,39,155,3,66.7
1020,3/11/2018 0:00,59,63,48,170,3,66.7
1021,3/11/2018 0:05,63,72,36,171,3,66.7
1022,3/11/2018 0:10,50,70,37,157,3,66.7
1023,3/11/2018 0:15,48,76,35,159,3,66.7
1024,3/11/2018 0:20,51,54,41,146,3,66.7
1025,3/11/2018 0:25,55,64,41,160,3,66.7
1026,3/11/2018 0:30,52,59,38,149,3,66.7
1027,3/11/2018 0:35,49,60,36,145,3,66.7
1028,3/11/2018 0:40,45,58,34,137,3,66.7
1029,3/11/2018 0:45,44,59,32,135,3,66.7
1030,3/11/2018 0:50,39,55,28,122,3,66.7
1031,3/11/2018 0:55,43,51,30,124,3,66.7
1032,3/11/2018 1:00,39,42,30,111,3,66.7
1033,3/11/2018 1:05,45,48,20,113,3,66.7
1034,3/11/2018 1:10,39,43,29,111,3,66.7
1035,3/11/2018 1:15,35,36,30,101,3,66.7
1036,3/11/2018 1:20,44,45,24,113,3,66.7
1037,3/11/2018 1:25,39,51,25,115,3,66.7
1038,3/11/2018 1:30,33,43,24,100,3,66.7
1039,3/11/2018 1:35,37,32,19,88,3,66.7
1040,3/11/2018 1:40,38,43,28,109,3,66.7
1041,3/11/2018 1:45,33,39,16,88,3,66.7
1042,3/11/2018 1:50,35,33,17,85,3,66.7
1043,3/11/2018 1:55,39,40,26,105,3,66.7
1044,3/11/2018 3:00,38,38,17,93,3,66.7
1045,3/11/2018 3:05,35,31,21,87,3,66.7
1046,3/11/2018 3:10,35,29,18,82,3,66.7
1047,3/11/2018 3:15,32,25,18,75,3,66.7
1048,3/11/2018 3:20,35,32,20,87,3,66.7
1049,3/11/2018 3:25,31,36,22,89,3,66.7
1050,3/11/2018 3:30,28,32,16,76,3,66.7
1051,3/11/2018 3:35,31,36,21,88,3,66.7
1052,3/11/2018 3:40,25,30,19,74,3,66.7
1053,3/11/2018 3:45,30,37,18,85,3,66.7
1054,3/11/2018 3:50,26,22,13,61,3,66.7
1055,3/11/2018 3:55,31,28,23,82,3,66.7
1056,3/11/2018 4:00,29,23,10,62,3,66.7
1057,3/11/2018 4:05,13,20,12,45,3,0.0
1058,3/11/2018 4:10,26,10,30,66,3,66.7
1059,3/11/2018 4:15,27,28,15,70,3,66.7
1060,3/11/2018 4:20,27,26,13,66,3,66.7
1061,3/11/2018 4:25,25,28,12,65,3,66.7
1062,3/11/2018 4:30,25,25,11,61,3,66.7
1063,3/11/2018 4:35,24,22,10,56,3,66.7
1064,3/11/2018 4:40,28,36,13,77,3,66.7
1065,3/11/2018 4:45,31,24,21,76,3,66.7
1066,3/11/2018 4:50,31,37,19,87,3,66.7
1067,3/11/2018 4:55,33,36,19,88,3,66.7
1068,3/11/2018 5:00,32,26,18,76,3,66.7
1069,3/11/2018 5:05,30,36,18,84,3,66.7
1070,3/11/2018 5:10,34,36,19,89,3,66.7
1071,3/11/2018 5:15,36,38,13,87,3,66.7
1072,3/11/2018 5:20,30,37,18,85,3,66.7
1073,3/11/2018 5:25,26,30,12,68,3,66.7
1074,3/11/2018 5:30,32,31,14,77,3,66.7
1075,3/11/2018 5:35,31,32,19,82,3,66.7
1076,3/11/2018 5:40,34,30,16,80,3,66.7
1077,3/11/2018 5:45,39,39,30,108,3,66.7
1078,3/11/2018 5:50,35,28,24,87,3,66.7
1079,3/11/2018 5:55,33,35,18,86,3,66.7
1080,3/11/2018 6:00,35,33,15,83,3,66.7
1081,3/11/2018 6:05,39,44,23,106,3,66.7
1082,3/11/2018 6:10,37,37,23,97,3,66.7
1083,3/11/2018 6:15,40,42,20,102,3,66.7
1084,3/11/2018 6:20,33,37,21,91,3,66.7
1085,3/11/2018 6:25,39,48,26,113,3,66.7
1086,3/11/2018 6:30,33,39,23,95,3,66.7
1087,3/11/2018 6:35,39,41,21,101,3,66.7
1088,3/11/2018 6:40,40,44,29,113,3,66.7
1089,3/11/2018 6:45,38,55,30,123,3,66.7
1090,3/11/2018 6:50,50,43,29,122,3,66.7
1091,3/11/2018 6:55,47,54,26,127,3,66.7
1092,3/11/2018 7:00,43,48,31,122,3,66.7
1093,3/11/2018 7:05,42,49,26,117,3,66.7
1094,3/11/2018 7:10,47,53,30,130,3,66.7
1095,3/11/2018 7:15,41,50,20,111,3,66.7
1096,3/11/2018 7:20,46,43,29,118,3,66.7
1097,3/11/2018 7:25,46,66,41,153,3,66.7
1098,3/11/2018 7:30,44,59,26,129,3,66.7
1099,3/11/2018 7:35,51,48,27,126,3,66.7
1100,3/11/2018 7:40,59,72,61,192,3,66.7
1101,3/11/2018 7:45,62,62,38,162,3,66.7
1102,3/11/2018 7:50,50,55,31,136,3,66.7
1103,3/11/2018 7:55,58,61,35,154,3,66.7
1104,3/11/2018 8:00,51,60,39,150,3,66.7
1105,3/11/2018 8:05,45,60,34,139,3,66.7
1106,3/11/2018 8:10,48,63,34,145,3,66.7
1107,3/11/2018 8:15,66,74,59,199,3,66.7
1108,3/11/2018 8:20,51,59,40,150,3,66.7
1109,3/11/2018 8:25,59,56,47,162,3,66.7
1110,3/11/2018 8:30,68,67,44,179,3,66.7
1111,3/11/2018 8:35,55,69,47,171,3,66.7
1112,3/11/2018 8:40,63,70,45,178,3,66.7
1113,3/11/2018 8:45,68,73,49,190,3,66.7
1114,3/11/2018 8:50,59,66,46,171,3,66.7
1115,3/11/2018 8:55,60,66,39,165,3,66.7
1116,3/11/2018 9:00,59,63,42,164,3,66.7
1117,3/11/2018 9:05,59,73,35,167,3,66.7
1118,3/11/2018 9:10,63,78,41,182,3,66.7
1119,3/11/2018 9:15,61,72,46,179,3,66.7
1120,3/11/2018 9:20,67,82,45,194,3,66.7
1121,3/11/2018 9:25,74,81,49,204,3,66.7
1122,3/11/2018 9:30,60,75,32,167,3,66.7
1123,3/11/2018 9:35,79,82,60,221,3,66.7
1124,3/11/2018 9:40,70,71,46,187,3,66.7
1125,3/11/2018 9:45,72,73,50,195,3,66.7
1126,3/11/2018 9:50,77,84,51,212,3,66.7
1127,3/11/2018 9:55,80,91,58,229,3,66.7
1128,3/11/2018 10:00,75,89,49,213,3,66.7
1129,3/11/2018 10:05,70,87,41,198,3,66.7
1130,3/11/2018 10:10,64,81,55,200,3,66.7
1131,3/11/2018 10:15,75,93,62,230,3,66.7
1132,3/11/2018 10:20,70,84,46,200,3,66.7
1133,3/11/2018 10:25,81,79,55,215,3,66.7
1134,3/11/2018 10:30,81,81,66,228,3,66.7
1135,3/11/2018 10:35,66,78,62,206,3,66.7
1136,3/11/2018 10:40,81,90,59,230,3,66.7
1137,3/11/2018 10:45,62,76,49,187,3,66.7
1138,3/11/2018 10:50,87,89,52,228,3,66.7
1139,3/11/2018 10:55,62,80,52,194,3,66.7
1140,3/11/2018 11:00,75,86,50,211,3,66.7
1141,3/11/2018 11:05,79,88,54,221,3,66.7
1142,3/11/2018 11:10,75,89,48,212,3,66.7
1143,3/11/2018 11:15,72,88,54,214,3,66.7
1144,3/11/2018 11:20,78,84,49,211,3,66.7
1145,3/11/2018 11:25,83,89,55,227,3,66.7
1146,3/11/2018 11:30,74,87,69,230,3,66.7
1147,3/11/2018 11:35,87,91,57,235,3,66.7
1148,3/11/2018 11:40,81,96,65,242,3,66.7
1149,3/11/2018 11:45,74,85,54,213,3,66.7
1150,3/11/2018 11:50,74,96,59,229,3,66.7
1151,3/11/2018 11:55,83,90,62,235,3,66.7
1152,3/11/2018 12:00,84,92,64,240,3,66.7
1153,3/11/2018 12:05,69,91,55,215,3,66.7
1154,3/11/2018 12:10,86,84,62,232,3,66.7
1155,3/11/2018 12:15,78,99,61,238,3,66.7
1156,3/11/2018 12:20,83,99,73,255,3,66.7
1157,3/11/2018 12:25,83,85,58,226,3,66.7
1158,3/11/2018 12:30,88,84,64,236,3,66.7
1159,3/11/2018 12:35,82,94,59,235,3,66.7
1160,3/11/2018 12:40,75,89,58,222,3,66.7
1161,3/11/2018 12:45,93,86,71,250,3,66.7
1162,3/11/2018 12:50,90,100,50,240,3,66.7
1163,3/11/2018 12:55,85,91,77,253,3,66.7
1164,3/11/2018 13:00,88,92,61,241,3,66.7
1165,3/11/2018 13:05,91,94,69,254,3,66.7
1166,3/11/2018 13:10,87,108,70,265,3,66.7
1167,3/11/2018 13:15,84,92,66,242,3,66.7
1168,3/11/2018 13:20,86,104,70,260,3,66.7
1169,3/11/2018 13:25,92,93,64,249,3,66.7
1170,3/11/2018 13:30,85,85,59,229,3,66.7
1171,3/11/2018 13:35,89,94,69,252,3,66.7
1172,3/11/2018 13:40,99,102,72,273,3,66.7
1173,3/11/2018 13:45,88,87,63,238,3,66.7
1174,3/11/2018 13:50,94,93,62,249,3,66.7
1175,3/11/2018 13:55,95,95,62,252,3,66.7
1176,3/11/2018 14:00,81,87,58,226,3,66.7
1177,3/11/2018 14:05,82,88,65,235,3,66.7
1178,3/11/2018 14:10,104,102,64,270,3,66.7
1179,3/11/2018 14:15,91,99,72,262,3,66.7
1180,3/11/2018 14:20,89,101,58,248,3,66.7
1181,3/11/2018 14:25,85,88,65,238,3,66.7
1182,3/11/2018 14:30,87,102,75,264,3,66.7
1183,3/11/2018 14:35,87,82,62,231,3,66.7
1184,3/11/2018 14:40,95,82,69,246,3,66.7
1185,3/11/2018 14:45,96,96,59,251,3,66.7
1186,3/11/2018 14:50,86,96,69,251,3,66.7
1187,3/11/2018 14:55,86,93,74,253,3,66.7
1188,3/11/2018 15:00,86,93,61,240,3,66.7
1189,3/11/2018 15:05,85,90,61,236,3,66.7
1190,3/11/2018 15:10,94,110,69,273,3,66.7
1191,3/11/2018 15:15,97,108,78,283,3,66.7
1192,3/11/2018 15:20,86,107,76,269,3,66.7
1193,3/11/2018 15:25,93,98,77,268,3,66.7
1194,3/11/2018 15:30,84,93,61,238,3,66.7
1195,3/11/2018 15:35,88,87,64,239,3,66.7
1196,3/11/2018 15:40,91,102,64,257,3,66.7
1197,3/11/2018 15:45,89,88,67,244,3,66.7
1198,3/11/2018 15:50,87,93,72,252,3,66.7
1199,3/11/2018 15:55,85,98,57,240,3,66.7
1200,3/11/2018 16:00,80,88,61,229,3,66.7
1201,3/11/2018 16:05,78,92,68,238,3,66.7
1202,3/11/2018 16:10,77,105,69,251,3,66.7
1203,3/11/2018 16:15,88,95,69,252,3,66.7
1204,3/11/2018 16:20,90,99,76,265,3,66.7
1205,3/11/2018 16:25,86,97,67,250,3,66.7
1206,3/11/2018 16:30,85,105,71,261,3,66.7
1207,3/11/2018 16:35,95,108,68,271,3,66.7
1208,3/11/2018 16:40,92,111,76,279,3,66.7
1209,3/11/2018 16:45,87,108,79,274,3,66.7
1210,3/11/2018 16:50,88,94,68,250,3,66.7
1211,3/11/2018 16:55,84,76,58,218,3,66.7
1212,3/11/2018 17:00,96,100,70,266,3,66.7
1213,3/11/2018 17:05,81,86,68,235,3,66.7
1214,3/11/2018 17:10,91,106,80,277,3,66.7
1215,3/11/2018 17:15,92,96,76,264,3,66.7
1216,3/11/2018 17:20,91,93,67,251,3,66.7
1217,3/11/2018 17:25,76,95,57,228,3,66.7
1218,3/11/2018 17:30,72,96,52,220,3,66.7
1219,3/11/2018 17:35,84,79,63,226,3,66.7
1220,3/11/2018 17:40,90,86,65,241,3,66.7
1221,3/11/2018 17:45,84,88,74,246,3,66.7
1222,3/11/2018 17:50,72,85,55,212,3,66.7
1223,3/11/2018 17:55,85,97,62,244,3,66.7
1224,3/11/2018 18:00,88,83,61,232,3,66.7
1225,3/11/2018 18:05,87,85,62,234,3,66.7
1226,3/11/2018 18:10,82,102,65,249,3,66.7
1227,3/11/2018 18:15,79,97,61,237,3,66.7
1228,3/11/2018 18:20,99,101,77,277,3,66.7
1229,3/11/2018 18:25,84,93,69,246,3,66.7
1230,3/11/2018 18:30,79,107,63,249,3,66.7
1231,3/11/2018 18:35,73,90,56,219,3,66.7
1232,3/11/2018 18:40,88,90,64,242,3,66.7
1233,3/11/2018 18:45,80,94,70,244,3,66.7
1234,3/11/2018 18:50,78,103,57,238,3,66.7
1235,3/11/2018 18:55,85,101,58,244,3,66.7
1236,3/11/2018 19:00,78,98,57,233,3,66.7
1237,3/11/2018 19:05,74,87,57,218,3,66.7
1238,3/11/2018 19:10,84,89,54,227,3,66.7
1239,3/11/2018 19:15,76,83,70,229,3,66.7
1240,3/11/2018 19:20,82,92,46,220,3,66.7
1241,3/11/2018 19:25,84,107,71,262,3,66.7
1242,3/11/2018 19:30,83,92,62,237,3,66.7
1243,3/11/2018 19:35,85,95,68,248,3,66.7
1244,3/11/2018 19:40,89,96,64,249,3,66.7
1245,3/11/2018 19:45,88,105,67,260,3,66.7
1246,3/11/2018 19:50,81,91,75,247,3,66.7
1247,3/11/2018 19:55,77,98,53,228,3,66.7
1248,3/11/2018 20:00,91,103,62,256,3,66.7
1249,3/11/2018 20:05,104,108,73,285,3,66.7
1250,3/11/2018 20:10,86,90,67,243,3,66.7
1251,3/11/2018 20:15,80,99,58,237,3,66.7
1252,3/11/2018 20:20,73,88,57,218,3,66.7
1253,3/11/2018 20:25,83,84,64,231,3,66.7
1254,3/11/2018 20:30,88,95,58,241,3,66.7
1255,3/11/2018 20:35,62,82,49,193,3,66.7
1256,3/11/2018 20:40,75,96,60,231,3,66.7
1257,3/11/2018 20:45,78,85,57,220,3,66.7
1258,3/11/2018 20:50,75,83,62,220,3,66.7
1259,3/11/2018 20:55,69,87,50,206,3,66.7
1260,3/11/2018 21:00,68,100,71,239,3,66.7
1261,3/11/2018 21:05,75,102,59,236,3,66.7
1262,3/11/2018 21:10,79,94,59,232,3,66.7
1263,3/11/2018 21:15,81,100,69,250,3,66.7
1264,3/11/2018 21:20,76,91,64,231,3,66.7
1265,3/11/2018 21:25,76,95,46,217,3,66.7
1266,3/11/2018 21:30,70,85,58,213,3,66.7
1267,3/11/2018 21:35,72,98,52,222,3,66.7
1268,3/11/2018 21:40,66,88,64,218,3,66.7
1269,3/11/2018 21:45,74,97,60,231,3,66.7
1270,3/11/2018 21:50,74,83,50,207,3,66.7
1271,3/11/2018 21:55,71,90,57,218,3,66.7
1272,3/11/2018 22:00,73,94,58,225,3,66.7
1273,3/11/2018 22:05,75,95,62,232,3,66.7
1274,3/11/2018 22:10,73,89,47,209,3,66.7
1275,3/11/2018 22:15,68,83,50,201,3,66.7
1276,3/11/2018 22:20,72,87,49,208,3,66.7
1277,3/11/2018 22:25,72,93,59,224,3,66.7
1278,3/11/2018 22:30,66,91,50,207,3,66.7
1279,3/11/2018 22:35,68,74,50,192,3,66.7
1280,3/11/2018 22:40,71,77,52,200,3,66.7
1281,3/11/2018 22:45,59,92,51,202,3,66.7
1282,3/11/2018 22:50,75,81,56,212,3,66.7
1283,3/11/2018 22:55,64,78,49,191,3,66.7
1284,3/11/2018 23:00,60,67,40,167,3,66.7
1285,3/11/2018 23:05,66,70,41,177,3,66.7
1286,3/11/2018 23:10,52,69,39,160,3,66.7
1287,3/11/2018 23:15,66,77,42,185,3,66.7
1288,3/11/2018 23:20,57,60,46,163,3,66.7
1289,3/11/2018 23:25,63,77,44,184,3,66.7
1290,3/11/2018 23:30,56,73,41,170,3,66.7
1291,3/11/2018 23:35,49,69,36,154,3,66.7
1292,3/11/2018 23:40,64,65,43,172,3,66.7
1293,3/11/2018 23:45,51,78,53,182,3,66.7
1294,3/11/2018 23:50,59,68,45,172,3,66.7
1295,3/11/2018 23:55,58,67,38,163,3,66.7
1296,3/12/2018 0:00,51,65,38,154,3,66.7
1297,3/12/2018 0:05,61,68,38,167,3,66.7
1298,3/12/2018 0:10,49,61,31,141,3,66.7
1299,3/12/2018 0:15,46,56,25,127,3,66.7
1300,3/12/2018 0:20,42,47,28,117,3,66.7
1301,3/12/2018 0:25,48,52,29,129,3,66.7
1302,3/12/2018 0:30,45,58,29,132,3,66.7
1303,3/12/2018 0:35,48,49,32,129,3,66.7
1304,3/12/2018 0:40,47,49,29,125,3,66.7
1305,3/12/2018 0:45,40,48,30,118,3,66.7
1306,3/12/2018 0:50,35,55,31,121,3,66.7
1307,3/12/2018 0:55,41,46,22,109,3,66.7
1308,3/12/2018 1:00,45,43,28,116,3,66.7
1309,3/12/2018 1:05,39,57,27,123,3,66.7
1310,3/12/2018 1:10,43,48,30,121,3,66.7
1311,3/12/2018 1:15,40,50,21,111,3,66.7
1312,3/12/2018 1:20,42,46,27,115,3,66.7
1313,3/12/2018 1:25,36,33,18,87,3,66.7
1314,3/12/2018 1:30,29,31,18,78,3,66.7
1315,3/12/2018 1:35,31,34,21,86,3,66.7
1316,3/12/2018 1:40,32,30,18,80,3,66.7
1317,3/12/2018 1:45,34,31,18,83,3,66.7
1318,3/12/2018 1:50,30,27,17,74,3,66.7
1319,3/12/2018 1:55,32,33,8,73,3,66.7
1320,3/12/2018 2:00,26,25,16,67,3,66.7
1321,3/12/2018 2:05,25,28,19,72,3,66.7
1322,3/12/2018 2:10,27,22,10,59,3,66.7
1323,3/12/2018 2:15,23,23,16,62,3,66.7
1324,3/12/2018 2:20,28,18,14,60,3,66.7
1325,3/12/2018 2:25,28,22,14,64,3,66.7
1326,3/12/2018 2:30,23,28,12,63,3,66.7
1327,3/12/2018 2:35,22,15,12,49,3,66.7
1328,3/12/2018 2:40,19,18,7,44,3,66.7
1329,3/12/2018 2:45,26,18,13,57,3,66.7
1330,3/12/2018 2:50,20,20,12,52,3,66.7
1331,3/12/2018 2:55,19,14,8,41,3,66.7
1332,3/12/2018 3:00,19,17,11,47,3,66.7
1333,3/12/2018 3:05,20,21,12,53,3,66.7
1334,3/12/2018 3:10,19,18,10,47,3,66.7
1335,3/12/2018 3:15,22,15,12,49,3,66.7
1336,3/12/2018 3:20,20,14,12,46,3,66.7
1337,3/12/2018 3:25,27,29,12,68,3,66.7
1338,3/12/2018 3:30,15,18,5,38,3,66.7
1339,3/12/2018 3:35,22,18,14,54,3,66.7
1340,3/12/2018 3:40,26,23,14,63,3,66.7
1341,3/12/2018 3:45,22,18,9,49,3,66.7
1342,3/12/2018 3:50,18,20,8,46,3,66.7
1343,3/12/2018 3:55,24,23,17,64,3,66.7
1344,3/12/2018 4:00,19,14,12,45,3,66.7
1345,3/12/2018 4:05,29,28,19,76,3,66.7
1346,3/12/2018 4:10,24,5,4,33,3,66.7
1347,3/12/2018 4:15,26,0,0,26,3,66.7
1348,3/12/2018 4:20,33,50,37,120,3,66.7
1349,3/12/2018 4:25,27,27,15,69,3,66.7
1350,3/12/2018 4:30,36,39,18,93,3,66.7
1351,3/12/2018 4:35,40,41,26,107,3,66.7
1352,3/12/2018 4:40,37,34,13,84,3,66.7
1353,3/12/2018 4:45,38,44,17,99,3,66.7
1354,3/12/2018 4:50,41,43,19,103,3,66.7
1355,3/12/2018 4:55,38,42,19,99,3,66.7
1356,3/12/2018 5:00,39,43,18,100,3,66.7
1357,3/12/2018 5:05,46,43,23,112,3,66.7
1358,3/12/2018 5:10,46,45,19,110,3,66.7
1359,3/12/2018 5:15,47,58,23,128,3,66.7
1360,3/12/2018 5:20,62,58,34,154,3,66.7
1361,3/12/2018 5:25,54,60,26,140,3,66.7
1362,3/12/2018 5:30,60,53,28,141,3,66.7
1363,3/12/2018 5:35,56,55,31,142,3,66.7
1364,3/12/2018 5:40,52,55,34,141,3,66.7
1365,3/12/2018 5:45,61,59,32,152,3,66.7
1366,3/12/2018 5:50,57,60,27,144,3,66.7
1367,3/12/2018 5:55,62,61,26,149,3,66.7
1368,3/12/2018 6:00,56,68,32,156,3,66.7
1369,3/12/2018 6:05,62,71,37,170,3,66.7
1370,3/12/2018 6:10,61,68,33,162,3,66.7
1371,3/12/2018 6:15,80,79,48,207,3,66.7
1372,3/12/2018 6:20,62,82,34,178,3,66.7
1373,3/12/2018 6:25,63,75,40,178,3,66.7
1374,3/12/2018 6:30,71,87,45,203,3,66.7
1375,3/12/2018 6:35,79,74,38,191,3,66.7
1376,3/12/2018 6:40,76,87,48,211,3,66.7
1377,3/12/2018 6:45,80,83,53,216,3,66.7
1378,3/12/2018 6:50,88,96,49,233,3,66.7
1379,3/12/2018 6:55,89,100,56,245,3,66.7
1380,3/12/2018 7:00,87,93,56,236,3,66.7
1381,3/12/2018 7:05,76,94,63,233,3,66.7
1382,3/12/2018 7:10,79,81,68,228,3,66.7
1383,3/12/2018 7:15,86,101,56,243,3,66.7
1384,3/12/2018 7:20,94,94,74,262,3,66.7
1385,3/12/2018 7:25,82,96,66,244,3,66.7
1386,3/12/2018 7:30,100,103,72,275,3,66.7
1387,3/12/2018 7:35,90,104,64,258,3,66.7
1388,3/12/2018 7:40,100,99,57,256,3,66.7
1389,3/12/2018 7:45,86,100,55,241,3,66.7
1390,3/12/2018 7:50,89,87,48,224,3,66.7
1391,3/12/2018 7:55,88,90,61,239,3,66.7
1392,3/12/2018 8:00,88,98,53,239,3,66.7
1393,3/12/2018 8:05,87,93,52,232,3,66.7
1394,3/12/2018 8:10,87,87,56,230,3,66.7
1395,3/12/2018 8:15,89,91,66,246,3,66.7
1396,3/12/2018 8:20,93,110,66,269,3,66.7
1397,3/12/2018 8:25,95,89,55,239,3,66.7
1398,3/12/2018 8:30,85,95,57,237,3,66.7
1399,3/12/2018 8:35,86,108,61,255,3,66.7
1400,3/12/2018 8:40,94,87,58,239,3,66.7
1401,3/12/2018 8:45,89,84,57,230,3,66.7
1402,3/12/2018 8:50,86,105,64,255,3,66.7
1403,3/12/2018 8:55,86,86,59,231,3,66.7
1404,3/12/2018 9:00,80,93,48,221,3,66.7
1405,3/12/2018 9:05,81,89,61,231,3,66.7
1406,3/12/2018 9:10,85,96,44,225,3,66.7
1407,3/12/2018 9:15,83,86,50,219,3,66.7
1408,3/12/2018 9:20,80,80,57,217,3,66.7
1409,3/12/2018 9:25,89,95,53,237,3,66.7
1410,3/12/2018 9:30,90,92,59,241,3,66.7
1411,3/12/2018 9:35,76,95,53,224,3,66.7
1412,3/12/2018 9:40,92,97,69,258,3,66.7
1413,3/12/2018 9:45,91,102,61,254,3,66.7
1414,3/12/2018 9:50,91,95,54,240,3,66.7
1415,3/12/2018 9:55,92,97,63,252,3,66.7
1416,3/12/2018 10:00,98,89,70,257,3,66.7
1417,3/12/2018 10:05,94,94,59,247,3,66.7
1418,3/12/2018 10:10,93,118,64,275,3,66.7
1419,3/12/2018 10:15,85,86,62,233,3,66.7
1420,3/12/2018 10:20,79,78,43,200,3,66.7
1421,3/12/2018 10:25,91,107,56,254,3,66.7
1422,3/12/2018 10:30,91,95,53,239,3,66.7
1423,3/12/2018 10:35,91,96,58,245,3,66.7
1424,3/12/2018 10:40,85,94,54,233,3,66.7
1425,3/12/2018 10:45,77,92,65,234,3,66.7
1426,3/12/2018 10:50,82,106,53,241,3,66.7
1427,3/12/2018 10:55,94,94,59,247,3,66.7
1428,3/12/2018 11:00,76,103,68,247,3,66.7
1429,3/12/2018 11:05,90,110,60,260,3,66.7
1430,3/12/2018 11:10,92,88,56,236,3,66.7
1431,3/12/2018 11:15,87,103,72,262,3,66.7
1432,3/12/2018 11:20,92,95,63,250,3,66.7
1433,3/12/2018 11:25,92,103,65,260,3,66.7
1434,3/12/2018 11:30,98,103,78,279,3,66.7
1435,3/12/2018 11:35,72,107,50,229,3,66.7
1436,3/12/2018 11:40,66,103,58,227,3,66.7
1437,3/12/2018 11:45,87,105,56,248,3,66.7
1438,3/12/2018 11:50,68,72,46,186,3,66.7
1439,3/12/2018 11:55,85,105,63,253,3,66.7
1440,3/12/2018 12:00,92,101,70,263,3,66.7
1441,3/12/2018 12:05,95,115,73,283,3,66.7
1442,3/12/2018 12:10,88,94,71,253,3,66.7
1443,3/12/2018 12:15,108,103,67,278,3,66.7
1444,3/12/2018 12:20,103,101,72,276,3,66.7
1445,3/12/2018 12:25,85,101,56,242,3,66.7
1446,3/12/2018 12:30,96,102,74,272,3,66.7
1447,3/12/2018 12:35,87,98,75,260,3,66.7
1448,3/12/2018 12:40,92,100,57,249,3,66.7
1449,3/12/2018 12:45,94,93,60,247,3,66.7
1450,3/12/2018 12:50,94,92,64,250,3,66.7
1451,3/12/2018 12:55,99,99,57,255,3,66.7
1452,3/12/2018 13:00,89,96,59,244,3,66.7
1453,3/12/2018 13:05,90,91,47,228,3,66.7
1454,3/12/2018 13:10,103,102,62,267,3,66.7
1455,3/12/2018 13:15,95,100,67,262,3,66.7
1456,3/12/2018 13:20,93,82,54,229,3,66.7
1457,3/12/2018 13:25,86,88,58,232,3,66.7
1458,3/12/2018 13:30,93,99,69,261,3,66.7
1459,3/12/2018 13:35,97,103,64,264,3,66.7
1460,3/12/2018 13:40,90,97,73,260,3,66.7
1461,3/12/2018 13:45,95,103,70,268,3,66.7
1462,3/12/2018 13:50,111,114,72,297,3,66.7
1463,3/12/2018 13:55,99,119,82,300,3,66.7
1464,3/12/2018 14:00,95,113,61,269,3,66.7
1465,3/12/2018 14:05,97,101,66,264,3,66.7
1466,3/12/2018 14:10,97,97,69,263,3,66.7
1467,3/12/2018 14:15,94,95,53,242,3,66.7
1468,3/12/2018 14:20,99,100,56,255,3,66.7
1469,3/12/2018 14:25,95,95,66,256,3,66.7
1470,3/12/2018 14:30,99,98,61,258,3,66.7
1471,3/12/2018 14:35,91,97,68,256,3,66.7
1472,3/12/2018 14:40,107,95,83,285,3,66.7
1473,3/12/2018 14:45,102,104,65,271,3,66.7
1474,3/12/2018 14:50,95,109,82,286,3,66.7
1475,3/12/2018 14:55,104,104,77,285,3,66.7
1476,3/12/2018 15:00,95,108,60,263,3,66.7
1477,3/12/2018 15:05,96,84,72,252,3,66.7
1478,3/12/2018 15:10,80,69,60,209,3,66.7
1479,3/12/2018 15:15,98,98,60,256,3,66.7
1480,3/12/2018 15:20,88,94,72,254,3,66.7
1481,3/12/2018 15:25,73,85,64,222,3,66.7
1482,3/12/2018 15:30,97,109,63,269,3,66.7
1483,3/12/2018 15:35,89,89,58,236,3,66.7
1484,3/12/2018 15:40,101,92,62,255,3,66.7
1485,3/12/2018 15:45,103,90,73,266,3,66.7
1486,3/12/2018 15:50,97,96,70,263,3,66.7
1487,3/12/2018 15:55,113,71,55,239,3,66.7
1488,3/12/2018 16:00,99,85,72,256,3,66.7
1489,3/12/2018 16:05,97,88,65,250,3,66.7
1490,3/12/2018 16:10,87,80,71,238,3,66.7
1491,3/12/2018 16:15,96,61,46,203,3,66.7
1492,3/12/2018 16:20,101,59,61,221,3,66.7
1493,3/12/2018 16:25,93,74,82,249,3,66.7
1494,3/12/2018 16:30,87,73,77,237,3,66.7
1495,3/12/2018 16:35,103,64,69,236,3,66.7
1496,3/12/2018 16:40,98,84,78,260,3,66.7
1497,3/12/2018 16:45,93,79,79,251,3,66.7
1498,3/12/2018 16:50,80,58,46,184,3,66.7
1499,3/12/2018 16:55,91,69,71,231,3,66.7
1500,3/12/2018 17:00,81,71,77,229,3,66.7
1501,3/12/2018 17:05,93,76,64,233,3,66.7
1502,3/12/2018 17:10,90,91,65,246,3,66.7
1503,3/12/2018 17:15,89,96,53,238,3,66.7
1504,3/12/2018 17:20,87,91,64,242,3,66.7
1505,3/12/2018 17:25,98,74,84,256,3,66.7
1506,3/12/2018 17:30,96,78,70,244,3,66.7
1507,3/12/2018 17:35,105,83,101,289,3,66.7
1508,3/12/2018 17:40,90,73,63,226,3,66.7
1509,3/12/2018 17:45,91,79,59,229,3,66.7
1510,3/12/2018 17:50,90,77,82,249,3,66.7
1511,3/12/2018 17:55,95,92,75,262,3,66.7
1512,3/12/2018 18:00,80,85,80,245,3,66.7
1513,3/12/2018 18:05,101,78,68,247,3,66.7
1514,3/12/2018 18:10,96,82,81,259,3,66.7
1515,3/12/2018 18:15,96,94,86,276,3,66.7
1516,3/12/2018 18:20,92,91,57,240,3,66.7
1517,3/12/2018 18:25,88,76,47,211,3,66.7
1518,3/12/2018 18:30,83,84,57,224,3,66.7
1519,3/12/2018 18:35,84,89,54,227,3,66.7
1520,3/12/2018 18:40,96,93,56,245,3,66.7
1521,3/12/2018 18:45,82,92,55,229,3,66.7
1522,3/12/2018 18:50,84,89,73,246,3,66.7
1523,3/12/2018 18:55,89,95,55,239,3,66.7
1524,3/12/2018 19:00,94,81,62,237,3,66.7
1525,3/12/2018 19:05,96,94,70,260,3,66.7
1526,3/12/2018 19:10,88,87,65,240,3,66.7
1527,3/12/2018 19:15,88,97,63,248,3,66.7
1528,3/12/2018 19:20,94,96,71,261,3,66.7
1529,3/12/2018 19:25,81,86,58,225,3,66.7
1530,3/12/2018 19:30,84,84,43,211,3,66.7
1531,3/12/2018 19:35,90,95,51,236,3,66.7
1532,3/12/2018 19:40,84,92,56,232,3,66.7
1533,3/12/2018 19:45,100,98,69,267,3,66.7
1534,3/12/2018 19:50,97,102,74,273,3,66.7
1535,3/12/2018 19:55,86,105,67,258,3,66.7
1536,3/12/2018 20:00,91,106,67,264,3,66.7
1537,3/12/2018 20:05,93,103,69,265,3,66.7
1538,3/12/2018 20:10,94,103,61,258,3,66.7
1539,3/12/2018 20:15,93,107,52,252,3,66.7
1540,3/12/2018 20:20,82,98,65,245,3,66.7
1541,3/12/2018 20:25,87,96,59,242,3,66.7
1542,3/12/2018 20:30,85,97,64,246,3,66.7
1543,3/12/2018 20:35,73,104,61,238,3,66.7
1544,3/12/2018 20:40,75,83,56,214,3,66.7
1545,3/12/2018 20:45,83,93,59,235,3,66.7
1546,3/12/2018 20:50,82,86,56,224,3,66.7
1547,3/12/2018 20:55,80,88,73,241,3,66.7
1548,3/12/2018 21:00,69,90,58,217,3,66.7
1549,3/12/2018 21:05,68,86,47,201,3,66.7
1550,3/12/2018 21:10,74,99,56,229,3,66.7
1551,3/12/2018 21:15,92,102,65,259,3,66.7
1552,3/12/2018 21:20,77,106,57,240,3,66.7
1553,3/12/2018 21:25,81,89,60,230,3,66.7
1554,3/12/2018 21:30,81,99,60,240,3,66.7
1555,3/12/2018 21:35,70,96,56,222,3,66.7
1556,3/12/2018 21:40,71,76,43,190,3,66.7
1557,3/12/2018 21:45,72,100,61,233,3,66.7
1558,3/12/2018 21:50,78,108,66,252,3,66.7
1559,3/12/2018 21:55,67,88,45,200,3,66.7
1560,3/12/2018 22:00,64,76,45,185,3,66.7
1561,3/12/2018 22:05,74,97,62,233,3,66.7
1562,3/12/2018 22:10,77,88,57,222,3,66.7
1563,3/12/2018 22:15,72,98,54,224,3,66.7
1564,3/12/2018 22:20,72,83,47,202,3,66.7
1565,3/12/2018 22:25,84,86,51,221,3,66.7
1566,3/12/2018 22:30,69,102,55,226,3,66.7
1567,3/12/2018 22:35,68,73,39,180,3,66.7
1568,3/12/2018 22:40,70,80,51,201,3,66.7
1569,3/12/2018 22:45,84,82,66,232,3,66.7
1570,3/12/2018 22:50,65,93,57,215,3,66.7
1571,3/12/2018 22:55,78,83,67,228,3,66.7
1572,3/12/2018 23:00,52,86,35,173,3,66.7
1573,3/12/2018 23:05,56,77,38,171,3,66.7
1574,3/12/2018 23:10,59,74,46,179,3,66.7
1575,3/12/2018 23:15,63,79,46,188,3,66.7
1576,3/12/2018 23:20,56,70,37,163,3,66.7
1577,3/12/2018 23:25,54,74,40,168,3,66.7
1578,3/12/2018 23:30,55,76,41,172,3,66.7
1579,3/12/2018 23:35,55,77,34,166,3,66.7
1580,3/12/2018 23:40,72,83,54,209,3,66.7
1581,3/12/2018 23:45,50,65,36,151,3,66.7
1582,3/12/2018 23:50,56,70,41,167,3,66.7
1583,3/12/2018 23:55,42,63,32,137,3,66.7
1584,3/13/2018 0:00,58,60,33,151,3,66.7
1585,3/13/2018 0:05,51,66,29,146,3,66.7
1586,3/13/2018 0:10,49,55,29,133,3,66.7
1587,3/13/2018 0:15,45,61,32,138,3,66.7
1588,3/13/2018 0:20,56,58,37,151,3,66.7
1589,3/13/2018 0:25,38,66,30,134,3,66.7
1590,3/13/2018 0:30,46,46,24,116,3,66.7
1591,3/13/2018 0:35,44,45,31,120,3,66.7
1592,3/13/2018 0:40,38,49,27,114,3,66.7
1593,3/13/2018 0:45,45,63,37,145,3,66.7
1594,3/13/2018 0:50,42,48,27,117,3,66.7
1595,3/13/2018 0:55,41,49,28,118,3,66.7
1596,3/13/2018 1:00,34,43,22,99,3,66.7
1597,3/13/2018 1:05,37,48,24,109,3,66.7
1598,3/13/2018 1:10,40,43,24,107,3,66.7
1599,3/13/2018 1:15,36,35,30,101,3,66.7
1600,3/13/2018 1:20,36,37,21,94,3,66.7
1601,3/13/2018 1:25,39,37,21,97,3,66.7
1602,3/13/2018 1:30,31,36,20,87,3,66.7
1603,3/13/2018 1:35,37,43,18,98,3,66.7
1604,3/13/2018 1:40,33,44,22,99,3,66.7
1605,3/13/2018 1:45,41,47,27,115,3,66.7
1606,3/13/2018 1:50,29,34,12,75,3,66.7
1607,3/13/2018 1:55,25,26,14,65,3,66.7
1608,3/13/2018 2:00,31,36,19,86,3,66.7
1609,3/13/2018 2:05,31,38,16,85,3,66.7
1610,3/13/2018 2:10,29,30,14,73,3,66.7
1611,3/13/2018 2:15,30,38,12,80,3,66.7
1612,3/13/2018 2:20,29,28,20,77,3,66.7
1613,3/13/2018 2:25,32,44,19,95,3,66.7
1614,3/13/2018 2:30,30,25,17,72,3,66.7
1615,3/13/2018 2:35,23,26,12,61,3,66.7
1616,3/13/2018 2:40,30,26,19,75,3,66.7
1617,3/13/2018 2:45,26,30,18,74,3,66.7
1618,3/13/2018 2:50,25,18,18,61,3,66.7
1619,3/13/2018 2:55,30,30,16,76,3,66.7
1620,3/13/2018 3:00,23,20,17,60,3,66.7
1621,3/13/2018 3:05,23,13,15,51,3,66.7
1622,3/13/2018 3:10,27,26,19,72,3,66.7
1623,3/13/2018 3:15,28,26,16,70,3,66.7
1624,3/13/2018 3:20,19,21,9,49,3,66.7
1625,3/13/2018 3:25,28,27,11,66,3,66.7
1626,3/13/2018 3:30,28,28,11,67,3,66.7
1627,3/13/2018 3:35,26,29,16,71,3,66.7
1628,3/13/2018 3:40,28,29,16,73,3,66.7
1629,3/13/2018 3:45,30,25,17,72,3,66.7
1630,3/13/2018 3:50,24,23,16,63,3,66.7
1631,3/13/2018 3:55,27,14,15,56,3,66.7
1632,3/13/2018 4:00,28,26,17,71,3,66.7
1633,3/13/2018 4:05,28,27,15,70,3,66.7
1634,3/13/2018 4:10,25,31,14,70,3,66.7
1635,3/13/2018 4:15,27,27,13,67,3,66.7
1636,3/13/2018 4:20,33,37,20,90,3,66.7
1637,3/13/2018 4:25,34,32,13,79,3,66.7
1638,3/13/2018 4:30,33,36,16,85,3,66.7
1639,3/13/2018 4:35,32,39,18,89,3,66.7
1640,3/13/2018 4:40,46,43,16,105,3,66.7
1641,3/13/2018 4:45,44,34,28,106,3,66.7
1642,3/13/2018 4:50,34,35,25,94,3,66.7
1643,3/13/2018 4:55,36,34,22,92,3,66.7
1644,3/13/2018 5:00,44,43,21,108,3,66.7
1645,3/13/2018 5:05,37,42,22,101,3,66.7
1646,3/13/2018 5:10,43,44,16,103,3,66.7
1647,3/13/2018 5:15,46,45,24,115,3,66.7
1648,3/13/2018 5:20,54,52,30,136,3,66.7
1649,3/13/2018 5:25,59,61,26,146,3,66.7
1650,3/13/2018 5:30,68,61,32,161,3,66.7
1651,3/13/2018 5:35,53,62,29,144,3,66.7
1652,3/13/2018 5:40,66,63,23,152,3,66.7
1653,3/13/2018 5:45,74,78,27,179,3,66.7
1654,3/13/2018 5:50,59,62,25,146,3,66.7
1655,3/13/2018 5:55,58,60,33,151,3,66.7
1656,3/13/2018 6:00,60,59,26,145,3,66.7
1657,3/13/2018 6:05,59,66,34,159,3,66.7
1658,3/13/2018 6:10,71,73,43,187,3,66.7
1659,3/13/2018 6:15,69,73,36,178,3,66.7
1660,3/13/2018 6:20,75,85,54,214,3,66.7
1661,3/13/2018 6:25,78,86,46,210,3,66.7
1662,3/13/2018 6:30,72,79,47,198,3,66.7
1663,3/13/2018 6:35,78,88,35,201,3,66.7
1664,3/13/2018 6:40,82,93,44,219,3,66.7
1665,3/13/2018 6:45,73,99,47,219,3,66.7
1666,3/13/2018 6:50,88,93,53,234,3,66.7
1667,3/13/2018 6:55,81,91,51,223,3,66.7
1668,3/13/2018 7:00,81,88,50,219,3,66.7
1669,3/13/2018 7:05,82,103,64,249,3,66.7
1670,3/13/2018 7:10,74,83,60,217,3,66.7
1671,3/13/2018 7:15,86,92,75,253,3,66.7
1672,3/13/2018 7:20,83,107,74,264,3,66.7
1673,3/13/2018 7:25,88,96,57,241,3,66.7
1674,3/13/2018 7:30,82,97,60,239,3,66.7
1675,3/13/2018 7:35,83,81,52,216,3,66.7
1676,3/13/2018 7:40,96,112,75,283,3,66.7
1677,3/13/2018 7:45,91,97,65,253,3,66.7
1678,3/13/2018 7:50,99,117,66,282,3,66.7
1679,3/13/2018 7:55,91,95,63,249,3,66.7
1680,3/13/2018 8:00,87,99,62,248,3,66.7
1681,3/13/2018 8:05,94,95,57,246,3,66.7
1682,3/13/2018 8:10,93,93,61,247,3,66.7
1683,3/13/2018 8:15,98,82,46,226,3,66.7
1684,3/13/2018 8:20,103,92,54,249,3,66.7
1685,3/13/2018 8:25,97,96,51,244,3,66.7
1686,3/13/2018 8:30,102,98,77,277,3,66.7
1687,3/13/2018 8:35,99,86,63,248,3,66.7
1688,3/13/2018 8:40,95,95,62,252,3,66.7
1689,3/13/2018 8:45,90,106,64,260,3,66.7
1690,3/13/2018 8:50,76,88,55,219,3,66.7
1691,3/13/2018 8:55,91,81,66,238,3,66.7
1692,3/13/2018 9:00,72,91,55,218,3,66.7
1693,3/13/2018 9:05,77,97,57,231,3,66.7
1694,3/13/2018 9:10,89,78,52,219,3,66.7
1695,3/13/2018 9:15,80,94,51,225,3,66.7
1696,3/13/2018 9:20,85,94,55,234,3,66.7
1697,3/13/2018 9:25,81,89,54,224,3,66.7
1698,3/13/2018 9:30,86,87,55,228,3,66.7
1699,3/13/2018 9:35,93,105,65,263,3,66.7
1700,3/13/2018 9:40,72,107,56,235,3,66.7
1701,3/13/2018 9:45,92,103,54,249,3,66.7
1702,3/13/2018 9:50,91,113,49,253,3,66.7
1703,3/13/2018 9:55,83,96,58,237,3,66.7
1704,3/13/2018 10:00,73,94,49,216,3,66.7
1705,3/13/2018 10:05,81,78,48,207,3,66.7
1706,3/13/2018 10:10,81,98,64,243,3,66.7
1707,3/13/2018 10:15,91,89,68,248,3,66.7
1708,3/13/2018 10:20,88,93,51,232,3,66.7
1709,3/13/2018 10:25,82,95,61,238,3,66.7
1710,3/13/2018 10:30,86,83,58,227,3,66.7
1711,3/13/2018 10:35,85,98,57,240,3,66.7
1712,3/13/2018 10:40,86,95,55,236,3,66.7
1713,3/13/2018 10:45,97,88,47,232,3,66.7
1714,3/13/2018 10:50,94,101,64,259,3,66.7
1715,3/13/2018 10:55,85,87,62,234,3,66.7
1716,3/13/2018 11:00,91,91,51,233,3,66.7
1717,3/13/2018 11:05,90,97,72,259,3,66.7
1718,3/13/2018 11:10,93,87,60,240,3,66.7
1719,3/13/2018 11:15,88,109,67,264,3,66.7
1720,3/13/2018 11:20,81,96,59,236,3,66.7
1721,3/13/2018 11:25,86,105,62,253,3,66.7
1722,3/13/2018 11:30,75,91,60,226,3,66.7
1723,3/13/2018 11:35,86,90,57,233,3,66.7
1724,3/13/2018 11:40,88,91,60,239,3,66.7
1725,3/13/2018 11:45,73,85,59,217,3,66.7
1726,3/13/2018 11:50,88,85,69,242,3,66.7
1727,3/13/2018 11:55,77,83,55,215,3,66.7
0,3/13/2018 11:00,91,91,51,233,3,66.7
1,3/13/2018 11:05,90,97,72,259,3,66.7
2,3/13/2018 11:10,93,87,60,240,3,66.7
3,3/13/2018 11:15,88,109,67,264,3,66.7
4,3/13/2018 11:20,81,96,59,236,3,66.7
5,3/13/2018 11:25,86,105,62,253,3,66.7
6,3/13/2018 11:30,75,91,60,226,3,66.7
7,3/13/2018 11:35,86,90,57,233,3,66.7
8,3/13/2018 11:40,88,91,60,239,3,66.7
9,3/13/2018 11:45,73,85,59,217,3,66.7
10,3/13/2018 11:50,88,85,69,242,3,66.7
11,3/13/2018 11:55,77,83,55,215,3,66.7
12,3/13/2018 12:00,95,95,66,256,3,66.7
13,3/13/2018 12:05,86,96,64,246,3,66.7
14,3/13/2018 12:10,93,100,60,253,3,66.7
15,3/13/2018 12:15,90,93,82,265,3,0.0
16,3/13/2018 12:20,106,107,93,306,3,0.0
17,3/13/2018 12:25,92,95,83,270,3,0.0
18,3/13/2018 12:30,97,99,87,283,3,0.0
19,3/13/2018 12:35,94,97,85,276,3,0.0
20,3/13/2018 12:40,106,107,94,307,3,0.0
21,3/13/2018 12:45,103,104,91,298,3,0.0
22,3/13/2018 12:50,95,97,85,277,3,0.0
23,3/13/2018 12:55,89,92,81,262,3,0.0
24,3/13/2018 13:00,101,103,91,295,3,0.0
25,3/13/2018 13:05,95,98,85,278,3,0.0
26,3/13/2018 13:10,94,96,85,275,3,0.0
27,3/13/2018 13:15,95,98,86,279,3,0.0
28,3/13/2018 13:20,98,99,87,284,3,0.0
29,3/13/2018 13:25,95,97,85,277,3,0.0
30,3/13/2018 13:30,98,100,88,286,3,0.0
31,3/13/2018 13:35,100,101,88,289,3,0.0
32,3/13/2018 13:40,108,109,95,312,3,0.0
33,3/13/2018 13:45,102,104,90,296,3,0.0
34,3/13/2018 13:50,99,100,88,287,3,0.0
35,3/13/2018 13:55,96,98,86,280,3,0.0
36,3/13/2018 14:00,88,91,80,259,3,0.0
37,3/13/2018 14:05,98,100,87,285,3,0.0
38,3/13/2018 14:10,104,105,92,301,3,0.0
39,3/13/2018 14:15,107,107,94,308,3,0.0
40,3/13/2018 14:20,102,104,91,297,3,0.0
41,3/13/2018 14:25,102,103,90,295,3,0.0
42,3/13/2018 14:30,92,94,82,268,3,0.0
43,3/13/2018 14:35,98,100,87,285,3,0.0
44,3/13/2018 14:40,104,105,92,301,3,0.0
45,3/13/2018 14:45,90,93,81,264,3,0.0
46,3/13/2018 14:50,110,110,96,316,3,0.0
47,3/13/2018 14:55,104,105,92,301,3,0.0
48,3/13/2018 15:00,96,99,87,282,3,0.0
49,3/13/2018 15:05,100,102,90,292,3,0.0
50,3/13/2018 15:10,102,103,90,295,3,0.0
51,3/13/2018 15:15,88,92,81,261,3,0.0
52,3/13/2018 15:20,90,94,82,266,3,0.0
53,3/13/2018 15:25,90,93,81,264,3,0.0
54,3/13/2018 15:30,84,87,77,248,3,0.0
55,3/13/2018 15:35,76,80,71,227,3,0.0
56,3/13/2018 15:40,90,93,82,265,3,0.0
57,3/13/2018 15:45,80,84,73,237,3,0.0
58,3/13/2018 15:50,81,85,75,241,3,0.0
59,3/13/2018 15:55,89,91,80,260,3,0.0
60,3/13/2018 16:00,82,85,75,242,3,0.0
61,3/13/2018 16:05,99,101,88,288,3,0.0
62,3/13/2018 16:10,87,90,79,256,3,0.0
63,3/13/2018 16:15,96,98,86,280,3,0.0
64,3/13/2018 16:20,94,96,84,274,3,0.0
65,3/13/2018 16:25,95,97,85,277,3,0.0
66,3/13/2018 16:30,96,97,85,278,3,0.0
67,3/13/2018 16:35,88,90,79,257,3,0.0
68,3/13/2018 16:40,93,95,84,272,3,0.0
69,3/13/2018 16:45,79,83,73,235,3,0.0
70,3/13/2018 16:50,83,86,76,245,3,0.0
71,3/13/2018 16:55,93,95,84,272,3,0.0
72,3/13/2018 17:00,102,103,91,296,3,0.0
73,3/13/2018 17:05,94,96,84,274,3,0.0
74,3/13/2018 17:10,91,94,82,267,3,0.0
75,3/13/2018 17:15,99,100,88,287,3,0.0
76,3/13/2018 17:20,95,97,85,277,3,0.0
77,3/13/2018 17:25,90,92,80,262,3,0.0
78,3/13/2018 17:30,91,93,81,265,3,0.0
79,3/13/2018 17:35,86,89,78,253,3,0.0
80,3/13/2018 17:40,90,92,81,263,3,0.0
81,3/13/2018 17:45,87,90,78,255,3,0.0
82,3/13/2018 17:50,89,91,79,259,3,0.0
83,3/13/2018 17:55,82,85,75,242,3,0.0
84,3/13/2018 18:00,86,89,78,253,3,0.0
85,3/13/2018 18:05,83,86,75,244,3,0.0
86,3/13/2018 18:10,82,85,74,241,3,0.0
87,3/13/2018 18:15,89,91,80,260,3,0.0
88,3/13/2018 18:20,82,85,75,242,3,0.0
89,3/13/2018 18:25,100,101,89,290,3,0.0
90,3/13/2018 18:30,110,110,97,317,3,0.0
91,3/13/2018 18:35,102,103,90,295,3,0.0
92,3/13/2018 18:40,92,95,84,271,3,0.0
93,3/13/2018 18:45,81,85,75,241,3,0.0
94,3/13/2018 18:50,82,86,75,243,3,0.0
95,3/13/2018 18:55,85,88,77,250,3,0.0
96,3/13/2018 19:00,86,89,78,253,3,0.0
97,3/13/2018 19:05,79,84,74,237,3,0.0
98,3/13/2018 19:10,105,106,92,303,3,0.0
99,3/13/2018 19:15,113,114,100,327,3,0.0
100,3/13/2018 19:20,86,90,79,255,3,0.0
101,3/13/2018 19:25,94,97,85,276,3,0.0
102,3/13/2018 19:30,98,101,89,288,3,0.0
103,3/13/2018 19:35,101,102,89,292,3,0.0
104,3/13/2018 19:40,99,100,88,287,3,0.0
105,3/13/2018 19:45,96,99,88,283,3,0.0
106,3/13/2018 19:50,96,98,87,281,3,0.0
107,3/13/2018 19:55,96,99,87,282,3,0.0
108,3/13/2018 20:00,94,97,85,276,3,0.0
109,3/13/2018 20:05,80,84,74,238,3,0.0
110,3/13/2018 20:10,94,96,84,274,3,0.0
111,3/13/2018 20:15,86,89,78,253,3,0.0
112,3/13/2018 20:20,97,99,87,283,3,0.0
113,3/13/2018 20:25,81,85,75,241,3,0.0
114,3/13/2018 20:30,83,86,76,245,3,0.0
115,3/13/2018 20:35,79,83,73,235,3,0.0
116,3/13/2018 20:40,93,95,84,272,3,0.0
117,3/13/2018 20:45,84,87,76,247,3,0.0
118,3/13/2018 20:50,82,86,76,244,3,0.0
119,3/13/2018 20:55,91,94,82,267,3,0.0
120,3/13/2018 21:00,81,85,75,241,3,0.0
121,3/13/2018 21:05,84,87,76,247,3,0.0
122,3/13/2018 21:10,85,89,78,252,3,0.0
123,3/13/2018 21:15,88,91,80,259,3,0.0
124,3/13/2018 21:20,91,94,82,267,3,0.0
125,3/13/2018 21:25,88,91,80,259,3,0.0
126,3/13/2018 21:30,87,90,79,256,3,0.0
127,3/13/2018 21:35,88,91,79,258,3,0.0
128,3/13/2018 21:40,83,87,76,246,3,0.0
129,3/13/2018 21:45,85,88,77,250,3,0.0
130,3/13/2018 21:50,76,80,70,226,3,0.0
131,3/13/2018 21:55,86,89,78,253,3,0.0
132,3/13/2018 22:00,72,77,67,216,3,0.0
133,3/13/2018 22:05,84,88,77,249,3,0.0
134,3/13/2018 22:10,82,86,76,244,3,0.0
135,3/13/2018 22:15,86,89,78,253,3,0.0
136,3/13/2018 22:20,82,86,75,243,3,0.0
137,3/13/2018 22:25,71,75,66,212,3,0.0
138,3/13/2018 22:30,76,80,71,227,3,0.0
139,3/13/2018 22:35,77,81,71,229,3,0.0
140,3/13/2018 22:40,83,87,76,246,3,0.0
141,3/13/2018 22:45,78,82,72,232,3,0.0
142,3/13/2018 22:50,67,72,63,202,3,0.0
143,3/13/2018 22:55,73,78,68,219,3,0.0
144,3/13/2018 23:00,64,69,61,194,3,0.0
145,3/13/2018 23:05,65,70,61,196,3,0.0
146,3/13/2018 23:10,63,69,60,192,3,0.0
147,3/13/2018 23:15,72,77,67,216,3,0.0
148,3/13/2018 23:20,67,72,63,202,3,0.0
149,3/13/2018 23:25,56,62,55,173,3,0.0
150,3/13/2018 23:30,63,69,60,192,3,0.0
151,3/13/2018 23:35,65,70,62,197,3,0.0
152,3/13/2018 23:40,73,78,68,219,3,0.0
153,3/13/2018 23:45,60,67,59,186,3,0.0
154,3/13/2018 23:50,54,61,54,169,3,0.0
155,3/13/2018 23:55,60,66,58,184,3,0.0
156,3/14/2018 0:00,51,58,51,160,3,0.0
157,3/14/2018 0:05,58,64,57,179,3,0.0
158,3/14/2018 0:10,52,59,52,163,3,0.0
159,3/14/2018 0:15,65,70,62,197,3,0.0
160,3/14/2018 0:20,50,56,50,156,3,0.0
161,3/14/2018 0:25,51,58,51,160,3,0.0
162,3/14/2018 0:30,45,53,48,146,3,0.0
163,3/14/2018 0:35,48,56,49,153,3,0.0
164,3/14/2018 0:40,45,52,46,143,3,0.0
165,3/14/2018 0:45,42,50,44,136,3,0.0
166,3/14/2018 0:50,39,47,41,127,3,0.0
167,3/14/2018 0:55,44,52,46,142,3,0.0
168,3/14/2018 1:00,41,49,44,134,3,0.0
169,3/14/2018 1:05,43,51,45,139,3,0.0
170,3/14/2018 1:10,36,46,41,123,3,0.0
171,3/14/2018 1:15,40,48,42,130,3,0.0
172,3/14/2018 1:20,37,45,40,122,3,0.0
173,3/14/2018 1:25,40,48,42,130,3,0.0
174,3/14/2018 1:30,33,42,38,113,3,0.0
175,3/14/2018 1:35,35,44,40,119,3,0.0
176,3/14/2018 1:40,40,48,43,131,3,0.0
177,3/14/2018 1:45,36,45,40,121,3,0.0
178,3/14/2018 1:50,41,50,45,136,3,0.0
179,3/14/2018 1:55,33,43,38,114,3,0.0
180,3/14/2018 2:00,30,40,37,107,3,0.0
181,3/14/2018 2:05,32,42,37,111,3,0.0
182,3/14/2018 2:10,37,46,42,125,3,0.0
183,3/14/2018 2:15,35,43,38,116,3,0.0
184,3/14/2018 2:20,31,40,36,107,3,0.0
185,3/14/2018 2:25,35,44,41,120,3,0.0
186,3/14/2018 2:30,35,45,40,120,3,0.0
187,3/14/2018 2:35,32,41,35,108,3,0.0
188,3/14/2018 2:40,37,45,39,121,3,0.0
189,3/14/2018 2:45,27,37,34,98,3,0.0
190,3/14/2018 2:50,29,38,34,101,3,0.0
191,3/14/2018 2:55,30,39,35,104,3,0.0
192,3/14/2018 3:00,24,34,31,89,3,0.0
193,3/14/2018 3:05,26,35,30,91,3,0.0
194,3/14/2018 3:10,26,35,30,91,3,0.0
195,3/14/2018 3:15,23,33,30,86,3,0.0
196,3/14/2018 3:20,26,35,32,93,3,0.0
197,3/14/2018 3:25,31,40,36,107,3,0.0
198,3/14/2018 3:30,29,39,34,102,3,0.0
199,3/14/2018 3:35,29,39,34,102,3,0.0
200,3/14/2018 3:40,24,35,33,92,3,0.0
201,3/14/2018 3:45,26,36,34,96,3,0.0
202,3/14/2018 3:50,29,38,34,101,3,0.0
203,3/14/2018 3:55,29,39,36,104,3,0.0
204,3/14/2018 4:00,28,38,35,101,3,0.0
205,3/14/2018 4:05,29,39,36,104,3,0.0
206,3/14/2018 4:10,29,38,34,101,3,0.0
207,3/14/2018 4:15,30,38,33,101,3,0.0
208,3/14/2018 4:20,35,44,39,118,3,0.0
209,3/14/2018 4:25,35,44,39,118,3,0.0
210,3/14/2018 4:30,36,44,38,118,3,0.0
211,3/14/2018 4:35,38,47,42,127,3,0.0
212,3/14/2018 4:40,45,53,48,146,3,0.0
213,3/14/2018 4:45,51,58,51,160,3,0.0
214,3/14/2018 4:50,47,54,48,149,3,0.0
215,3/14/2018 4:55,44,52,46,142,3,0.0
216,3/14/2018 5:00,51,57,50,158,3,0.0
217,3/14/2018 5:05,49,56,50,155,3,0.0
218,3/14/2018 5:10,56,63,57,176,3,0.0
219,3/14/2018 5:15,56,63,56,175,3,0.0
220,3/14/2018 5:20,54,61,53,168,3,0.0
221,3/14/2018 5:25,65,71,63,199,3,0.0
222,3/14/2018 5:30,65,71,63,199,3,0.0
223,3/14/2018 5:35,59,65,58,182,3,0.0
224,3/14/2018 5:40,67,73,64,204,3,0.0
225,3/14/2018 5:45,67,73,65,205,3,0.0
226,3/14/2018 5:50,69,74,66,209,3,0.0
227,3/14/2018 5:55,63,69,62,194,3,0.0
228,3/14/2018 6:00,62,68,61,191,3,0.0
229,3/14/2018 6:05,61,67,60,188,3,0.0
230,3/14/2018 6:10,76,81,72,229,3,0.0
231,3/14/2018 6:15,77,81,72,230,3,0.0
232,3/14/2018 6:20,74,79,70,223,3,0.0
233,3/14/2018 6:25,73,78,69,220,3,0.0
234,3/14/2018 6:30,72,77,68,217,3,0.0
235,3/14/2018 6:35,76,80,71,227,3,0.0
236,3/14/2018 6:40,77,81,71,229,3,0.0
237,3/14/2018 6:45,81,85,75,241,3,0.0
238,3/14/2018 6:50,90,93,82,265,3,0.0
239,3/14/2018 6:55,95,97,86,278,3,0.0
240,3/14/2018 7:00,84,88,78,250,3,0.0
241,3/14/2018 7:05,76,81,71,228,3,0.0
242,3/14/2018 7:10,85,89,79,253,3,0.0
243,3/14/2018 7:15,88,91,80,259,3,0.0
244,3/14/2018 7:20,89,92,81,262,3,0.0
245,3/14/2018 7:25,93,96,84,273,3,0.0
246,3/14/2018 7:30,92,95,83,270,3,0.0
247,3/14/2018 7:35,93,96,85,274,3,0.0
248,3/14/2018 7:40,83,87,77,247,3,0.0
249,3/14/2018 7:45,94,97,85,276,3,0.0
250,3/14/2018 7:50,88,91,80,259,3,0.0
251,3/14/2018 7:55,82,86,76,244,3,0.0
252,3/14/2018 8:00,89,93,82,264,3,0.0
253,3/14/2018 8:05,97,100,88,285,3,0.0
254,3/14/2018 8:10,93,96,85,274,3,0.0
255,3/14/2018 8:15,92,94,83,269,3,0.0
256,3/14/2018 8:20,98,100,87,285,3,0.0
257,3/14/2018 8:25,100,102,89,291,3,0.0
258,3/14/2018 8:30,82,86,76,244,3,0.0
259,3/14/2018 8:35,83,87,76,246,3,0.0
260,3/14/2018 8:40,89,92,80,261,3,0.0
261,3/14/2018 8:45,89,92,82,263,3,0.0
262,3/14/2018 8:50,88,91,80,259,3,0.0
263,3/14/2018 8:55,85,89,78,252,3,0.0
264,3/14/2018 9:00,75,80,70,225,3,0.0
265,3/14/2018 9:05,88,92,81,261,3,0.0
266,3/14/2018 9:10,82,86,76,244,3,0.0
267,3/14/2018 9:15,83,87,77,247,3,0.0
268,3/14/2018 9:20,77,81,72,230,3,0.0
269,3/14/2018 9:25,75,80,70,225,3,0.0
270,3/14/2018 9:30,91,94,83,268,3,0.0
271,3/14/2018 9:35,81,85,75,241,3,0.0
272,3/14/2018 9:40,89,93,82,264,3,0.0
273,3/14/2018 9:45,85,88,78,251,3,0.0
274,3/14/2018 9:50,85,88,77,250,3,0.0
275,3/14/2018 9:55,78,83,73,234,3,0.0
276,3/14/2018 10:00,79,83,73,235,3,0.0
277,3/14/2018 10:05,77,82,72,231,3,0.0
278,3/14/2018 10:10,86,90,79,255,3,0.0
279,3/14/2018 10:15,86,89,79,254,3,0.0
280,3/14/2018 10:20,81,85,75,241,3,0.0
281,3/14/2018 10:25,83,87,76,246,3,0.0
282,3/14/2018 10:30,76,81,71,228,3,0.0
283,3/14/2018 10:35,93,95,84,272,3,0.0
284,3/14/2018 10:40,88,92,81,261,3,0.0
285,3/14/2018 10:45,80,84,74,238,3,0.0
286,3/14/2018 10:50,84,88,78,250,3,0.0
287,3/14/2018 10:55,83,87,76,246,3,0.0
288,3/14/2018 11:00,82,86,76,244,3,0.0
289,3/14/2018 11:05,91,93,82,266,3,0.0
290,3/14/2018 11:10,90,93,81,264,3,0.0
291,3/14/2018 11:15,90,93,82,265,3,0.0
292,3/14/2018 11:20,89,92,81,262,3,0.0
293,3/14/2018 11:25,92,94,83,269,3,0.0
294,3/14/2018 11:30,84,87,77,248,3,0.0
295,3/14/2018 11:35,87,90,79,256,3,0.0
296,3/14/2018 11:40,88,91,80,259,3,0.0
297,3/14/2018 11:45,87,90,79,256,3,0.0
298,3/14/2018 11:50,96,98,86,280,3,0.0
299,3/14/2018 11:55,93,96,84,273,3,0.0
300,3/14/2018 12:00,82,86,75,243,3,0.0
301,3/14/2018 12:05,86,89,78,253,3,0.0
302,3/14/2018 12:10,99,101,89,289,3,0.0
303,3/14/2018 12:15,88,91,80,259,3,0.0
304,3/14/2018 12:20,98,101,88,287,3,0.0
305,3/14/2018 12:25,93,95,84,272,3,0.0
306,3/14/2018 12:30,98,101,88,287,3,0.0
307,3/14/2018 12:35,103,105,91,299,3,0.0
308,3/14/2018 12:40,108,110,96,314,3,0.0
309,3/14/2018 12:45,106,108,94,308,3,0.0
310,3/14/2018 12:50,98,100,87,285,3,0.0
311,3/14/2018 12:55,98,100,87,285,3,0.0
312,3/14/2018 13:00,103,105,92,300,3,0.0
313,3/14/2018 13:05,90,93,81,264,3,0.0
314,3/14/2018 13:10,104,106,93,303,3,0.0
315,3/14/2018 13:15,108,108,95,311,3,0.0
316,3/14/2018 13:20,101,104,91,296,3,0.0
317,3/14/2018 13:25,101,102,89,292,3,0.0
318,3/14/2018 13:30,111,112,98,321,3,0.0
319,3/14/2018 13:35,98,100,88,286,3,0.0
320,3/14/2018 13:40,98,100,87,285,3,0.0
321,3/14/2018 13:45,100,102,89,291,3,0.0
322,3/14/2018 13:50,101,103,91,295,3,0.0
323,3/14/2018 13:55,111,111,97,319,3,0.0
324,3/14/2018 14:00,112,112,98,322,3,0.0
325,3/14/2018 14:05,110,112,99,321,3,0.0
326,3/14/2018 14:10,111,112,99,322,3,0.0
327,3/14/2018 14:15,104,106,93,303,3,0.0
328,3/14/2018 14:20,103,105,92,300,3,0.0
329,3/14/2018 14:25,100,103,90,293,3,0.0
330,3/14/2018 14:30,102,103,90,295,3,0.0
331,3/14/2018 14:35,99,101,89,289,3,0.0
332,3/14/2018 14:40,98,100,88,286,3,0.0
333,3/14/2018 14:45,105,107,93,305,3,0.0
334,3/14/2018 14:50,108,109,95,312,3,0.0
335,3/14/2018 14:55,110,111,96,317,3,0.0
336,3/14/2018 15:00,101,102,89,292,3,0.0
337,3/14/2018 15:05,107,108,94,309,3,0.0
338,3/14/2018 15:10,98,100,88,286,3,0.0
339,3/14/2018 15:15,101,102,90,293,3,0.0
340,3/14/2018 15:20,105,107,93,305,3,0.0
341,3/14/2018 15:25,97,100,88,285,3,0.0
342,3/14/2018 15:30,101,103,90,294,3,0.0
343,3/14/2018 15:35,103,105,92,300,3,0.0
344,3/14/2018 15:40,88,91,80,259,3,0.0
345,3/14/2018 15:45,94,97,85,276,3,0.0
346,3/14/2018 15:50,106,108,95,309,3,0.0
347,3/14/2018 15:55,108,109,95,312,3,0.0
348,3/14/2018 16:00,105,107,94,306,3,0.0
349,3/14/2018 16:05,109,111,97,317,3,0.0
350,3/14/2018 16:10,99,101,89,289,3,0.0
351,3/14/2018 16:15,104,105,91,300,3,0.0
352,3/14/2018 16:20,99,101,88,288,3,0.0
353,3/14/2018 16:25,97,99,87,283,3,0.0
354,3/14/2018 16:30,99,101,89,289,3,0.0
355,3/14/2018 16:35,96,98,86,280,3,0.0
356,3/14/2018 16:40,88,91,80,259,3,0.0
357,3/14/2018 16:45,97,99,87,283,3,0.0
358,3/14/2018 16:50,91,94,83,268,3,0.0
359,3/14/2018 16:55,95,97,85,277,3,0.0
360,3/14/2018 17:00,92,95,84,271,3,0.0
361,3/14/2018 17:05,94,97,85,276,3,0.0
362,3/14/2018 17:10,88,91,79,258,3,0.0
363,3/14/2018 17:15,86,90,79,255,3,0.0
364,3/14/2018 17:20,91,94,83,268,3,0.0
365,3/14/2018 17:25,103,105,92,300,3,0.0
366,3/14/2018 17:30,96,98,86,280,3,0.0
367,3/14/2018 17:35,94,97,85,276,3,0.0
368,3/14/2018 17:40,98,99,87,284,3,0.0
369,3/14/2018 17:45,101,103,90,294,3,0.0
370,3/14/2018 17:50,102,103,91,296,3,0.0
371,3/14/2018 17:55,89,92,81,262,3,0.0
372,3/14/2018 18:00,94,97,85,276,3,0.0
373,3/14/2018 18:05,91,94,83,268,3,0.0
374,3/14/2018 18:10,103,105,92,300,3,0.0
375,3/14/2018 18:15,91,94,83,268,3,0.0
376,3/14/2018 18:20,99,101,89,289,3,0.0
377,3/14/2018 18:25,100,101,88,289,3,0.0
378,3/14/2018 18:30,91,94,83,268,3,0.0
379,3/14/2018 18:35,87,91,80,258,3,0.0
380,3/14/2018 18:40,105,106,92,303,3,0.0
381,3/14/2018 18:45,90,93,81,264,3,0.0
382,3/14/2018 18:50,105,106,92,303,3,0.0
383,3/14/2018 18:55,104,104,91,299,3,0.0
384,3/14/2018 19:00,106,107,93,306,3,0.0
385,3/14/2018 19:05,107,108,94,309,3,0.0
386,3/14/2018 19:10,89,93,81,263,3,0.0
387,3/14/2018 19:15,88,91,81,260,3,0.0
388,3/14/2018 19:20,96,99,87,282,3,0.0
389,3/14/2018 19:25,96,98,86,280,3,0.0
390,3/14/2018 19:30,103,104,91,298,3,0.0
391,3/14/2018 19:35,100,101,88,289,3,0.0
392,3/14/2018 19:40,95,98,85,278,3,0.0
393,3/14/2018 19:45,98,100,87,285,3,0.0
394,3/14/2018 19:50,91,94,82,267,3,0.0
395,3/14/2018 19:55,91,94,83,268,3,0.0
396,3/14/2018 20:00,97,99,87,283,3,0.0
397,3/14/2018 20:05,83,87,77,247,3,0.0
398,3/14/2018 20:10,96,99,87,282,3,0.0
399,3/14/2018 20:15,95,98,86,279,3,0.0
400,3/14/2018 20:20,92,94,82,268,3,0.0
401,3/14/2018 20:25,97,98,86,281,3,0.0
402,3/14/2018 20:30,95,98,85,278,3,0.0
403,3/14/2018 20:35,89,93,81,263,3,0.0
404,3/14/2018 20:40,94,97,85,276,3,0.0
405,3/14/2018 20:45,92,95,83,270,3,0.0
406,3/14/2018 20:50,100,102,89,291,3,0.0
407,3/14/2018 20:55,91,93,81,265,3,0.0
408,3/14/2018 21:00,87,91,79,257,3,0.0
409,3/14/2018 21:05,90,92,81,263,3,0.0
410,3/14/2018 21:10,82,86,75,243,3,0.0
411,3/14/2018 21:15,81,85,74,240,3,0.0
412,3/14/2018 21:20,85,88,77,250,3,0.0
413,3/14/2018 21:25,93,95,83,271,3,0.0
414,3/14/2018 21:30,85,89,77,251,3,0.0
415,3/14/2018 21:35,90,93,81,264,3,0.0
416,3/14/2018 21:40,88,92,80,260,3,0.0
417,3/14/2018 21:45,84,87,76,247,3,0.0
418,3/14/2018 21:50,84,87,76,247,3,0.0
419,3/14/2018 21:55,86,88,77,251,3,0.0
420,3/14/2018 22:00,82,86,75,243,3,0.0
421,3/14/2018 22:05,80,84,73,237,3,0.0
422,3/14/2018 22:10,93,95,83,271,3,0.0
423,3/14/2018 22:15,85,88,77,250,3,0.0
424,3/14/2018 22:20,72,77,68,217,3,0.0
425,3/14/2018 22:25,83,87,76,246,3,0.0
426,3/14/2018 22:30,73,77,68,218,3,0.0
427,3/14/2018 22:35,82,86,76,244,3,0.0
428,3/14/2018 22:40,80,84,74,238,3,0.0
429,3/14/2018 22:45,84,87,76,247,3,0.0
430,3/14/2018 22:50,89,91,80,260,3,0.0
431,3/14/2018 22:55,60,66,58,184,3,0.0
432,3/14/2018 23:00,68,73,64,205,3,0.0
433,3/14/2018 23:05,71,75,66,212,3,0.0
434,3/14/2018 23:10,62,67,59,188,3,0.0
435,3/14/2018 23:15,72,77,68,217,3,0.0
436,3/14/2018 23:20,67,72,63,202,3,0.0
437,3/14/2018 23:25,63,69,61,193,3,0.0
438,3/14/2018 23:30,64,70,61,195,3,0.0
439,3/14/2018 23:35,58,64,56,178,3,0.0
440,3/14/2018 23:40,62,67,59,188,3,0.0
441,3/14/2018 23:45,58,64,56,178,3,0.0
442,3/14/2018 23:50,58,65,58,181,3,0.0
443,3/14/2018 23:55,63,68,60,191,3,0.0
444,3/15/2018 0:00,51,54,38,143,3,66.7
445,3/15/2018 0:05,45,62,31,138,3,66.7
446,3/15/2018 0:10,56,70,41,167,3,66.7
447,3/15/2018 0:15,57,63,32,152,3,66.7
448,3/15/2018 0:20,45,57,30,132,3,66.7
449,3/15/2018 0:25,49,64,34,147,3,66.7
450,3/15/2018 0:30,55,61,43,159,3,66.7
451,3/15/2018 0:35,49,60,25,134,3,66.7
452,3/15/2018 0:40,42,58,31,131,3,66.7
453,3/15/2018 0:45,40,54,28,122,3,66.7
454,3/15/2018 0:50,44,47,31,122,3,66.7
455,3/15/2018 0:55,36,41,17,94,3,66.7
456,3/15/2018 1:00,38,45,24,107,3,66.7
457,3/15/2018 1:05,36,36,17,89,3,66.7
458,3/15/2018 1:10,35,40,24,99,3,66.7
459,3/15/2018 1:15,39,43,25,107,3,66.7
460,3/15/2018 1:20,32,40,14,86,3,66.7
461,3/15/2018 1:25,35,47,17,99,3,66.7
462,3/15/2018 1:30,35,47,23,105,3,66.7
463,3/15/2018 1:35,40,45,23,108,3,66.7
464,3/15/2018 1:40,36,45,16,97,3,66.7
465,3/15/2018 1:45,27,40,21,88,3,66.7
466,3/15/2018 1:50,39,42,18,99,3,66.7
467,3/15/2018 1:55,26,33,12,71,3,66.7
468,3/15/2018 2:00,33,36,11,80,3,66.7
469,3/15/2018 2:05,27,32,13,72,3,66.7
470,3/15/2018 2:10,30,31,20,81,3,66.7
471,3/15/2018 2:15,30,35,13,78,3,66.7
472,3/15/2018 2:20,31,34,16,81,3,66.7
473,3/15/2018 2:25,35,35,21,91,3,66.7
474,3/15/2018 2:30,31,31,16,78,3,66.7
475,3/15/2018 2:35,27,28,16,71,3,66.7
476,3/15/2018 2:40,37,42,22,101,3,66.7
477,3/15/2018 2:45,28,29,14,71,3,66.7
478,3/15/2018 2:50,22,29,10,61,3,66.7
479,3/15/2018 2:55,26,31,13,70,3,66.7
480,3/15/2018 3:00,22,18,14,54,3,66.7
481,3/15/2018 3:05,29,27,12,68,3,66.7
482,3/15/2018 3:10,28,24,19,71,3,66.7
483,3/15/2018 3:15,23,13,11,47,3,66.7
484,3/15/2018 3:20,23,20,10,53,3,66.7
485,3/15/2018 3:25,23,15,13,51,3,66.7
486,3/15/2018 3:30,24,26,20,70,3,66.7
487,3/15/2018 3:35,19,20,12,51,3,66.7
488,3/15/2018 3:40,20,21,8,49,3,66.7
489,3/15/2018 3:45,24,19,15,58,3,66.7
490,3/15/2018 3:50,25,27,13,65,3,66.7
491,3/15/2018 3:55,25,25,7,57,3,66.7
492,3/15/2018 4:00,28,23,15,66,3,66.7
493,3/15/2018 4:05,14,29,15,58,3,0.0
494,3/15/2018 4:10,27,30,12,69,3,66.7
495,3/15/2018 4:15,34,39,11,84,3,66.7
496,3/15/2018 4:20,30,31,14,75,3,66.7
497,3/15/2018 4:25,32,34,13,79,3,66.7
498,3/15/2018 4:30,29,32,18,79,3,66.7
499,3/15/2018 4:35,36,41,17,94,3,66.7
500,3/15/2018 4:40,41,43,20,104,3,66.7
501,3/15/2018 4:45,45,52,16,113,3,66.7
502,3/15/2018 4:50,38,47,20,105,3,66.7
503,3/15/2018 4:55,39,42,15,96,3,66.7
504,3/15/2018 5:00,37,42,16,95,3,66.7
505,3/15/2018 5:05,41,42,19,102,3,66.7
506,3/15/2018 5:10,49,52,22,123,3,66.7
507,3/15/2018 5:15,35,50,16,101,3,66.7
508,3/15/2018 5:20,64,62,41,167,3,66.7
509,3/15/2018 5:25,56,60,25,141,3,66.7
510,3/15/2018 5:30,55,54,20,129,3,66.7
511,3/15/2018 5:35,51,55,25,131,3,66.7
512,3/15/2018 5:40,62,62,32,156,3,66.7
513,3/15/2018 5:45,57,58,40,155,3,66.7
514,3/15/2018 5:50,59,66,28,153,3,66.7
515,3/15/2018 5:55,69,63,30,162,3,66.7
516,3/15/2018 6:00,58,49,33,140,3,66.7
517,3/15/2018 6:05,59,67,39,165,3,66.7
518,3/15/2018 6:10,70,75,34,179,3,66.7
519,3/15/2018 6:15,74,71,40,185,3,66.7
520,3/15/2018 6:20,74,80,37,191,3,66.7
521,3/15/2018 6:25,65,77,37,179,3,66.7
522,3/15/2018 6:30,63,91,46,200,3,66.7
523,3/15/2018 6:35,85,90,40,215,3,66.7
524,3/15/2018 6:40,87,89,58,234,3,66.7
525,3/15/2018 6:45,84,88,54,226,3,66.7
526,3/15/2018 6:50,84,94,56,234,3,66.7
527,3/15/2018 6:55,81,96,51,228,3,66.7
528,3/15/2018 7:00,77,90,56,223,3,66.7
529,3/15/2018 7:05,73,102,55,230,3,66.7
530,3/15/2018 7:10,89,100,59,248,3,66.7
531,3/15/2018 7:15,94,98,62,254,3,66.7
532,3/15/2018 7:20,72,103,57,232,3,66.7
533,3/15/2018 7:25,80,88,57,225,3,66.7
534,3/15/2018 7:30,82,89,60,231,3,66.7
535,3/15/2018 7:35,92,96,61,249,3,66.7
536,3/15/2018 7:40,95,99,75,269,3,66.7
537,3/15/2018 7:45,84,97,61,242,3,66.7
538,3/15/2018 7:50,84,107,70,261,3,66.7
539,3/15/2018 7:55,80,107,61,248,3,66.7
540,3/15/2018 8:00,81,104,53,238,3,66.7
541,3/15/2018 8:05,92,107,54,253,3,66.7
542,3/15/2018 8:10,87,102,56,245,3,66.7
543,3/15/2018 8:15,78,101,69,248,3,66.7
544,3/15/2018 8:20,98,107,61,266,3,66.7
545,3/15/2018 8:25,98,105,65,268,3,66.7
546,3/15/2018 8:30,90,98,64,252,3,66.7
547,3/15/2018 8:35,84,102,59,245,3,66.7
548,3/15/2018 8:40,85,102,58,245,3,66.7
549,3/15/2018 8:45,94,98,52,244,3,66.7
550,3/15/2018 8:50,92,94,56,242,3,66.7
551,3/15/2018 8:55,81,87,55,223,3,66.7
552,3/15/2018 9:00,72,79,47,198,3,66.7
553,3/15/2018 9:05,81,76,47,204,3,66.7
554,3/15/2018 9:10,86,77,52,215,3,66.7
555,3/15/2018 9:15,81,75,53,209,3,66.7
556,3/15/2018 9:20,86,83,51,220,3,66.7
557,3/15/2018 9:25,73,81,48,202,3,66.7
558,3/15/2018 9:30,79,89,56,224,3,66.7
559,3/15/2018 9:35,84,83,61,228,3,66.7
560,3/15/2018 9:40,88,99,50,237,3,66.7
561,3/15/2018 9:45,88,87,68,243,3,66.7
562,3/15/2018 9:50,89,91,61,241,3,66.7
563,3/15/2018 9:55,79,91,57,227,3,66.7
564,3/15/2018 10:00,82,96,57,235,3,66.7
565,3/15/2018 10:05,69,89,49,207,3,66.7
566,3/15/2018 10:10,83,92,58,233,3,66.7
567,3/15/2018 10:15,81,91,55,227,3,66.7
568,3/15/2018 10:20,74,96,52,222,3,66.7
569,3/15/2018 10:25,70,98,45,213,3,66.7
570,3/15/2018 10:30,74,88,59,221,3,66.7
571,3/15/2018 10:35,79,85,48,212,3,66.7
572,3/15/2018 10:40,84,107,70,261,3,66.7
573,3/15/2018 10:45,82,97,53,232,3,66.7
574,3/15/2018 10:50,68,91,50,209,3,66.7
575,3/15/2018 10:55,83,95,50,228,3,66.7
576,3/15/2018 11:00,87,94,45,226,3,66.7
577,3/15/2018 11:05,88,96,64,248,3,66.7
578,3/15/2018 11:10,85,103,64,252,3,66.7
579,3/15/2018 11:15,81,100,51,232,3,66.7
580,3/15/2018 11:20,91,105,76,272,3,66.7
581,3/15/2018 11:25,88,93,62,243,3,66.7
582,3/15/2018 11:30,89,93,57,239,3,66.7
583,3/15/2018 11:35,85,94,57,236,3,66.7
584,3/15/2018 11:40,86,106,59,251,3,66.7
585,3/15/2018 11:45,94,89,64,247,3,66.7
586,3/15/2018 11:50,87,94,61,242,3,66.7
587,3/15/2018 11:55,92,91,61,244,3,66.7
588,3/15/2018 12:00,95,87,67,249,3,66.7
589,3/15/2018 12:05,87,99,66,252,3,66.7
590,3/15/2018 12:10,102,103,59,264,3,66.7
591,3/15/2018 12:15,96,102,56,254,3,66.7
592,3/15/2018 12:20,102,103,62,267,3,66.7
593,3/15/2018 12:25,94,97,60,251,3,66.7
594,3/15/2018 12:30,95,97,68,260,3,66.7
595,3/15/2018 12:35,96,108,60,264,3,66.7
596,3/15/2018 12:40,93,111,69,273,3,66.7
597,3/15/2018 12:45,92,109,71,272,3,66.7
598,3/15/2018 12:50,97,107,74,278,3,66.7
599,3/15/2018 12:55,100,109,61,270,3,66.7
600,3/15/2018 13:00,96,92,77,265,3,66.7
601,3/15/2018 13:05,89,87,68,244,3,66.7
602,3/15/2018 13:10,90,93,67,250,3,66.7
603,3/15/2018 13:15,101,112,61,274,3,66.7
604,3/15/2018 13:20,94,96,46,236,3,66.7
605,3/15/2018 13:25,101,94,69,264,3,66.7
606,3/15/2018 13:30,103,83,56,242,3,66.7
607,3/15/2018 13:35,94,88,67,249,3,66.7
608,3/15/2018 13:40,80,94,63,237,3,66.7
609,3/15/2018 13:45,107,82,70,259,3,66.7
610,3/15/2018 13:50,85,89,63,237,3,66.7
611,3/15/2018 13:55,98,94,75,267,3,66.7
612,3/15/2018 14:00,100,100,70,270,3,66.7
613,3/15/2018 14:05,93,97,57,247,3,66.7
614,3/15/2018 14:10,106,110,59,275,3,66.7
615,3/15/2018 14:15,90,84,58,232,3,66.7
616,3/15/2018 14:20,87,88,54,229,3,66.7
617,3/15/2018 14:25,97,78,67,242,3,66.7
618,3/15/2018 14:30,94,101,65,260,3,66.7
619,3/15/2018 14:35,102,91,60,253,3,66.7
620,3/15/2018 14:40,91,93,72,256,3,66.7
621,3/15/2018 14:45,102,101,76,279,3,66.7
622,3/15/2018 14:50,102,83,77,262,3,66.7
623,3/15/2018 14:55,97,84,79,260,3,66.7
624,3/15/2018 15:00,87,67,66,220,3,66.7
625,3/15/2018 15:05,87,76,63,226,3,66.7
626,3/15/2018 15:10,91,75,82,248,3,66.7
627,3/15/2018 15:15,92,65,70,227,3,66.7
628,3/15/2018 15:20,95,80,68,243,3,66.7
629,3/15/2018 15:25,86,64,73,223,3,66.7
630,3/15/2018 15:30,88,67,67,222,3,66.7
631,3/15/2018 15:35,96,81,99,276,3,66.7
632,3/15/2018 15:40,93,81,86,260,3,66.7
633,3/15/2018 15:45,94,63,70,227,3,66.7
634,3/15/2018 15:50,102,71,61,234,3,66.7
635,3/15/2018 15:55,93,59,64,216,3,66.7
636,3/15/2018 16:00,79,61,64,204,3,66.7
637,3/15/2018 16:05,85,72,80,237,3,66.7
638,3/15/2018 16:10,93,65,58,216,3,66.7
639,3/15/2018 16:15,94,64,60,218,3,66.7
640,3/15/2018 16:20,86,65,50,201,3,66.7
641,3/15/2018 16:25,85,56,60,201,3,66.7
642,3/15/2018 16:30,86,46,52,184,3,66.7
643,3/15/2018 16:35,89,61,60,210,3,66.7
644,3/15/2018 16:40,86,67,67,220,3,66.7
645,3/15/2018 16:45,81,60,76,217,3,66.7
646,3/15/2018 16:50,88,59,53,200,3,66.7
647,3/15/2018 16:55,93,60,47,200,3,66.7
648,3/15/2018 17:00,76,52,45,173,3,66.7
649,3/15/2018 17:05,84,66,47,197,3,66.7
650,3/15/2018 17:10,96,69,63,228,3,66.7
651,3/15/2018 17:15,111,56,52,219,3,66.7
652,3/15/2018 17:20,109,72,53,234,3,66.7
653,3/15/2018 17:25,88,60,57,205,3,66.7
654,3/15/2018 17:30,83,70,49,202,3,66.7
655,3/15/2018 17:35,79,59,45,183,3,66.7
656,3/15/2018 17:40,63,69,55,187,3,66.7
657,3/15/2018 17:45,76,59,47,182,3,66.7
658,3/15/2018 17:50,76,83,61,220,3,66.7
659,3/15/2018 17:55,86,70,50,206,3,66.7
660,3/15/2018 18:00,103,62,63,228,3,66.7
661,3/15/2018 18:05,100,57,48,205,3,66.7
662,3/15/2018 18:10,102,61,51,214,3,66.7
663,3/15/2018 18:15,97,59,54,210,3,66.7
664,3/15/2018 18:20,91,72,62,225,3,66.7
665,3/15/2018 18:25,81,56,54,191,3,66.7
666,3/15/2018 18:30,78,53,52,183,3,66.7
667,3/15/2018 18:35,85,64,56,205,3,66.7
668,3/15/2018 18:40,83,86,86,255,3,66.7
669,3/15/2018 18:45,84,55,51,190,3,66.7
670,3/15/2018 18:50,81,71,70,222,3,66.7
671,3/15/2018 18:55,76,68,52,196,3,66.7
672,3/15/2018 19:00,91,85,51,227,3,66.7
673,3/15/2018 19:05,82,92,46,220,3,66.7
674,3/15/2018 19:10,84,76,69,229,3,66.7
675,3/15/2018 19:15,75,77,47,199,3,66.7
676,3/15/2018 19:20,85,86,62,233,3,66.7
677,3/15/2018 19:25,78,78,63,219,3,66.7
678,3/15/2018 19:30,80,82,51,213,3,66.7
679,3/15/2018 19:35,84,86,57,227,3,66.7
680,3/15/2018 19:40,94,89,59,242,3,66.7
681,3/15/2018 19:45,95,93,64,252,3,66.7
682,3/15/2018 19:50,91,104,64,259,3,66.7
683,3/15/2018 19:55,84,95,66,245,3,66.7
684,3/15/2018 20:00,93,94,72,259,3,66.7
685,3/15/2018 20:05,85,93,56,234,3,66.7
686,3/15/2018 20:10,97,102,73,272,3,66.7
687,3/15/2018 20:15,97,98,72,267,3,66.7
688,3/15/2018 20:20,86,93,60,239,3,66.7
689,3/15/2018 20:25,87,82,56,225,3,66.7
690,3/15/2018 20:30,89,89,62,240,3,66.7
691,3/15/2018 20:35,82,81,62,225,3,66.7
692,3/15/2018 20:40,88,106,62,256,3,66.7
693,3/15/2018 20:45,98,107,58,263,3,66.7
694,3/15/2018 20:50,86,93,47,226,3,66.7
695,3/15/2018 20:55,99,94,61,254,3,66.7
696,3/15/2018 21:00,93,97,61,251,3,66.7
697,3/15/2018 21:05,85,96,62,243,3,66.7
698,3/15/2018 21:10,83,109,60,252,3,66.7
699,3/15/2018 21:15,84,105,68,257,3,66.7
700,3/15/2018 21:20,92,99,60,251,3,66.7
701,3/15/2018 21:25,90,119,69,278,3,66.7
702,3/15/2018 21:30,81,101,55,237,3,66.7
703,3/15/2018 21:35,86,104,68,258,3,66.7
704,3/15/2018 21:40,80,102,63,245,3,66.7
705,3/15/2018 21:45,85,108,68,261,3,66.7
706,3/15/2018 21:50,74,99,62,235,3,66.7
707,3/15/2018 21:55,87,112,63,262,3,66.7
708,3/15/2018 22:00,81,105,68,254,3,66.7
709,3/15/2018 22:05,78,101,63,242,3,66.7
710,3/15/2018 22:10,82,98,56,236,3,66.7
711,3/15/2018 22:15,82,115,64,261,3,66.7
712,3/15/2018 22:20,74,92,57,223,3,66.7
713,3/15/2018 22:25,81,108,64,253,3,66.7
714,3/15/2018 22:30,84,102,66,252,3,66.7
715,3/15/2018 22:35,86,91,54,231,3,66.7
716,3/15/2018 22:40,84,95,64,243,3,66.7
717,3/15/2018 22:45,91,118,77,286,3,66.7
718,3/15/2018 22:50,69,103,61,233,3,66.7
719,3/15/2018 22:55,74,97,55,226,3,66.7
720,3/15/2018 23:00,63,76,49,188,3,66.7
721,3/15/2018 23:05,64,101,57,222,3,66.7
722,3/15/2018 23:10,61,86,48,195,3,66.7
723,3/15/2018 23:15,67,83,53,203,3,66.7
724,3/15/2018 23:20,65,84,40,189,3,66.7
725,3/15/2018 23:25,67,96,51,214,3,66.7
726,3/15/2018 23:30,61,68,31,160,3,66.7
727,3/15/2018 23:35,58,89,49,196,3,66.7
728,3/15/2018 23:40,64,83,50,197,3,66.7
729,3/15/2018 23:45,63,78,38,179,3,66.7
730,3/15/2018 23:50,48,78,37,163,3,66.7
731,3/15/2018 23:55,60,68,49,177,3,66.7
732,3/16/2018 0:00,55,65,34,154,3,66.7
733,3/16/2018 0:05,56,74,42,172,3,66.7
734,3/16/2018 0:10,58,74,33,165,3,66.7
735,3/16/2018 0:15,57,69,33,159,3,66.7
736,3/16/2018 0:20,52,52,36,140,3,66.7
737,3/16/2018 0:25,60,68,38,166,3,66.7
738,3/16/2018 0:30,52,66,30,148,3,66.7
739,3/16/2018 0:35,51,73,35,159,3,66.7
740,3/16/2018 0:40,40,54,25,119,3,66.7
741,3/16/2018 0:45,49,64,32,145,3,66.7
742,3/16/2018 0:50,43,51,38,132,3,66.7
743,3/16/2018 0:55,43,53,29,125,3,66.7
744,3/16/2018 1:00,47,51,26,124,3,66.7
745,3/16/2018 1:05,43,50,19,112,3,66.7
746,3/16/2018 1:10,42,48,33,123,3,66.7
747,3/16/2018 1:15,44,47,25,116,3,66.7
748,3/16/2018 1:20,38,58,20,116,3,66.7
749,3/16/2018 1:25,43,51,21,115,3,66.7
750,3/16/2018 1:30,45,47,29,121,3,66.7
751,3/16/2018 1:35,42,45,19,106,3,66.7
752,3/16/2018 1:40,47,58,29,134,3,66.7
753,3/16/2018 1:45,40,50,19,109,3,66.7
754,3/16/2018 1:50,38,44,22,104,3,66.7
755,3/16/2018 1:55,38,41,28,107,3,66.7
756,3/16/2018 2:00,32,33,14,79,3,66.7
757,3/16/2018 2:05,37,46,23,106,3,66.7
758,3/16/2018 2:10,33,38,21,92,3,66.7
759,3/16/2018 2:15,35,23,21,79,3,66.7
760,3/16/2018 2:20,35,28,18,81,3,66.7
761,3/16/2018 2:25,39,36,22,97,3,66.7
762,3/16/2018 2:30,30,36,21,87,3,66.7
763,3/16/2018 2:35,27,23,14,64,3,66.7
764,3/16/2018 2:40,33,34,19,86,3,66.7
765,3/16/2018 2:45,31,29,22,82,3,66.7
766,3/16/2018 2:50,34,32,19,85,3,66.7
767,3/16/2018 2:55,34,35,19,88,3,66.7
768,3/16/2018 3:00,21,18,9,48,3,66.7
769,3/16/2018 3:05,26,25,14,65,3,66.7
770,3/16/2018 3:10,25,25,13,63,3,66.7
771,3/16/2018 3:15,24,23,16,63,3,66.7
772,3/16/2018 3:20,30,24,18,72,3,66.7
773,3/16/2018 3:25,28,33,17,78,3,66.7
774,3/16/2018 3:30,27,29,11,67,3,66.7
775,3/16/2018 3:35,30,21,19,70,3,66.7
776,3/16/2018 3:40,27,30,9,66,3,66.7
777,3/16/2018 3:45,29,32,12,73,3,66.7
778,3/16/2018 3:50,21,32,12,65,3,66.7
779,3/16/2018 3:55,22,16,8,46,3,66.7
780,3/16/2018 4:00,23,22,17,62,3,66.7
781,3/16/2018 4:05,33,28,17,78,3,66.7
782,3/16/2018 4:10,32,29,19,80,3,66.7
783,3/16/2018 4:15,35,40,22,97,3,66.7
784,3/16/2018 4:20,30,31,13,74,3,66.7
785,3/16/2018 4:25,33,37,17,87,3,66.7
786,3/16/2018 4:30,41,31,25,97,3,66.7
787,3/16/2018 4:35,42,34,20,96,3,66.7
788,3/16/2018 4:40,41,44,21,106,3,66.7
789,3/16/2018 4:45,40,36,17,93,3,66.7
790,3/16/2018 4:50,41,44,28,113,3,66.7
791,3/16/2018 4:55,37,38,20,95,3,66.7
792,3/16/2018 5:00,38,40,23,101,3,66.7
793,3/16/2018 5:05,44,47,17,108,3,66.7
794,3/16/2018 5:10,47,49,27,123,3,66.7
795,3/16/2018 5:15,54,51,23,128,3,66.7
796,3/16/2018 5:20,50,54,27,131,3,66.7
797,3/16/2018 5:25,56,56,25,137,3,66.7
798,3/16/2018 5:30,50,55,27,132,3,66.7
799,3/16/2018 5:35,57,60,34,151,3,66.7
800,3/16/2018 5:40,65,65,26,156,3,66.7
801,3/16/2018 5:45,48,53,32,133,3,66.7
802,3/16/2018 5:50,66,62,32,160,3,66.7
803,3/16/2018 5:55,56,58,33,147,3,66.7
804,3/16/2018 6:00,65,59,22,146,3,66.7
805,3/16/2018 6:05,53,61,29,143,3,66.7
806,3/16/2018 6:10,61,60,36,157,3,66.7
807,3/16/2018 6:15,74,77,43,194,3,66.7
808,3/16/2018 6:20,66,80,40,186,3,66.7
809,3/16/2018 6:25,71,76,49,196,3,66.7
810,3/16/2018 6:30,72,78,40,190,3,66.7
811,3/16/2018 6:35,83,89,54,226,3,66.7
812,3/16/2018 6:40,75,73,45,193,3,66.7
813,3/16/2018 6:45,85,86,47,218,3,66.7
814,3/16/2018 6:50,80,93,51,224,3,66.7
815,3/16/2018 6:55,79,87,50,216,3,66.7
816,3/16/2018 7:00,83,99,59,241,3,66.7
817,3/16/2018 7:05,73,94,54,221,3,66.7
818,3/16/2018 7:10,84,103,60,247,3,66.7
819,3/16/2018 7:15,77,90,63,230,3,66.7
820,3/16/2018 7:20,85,109,64,258,3,66.7
821,3/16/2018 7:25,82,105,65,252,3,66.7
822,3/16/2018 7:30,77,99,59,235,3,66.7
823,3/16/2018 7:35,96,91,76,263,3,66.7
824,3/16/2018 7:40,85,120,73,278,3,66.7
825,3/16/2018 7:45,98,104,70,272,3,66.7
826,3/16/2018 7:50,86,106,58,250,3,66.7
827,3/16/2018 7:55,84,94,62,240,3,66.7
828,3/16/2018 8:00,83,104,59,246,3,66.7
829,3/16/2018 8:05,97,112,54,263,3,66.7
830,3/16/2018 8:10,86,91,57,234,3,66.7
831,3/16/2018 8:15,90,112,60,262,3,66.7
832,3/16/2018 8:20,85,109,59,253,3,66.7
833,3/16/2018 8:25,99,95,64,258,3,66.7
834,3/16/2018 8:30,90,101,68,259,3,66.7
835,3/16/2018 8:35,93,108,62,263,3,66.7
836,3/16/2018 8:40,83,97,53,233,3,66.7
837,3/16/2018 8:45,86,96,65,247,3,66.7
838,3/16/2018 8:50,87,91,58,236,3,66.7
839,3/16/2018 8:55,81,89,47,217,3,66.7
840,3/16/2018 9:00,77,88,55,220,3,66.7
841,3/16/2018 9:05,85,90,53,228,3,66.7
842,3/16/2018 9:10,85,92,45,222,3,66.7
843,3/16/2018 9:15,80,100,53,233,3,66.7
844,3/16/2018 9:20,82,104,59,245,3,66.7
845,3/16/2018 9:25,82,96,58,236,3,66.7
846,3/16/2018 9:30,81,105,53,239,3,66.7
847,3/16/2018 9:35,99,96,59,254,3,66.7
848,3/16/2018 9:40,87,94,57,238,3,66.7
849,3/16/2018 9:45,93,100,55,248,3,66.7
850,3/16/2018 9:50,82,89,50,221,3,66.7
851,3/16/2018 9:55,79,93,48,220,3,66.7
852,3/16/2018 10:00,85,85,67,237,3,66.7
853,3/16/2018 10:05,81,84,61,226,3,66.7
854,3/16/2018 10:10,83,83,69,235,3,66.7
855,3/16/2018 10:15,81,91,52,224,3,66.7
856,3/16/2018 10:20,92,103,70,265,3,66.7
857,3/16/2018 10:25,79,80,60,219,3,66.7
858,3/16/2018 10:30,93,99,60,252,3,66.7
859,3/16/2018 10:35,93,92,63,248,3,66.7
860,3/16/2018 10:40,87,101,55,243,3,66.7
861,3/16/2018 10:45,88,82,59,229,3,66.7
862,3/16/2018 10:50,90,95,63,248,3,66.7
863,3/16/2018 10:55,89,95,67,251,3,66.7
864,3/16/2018 11:00,89,91,67,247,3,66.7
865,3/16/2018 11:05,93,110,67,270,3,66.7
866,3/16/2018 11:10,89,88,64,241,3,66.7
867,3/16/2018 11:15,96,103,71,270,3,66.7
868,3/16/2018 11:20,88,106,78,272,3,66.7
869,3/16/2018 11:25,90,108,62,260,3,66.7
870,3/16/2018 11:30,81,98,60,239,3,66.7
871,3/16/2018 11:35,93,103,63,259,3,66.7
872,3/16/2018 11:40,94,83,57,234,3,66.7
873,3/16/2018 11:45,97,107,71,275,3,66.7
874,3/16/2018 11:50,89,95,59,243,3,66.7
875,3/16/2018 11:55,83,100,66,249,3,66.7
876,3/16/2018 12:00,98,117,72,287,3,66.7
877,3/16/2018 12:05,97,112,68,277,3,66.7
878,3/16/2018 12:10,97,104,58,259,3,66.7
879,3/16/2018 12:15,105,112,69,286,3,66.7
880,3/16/2018 12:20,101,99,65,265,3,66.7
881,3/16/2018 12:25,90,93,60,243,3,66.7
882,3/16/2018 12:30,99,101,55,255,3,66.7
883,3/16/2018 12:35,98,92,72,262,3,66.7
884,3/16/2018 12:40,96,110,60,266,3,66.7
885,3/16/2018 12:45,85,94,56,235,3,66.7
886,3/16/2018 12:50,95,89,61,245,3,66.7
887,3/16/2018 12:55,78,79,54,211,3,66.7
888,3/16/2018 13:00,96,92,64,252,3,66.7
889,3/16/2018 13:05,92,85,66,243,3,66.7
890,3/16/2018 13:10,99,96,72,267,3,66.7
891,3/16/2018 13:15,98,102,71,271,3,66.7
892,3/16/2018 13:20,96,102,67,265,3,66.7
893,3/16/2018 13:25,107,107,70,284,3,66.7
894,3/16/2018 13:30,98,95,64,257,3,66.7
895,3/16/2018 13:35,91,96,76,263,3,66.7
896,3/16/2018 13:40,91,88,73,252,3,66.7
897,3/16/2018 13:45,104,105,73,282,3,66.7
898,3/16/2018 13:50,94,99,76,269,3,66.7
899,3/16/2018 13:55,92,98,75,265,3,66.7
900,3/16/2018 14:00,109,109,70,288,3,66.7
901,3/16/2018 14:05,92,102,60,254,3,66.7
902,3/16/2018 14:10,94,101,61,256,3,66.7
903,3/16/2018 14:15,103,93,64,260,3,66.7
904,3/16/2018 14:20,97,103,73,273,3,66.7
905,3/16/2018 14:25,97,96,75,268,3,66.7
906,3/16/2018 14:30,100,70,82,252,3,66.7
907,3/16/2018 14:35,103,92,80,275,3,66.7
908,3/16/2018 14:40,97,73,74,244,3,66.7
909,3/16/2018 14:45,108,83,83,274,3,66.7
910,3/16/2018 14:50,103,80,63,246,3,66.7
911,3/16/2018 14:55,101,87,80,268,3,66.7
912,3/16/2018 15:00,102,89,85,276,3,66.7
913,3/16/2018 15:05,92,79,72,243,3,66.7
914,3/16/2018 15:10,86,61,65,212,3,66.7
915,3/16/2018 15:15,87,84,72,243,3,66.7
916,3/16/2018 15:20,87,72,57,216,3,66.7
917,3/16/2018 15:25,80,75,66,221,3,66.7
918,3/16/2018 15:30,95,79,80,254,3,66.7
919,3/16/2018 15:35,95,83,76,254,3,66.7
920,3/16/2018 15:40,88,80,79,247,3,66.7
921,3/16/2018 15:45,82,60,57,199,3,66.7
922,3/16/2018 15:50,91,75,76,242,3,66.7
923,3/16/2018 15:55,79,71,64,214,3,66.7
924,3/16/2018 16:00,99,57,61,217,3,66.7
925,3/16/2018 16:05,91,59,64,214,3,66.7
926,3/16/2018 16:10,91,70,63,224,3,66.7
927,3/16/2018 16:15,91,85,87,263,3,66.7
928,3/16/2018 16:20,83,78,60,221,3,66.7
929,3/16/2018 16:25,96,66,60,222,3,66.7
930,3/16/2018 16:30,89,59,45,193,3,66.7
931,3/16/2018 16:35,85,76,62,223,3,66.7
932,3/16/2018 16:40,91,72,71,234,3,66.7
933,3/16/2018 16:45,82,73,84,239,3,66.7
934,3/16/2018 16:50,93,52,54,199,3,66.7
935,3/16/2018 16:55,92,72,66,230,3,66.7
936,3/16/2018 17:00,87,75,69,231,3,66.7
937,3/16/2018 17:05,96,72,77,245,3,66.7
938,3/16/2018 17:10,89,61,55,205,3,66.7
939,3/16/2018 17:15,85,72,62,219,3,66.7
940,3/16/2018 17:20,105,76,78,259,3,66.7
941,3/16/2018 17:25,101,64,67,232,3,66.7
942,3/16/2018 17:30,89,74,66,229,3,66.7
943,3/16/2018 17:35,96,83,70,249,3,66.7
944,3/16/2018 17:40,81,69,79,229,3,66.7
945,3/16/2018 17:45,94,82,77,253,3,66.7
946,3/16/2018 17:50,92,80,74,246,3,66.7
947,3/16/2018 17:55,85,72,67,224,3,66.7
948,3/16/2018 18:00,90,75,69,234,3,66.7
949,3/16/2018 18:05,86,93,77,256,3,66.7
950,3/16/2018 18:10,82,71,65,218,3,66.7
951,3/16/2018 18:15,98,97,77,272,3,66.7
952,3/16/2018 18:20,94,83,57,234,3,66.7
953,3/16/2018 18:25,84,81,80,245,3,66.7
954,3/16/2018 18:30,89,78,73,240,3,66.7
955,3/16/2018 18:35,91,82,80,253,3,66.7
956,3/16/2018 18:40,93,80,70,243,3,66.7
957,3/16/2018 18:45,78,82,62,222,3,66.7
958,3/16/2018 18:50,94,93,58,245,3,66.7
959,3/16/2018 18:55,84,81,57,222,3,66.7
960,3/16/2018 19:00,85,80,48,213,3,66.7
961,3/16/2018 19:05,84,75,53,212,3,66.7
962,3/16/2018 19:10,78,79,54,211,3,66.7
963,3/16/2018 19:15,65,66,46,177,3,66.7
964,3/16/2018 19:20,90,88,49,227,3,66.7
965,3/16/2018 19:25,87,88,50,225,3,66.7
966,3/16/2018 19:30,76,77,57,210,3,66.7
967,3/16/2018 19:35,85,91,55,231,3,66.7
968,3/16/2018 19:40,89,96,66,251,3,66.7
969,3/16/2018 19:45,80,84,60,224,3,66.7
970,3/16/2018 19:50,84,84,58,226,3,66.7
971,3/16/2018 19:55,87,83,61,231,3,66.7
972,3/16/2018 20:00,76,76,51,203,3,66.7
973,3/16/2018 20:05,82,98,55,235,3,66.7
974,3/16/2018 20:10,87,74,61,222,3,66.7
975,3/16/2018 20:15,95,97,62,254,3,66.7
976,3/16/2018 20:20,80,87,71,238,3,66.7
977,3/16/2018 20:25,91,100,61,252,3,66.7
978,3/16/2018 20:30,88,92,81,261,3,0.0
979,3/16/2018 20:35,81,74,67,222,3,66.7
980,3/16/2018 20:40,91,100,73,264,3,66.7
981,3/16/2018 20:45,84,103,65,252,3,66.7
982,3/16/2018 20:50,86,90,65,241,3,66.7
983,3/16/2018 20:55,87,84,54,225,3,66.7
984,3/16/2018 21:00,76,87,68,231,3,66.7
985,3/16/2018 21:05,77,88,59,224,3,66.7
986,3/16/2018 21:10,82,85,60,227,3,66.7
987,3/16/2018 21:15,70,88,49,207,3,66.7
988,3/16/2018 21:20,78,88,56,222,3,66.7
989,3/16/2018 21:25,75,94,63,232,3,66.7
990,3/16/2018 21:30,81,88,57,226,3,66.7
991,3/16/2018 21:35,76,92,57,225,3,66.7
992,3/16/2018 21:40,86,89,77,252,3,66.7
993,3/16/2018 21:45,78,91,66,235,3,66.7
994,3/16/2018 21:50,80,89,44,213,3,66.7
995,3/16/2018 21:55,76,71,54,201,3,66.7
996,3/16/2018 22:00,69,93,41,203,3,66.7
997,3/16/2018 22:05,81,82,53,216,3,66.7
998,3/16/2018 22:10,76,94,60,230,3,66.7
999,3/16/2018 22:15,79,91,66,236,3,66.7
1000,3/16/2018 22:20,80,87,63,230,3,66.7
1001,3/16/2018 22:25,79,74,58,211,3,66.7
1002,3/16/2018 22:30,68,87,46,201,3,66.7
1003,3/16/2018 22:35,81,95,56,232,3,66.7
1004,3/16/2018 22:40,77,102,66,245,3,66.7
1005,3/16/2018 22:45,76,98,60,234,3,66.7
1006,3/16/2018 22:50,82,91,66,239,3,66.7
1007,3/16/2018 22:55,74,86,54,214,3,66.7
1008,3/16/2018 23:00,82,88,64,234,3,66.7
1009,3/16/2018 23:05,69,83,54,206,3,66.7
1010,3/16/2018 23:10,69,90,57,216,3,66.7
1011,3/16/2018 23:15,71,86,60,217,3,66.7
1012,3/16/2018 23:20,82,80,65,227,3,66.7
1013,3/16/2018 23:25,67,81,50,198,3,66.7
1014,3/16/2018 23:30,64,88,57,209,3,66.7
1015,3/16/2018 23:35,72,82,60,214,3,66.7
1016,3/16/2018 23:40,72,85,50,207,3,66.7
1017,3/16/2018 23:45,74,84,62,220,3,66.7
1018,3/16/2018 23:50,60,74,43,177,3,66.7
1019,3/16/2018 23:55,63,61,48,172,3,66.7
1020,3/17/2018 0:00,62,67,40,169,3,66.7
1021,3/17/2018 0:05,55,64,27,146,3,66.7
1022,3/17/2018 0:10,59,72,50,181,3,66.7
1023,3/17/2018 0:15,56,65,41,162,3,66.7
1024,3/17/2018 0:20,58,69,37,164,3,66.7
1025,3/17/2018 0:25,61,57,42,160,3,66.7
1026,3/17/2018 0:30,48,72,32,152,3,66.7
1027,3/17/2018 0:35,55,59,36,150,3,66.7
1028,3/17/2018 0:40,60,69,43,172,3,66.7
1029,3/17/2018 0:45,49,60,40,149,3,66.7
1030,3/17/2018 0:50,44,50,31,125,3,66.7
1031,3/17/2018 0:55,46,45,24,115,3,66.7
1032,3/17/2018 1:00,43,46,24,113,3,66.7
1033,3/17/2018 1:05,46,48,31,125,3,66.7
1034,3/17/2018 1:10,45,51,23,119,3,66.7
1035,3/17/2018 1:15,43,53,29,125,3,66.7
1036,3/17/2018 1:20,50,53,30,133,3,66.7
1037,3/17/2018 1:25,44,35,30,109,3,66.7
1038,3/17/2018 1:30,48,56,49,153,3,0.0
1039,3/17/2018 1:35,49,56,50,155,3,0.0
1040,3/17/2018 1:40,48,55,49,152,3,0.0
1041,3/17/2018 1:45,46,53,47,146,3,0.0
1042,3/17/2018 1:50,42,50,44,136,3,0.0
1043,3/17/2018 1:55,42,49,43,134,3,0.0
1044,3/17/2018 2:00,39,47,42,128,3,0.0
1045,3/17/2018 2:05,40,48,42,130,3,0.0
1046,3/17/2018 2:10,40,48,42,130,3,0.0
1047,3/17/2018 2:15,43,51,45,139,3,0.0
1048,3/17/2018 2:20,39,53,30,122,3,66.7
1049,3/17/2018 2:25,31,41,19,91,3,66.7
1050,3/17/2018 2:30,33,31,18,82,3,66.7
1051,3/17/2018 2:35,30,39,17,86,3,66.7
1052,3/17/2018 2:40,39,38,23,100,3,66.7
1053,3/17/2018 2:45,37,39,23,99,3,66.7
1054,3/17/2018 2:50,29,37,14,80,3,66.7
1055,3/17/2018 2:55,28,34,18,80,3,66.7
1056,3/17/2018 3:00,28,33,19,80,3,66.7
1057,3/17/2018 3:05,25,26,17,68,3,66.7
1058,3/17/2018 3:10,30,26,17,73,3,66.7
1059,3/17/2018 3:15,30,30,13,73,3,66.7
1060,3/17/2018 3:20,21,27,23,71,3,66.7
1061,3/17/2018 3:25,25,35,31,91,3,0.0
1062,3/17/2018 3:30,27,36,31,94,3,0.0
1063,3/17/2018 3:35,30,38,33,101,3,0.0
1064,3/17/2018 3:40,30,39,35,104,3,0.0
1065,3/17/2018 3:45,30,39,36,105,3,0.0
1066,3/17/2018 3:50,25,36,33,94,3,0.0
1067,3/17/2018 3:55,27,37,33,97,3,0.0
1068,3/17/2018 4:00,31,40,34,105,3,0.0
1069,3/17/2018 4:05,29,38,32,99,3,0.0
1070,3/17/2018 4:10,27,37,34,98,3,0.0
1071,3/17/2018 4:15,30,30,14,74,3,66.7
1072,3/17/2018 4:20,31,38,19,88,3,66.7
1073,3/17/2018 4:25,29,21,11,61,3,66.7
1074,3/17/2018 4:30,27,31,13,71,3,66.7
1075,3/17/2018 4:35,30,28,13,71,3,66.7
1076,3/17/2018 4:40,29,32,12,73,3,66.7
1077,3/17/2018 4:45,33,31,18,82,3,66.7
1078,3/17/2018 4:50,33,33,17,83,3,66.7
1079,3/17/2018 4:55,30,34,16,80,3,66.7
1080,3/17/2018 5:00,30,34,17,81,3,66.7
1081,3/17/2018 5:05,34,36,13,83,3,66.7
1082,3/17/2018 5:10,33,35,18,86,3,66.7
1083,3/17/2018 5:15,35,44,20,99,3,66.7
1084,3/17/2018 5:20,35,35,20,90,3,66.7
1085,3/17/2018 5:25,38,43,27,108,3,66.7
1086,3/17/2018 5:30,43,42,18,103,3,66.7
1087,3/17/2018 5:35,46,50,18,114,3,66.7
1088,3/17/2018 5:40,49,48,23,120,3,66.7
1089,3/17/2018 5:45,40,42,19,101,3,66.7
1090,3/17/2018 5:50,50,48,22,120,3,66.7
1091,3/17/2018 5:55,39,42,19,100,3,66.7
1092,3/17/2018 6:00,48,49,26,123,3,66.7
1093,3/17/2018 6:05,39,43,20,102,3,66.7
1094,3/17/2018 6:10,46,42,23,111,3,66.7
1095,3/17/2018 6:15,41,55,26,122,3,66.7
1096,3/17/2018 6:20,38,50,23,111,3,66.7
1097,3/17/2018 6:25,51,58,23,132,3,66.7
1098,3/17/2018 6:30,48,48,28,124,3,66.7
1099,3/17/2018 6:35,55,52,33,140,3,66.7
1100,3/17/2018 6:40,56,70,35,161,3,66.7
1101,3/17/2018 6:45,58,58,34,150,3,66.7
1102,3/17/2018 6:50,55,64,35,154,3,66.7
1103,3/17/2018 6:55,59,64,38,161,3,66.7
1104,3/17/2018 7:00,57,72,34,163,3,66.7
1105,3/17/2018 7:05,53,60,27,140,3,66.7
1106,3/17/2018 7:10,64,80,41,185,3,66.7
1107,3/17/2018 7:15,69,73,43,185,3,66.7
1108,3/17/2018 7:20,62,76,41,179,3,66.7
1109,3/17/2018 7:25,69,73,53,195,3,66.7
1110,3/17/2018 7:30,57,72,39,168,3,66.7
1111,3/17/2018 7:35,70,84,50,204,3,66.7
1112,3/17/2018 7:40,73,83,42,198,3,66.7
1113,3/17/2018 7:45,72,82,51,205,3,66.7
1114,3/17/2018 7:50,63,84,40,187,3,66.7
1115,3/17/2018 7:55,74,86,53,213,3,66.7
1116,3/17/2018 8:00,56,73,44,173,3,66.7
1117,3/17/2018 8:05,67,65,37,169,3,66.7
1118,3/17/2018 8:10,72,81,40,193,3,66.7
1119,3/17/2018 8:15,66,95,43,204,3,66.7
1120,3/17/2018 8:20,72,87,53,212,3,66.7
1121,3/17/2018 8:25,79,93,55,227,3,66.7
1122,3/17/2018 8:30,76,91,50,217,3,66.7
1123,3/17/2018 8:35,76,91,48,215,3,66.7
1124,3/17/2018 8:40,81,76,53,210,3,66.7
1125,3/17/2018 8:45,66,96,51,213,3,66.7
1126,3/17/2018 8:50,79,76,49,204,3,66.7
1127,3/17/2018 8:55,86,105,71,262,3,66.7
1128,3/17/2018 9:00,78,83,51,212,3,66.7
1129,3/17/2018 9:05,73,97,52,222,3,66.7
1130,3/17/2018 9:10,69,87,54,210,3,66.7
1131,3/17/2018 9:15,62,80,48,190,3,66.7
1132,3/17/2018 9:20,90,103,57,250,3,66.7
1133,3/17/2018 9:25,79,94,57,230,3,66.7
1134,3/17/2018 9:30,74,105,62,241,3,66.7
1135,3/17/2018 9:35,75,109,65,249,3,66.7
1136,3/17/2018 9:40,79,96,66,241,3,66.7
1137,3/17/2018 9:45,78,101,58,237,3,66.7
1138,3/17/2018 9:50,76,81,48,205,3,66.7
1139,3/17/2018 9:55,81,83,50,214,3,66.7
1140,3/17/2018 10:00,77,89,60,226,3,66.7
1141,3/17/2018 10:05,84,91,54,229,3,66.7
1142,3/17/2018 10:10,87,96,63,246,3,66.7
1143,3/17/2018 10:15,99,96,61,256,3,66.7
1144,3/17/2018 10:20,88,88,65,241,3,66.7
1145,3/17/2018 10:25,87,95,56,238,3,66.7
1146,3/17/2018 10:30,90,98,57,245,3,66.7
1147,3/17/2018 10:35,93,98,64,255,3,66.7
1148,3/17/2018 10:40,91,100,55,246,3,66.7
1149,3/17/2018 10:45,84,117,78,279,3,66.7
1150,3/17/2018 10:50,105,104,71,280,3,66.7
1151,3/17/2018 10:55,85,97,60,242,3,66.7
1152,3/17/2018 11:00,91,98,68,257,3,66.7
1153,3/17/2018 11:05,92,99,65,256,3,66.7
1154,3/17/2018 11:10,98,108,75,281,3,66.7
1155,3/17/2018 11:15,95,100,66,261,3,66.7
1156,3/17/2018 11:20,90,97,64,251,3,66.7
1157,3/17/2018 11:25,102,102,61,265,3,66.7
1158,3/17/2018 11:30,96,99,70,265,3,66.7
1159,3/17/2018 11:35,85,96,63,244,3,66.7
1160,3/17/2018 11:40,85,95,60,240,3,66.7
1161,3/17/2018 11:45,102,95,64,261,3,66.7
1162,3/17/2018 11:50,87,103,62,252,3,66.7
1163,3/17/2018 11:55,97,115,72,284,3,66.7
1164,3/17/2018 12:00,90,90,67,247,3,66.7
1165,3/17/2018 12:05,85,92,57,234,3,66.7
1166,3/17/2018 12:10,101,106,76,283,3,66.7
1167,3/17/2018 12:15,95,98,62,255,3,66.7
1168,3/17/2018 12:20,91,88,57,236,3,66.7
1169,3/17/2018 12:25,102,102,69,273,3,66.7
1170,3/17/2018 12:30,105,115,76,296,3,66.7
1171,3/17/2018 12:35,97,99,62,258,3,66.7
1172,3/17/2018 12:40,97,102,66,265,3,66.7
1173,3/17/2018 12:45,97,97,76,270,3,66.7
1174,3/17/2018 12:50,95,97,64,256,3,66.7
1175,3/17/2018 12:55,100,95,79,274,3,66.7
1176,3/17/2018 13:00,93,101,65,259,3,66.7
1177,3/17/2018 13:05,92,94,63,249,3,66.7
1178,3/17/2018 13:10,93,107,68,268,3,66.7
1179,3/17/2018 13:15,92,85,69,246,3,66.7
1180,3/17/2018 13:20,58,64,44,166,3,66.7
1181,3/17/2018 13:25,66,64,50,180,3,66.7
1182,3/17/2018 13:30,61,67,48,176,3,66.7
1183,3/17/2018 13:35,69,67,47,183,3,66.7
1184,3/17/2018 13:40,41,54,32,127,3,66.7
1185,3/17/2018 13:45,41,32,18,91,3,66.7
1186,3/17/2018 13:50,86,93,64,243,3,66.7
1187,3/17/2018 13:55,83,90,69,242,3,66.7
1188,3/17/2018 14:00,85,95,68,248,3,66.7
1189,3/17/2018 14:05,83,84,65,232,3,66.7
1190,3/17/2018 14:10,82,86,73,241,3,66.7
1191,3/17/2018 14:15,89,91,63,243,3,66.7
1192,3/17/2018 14:20,81,88,79,248,3,66.7
1193,3/17/2018 14:25,97,98,88,283,3,66.7
1194,3/17/2018 14:30,89,85,74,248,3,66.7
1195,3/17/2018 14:35,92,93,73,258,3,66.7
1196,3/17/2018 14:40,98,95,74,267,3,66.7
1197,3/17/2018 14:45,96,91,60,247,3,66.7
1198,3/17/2018 14:50,100,87,79,266,3,66.7
1199,3/17/2018 14:55,106,95,80,281,3,66.7
1200,3/17/2018 15:00,102,104,81,287,3,66.7
1201,3/17/2018 15:05,92,97,76,265,3,66.7
1202,3/17/2018 15:10,98,107,89,294,3,66.7
1203,3/17/2018 15:15,92,100,68,260,3,66.7
1204,3/17/2018 15:20,100,100,74,274,3,66.7
1205,3/17/2018 15:25,104,103,78,285,3,66.7
1206,3/17/2018 15:30,89,79,61,229,3,66.7
1207,3/17/2018 15:35,94,102,67,263,3,66.7
1208,3/17/2018 15:40,103,89,82,274,3,66.7
1209,3/17/2018 15:45,102,96,77,275,3,66.7
1210,3/17/2018 15:50,89,84,64,237,3,66.7
1211,3/17/2018 15:55,94,99,67,260,3,66.7
1212,3/17/2018 16:00,101,104,72,277,3,66.7
1213,3/17/2018 16:05,92,100,70,262,3,66.7
1214,3/17/2018 16:10,94,88,71,253,3,66.7
1215,3/17/2018 16:15,95,95,68,258,3,66.7
1216,3/17/2018 16:20,90,99,67,256,3,66.7
1217,3/17/2018 16:25,98,105,70,273,3,66.7
1218,3/17/2018 16:30,94,99,76,269,3,66.7
1219,3/17/2018 16:35,93,100,80,273,3,66.7
1220,3/17/2018 16:40,100,97,69,266,3,66.7
1221,3/17/2018 16:45,111,111,73,295,3,66.7
1222,3/17/2018 16:50,101,97,68,266,3,66.7
1223,3/17/2018 16:55,100,98,59,257,3,66.7
1224,3/17/2018 17:00,88,98,59,245,3,66.7
1225,3/17/2018 17:05,98,93,66,257,3,66.7
1226,3/17/2018 17:10,88,94,64,246,3,66.7
1227,3/17/2018 17:15,89,89,68,246,3,66.7
1228,3/17/2018 17:20,103,98,78,279,3,66.7
1229,3/17/2018 17:25,91,105,67,263,3,66.7
1230,3/17/2018 17:30,91,93,66,250,3,66.7
1231,3/17/2018 17:35,99,90,72,261,3,66.7
1232,3/17/2018 17:40,92,104,68,264,3,66.7
1233,3/17/2018 17:45,92,91,63,246,3,66.7
1234,3/17/2018 17:50,104,93,79,276,3,66.7
1235,3/17/2018 17:55,99,103,83,285,3,66.7
1236,3/17/2018 18:00,81,82,52,215,3,66.7
1237,3/17/2018 18:05,85,84,61,230,3,66.7
1238,3/17/2018 18:10,87,81,60,228,3,66.7
1239,3/17/2018 18:15,78,106,67,251,3,66.7
1240,3/17/2018 18:20,90,92,66,248,3,66.7
1241,3/17/2018 18:25,88,81,63,232,3,66.7
1242,3/17/2018 18:30,79,89,61,229,3,66.7
1243,3/17/2018 18:35,84,87,50,221,3,66.7
1244,3/17/2018 18:40,89,93,66,248,3,66.7
1245,3/17/2018 18:45,96,84,59,239,3,66.7
1246,3/17/2018 18:50,84,91,53,228,3,66.7
1247,3/17/2018 18:55,83,86,61,230,3,66.7
1248,3/17/2018 19:00,88,80,53,221,3,66.7
1249,3/17/2018 19:05,72,97,50,219,3,66.7
1250,3/17/2018 19:10,90,97,68,255,3,66.7
1251,3/17/2018 19:15,86,92,67,245,3,66.7
1252,3/17/2018 19:20,92,103,70,265,3,66.7
1253,3/17/2018 19:25,89,114,70,273,3,66.7
1254,3/17/2018 19:30,85,96,66,247,3,66.7
1255,3/17/2018 19:35,87,94,70,251,3,66.7
1256,3/17/2018 19:40,86,87,51,224,3,66.7
1257,3/17/2018 19:45,71,93,56,220,3,66.7
1258,3/17/2018 19:50,81,91,59,231,3,66.7
1259,3/17/2018 19:55,80,99,61,240,3,66.7
1260,3/17/2018 20:00,71,84,53,208,3,66.7
1261,3/17/2018 20:05,77,80,61,218,3,66.7
1262,3/17/2018 20:10,86,82,56,224,3,66.7
1263,3/17/2018 20:15,81,104,75,260,3,66.7
1264,3/17/2018 20:20,91,98,63,252,3,66.7
1265,3/17/2018 20:25,83,96,63,242,3,66.7
1266,3/17/2018 20:30,78,109,58,245,3,66.7
1267,3/17/2018 20:35,87,92,68,247,3,66.7
1268,3/17/2018 20:40,78,79,56,213,3,66.7
1269,3/17/2018 20:45,87,105,66,258,3,66.7
1270,3/17/2018 20:50,82,101,62,245,3,66.7
1271,3/17/2018 20:55,79,95,63,237,3,66.7
1272,3/17/2018 21:00,71,90,58,219,3,66.7
1273,3/17/2018 21:05,72,88,47,207,3,66.7
1274,3/17/2018 21:10,87,94,62,243,3,66.7
1275,3/17/2018 21:15,80,109,63,252,3,66.7
1276,3/17/2018 21:20,92,87,64,243,3,66.7
1277,3/17/2018 21:25,80,92,66,238,3,66.7
1278,3/17/2018 21:30,82,90,55,227,3,66.7
1279,3/17/2018 21:35,73,82,57,212,3,66.7
1280,3/17/2018 21:40,71,86,48,205,3,66.7
1281,3/17/2018 21:45,73,92,54,219,3,66.7
1282,3/17/2018 21:50,68,93,54,215,3,66.7
1283,3/17/2018 21:55,84,92,56,232,3,66.7
1284,3/17/2018 22:00,84,95,61,240,3,66.7
1285,3/17/2018 22:05,71,83,47,201,3,66.7
1286,3/17/2018 22:10,82,89,59,230,3,66.7
1287,3/17/2018 22:15,84,104,48,236,3,66.7
1288,3/17/2018 22:20,82,97,63,242,3,66.7
1289,3/17/2018 22:25,98,112,80,290,3,66.7
1290,3/17/2018 22:30,75,98,55,228,3,66.7
1291,3/17/2018 22:35,81,99,75,255,3,66.7
1292,3/17/2018 22:40,75,94,58,227,3,66.7
1293,3/17/2018 22:45,81,88,61,230,3,66.7
1294,3/17/2018 22:50,79,81,56,216,3,66.7
1295,3/17/2018 22:55,73,95,53,221,3,66.7
1296,3/17/2018 23:00,47,77,41,165,3,66.7
1297,3/17/2018 23:05,54,60,32,146,3,66.7
1298,3/17/2018 23:10,52,59,35,146,3,66.7
1299,3/17/2018 23:15,60,69,40,169,3,66.7
1300,3/17/2018 23:20,55,79,35,169,3,66.7
1301,3/17/2018 23:25,59,72,38,169,3,66.7
1302,3/17/2018 23:30,60,71,44,175,3,66.7
1303,3/17/2018 23:35,53,58,45,156,3,66.7
1304,3/17/2018 23:40,58,60,41,159,3,66.7
1305,3/17/2018 23:45,47,64,35,146,3,66.7
1306,3/17/2018 23:50,54,66,39,159,3,66.7
1307,3/17/2018 23:55,53,66,45,164,3,66.7
1308,3/18/2018 0:00,54,60,38,152,3,66.7
1309,3/18/2018 0:05,56,68,37,161,3,66.7
1310,3/18/2018 0:10,53,67,37,157,3,66.7
1311,3/18/2018 0:15,51,50,33,134,3,66.7
1312,3/18/2018 0:20,51,67,34,152,3,66.7
1313,3/18/2018 0:25,47,61,29,137,3,66.7
1314,3/18/2018 0:30,54,60,29,143,3,66.7
1315,3/18/2018 0:35,50,55,33,138,3,66.7
1316,3/18/2018 0:40,44,57,35,136,3,66.7
1317,3/18/2018 0:45,46,58,36,140,3,66.7
1318,3/18/2018 0:50,41,49,29,119,3,66.7
1319,3/18/2018 0:55,47,50,23,120,3,66.7
1320,3/18/2018 1:00,40,50,25,115,3,66.7
1321,3/18/2018 1:05,44,47,31,122,3,66.7
1322,3/18/2018 1:10,49,55,31,135,3,66.7
1323,3/18/2018 1:15,36,53,25,114,3,66.7
1324,3/18/2018 1:20,43,58,38,139,3,66.7
1325,3/18/2018 1:25,47,52,32,131,3,66.7
1326,3/18/2018 1:30,41,42,27,110,3,66.7
1327,3/18/2018 1:35,34,36,17,87,3,66.7
1328,3/18/2018 1:40,44,49,27,120,3,66.7
1329,3/18/2018 1:45,41,47,19,107,3,66.7
1330,3/18/2018 1:50,38,48,20,106,3,66.7
1331,3/18/2018 1:55,38,43,22,103,3,66.7
1332,3/18/2018 2:00,31,31,11,73,3,66.7
1333,3/18/2018 2:05,44,45,26,115,3,66.7
1334,3/18/2018 2:10,32,35,23,90,3,66.7
1335,3/18/2018 2:15,30,30,21,81,3,66.7
1336,3/18/2018 2:20,35,42,23,100,3,66.7
1337,3/18/2018 2:25,39,46,23,108,3,66.7
1338,3/18/2018 2:30,32,36,14,82,3,66.7
1339,3/18/2018 2:35,27,30,15,72,3,66.7
1340,3/18/2018 2:40,31,33,17,81,3,66.7
1341,3/18/2018 2:45,32,30,12,74,3,66.7
1342,3/18/2018 2:50,27,36,16,79,3,66.7
1343,3/18/2018 2:55,32,28,20,80,3,66.7
1344,3/18/2018 3:00,31,34,14,79,3,66.7
1345,3/18/2018 3:05,32,29,21,82,3,66.7
1346,3/18/2018 3:10,32,42,38,112,3,0.0
1347,3/18/2018 3:15,30,38,33,101,3,0.0
1348,3/18/2018 3:20,23,34,32,89,3,0.0
1349,3/18/2018 3:25,30,39,34,103,3,0.0
1350,3/18/2018 3:30,23,32,29,84,3,0.0
1351,3/18/2018 3:35,26,36,32,94,3,0.0
1352,3/18/2018 3:40,26,35,30,91,3,0.0
1353,3/18/2018 3:45,30,38,33,101,3,0.0
1354,3/18/2018 3:50,25,36,33,94,3,0.0
1355,3/18/2018 3:55,29,39,33,101,3,0.0
1356,3/18/2018 4:00,27,36,32,95,3,0.0
1357,3/18/2018 4:05,27,37,33,97,3,0.0
1358,3/18/2018 4:10,24,19,14,57,3,66.7
1359,3/18/2018 4:15,25,21,15,61,3,66.7
1360,3/18/2018 4:20,26,25,15,66,3,66.7
1361,3/18/2018 4:25,22,20,13,55,3,66.7
1362,3/18/2018 4:30,31,26,9,66,3,66.7
1363,3/18/2018 4:35,24,22,9,55,3,66.7
1364,3/18/2018 4:40,24,31,15,70,3,66.7
1365,3/18/2018 4:45,28,24,11,63,3,66.7
1366,3/18/2018 4:50,29,30,11,70,3,66.7
1367,3/18/2018 4:55,27,27,15,69,3,66.7
1368,3/18/2018 5:00,24,22,11,57,3,66.7
1369,3/18/2018 5:05,27,24,12,63,3,66.7
1370,3/18/2018 5:10,29,34,13,76,3,66.7
1371,3/18/2018 5:15,33,31,14,78,3,66.7
1372,3/18/2018 5:20,28,29,16,73,3,66.7
1373,3/18/2018 5:25,35,34,13,82,3,66.7
1374,3/18/2018 5:30,31,30,15,76,3,66.7
1375,3/18/2018 5:35,37,37,19,93,3,66.7
1376,3/18/2018 5:40,32,37,21,90,3,66.7
1377,3/18/2018 5:45,38,46,41,125,3,0.0
1378,3/18/2018 5:50,38,46,41,125,3,0.0
1379,3/18/2018 5:55,35,43,38,116,3,0.0
1380,3/18/2018 6:00,35,43,38,116,3,0.0
1381,3/18/2018 6:05,35,43,38,116,3,0.0
1382,3/18/2018 6:10,41,49,44,134,3,0.0
1383,3/18/2018 6:15,41,49,43,133,3,0.0
1384,3/18/2018 6:20,45,53,47,145,3,0.0
1385,3/18/2018 6:25,44,52,46,142,3,0.0
1386,3/18/2018 6:30,38,46,41,125,3,0.0
1387,3/18/2018 6:35,47,55,49,151,3,0.0
1388,3/18/2018 6:40,41,49,44,134,3,0.0
1389,3/18/2018 6:45,52,59,52,163,3,0.0
1390,3/18/2018 6:50,44,52,47,143,3,0.0
1391,3/18/2018 6:55,41,49,43,133,3,0.0
1392,3/18/2018 7:00,55,61,54,170,3,0.0
1393,3/18/2018 7:05,54,61,54,169,3,0.0
1394,3/18/2018 7:10,51,58,53,162,3,0.0
1395,3/18/2018 7:15,57,64,57,178,3,0.0
1396,3/18/2018 7:20,59,65,58,182,3,0.0
1397,3/18/2018 7:25,59,66,58,183,3,0.0
1398,3/18/2018 7:30,62,68,60,190,3,0.0
1399,3/18/2018 7:35,61,67,59,187,3,0.0
1400,3/18/2018 7:40,64,70,62,196,3,0.0
1401,3/18/2018 7:45,67,73,64,204,3,0.0
1402,3/18/2018 7:50,68,73,64,205,3,0.0
1403,3/18/2018 7:55,68,73,64,205,3,0.0
1404,3/18/2018 8:00,59,66,58,183,3,0.0
1405,3/18/2018 8:05,62,68,60,190,3,0.0
1406,3/18/2018 8:10,68,73,65,206,3,0.0
1407,3/18/2018 8:15,68,73,64,205,3,0.0
1408,3/18/2018 8:20,69,74,65,208,3,0.0
1409,3/18/2018 8:25,65,71,62,198,3,0.0
1410,3/18/2018 8:30,63,69,60,192,3,0.0
1411,3/18/2018 8:35,73,77,69,219,3,0.0
1412,3/18/2018 8:40,82,86,75,243,3,0.0
1413,3/18/2018 8:45,64,70,62,196,3,0.0
1414,3/18/2018 8:50,75,80,70,225,3,0.0
1415,3/18/2018 8:55,77,81,72,230,3,0.0
1416,3/18/2018 9:00,73,77,68,218,3,0.0
1417,3/18/2018 9:05,86,90,79,255,3,0.0
1418,3/18/2018 9:10,77,81,71,229,3,0.0
1419,3/18/2018 9:15,88,91,80,259,3,0.0
1420,3/18/2018 9:20,80,84,74,238,3,0.0
1421,3/18/2018 9:25,80,84,74,238,3,0.0
1422,3/18/2018 9:30,88,92,80,260,3,0.0
1423,3/18/2018 9:35,79,83,73,235,3,0.0
1424,3/18/2018 9:40,94,97,85,276,3,0.0
1425,3/18/2018 9:45,81,84,74,239,3,0.0
1426,3/18/2018 9:50,104,105,92,301,3,0.0
1427,3/18/2018 9:55,92,95,83,270,3,0.0
1428,3/18/2018 10:00,100,103,90,293,3,0.0
1429,3/18/2018 10:05,77,81,71,229,3,0.0
1430,3/18/2018 10:10,98,101,88,287,3,0.0
1431,3/18/2018 10:15,93,96,84,273,3,0.0
1432,3/18/2018 10:20,106,108,94,308,3,0.0
1433,3/18/2018 10:25,104,106,93,303,3,0.0
1434,3/18/2018 10:30,89,38,23,150,3,66.7
1435,3/18/2018 10:35,95,100,61,256,3,66.7
1436,3/18/2018 10:40,95,94,84,273,3,66.7
1437,3/18/2018 10:45,88,98,85,271,3,66.7
1438,3/18/2018 10:50,89,84,66,239,3,66.7
1439,3/18/2018 10:55,88,92,54,234,3,66.7
1440,3/18/2018 11:00,96,91,61,248,3,66.7
1441,3/18/2018 11:05,85,82,72,239,3,66.7
1442,3/18/2018 11:10,89,83,70,242,3,66.7
1443,3/18/2018 11:15,93,94,61,248,3,66.7
1444,3/18/2018 11:20,107,101,71,279,3,66.7
1445,3/18/2018 11:25,100,103,66,269,3,66.7
1446,3/18/2018 11:30,96,95,59,250,3,66.7
1447,3/18/2018 11:35,96,78,65,239,3,66.7
1448,3/18/2018 11:40,87,86,62,235,3,66.7
1449,3/18/2018 11:45,84,78,62,224,3,66.7
1450,3/18/2018 11:50,85,85,54,224,3,66.7
1451,3/18/2018 11:55,83,89,55,227,3,66.7
1452,3/18/2018 12:00,86,84,57,227,3,66.7
1453,3/18/2018 12:05,83,90,63,236,3,66.7
1454,3/18/2018 12:10,81,98,59,238,3,66.7
1455,3/18/2018 12:15,86,97,69,252,3,66.7
1456,3/18/2018 12:20,91,103,71,265,3,66.7
1457,3/18/2018 12:25,86,99,52,237,3,66.7
1458,3/18/2018 12:30,92,109,70,271,3,66.7
1459,3/18/2018 12:35,94,94,71,259,3,66.7
1460,3/18/2018 12:40,92,97,65,254,3,66.7
1461,3/18/2018 12:45,92,97,73,262,3,66.7
1462,3/18/2018 12:50,85,103,69,257,3,66.7
1463,3/18/2018 12:55,84,104,69,257,3,66.7
1464,3/18/2018 13:00,97,90,69,256,3,66.7
1465,3/18/2018 13:05,80,93,66,239,3,66.7
1466,3/18/2018 13:10,90,87,54,231,3,66.7
1467,3/18/2018 13:15,96,94,59,249,3,66.7
1468,3/18/2018 13:20,88,95,72,255,3,66.7
1469,3/18/2018 13:25,100,100,65,265,3,66.7
1470,3/18/2018 13:30,92,91,66,249,3,66.7
1471,3/18/2018 13:35,92,86,61,239,3,66.7
1472,3/18/2018 13:40,110,105,74,289,3,66.7
1473,3/18/2018 13:45,110,100,70,280,3,66.7
1474,3/18/2018 13:50,101,77,61,239,3,66.7
1475,3/18/2018 13:55,91,97,66,254,3,66.7
1476,3/18/2018 14:00,87,91,69,247,3,66.7
1477,3/18/2018 14:05,92,88,71,251,3,66.7
1478,3/18/2018 14:10,92,82,68,242,3,66.7
1479,3/18/2018 14:15,104,114,84,302,3,66.7
1480,3/18/2018 14:20,87,93,62,242,3,66.7
1481,3/18/2018 14:25,87,93,72,252,3,66.7
1482,3/18/2018 14:30,95,85,74,254,3,66.7
1483,3/18/2018 14:35,100,93,63,256,3,66.7
1484,3/18/2018 14:40,95,95,60,250,3,66.7
1485,3/18/2018 14:45,93,104,66,263,3,66.7
1486,3/18/2018 14:50,86,107,81,274,3,66.7
1487,3/18/2018 14:55,91,100,58,249,3,66.7
1488,3/18/2018 15:00,109,108,67,284,3,66.7
1489,3/18/2018 15:05,94,107,67,268,3,66.7
1490,3/18/2018 15:10,84,80,64,228,3,66.7
1491,3/18/2018 15:15,105,99,66,270,3,66.7
1492,3/18/2018 15:20,84,89,60,233,3,66.7
1493,3/18/2018 15:25,94,104,73,271,3,66.7
1494,3/18/2018 15:30,91,94,69,254,3,66.7
1495,3/18/2018 15:35,90,106,65,261,3,66.7
1496,3/18/2018 15:40,100,96,66,262,3,66.7
1497,3/18/2018 15:45,90,99,74,263,3,66.7
1498,3/18/2018 15:50,93,102,82,277,3,66.7
1499,3/18/2018 15:55,89,92,82,263,3,66.7
1500,3/18/2018 16:00,88,98,68,254,3,66.7
1501,3/18/2018 16:05,89,97,64,250,3,66.7
1502,3/18/2018 16:10,88,95,61,244,3,66.7
1503,3/18/2018 16:15,80,100,69,249,3,66.7
1504,3/18/2018 16:20,93,89,64,246,3,66.7
1505,3/18/2018 16:25,97,108,81,286,3,66.7
1506,3/18/2018 16:30,90,106,66,262,3,66.7
1507,3/18/2018 16:35,92,105,74,271,3,66.7
1508,3/18/2018 16:40,101,102,74,277,3,66.7
1509,3/18/2018 16:45,96,95,67,258,3,66.7
1510,3/18/2018 16:50,95,106,69,270,3,66.7
1511,3/18/2018 16:55,91,107,76,274,3,66.7
1512,3/18/2018 17:00,93,98,66,257,3,66.7
1513,3/18/2018 17:05,100,101,78,279,3,66.7
1514,3/18/2018 17:10,94,114,86,294,3,66.7
1515,3/18/2018 17:15,103,99,73,275,3,66.7
1516,3/18/2018 17:20,97,116,80,293,3,66.7
1517,3/18/2018 17:25,89,101,66,256,3,66.7
1518,3/18/2018 17:30,86,99,71,256,3,66.7
1519,3/18/2018 17:35,90,100,68,258,3,66.7
1520,3/18/2018 17:40,95,121,82,298,3,66.7
1521,3/18/2018 17:45,91,96,64,251,3,66.7
1522,3/18/2018 17:50,94,108,70,272,3,66.7
1523,3/18/2018 17:55,93,100,70,263,3,66.7
1524,3/18/2018 18:00,89,107,78,274,3,66.7
1525,3/18/2018 18:05,82,97,82,261,3,66.7
1526,3/18/2018 18:10,91,109,77,277,3,66.7
1527,3/18/2018 18:15,94,116,68,278,3,66.7
1528,3/18/2018 18:20,88,99,65,252,3,66.7
1529,3/18/2018 18:25,93,91,73,257,3,66.7
1530,3/18/2018 18:30,82,91,69,242,3,66.7
1531,3/18/2018 18:35,86,94,62,242,3,66.7
1532,3/18/2018 18:40,79,90,67,236,3,66.7
1533,3/18/2018 18:45,83,92,60,235,3,66.7
1534,3/18/2018 18:50,86,95,68,249,3,66.7
1535,3/18/2018 18:55,92,89,69,250,3,66.7
1536,3/18/2018 19:00,90,108,70,268,3,66.7
1537,3/18/2018 19:05,92,94,70,256,3,66.7
1538,3/18/2018 19:10,82,87,58,227,3,66.7
1539,3/18/2018 19:15,83,94,73,250,3,66.7
1540,3/18/2018 19:20,81,97,53,231,3,66.7
1541,3/18/2018 19:25,77,99,58,234,3,66.7
1542,3/18/2018 19:30,83,103,63,249,3,66.7
1543,3/18/2018 19:35,84,98,66,248,3,66.7
1544,3/18/2018 19:40,80,97,59,236,3,66.7
1545,3/18/2018 19:45,84,106,71,261,3,66.7
1546,3/18/2018 19:50,84,94,66,244,3,66.7
1547,3/18/2018 19:55,83,95,65,243,3,66.7
1548,3/18/2018 20:00,73,90,62,225,3,66.7
1549,3/18/2018 20:05,79,103,59,241,3,66.7
1550,3/18/2018 20:10,78,79,56,213,3,66.7
1551,3/18/2018 20:15,84,101,58,243,3,66.7
1552,3/18/2018 20:20,77,92,53,222,3,66.7
1553,3/18/2018 20:25,75,92,53,220,3,66.7
1554,3/18/2018 20:30,75,86,49,210,3,66.7
1555,3/18/2018 20:35,84,98,68,250,3,66.7
1556,3/18/2018 20:40,75,88,53,216,3,66.7
1557,3/18/2018 20:45,73,80,39,192,3,66.7
1558,3/18/2018 20:50,85,100,53,238,3,66.7
1559,3/18/2018 20:55,71,85,53,209,3,66.7
1560,3/18/2018 21:00,80,93,69,242,3,66.7
1561,3/18/2018 21:05,77,92,58,227,3,66.7
1562,3/18/2018 21:10,71,88,45,204,3,66.7
1563,3/18/2018 21:15,76,83,58,217,3,66.7
1564,3/18/2018 21:20,82,92,61,235,3,66.7
1565,3/18/2018 21:25,70,69,51,190,3,66.7
1566,3/18/2018 21:30,84,108,53,245,3,66.7
1567,3/18/2018 21:35,70,98,52,220,3,66.7
1568,3/18/2018 21:40,81,81,57,219,3,66.7
1569,3/18/2018 21:45,65,101,58,224,3,66.7
1570,3/18/2018 21:50,62,91,53,206,3,66.7
1571,3/18/2018 21:55,71,72,49,192,3,66.7
1572,3/18/2018 22:00,55,76,38,169,3,66.7
1573,3/18/2018 22:05,83,88,65,236,3,66.7
1574,3/18/2018 22:10,57,79,46,182,3,66.7
1575,3/18/2018 22:15,82,87,54,223,3,66.7
1576,3/18/2018 22:20,66,93,55,214,3,66.7
1577,3/18/2018 22:25,65,72,48,185,3,66.7
1578,3/18/2018 22:30,65,84,46,195,3,66.7
1579,3/18/2018 22:35,71,90,43,204,3,66.7
1580,3/18/2018 22:40,72,93,47,212,3,66.7
1581,3/18/2018 22:45,72,72,52,196,3,66.7
1582,3/18/2018 22:50,59,67,51,177,3,66.7
1583,3/18/2018 22:55,70,77,41,188,3,66.7
1584,3/18/2018 23:00,67,83,38,188,3,66.7
1585,3/18/2018 23:05,60,73,44,177,3,66.7
1586,3/18/2018 23:10,57,81,43,181,3,66.7
1587,3/18/2018 23:15,52,78,35,165,3,66.7
1588,3/18/2018 23:20,56,62,35,153,3,66.7
1589,3/18/2018 23:25,67,84,49,200,3,66.7
1590,3/18/2018 23:30,58,83,42,183,3,66.7
1591,3/18/2018 23:35,56,66,36,158,3,66.7
1592,3/18/2018 23:40,52,76,47,175,3,66.7
1593,3/18/2018 23:45,64,79,41,184,3,66.7
1594,3/18/2018 23:50,56,66,38,160,3,66.7
1595,3/18/2018 23:55,46,61,30,137,3,66.7
1596,3/19/2018 0:00,55,69,31,155,3,66.7
1597,3/19/2018 0:05,54,56,28,138,3,66.7
1598,3/19/2018 0:10,50,70,34,154,3,66.7
1599,3/19/2018 0:15,48,54,34,136,3,66.7
1600,3/19/2018 0:20,38,60,31,129,3,66.7
1601,3/19/2018 0:25,48,55,31,134,3,66.7
1602,3/19/2018 0:30,43,54,26,123,3,66.7
1603,3/19/2018 0:35,36,50,23,109,3,66.7
1604,3/19/2018 0:40,45,55,23,123,3,66.7
1605,3/19/2018 0:45,43,50,29,122,3,66.7
1606,3/19/2018 0:50,42,49,28,119,3,66.7
1607,3/19/2018 0:55,37,39,22,98,3,66.7
1608,3/19/2018 1:00,33,36,24,93,3,66.7
1609,3/19/2018 1:05,39,41,23,103,3,66.7
1610,3/19/2018 1:10,33,45,26,104,3,66.7
1611,3/19/2018 1:15,33,36,13,82,3,66.7
1612,3/19/2018 1:20,33,36,15,84,3,66.7
1613,3/19/2018 1:25,31,33,19,83,3,66.7
1614,3/19/2018 1:30,36,43,24,103,3,66.7
1615,3/19/2018 1:35,29,32,16,77,3,66.7
1616,3/19/2018 1:40,32,39,19,90,3,66.7
1617,3/19/2018 1:45,32,36,18,86,3,66.7
1618,3/19/2018 1:50,34,39,16,89,3,66.7
1619,3/19/2018 1:55,33,34,21,88,3,66.7
1620,3/19/2018 2:00,31,31,12,74,3,66.7
1621,3/19/2018 2:05,28,30,18,76,3,66.7
1622,3/19/2018 2:10,18,11,10,39,3,66.7
1623,3/19/2018 2:15,24,29,11,64,3,66.7
1624,3/19/2018 2:20,25,24,19,68,3,66.7
1625,3/19/2018 2:25,20,23,13,56,3,66.7
1626,3/19/2018 2:30,20,17,7,44,3,66.7
1627,3/19/2018 2:35,21,22,11,54,3,66.7
1628,3/19/2018 2:40,21,16,11,48,3,66.7
1629,3/19/2018 2:45,23,16,12,51,3,66.7
1630,3/19/2018 2:50,24,28,12,64,3,66.7
1631,3/19/2018 2:55,18,20,9,47,3,66.7
1632,3/19/2018 3:00,24,27,12,63,3,66.7
1633,3/19/2018 3:05,22,19,12,53,3,66.7
1634,3/19/2018 3:10,19,15,8,42,3,66.7
1635,3/19/2018 3:15,22,21,13,56,3,66.7
1636,3/19/2018 3:20,15,11,11,37,3,66.7
1637,3/19/2018 3:25,23,19,13,55,3,66.7
1638,3/19/2018 3:30,20,16,9,45,3,66.7
1639,3/19/2018 3:35,22,21,8,51,3,66.7
1640,3/19/2018 3:40,23,25,9,57,3,66.7
1641,3/19/2018 3:45,25,26,14,65,3,66.7
1642,3/19/2018 3:50,25,22,15,62,3,66.7
1643,3/19/2018 3:55,23,15,11,49,3,66.7
1644,3/19/2018 4:00,27,14,19,60,3,66.7
1645,3/19/2018 4:05,27,27,18,72,3,66.7
1646,3/19/2018 4:10,27,25,9,61,3,66.7
1647,3/19/2018 4:15,30,28,12,70,3,66.7
1648,3/19/2018 4:20,33,36,19,88,3,66.7
1649,3/19/2018 4:25,26,27,14,67,3,66.7
1650,3/19/2018 4:30,25,28,16,69,3,66.7
1651,3/19/2018 4:35,34,33,17,84,3,66.7
1652,3/19/2018 4:40,33,38,15,86,3,66.7
1653,3/19/2018 4:45,36,31,21,88,3,66.7
1654,3/19/2018 4:50,39,37,21,97,3,66.7
1655,3/19/2018 4:55,41,41,21,103,3,66.7
1656,3/19/2018 5:00,41,47,21,109,3,66.7
1657,3/19/2018 5:05,45,48,23,116,3,66.7
1658,3/19/2018 5:10,47,47,22,116,3,66.7
1659,3/19/2018 5:15,51,53,27,131,3,66.7
1660,3/19/2018 5:20,48,41,23,112,3,66.7
1661,3/19/2018 5:25,58,61,26,145,3,66.7
1662,3/19/2018 5:30,54,58,26,138,3,66.7
1663,3/19/2018 5:35,56,56,25,137,3,66.7
1664,3/19/2018 5:40,60,62,24,146,3,66.7
1665,3/19/2018 5:45,56,58,25,139,3,66.7
1666,3/19/2018 5:50,57,51,31,139,3,66.7
1667,3/19/2018 5:55,52,56,34,142,3,66.7
1668,3/19/2018 6:00,55,56,27,138,3,66.7
1669,3/19/2018 6:05,60,66,33,159,3,66.7
1670,3/19/2018 6:10,61,62,45,168,3,66.7
1671,3/19/2018 6:15,72,74,45,191,3,66.7
1672,3/19/2018 6:20,74,78,41,193,3,66.7
1673,3/19/2018 6:25,71,71,42,184,3,66.7
1674,3/19/2018 6:30,76,78,40,194,3,66.7
1675,3/19/2018 6:35,75,68,40,183,3,66.7
1676,3/19/2018 6:40,85,89,78,252,3,0.0
1677,3/19/2018 6:45,90,93,82,265,3,0.0
1678,3/19/2018 6:50,86,90,79,255,3,0.0
1679,3/19/2018 6:55,78,82,73,233,3,0.0
1680,3/19/2018 7:00,80,85,75,240,3,0.0
1681,3/19/2018 7:05,87,91,80,258,3,0.0
1682,3/19/2018 7:10,71,77,53,201,3,66.7
1683,3/19/2018 7:15,71,93,40,204,3,66.7
1684,3/19/2018 7:20,78,83,73,234,3,0.0
1685,3/19/2018 7:25,85,89,78,252,3,0.0
1686,3/19/2018 7:30,93,95,84,272,3,0.0
1687,3/19/2018 7:35,89,93,82,264,3,0.0
1688,3/19/2018 7:40,98,100,87,285,3,0.0
1689,3/19/2018 7:45,100,102,90,292,3,0.0
1690,3/19/2018 7:50,87,91,80,258,3,0.0
1691,3/19/2018 7:55,90,93,82,265,3,0.0
1692,3/19/2018 8:00,91,93,82,266,3,0.0
1693,3/19/2018 8:05,97,100,88,285,3,0.0
1694,3/19/2018 8:10,98,101,88,287,3,0.0
1695,3/19/2018 8:15,99,101,89,289,3,0.0
1696,3/19/2018 8:20,92,95,84,271,3,0.0
1697,3/19/2018 8:25,102,104,91,297,3,0.0
1698,3/19/2018 8:30,102,105,92,299,3,0.0
1699,3/19/2018 8:35,88,92,81,261,3,0.0
1700,3/19/2018 8:40,100,55,35,190,3,66.7
1701,3/19/2018 8:45,91,93,55,239,3,66.7
1702,3/19/2018 8:50,101,104,57,262,3,66.7
1703,3/19/2018 8:55,98,99,72,269,3,66.7
1704,3/19/2018 9:00,78,81,39,198,3,66.7
1705,3/19/2018 9:05,78,82,45,205,3,66.7
1706,3/19/2018 9:10,86,81,52,219,3,66.7
1707,3/19/2018 9:15,74,80,45,199,3,66.7
1708,3/19/2018 9:20,84,79,47,210,3,66.7
1709,3/19/2018 9:25,86,93,59,238,3,66.7
1710,3/19/2018 9:30,67,78,56,201,3,66.7
1711,3/19/2018 9:35,83,102,62,247,3,66.7
1712,3/19/2018 9:40,79,89,48,216,3,66.7
1713,3/19/2018 9:45,77,88,56,221,3,66.7
1714,3/19/2018 9:50,83,106,59,248,3,66.7
1715,3/19/2018 9:55,84,83,56,223,3,66.7
1716,3/19/2018 10:00,80,91,51,222,3,66.7
1717,3/19/2018 10:05,74,103,62,239,3,66.7
1718,3/19/2018 10:10,74,96,65,235,3,66.7
1719,3/19/2018 10:15,75,90,60,225,3,66.7
1720,3/19/2018 10:20,77,108,54,239,3,66.7
1721,3/19/2018 10:25,84,86,49,219,3,66.7
1722,3/19/2018 10:30,86,92,59,237,3,66.7
1723,3/19/2018 10:35,84,88,62,234,3,66.7
1724,3/19/2018 10:40,82,102,54,238,3,66.7
1725,3/19/2018 10:45,85,84,59,228,3,66.7
1726,3/19/2018 10:50,76,83,52,211,3,66.7
1727,3/19/2018 10:55,85,93,62,240,3,66.7
1728,3/19/2018 11:00,84,88,57,229,3,66.7
1729,3/19/2018 11:05,86,81,46,213,3,66.7
1730,3/19/2018 11:10,93,81,67,241,3,66.7
1731,3/19/2018 11:15,91,103,57,251,3,66.7
1732,3/19/2018 11:20,93,96,56,245,3,66.7
1733,3/19/2018 11:25,97,102,61,260,3,66.7
1734,3/19/2018 11:30,89,105,64,258,3,66.7
1735,3/19/2018 11:35,89,94,49,232,3,66.7
1736,3/19/2018 11:40,94,103,63,260,3,66.7
1737,3/19/2018 11:45,82,93,77,252,3,66.7
1738,3/19/2018 11:50,94,101,66,261,3,66.7
1739,3/19/2018 11:55,84,92,56,232,3,66.7
0,3/19/2018 11:00,84,88,57,229,3,66.7
1,3/19/2018 11:05,86,81,46,213,3,66.7
2,3/19/2018 11:10,93,81,67,241,3,66.7
3,3/19/2018 11:15,91,103,57,251,3,66.7
4,3/19/2018 11:20,93,96,56,245,3,66.7
5,3/19/2018 11:25,97,102,61,260,3,66.7
6,3/19/2018 11:30,89,105,64,258,3,66.7
7,3/19/2018 11:35,89,94,49,232,3,66.7
8,3/19/2018 11:40,94,103,63,260,3,66.7
9,3/19/2018 11:45,82,93,77,252,3,66.7
10,3/19/2018 11:50,94,101,66,261,3,66.7
11,3/19/2018 11:55,84,92,56,232,3,66.7
12,3/19/2018 12:00,92,103,70,265,3,66.7
13,3/19/2018 12:05,89,91,54,234,3,66.7
14,3/19/2018 12:10,102,85,49,236,3,66.7
15,3/19/2018 12:15,86,90,54,230,3,66.7
16,3/19/2018 12:20,95,97,71,263,3,66.7
17,3/19/2018 12:25,102,106,78,286,3,66.7
18,3/19/2018 12:30,107,132,74,313,3,66.7
19,3/19/2018 12:35,92,100,65,257,3,66.7
20,3/19/2018 12:40,95,88,63,246,3,66.7
21,3/19/2018 12:45,88,79,70,237,3,66.7
22,3/19/2018 12:50,86,72,55,213,3,66.7
23,3/19/2018 12:55,102,100,67,269,3,66.7
24,3/19/2018 13:00,87,86,65,238,3,66.7
25,3/19/2018 13:05,96,94,53,243,3,66.7
26,3/19/2018 13:10,95,93,60,248,3,66.7
27,3/19/2018 13:15,92,87,75,254,3,66.7
28,3/19/2018 13:20,95,94,67,256,3,66.7
29,3/19/2018 13:25,97,88,71,256,3,66.7
30,3/19/2018 13:30,96,90,56,242,3,66.7
31,3/19/2018 13:35,92,97,54,243,3,66.7
32,3/19/2018 13:40,81,83,62,226,3,66.7
33,3/19/2018 13:45,97,103,68,268,3,66.7
34,3/19/2018 13:50,92,97,70,259,3,66.7
35,3/19/2018 13:55,106,91,79,276,3,66.7
36,3/19/2018 14:00,91,110,75,276,3,66.7
37,3/19/2018 14:05,94,88,69,251,3,66.7
38,3/19/2018 14:10,107,113,75,295,3,66.7
39,3/19/2018 14:15,96,99,64,259,3,66.7
40,3/19/2018 14:20,96,90,64,250,3,66.7
41,3/19/2018 14:25,96,89,68,253,3,66.7
42,3/19/2018 14:30,99,97,66,262,3,66.7
43,3/19/2018 14:35,88,90,66,244,3,66.7
44,3/19/2018 14:40,103,108,69,280,3,66.7
45,3/19/2018 14:45,107,98,68,273,3,66.7
46,3/19/2018 14:50,101,99,63,263,3,66.7
47,3/19/2018 14:55,91,93,70,254,3,66.7
48,3/19/2018 15:00,108,97,80,285,3,66.7
49,3/19/2018 15:05,84,90,69,243,3,66.7
50,3/19/2018 15:10,101,87,66,254,3,66.7
51,3/19/2018 15:15,88,92,57,237,3,66.7
52,3/19/2018 15:20,87,94,71,252,3,66.7
53,3/19/2018 15:25,105,108,69,282,3,66.7
54,3/19/2018 15:30,95,79,88,262,3,66.7
55,3/19/2018 15:35,106,94,79,279,3,66.7
56,3/19/2018 15:40,102,88,70,260,3,66.7
57,3/19/2018 15:45,103,77,75,255,3,66.7
58,3/19/2018 15:50,97,83,72,252,3,66.7
59,3/19/2018 15:55,92,79,61,232,3,66.7
60,3/19/2018 16:00,100,72,62,234,3,66.7
61,3/19/2018 16:05,94,70,59,223,3,66.7
62,3/19/2018 16:10,99,61,50,210,3,66.7
63,3/19/2018 16:15,96,64,57,217,3,66.7
64,3/19/2018 16:20,99,73,60,232,3,66.7
65,3/19/2018 16:25,81,74,71,226,3,66.7
66,3/19/2018 16:30,92,64,56,212,3,66.7
67,3/19/2018 16:35,96,86,69,251,3,66.7
68,3/19/2018 16:40,97,62,70,229,3,66.7
69,3/19/2018 16:45,96,72,74,242,3,66.7
70,3/19/2018 16:50,88,88,75,251,3,66.7
71,3/19/2018 16:55,91,69,77,237,3,66.7
72,3/19/2018 17:00,90,53,57,200,3,66.7
73,3/19/2018 17:05,101,61,53,215,3,66.7
74,3/19/2018 17:10,99,72,64,235,3,66.7
75,3/19/2018 17:15,92,73,68,233,3,66.7
76,3/19/2018 17:20,102,80,74,256,3,66.7
77,3/19/2018 17:25,91,93,91,275,3,66.7
78,3/19/2018 17:30,89,78,80,247,3,66.7
79,3/19/2018 17:35,79,72,57,208,3,66.7
80,3/19/2018 17:40,81,99,65,245,3,66.7
81,3/19/2018 17:45,88,77,85,250,3,66.7
82,3/19/2018 17:50,95,67,67,229,3,66.7
83,3/19/2018 17:55,88,75,66,229,3,66.7
84,3/19/2018 18:00,89,59,78,226,3,66.7
85,3/19/2018 18:05,88,53,67,208,3,66.7
86,3/19/2018 18:10,95,68,62,225,3,66.7
87,3/19/2018 18:15,84,78,73,235,3,66.7
88,3/19/2018 18:20,97,81,73,251,3,66.7
89,3/19/2018 18:25,97,99,50,246,3,66.7
90,3/19/2018 18:30,92,71,48,211,3,66.7
91,3/19/2018 18:35,97,70,42,209,3,66.7
92,3/19/2018 18:40,92,81,51,224,3,66.7
93,3/19/2018 18:45,91,85,55,231,3,66.7
94,3/19/2018 18:50,97,90,56,243,3,66.7
95,3/19/2018 18:55,101,92,53,246,3,66.7
96,3/19/2018 19:00,105,108,63,276,3,66.7
97,3/19/2018 19:05,103,103,66,272,3,66.7
98,3/19/2018 19:10,94,106,64,264,3,66.7
99,3/19/2018 19:15,86,98,58,242,3,66.7
100,3/19/2018 19:20,89,88,59,236,3,66.7
101,3/19/2018 19:25,87,90,63,240,3,66.7
102,3/19/2018 19:30,91,92,68,251,3,66.7
103,3/19/2018 19:35,89,90,68,247,3,66.7
104,3/19/2018 19:40,90,93,62,245,3,66.7
105,3/19/2018 19:45,88,108,62,258,3,66.7
106,3/19/2018 19:50,86,97,61,244,3,66.7
107,3/19/2018 19:55,94,103,72,269,3,66.7
108,3/19/2018 20:00,80,101,62,243,3,66.7
109,3/19/2018 20:05,87,101,68,256,3,66.7
110,3/19/2018 20:10,80,110,64,254,3,66.7
111,3/19/2018 20:15,84,101,65,250,3,66.7
112,3/19/2018 20:20,82,90,63,235,3,66.7
113,3/19/2018 20:25,89,90,70,249,3,66.7
114,3/19/2018 20:30,90,98,51,239,3,66.7
115,3/19/2018 20:35,85,115,69,269,3,66.7
116,3/19/2018 20:40,89,95,65,249,3,66.7
117,3/19/2018 20:45,85,102,70,257,3,66.7
118,3/19/2018 20:50,72,87,60,219,3,66.7
119,3/19/2018 20:55,77,103,67,247,3,66.7
120,3/19/2018 21:00,71,80,50,201,3,66.7
121,3/19/2018 21:05,70,100,60,230,3,66.7
122,3/19/2018 21:10,79,101,59,239,3,66.7
123,3/19/2018 21:15,72,88,61,221,3,66.7
124,3/19/2018 21:20,74,101,53,228,3,66.7
125,3/19/2018 21:25,80,99,55,234,3,66.7
126,3/19/2018 21:30,76,95,55,226,3,66.7
127,3/19/2018 21:35,72,79,51,202,3,66.7
128,3/19/2018 21:40,76,101,67,244,3,66.7
129,3/19/2018 21:45,82,90,48,220,3,66.7
130,3/19/2018 21:50,74,98,57,229,3,66.7
131,3/19/2018 21:55,62,85,54,201,3,66.7
132,3/19/2018 22:00,61,78,47,186,3,66.7
133,3/19/2018 22:05,72,96,51,219,3,66.7
134,3/19/2018 22:10,83,79,49,211,3,66.7
135,3/19/2018 22:15,76,100,60,236,3,66.7
136,3/19/2018 22:20,74,101,63,238,3,66.7
137,3/19/2018 22:25,75,76,55,206,3,66.7
138,3/19/2018 22:30,66,83,48,197,3,66.7
139,3/19/2018 22:35,68,78,43,189,3,66.7
140,3/19/2018 22:40,67,86,61,214,3,66.7
141,3/19/2018 22:45,64,89,53,206,3,66.7
142,3/19/2018 22:50,64,84,43,191,3,66.7
143,3/19/2018 22:55,46,71,50,167,3,66.7
144,3/19/2018 23:00,50,50,29,129,3,66.7
145,3/19/2018 23:05,43,56,28,127,3,66.7
146,3/19/2018 23:10,45,56,28,129,3,66.7
147,3/19/2018 23:15,46,51,28,125,3,66.7
148,3/19/2018 23:20,46,56,31,133,3,66.7
149,3/19/2018 23:25,46,68,33,147,3,66.7
150,3/19/2018 23:30,47,59,35,141,3,66.7
151,3/19/2018 23:35,42,61,40,143,3,66.7
152,3/19/2018 23:40,49,55,32,136,3,66.7
153,3/19/2018 23:45,49,63,38,150,3,66.7
154,3/19/2018 23:50,44,42,23,109,3,66.7
155,3/19/2018 23:55,46,54,34,134,3,66.7
156,3/20/2018 0:00,40,49,27,116,3,66.7
157,3/20/2018 0:05,45,54,29,128,3,66.7
158,3/20/2018 0:10,47,61,22,130,3,66.7
159,3/20/2018 0:15,45,56,29,130,3,66.7
160,3/20/2018 0:20,35,42,25,102,3,66.7
161,3/20/2018 0:25,39,36,21,96,3,66.7
162,3/20/2018 0:30,39,50,26,115,3,66.7
163,3/20/2018 0:35,36,42,19,97,3,66.7
164,3/20/2018 0:40,42,51,31,124,3,66.7
165,3/20/2018 0:45,41,54,31,126,3,66.7
166,3/20/2018 0:50,40,56,24,120,3,66.7
167,3/20/2018 0:55,30,35,18,83,3,66.7
168,3/20/2018 1:00,37,48,24,109,3,66.7
169,3/20/2018 1:05,35,39,18,92,3,66.7
170,3/20/2018 1:10,41,51,32,124,3,66.7
171,3/20/2018 1:15,39,44,23,106,3,66.7
172,3/20/2018 1:20,30,45,15,90,3,66.7
173,3/20/2018 1:25,33,32,21,86,3,66.7
174,3/20/2018 1:30,37,40,21,98,3,66.7
175,3/20/2018 1:35,34,34,13,81,3,66.7
176,3/20/2018 1:40,38,39,21,98,3,66.7
177,3/20/2018 1:45,36,38,17,91,3,66.7
178,3/20/2018 1:50,33,41,19,93,3,66.7
179,3/20/2018 1:55,29,30,13,72,3,66.7
180,3/20/2018 2:00,25,31,20,76,3,66.7
181,3/20/2018 2:05,23,28,11,62,3,66.7
182,3/20/2018 2:10,28,32,16,76,3,66.7
183,3/20/2018 2:15,25,24,17,66,3,66.7
184,3/20/2018 2:20,25,20,15,60,3,66.7
185,3/20/2018 2:25,33,25,15,73,3,66.7
186,3/20/2018 2:30,23,28,10,61,3,66.7
187,3/20/2018 2:35,23,22,7,52,3,66.7
188,3/20/2018 2:40,23,37,12,72,3,66.7
189,3/20/2018 2:45,25,22,17,64,3,66.7
190,3/20/2018 2:50,25,18,14,57,3,66.7
191,3/20/2018 2:55,29,33,14,76,3,66.7
192,3/20/2018 3:00,27,31,9,67,3,66.7
193,3/20/2018 3:05,25,33,14,72,3,66.7
194,3/20/2018 3:10,28,24,10,62,3,66.7
195,3/20/2018 3:15,28,28,10,66,3,66.7
196,3/20/2018 3:20,24,22,10,56,3,66.7
197,3/20/2018 3:25,19,19,11,49,3,66.7
198,3/20/2018 3:30,24,18,10,52,3,66.7
199,3/20/2018 3:35,26,23,13,62,3,66.7
200,3/20/2018 3:40,25,21,16,62,3,66.7
201,3/20/2018 3:45,24,24,16,64,3,66.7
202,3/20/2018 3:50,30,23,13,66,3,66.7
203,3/20/2018 3:55,23,26,18,67,3,66.7
204,3/20/2018 4:00,27,18,20,65,3,66.7
205,3/20/2018 4:05,25,30,14,69,3,66.7
206,3/20/2018 4:10,24,30,16,70,3,66.7
207,3/20/2018 4:15,35,22,24,81,3,66.7
208,3/20/2018 4:20,31,34,16,81,3,66.7
209,3/20/2018 4:25,30,30,22,82,3,66.7
210,3/20/2018 4:30,34,35,22,91,3,66.7
211,3/20/2018 4:35,40,42,12,94,3,66.7
212,3/20/2018 4:40,40,43,21,104,3,66.7
213,3/20/2018 4:45,45,45,26,116,3,66.7
214,3/20/2018 4:50,47,54,24,125,3,66.7
215,3/20/2018 4:55,35,38,18,91,3,66.7
216,3/20/2018 5:00,36,38,16,90,3,66.7
217,3/20/2018 5:05,43,52,17,112,3,66.7
218,3/20/2018 5:10,48,50,28,126,3,66.7
219,3/20/2018 5:15,52,50,32,134,3,66.7
220,3/20/2018 5:20,47,53,27,127,3,66.7
221,3/20/2018 5:25,63,60,27,150,3,66.7
222,3/20/2018 5:30,45,47,23,115,3,66.7
223,3/20/2018 5:35,65,61,37,163,3,66.7
224,3/20/2018 5:40,59,58,30,147,3,66.7
225,3/20/2018 5:45,67,68,32,167,3,66.7
226,3/20/2018 5:50,50,57,31,138,3,66.7
227,3/20/2018 5:55,55,61,29,145,3,66.7
228,3/20/2018 6:00,60,56,29,145,3,66.7
229,3/20/2018 6:05,64,63,36,163,3,66.7
230,3/20/2018 6:10,72,73,34,179,3,66.7
231,3/20/2018 6:15,69,94,49,212,3,66.7
232,3/20/2018 6:20,64,84,38,186,3,66.7
233,3/20/2018 6:25,86,90,41,217,3,66.7
234,3/20/2018 6:30,70,75,43,188,3,66.7
235,3/20/2018 6:35,90,93,44,227,3,66.7
236,3/20/2018 6:40,78,86,53,217,3,66.7
237,3/20/2018 6:45,84,98,70,252,3,66.7
238,3/20/2018 6:50,84,86,62,232,3,66.7
239,3/20/2018 6:55,74,97,59,230,3,66.7
240,3/20/2018 7:00,100,91,69,260,3,66.7
241,3/20/2018 7:05,75,111,64,250,3,66.7
242,3/20/2018 7:10,72,101,68,241,3,66.7
243,3/20/2018 7:15,71,94,52,217,3,66.7
244,3/20/2018 7:20,86,110,65,261,3,66.7
245,3/20/2018 7:25,90,108,68,266,3,66.7
246,3/20/2018 7:30,96,108,69,273,3,66.7
247,3/20/2018 7:35,105,113,81,299,3,66.7
248,3/20/2018 7:40,88,99,72,259,3,66.7
249,3/20/2018 7:45,90,105,75,270,3,66.7
250,3/20/2018 7:50,80,102,58,240,3,66.7
251,3/20/2018 7:55,96,113,65,274,3,66.7
252,3/20/2018 8:00,95,94,54,243,3,66.7
253,3/20/2018 8:05,87,93,60,240,3,66.7
254,3/20/2018 8:10,93,100,66,259,3,66.7
255,3/20/2018 8:15,85,83,59,227,3,66.7
256,3/20/2018 8:20,112,106,53,271,3,66.7
257,3/20/2018 8:25,84,90,65,239,3,66.7
258,3/20/2018 8:30,86,95,52,233,3,66.7
259,3/20/2018 8:35,89,87,50,226,3,66.7
260,3/20/2018 8:40,88,113,56,257,3,66.7
261,3/20/2018 8:45,100,105,72,277,3,66.7
262,3/20/2018 8:50,92,87,67,246,3,66.7
263,3/20/2018 8:55,93,108,64,265,3,66.7
264,3/20/2018 9:00,91,92,49,232,3,66.7
265,3/20/2018 9:05,83,96,50,229,3,66.7
266,3/20/2018 9:10,83,102,54,239,3,66.7
267,3/20/2018 9:15,94,99,60,253,3,66.7
268,3/20/2018 9:20,78,101,51,230,3,66.7
269,3/20/2018 9:25,92,106,56,254,3,66.7
270,3/20/2018 9:30,80,104,61,245,3,66.7
271,3/20/2018 9:35,83,69,52,204,3,66.7
272,3/20/2018 9:40,81,87,58,226,3,66.7
273,3/20/2018 9:45,91,102,56,249,3,66.7
274,3/20/2018 9:50,81,94,57,232,3,66.7
275,3/20/2018 9:55,68,68,40,176,3,66.7
276,3/20/2018 10:00,89,97,53,239,3,66.7
277,3/20/2018 10:05,86,85,54,225,3,66.7
278,3/20/2018 10:10,82,105,73,260,3,66.7
279,3/20/2018 10:15,76,101,55,232,3,66.7
280,3/20/2018 10:20,92,99,59,250,3,66.7
281,3/20/2018 10:25,81,101,62,244,3,66.7
282,3/20/2018 10:30,72,85,58,215,3,66.7
283,3/20/2018 10:35,76,100,46,222,3,66.7
284,3/20/2018 10:40,86,104,61,251,3,66.7
285,3/20/2018 10:45,80,89,54,223,3,66.7
286,3/20/2018 10:50,87,102,68,257,3,66.7
287,3/20/2018 10:55,79,86,50,215,3,66.7
288,3/20/2018 11:00,85,102,60,247,3,66.7
289,3/20/2018 11:05,97,104,69,270,3,66.7
290,3/20/2018 11:10,88,98,57,243,3,66.7
291,3/20/2018 11:15,85,94,50,229,3,66.7
292,3/20/2018 11:20,111,95,64,270,3,66.7
293,3/20/2018 11:25,94,103,62,259,3,66.7
294,3/20/2018 11:30,97,98,62,257,3,66.7
295,3/20/2018 11:35,96,110,61,267,3,66.7
296,3/20/2018 11:40,97,94,68,259,3,66.7
297,3/20/2018 11:45,93,90,58,241,3,66.7
298,3/20/2018 11:50,90,90,53,233,3,66.7
299,3/20/2018 11:55,85,96,67,248,3,66.7
300,3/20/2018 12:00,89,94,53,236,3,66.7
301,3/20/2018 12:05,93,101,59,253,3,66.7
302,3/20/2018 12:10,91,112,74,277,3,66.7
303,3/20/2018 12:15,84,104,68,256,3,66.7
304,3/20/2018 12:20,90,101,71,262,3,66.7
305,3/20/2018 12:25,96,92,61,249,3,66.7
306,3/20/2018 12:30,91,104,69,264,3,66.7
307,3/20/2018 12:35,82,110,74,266,3,66.7
308,3/20/2018 12:40,93,102,61,256,3,66.7
309,3/20/2018 12:45,100,108,83,291,3,66.7
310,3/20/2018 12:50,105,95,64,264,3,66.7
311,3/20/2018 12:55,92,99,70,261,3,66.7
312,3/20/2018 13:00,84,83,62,229,3,66.7
313,3/20/2018 13:05,97,98,68,263,3,66.7
314,3/20/2018 13:10,100,94,76,270,3,66.7
315,3/20/2018 13:15,99,101,62,262,3,66.7
316,3/20/2018 13:20,106,104,77,287,3,66.7
317,3/20/2018 13:25,98,107,57,262,3,66.7
318,3/20/2018 13:30,100,98,81,279,3,66.7
319,3/20/2018 13:35,101,106,63,270,3,66.7
320,3/20/2018 13:40,92,98,62,252,3,66.7
321,3/20/2018 13:45,103,107,64,274,3,66.7
322,3/20/2018 13:50,103,109,69,281,3,66.7
323,3/20/2018 13:55,99,103,71,273,3,66.7
324,3/20/2018 14:00,89,88,61,238,3,66.7
325,3/20/2018 14:05,96,96,72,264,3,66.7
326,3/20/2018 14:10,106,100,72,278,3,66.7
327,3/20/2018 14:15,98,87,70,255,3,66.7
328,3/20/2018 14:20,98,88,71,257,3,66.7
329,3/20/2018 14:25,92,82,71,245,3,66.7
330,3/20/2018 14:30,89,92,71,252,3,66.7
331,3/20/2018 14:35,94,81,71,246,3,66.7
332,3/20/2018 14:40,91,87,72,250,3,66.7
333,3/20/2018 14:45,90,98,62,250,3,66.7
334,3/20/2018 14:50,96,76,62,234,3,66.7
335,3/20/2018 14:55,87,79,72,238,3,66.7
336,3/20/2018 15:00,100,79,65,244,3,66.7
337,3/20/2018 15:05,86,83,85,254,3,66.7
338,3/20/2018 15:10,105,84,55,244,3,66.7
339,3/20/2018 15:15,91,80,70,241,3,66.7
340,3/20/2018 15:20,99,51,46,196,3,66.7
341,3/20/2018 15:25,85,89,85,259,3,66.7
342,3/20/2018 15:30,92,80,95,267,3,66.7
343,3/20/2018 15:35,75,63,60,198,3,66.7
344,3/20/2018 15:40,81,78,59,218,3,66.7
345,3/20/2018 15:45,96,86,71,253,3,66.7
346,3/20/2018 15:50,102,72,67,241,3,66.7
347,3/20/2018 15:55,99,62,61,222,3,66.7
348,3/20/2018 16:00,94,90,67,251,3,66.7
349,3/20/2018 16:05,96,67,53,216,3,66.7
350,3/20/2018 16:10,94,77,78,249,3,66.7
351,3/20/2018 16:15,106,81,75,262,3,66.7
352,3/20/2018 16:20,105,81,74,260,3,66.7
353,3/20/2018 16:25,91,65,67,223,3,66.7
354,3/20/2018 16:30,94,76,66,236,3,66.7
355,3/20/2018 16:35,102,80,74,256,3,66.7
356,3/20/2018 16:40,92,53,50,195,3,66.7
357,3/20/2018 16:45,98,73,61,232,3,66.7
358,3/20/2018 16:50,88,77,70,235,3,66.7
359,3/20/2018 16:55,85,61,54,200,3,66.7
360,3/20/2018 17:00,94,63,54,211,3,66.7
361,3/20/2018 17:05,82,59,50,191,3,66.7
362,3/20/2018 17:10,83,79,69,231,3,66.7
363,3/20/2018 17:15,84,68,51,203,3,66.7
364,3/20/2018 17:20,82,74,58,214,3,66.7
365,3/20/2018 17:25,84,69,75,228,3,66.7
366,3/20/2018 17:30,92,49,53,194,3,66.7
367,3/20/2018 17:35,87,96,76,259,3,66.7
368,3/20/2018 17:40,90,91,74,255,3,66.7
369,3/20/2018 17:45,99,91,60,250,3,66.7
370,3/20/2018 17:50,90,68,55,213,3,66.7
371,3/20/2018 17:55,104,67,64,235,3,66.7
372,3/20/2018 18:00,96,64,55,215,3,66.7
373,3/20/2018 18:05,96,86,58,240,3,66.7
374,3/20/2018 18:10,92,69,49,210,3,66.7
375,3/20/2018 18:15,89,54,48,191,3,66.7
376,3/20/2018 18:20,92,58,44,194,3,66.7
377,3/20/2018 18:25,83,61,70,214,3,66.7
378,3/20/2018 18:30,82,70,76,228,3,66.7
379,3/20/2018 18:35,94,63,61,218,3,66.7
380,3/20/2018 18:40,97,83,62,242,3,66.7
381,3/20/2018 18:45,93,82,68,243,3,66.7
382,3/20/2018 18:50,84,83,57,224,3,66.7
383,3/20/2018 18:55,93,88,76,257,3,66.7
384,3/20/2018 19:00,92,84,66,242,3,66.7
385,3/20/2018 19:05,89,101,67,257,3,66.7
386,3/20/2018 19:10,100,88,59,247,3,66.7
387,3/20/2018 19:15,82,87,60,229,3,66.7
388,3/20/2018 19:20,87,87,54,228,3,66.7
389,3/20/2018 19:25,86,74,57,217,3,66.7
390,3/20/2018 19:30,85,94,57,236,3,66.7
391,3/20/2018 19:35,88,92,50,230,3,66.7
392,3/20/2018 19:40,92,96,65,253,3,66.7
393,3/20/2018 19:45,86,87,67,240,3,66.7
394,3/20/2018 19:50,89,96,67,252,3,66.7
395,3/20/2018 19:55,78,88,58,224,3,66.7
396,3/20/2018 20:00,86,90,56,232,3,66.7
397,3/20/2018 20:05,95,108,61,264,3,66.7
398,3/20/2018 20:10,84,80,53,217,3,66.7
399,3/20/2018 20:15,76,97,58,231,3,66.7
400,3/20/2018 20:20,84,101,64,249,3,66.7
401,3/20/2018 20:25,81,90,53,224,3,66.7
402,3/20/2018 20:30,79,90,60,229,3,66.7
403,3/20/2018 20:35,82,102,61,245,3,66.7
404,3/20/2018 20:40,82,88,64,234,3,66.7
405,3/20/2018 20:45,91,110,57,258,3,66.7
406,3/20/2018 20:50,81,93,51,225,3,66.7
407,3/20/2018 20:55,70,84,58,212,3,66.7
408,3/20/2018 21:00,66,93,54,213,3,66.7
409,3/20/2018 21:05,82,82,71,235,3,66.7
410,3/20/2018 21:10,69,102,59,230,3,66.7
411,3/20/2018 21:15,79,93,54,226,3,66.7
412,3/20/2018 21:20,70,81,62,213,3,66.7
413,3/20/2018 21:25,87,96,59,242,3,66.7
414,3/20/2018 21:30,85,90,47,222,3,66.7
415,3/20/2018 21:35,74,102,61,237,3,66.7
416,3/20/2018 21:40,77,98,51,226,3,66.7
417,3/20/2018 21:45,78,104,57,239,3,66.7
418,3/20/2018 21:50,62,101,55,218,3,66.7
419,3/20/2018 21:55,83,84,56,223,3,66.7
420,3/20/2018 22:00,79,92,63,234,3,66.7
421,3/20/2018 22:05,78,100,57,235,3,66.7
422,3/20/2018 22:10,81,98,65,244,3,66.7
423,3/20/2018 22:15,71,89,42,202,3,66.7
424,3/20/2018 22:20,80,76,58,214,3,66.7
425,3/20/2018 22:25,68,96,61,225,3,66.7
426,3/20/2018 22:30,70,92,48,210,3,66.7
427,3/20/2018 22:35,73,80,54,207,3,66.7
428,3/20/2018 22:40,62,81,51,194,3,66.7
429,3/20/2018 22:45,72,82,61,215,3,66.7
430,3/20/2018 22:50,61,83,44,188,3,66.7
431,3/20/2018 22:55,63,73,40,176,3,66.7
432,3/20/2018 23:00,67,80,49,196,3,66.7
433,3/20/2018 23:05,53,82,33,168,3,66.7
434,3/20/2018 23:10,60,72,46,178,3,66.7
435,3/20/2018 23:15,59,75,47,181,3,66.7
436,3/20/2018 23:20,51,68,32,151,3,66.7
437,3/20/2018 23:25,58,60,49,167,3,66.7
438,3/20/2018 23:30,55,71,42,168,3,66.7
439,3/20/2018 23:35,56,69,33,158,3,66.7
440,3/20/2018 23:40,54,64,41,159,3,66.7
441,3/20/2018 23:45,62,66,40,168,3,66.7
442,3/20/2018 23:50,59,72,45,176,3,66.7
443,3/20/2018 23:55,46,45,33,124,3,66.7
444,3/21/2018 0:00,53,59,31,143,3,66.7
445,3/21/2018 0:05,54,64,36,154,3,66.7
446,3/21/2018 0:10,50,69,30,149,3,66.7
447,3/21/2018 0:15,50,52,40,142,3,66.7
448,3/21/2018 0:20,48,70,43,161,3,66.7
449,3/21/2018 0:25,43,66,33,142,3,66.7
450,3/21/2018 0:30,52,63,31,146,3,66.7
451,3/21/2018 0:35,46,52,34,132,3,66.7
452,3/21/2018 0:40,46,55,35,136,3,66.7
453,3/21/2018 0:45,45,57,34,136,3,66.7
454,3/21/2018 0:50,46,46,26,118,3,66.7
455,3/21/2018 0:55,46,45,24,115,3,66.7
456,3/21/2018 1:00,35,42,24,101,3,66.7
457,3/21/2018 1:05,39,39,24,102,3,66.7
458,3/21/2018 1:10,38,49,28,115,3,66.7
459,3/21/2018 1:15,41,43,15,99,3,66.7
460,3/21/2018 1:20,38,50,20,108,3,66.7
461,3/21/2018 1:25,36,41,16,93,3,66.7
462,3/21/2018 1:30,35,34,26,95,3,66.7
463,3/21/2018 1:35,36,38,21,95,3,66.7
464,3/21/2018 1:40,46,46,27,119,3,66.7
465,3/21/2018 1:45,36,43,27,106,3,66.7
466,3/21/2018 1:50,37,40,19,96,3,66.7
467,3/21/2018 1:55,32,32,15,79,3,66.7
468,3/21/2018 2:00,28,33,9,70,3,66.7
469,3/21/2018 2:05,34,30,20,84,3,66.7
470,3/21/2018 2:10,36,38,18,92,3,66.7
471,3/21/2018 2:15,37,48,23,108,3,66.7
472,3/21/2018 2:20,36,33,20,89,3,66.7
473,3/21/2018 2:25,36,36,14,86,3,66.7
474,3/21/2018 2:30,30,30,14,74,3,66.7
475,3/21/2018 2:35,29,27,19,75,3,66.7
476,3/21/2018 2:40,34,35,26,95,3,66.7
477,3/21/2018 2:45,24,21,18,63,3,66.7
478,3/21/2018 2:50,24,21,10,55,3,66.7
479,3/21/2018 2:55,28,27,12,67,3,66.7
480,3/21/2018 3:00,22,25,10,57,3,66.7
481,3/21/2018 3:05,25,20,14,59,3,66.7
482,3/21/2018 3:10,27,26,16,69,3,66.7
483,3/21/2018 3:15,19,20,12,51,3,66.7
484,3/21/2018 3:20,23,19,9,51,3,66.7
485,3/21/2018 3:25,23,20,12,55,3,66.7
486,3/21/2018 3:30,20,20,12,52,3,66.7
487,3/21/2018 3:35,25,24,12,61,3,66.7
488,3/21/2018 3:40,35,32,24,91,3,66.7
489,3/21/2018 3:45,29,19,18,66,3,66.7
490,3/21/2018 3:50,28,23,15,66,3,66.7
491,3/21/2018 3:55,21,23,10,54,3,66.7
492,3/21/2018 4:00,25,20,13,58,3,66.7
493,3/21/2018 4:05,32,31,15,78,3,66.7
494,3/21/2018 4:10,34,35,17,86,3,66.7
495,3/21/2018 4:15,30,32,15,77,3,66.7
496,3/21/2018 4:20,23,24,15,62,3,66.7
497,3/21/2018 4:25,30,24,18,72,3,66.7
498,3/21/2018 4:30,31,32,22,85,3,66.7
499,3/21/2018 4:35,36,42,15,93,3,66.7
500,3/21/2018 4:40,42,42,21,105,3,66.7
501,3/21/2018 4:45,38,36,13,87,3,66.7
502,3/21/2018 4:50,44,40,26,110,3,66.7
503,3/21/2018 4:55,41,41,24,106,3,66.7
504,3/21/2018 5:00,32,35,16,83,3,66.7
505,3/21/2018 5:05,38,40,23,101,3,66.7
506,3/21/2018 5:10,47,47,25,119,3,66.7
507,3/21/2018 5:15,49,51,26,126,3,66.7
508,3/21/2018 5:20,47,49,34,130,3,66.7
509,3/21/2018 5:25,58,54,25,137,3,66.7
510,3/21/2018 5:30,50,54,24,128,3,66.7
511,3/21/2018 5:35,63,65,31,159,3,66.7
512,3/21/2018 5:40,60,70,31,161,3,66.7
513,3/21/2018 5:45,56,61,32,149,3,66.7
514,3/21/2018 5:50,54,56,27,137,3,66.7
515,3/21/2018 5:55,67,68,29,164,3,66.7
516,3/21/2018 6:00,64,67,32,163,3,66.7
517,3/21/2018 6:05,64,75,40,179,3,66.7
518,3/21/2018 6:10,59,69,41,169,3,66.7
519,3/21/2018 6:15,67,65,39,171,3,66.7
520,3/21/2018 6:20,67,70,36,173,3,66.7
521,3/21/2018 6:25,68,76,36,180,3,66.7
522,3/21/2018 6:30,70,79,37,186,3,66.7
523,3/21/2018 6:35,77,75,50,202,3,66.7
524,3/21/2018 6:40,92,87,52,231,3,66.7
525,3/21/2018 6:45,91,105,52,248,3,66.7
526,3/21/2018 6:50,86,99,55,240,3,66.7
527,3/21/2018 6:55,81,87,56,224,3,66.7
528,3/21/2018 7:00,83,83,64,230,3,66.7
529,3/21/2018 7:05,76,88,51,215,3,66.7
530,3/21/2018 7:10,86,100,59,245,3,66.7
531,3/21/2018 7:15,85,111,65,261,3,66.7
532,3/21/2018 7:20,84,110,73,267,3,66.7
533,3/21/2018 7:25,94,101,70,265,3,66.7
534,3/21/2018 7:30,96,120,62,278,3,66.7
535,3/21/2018 7:35,85,81,47,213,3,66.7
536,3/21/2018 7:40,89,104,74,267,3,66.7
537,3/21/2018 7:45,92,91,54,237,3,66.7
538,3/21/2018 7:50,88,105,57,250,3,66.7
539,3/21/2018 7:55,83,97,66,246,3,66.7
540,3/21/2018 8:00,93,109,57,259,3,66.7
541,3/21/2018 8:05,86,106,57,249,3,66.7
542,3/21/2018 8:10,86,89,60,235,3,66.7
543,3/21/2018 8:15,87,99,68,254,3,66.7
544,3/21/2018 8:20,95,109,59,263,3,66.7
545,3/21/2018 8:25,102,100,65,267,3,66.7
546,3/21/2018 8:30,97,100,66,263,3,66.7
547,3/21/2018 8:35,89,98,64,251,3,66.7
548,3/21/2018 8:40,90,97,64,251,3,66.7
549,3/21/2018 8:45,93,103,73,269,3,66.7
550,3/21/2018 8:50,80,101,69,250,3,66.7
551,3/21/2018 8:55,80,102,55,237,3,66.7
552,3/21/2018 9:00,82,81,55,218,3,66.7
553,3/21/2018 9:05,86,92,58,236,3,66.7
554,3/21/2018 9:10,86,90,50,226,3,66.7
555,3/21/2018 9:15,75,87,56,218,3,66.7
556,3/21/2018 9:20,75,93,59,227,3,66.7
557,3/21/2018 9:25,73,92,56,221,3,66.7
558,3/21/2018 9:30,85,96,46,227,3,66.7
559,3/21/2018 9:35,87,104,73,264,3,66.7
560,3/21/2018 9:40,88,89,57,234,3,66.7
561,3/21/2018 9:45,93,105,60,258,3,66.7
562,3/21/2018 9:50,84,93,62,239,3,66.7
563,3/21/2018 9:55,81,110,56,247,3,66.7
564,3/21/2018 10:00,90,90,48,228,3,66.7
565,3/21/2018 10:05,77,86,53,216,3,66.7
566,3/21/2018 10:10,89,95,52,236,3,66.7
567,3/21/2018 10:15,74,99,58,231,3,66.7
568,3/21/2018 10:20,79,99,61,239,3,66.7
569,3/21/2018 10:25,78,80,52,210,3,66.7
570,3/21/2018 10:30,84,97,67,248,3,66.7
571,3/21/2018 10:35,81,107,61,249,3,66.7
572,3/21/2018 10:40,78,105,62,245,3,66.7
573,3/21/2018 10:45,80,83,57,220,3,66.7
574,3/21/2018 10:50,74,89,50,213,3,66.7
575,3/21/2018 10:55,68,81,71,220,3,66.7
576,3/21/2018 11:00,79,95,58,232,3,66.7
577,3/21/2018 11:05,77,95,58,230,3,66.7
578,3/21/2018 11:10,84,82,67,233,3,66.7
579,3/21/2018 11:15,83,99,64,246,3,66.7
580,3/21/2018 11:20,88,93,59,240,3,66.7
581,3/21/2018 11:25,95,102,61,258,3,66.7
582,3/21/2018 11:30,80,99,61,240,3,66.7
583,3/21/2018 11:35,87,93,59,239,3,66.7
584,3/21/2018 11:40,89,99,64,252,3,66.7
585,3/21/2018 11:45,71,85,53,209,3,66.7
586,3/21/2018 11:50,79,85,64,228,3,66.7
587,3/21/2018 11:55,73,78,64,215,3,66.7
588,3/21/2018 12:00,79,71,50,200,3,66.7
589,3/21/2018 12:05,81,87,49,217,3,66.7
590,3/21/2018 12:10,77,74,70,221,3,66.7
591,3/21/2018 12:15,72,74,60,206,3,66.7
592,3/21/2018 12:20,79,94,49,222,3,66.7
593,3/21/2018 12:25,83,83,64,230,3,66.7
594,3/21/2018 12:30,70,80,44,194,3,66.7
595,3/21/2018 12:35,80,82,54,216,3,66.7
596,3/21/2018 12:40,82,85,49,216,3,66.7
597,3/21/2018 12:45,84,101,57,242,3,66.7
598,3/21/2018 12:50,78,87,58,223,3,66.7
599,3/21/2018 12:55,83,95,62,240,3,66.7
600,3/21/2018 13:00,90,85,63,238,3,66.7
601,3/21/2018 13:05,76,90,61,227,3,66.7
602,3/21/2018 13:10,84,71,46,201,3,66.7
603,3/21/2018 13:15,84,103,69,256,3,66.7
604,3/21/2018 13:20,81,80,50,211,3,66.7
605,3/21/2018 13:25,89,94,59,242,3,66.7
606,3/21/2018 13:30,89,93,77,259,3,66.7
607,3/21/2018 13:35,92,95,66,253,3,66.7
608,3/21/2018 13:40,91,83,73,247,3,66.7
609,3/21/2018 13:45,100,81,70,251,3,66.7
610,3/21/2018 13:50,98,82,73,253,3,66.7
611,3/21/2018 13:55,102,85,84,271,3,66.7
612,3/21/2018 14:00,89,98,92,279,3,66.7
613,3/21/2018 14:05,88,74,65,227,3,66.7
614,3/21/2018 14:10,92,93,68,253,3,66.7
615,3/21/2018 14:15,92,86,64,242,3,66.7
616,3/21/2018 14:20,89,90,55,234,3,66.7
617,3/21/2018 14:25,98,102,64,264,3,66.7
618,3/21/2018 14:30,100,91,62,253,3,66.7
619,3/21/2018 14:35,101,98,67,266,3,66.7
620,3/21/2018 14:40,96,102,60,258,3,66.7
621,3/21/2018 14:45,104,95,81,280,3,66.7
622,3/21/2018 14:50,103,103,79,285,3,66.7
623,3/21/2018 14:55,110,80,75,265,3,66.7
624,3/21/2018 15:00,102,93,82,277,3,66.7
625,3/21/2018 15:05,95,96,88,279,3,66.7
626,3/21/2018 15:10,101,63,57,221,3,66.7
627,3/21/2018 15:15,93,59,53,205,3,66.7
628,3/21/2018 15:20,95,82,73,250,3,66.7
629,3/21/2018 15:25,97,89,90,276,3,66.7
630,3/21/2018 15:30,91,74,75,240,3,66.7
631,3/21/2018 15:35,88,96,80,264,3,66.7
632,3/21/2018 15:40,67,81,63,211,3,66.7
633,3/21/2018 15:45,81,82,54,217,3,66.7
634,3/21/2018 15:50,88,78,66,232,3,66.7
635,3/21/2018 15:55,95,86,51,232,3,66.7
636,3/21/2018 16:00,91,83,67,241,3,66.7
637,3/21/2018 16:05,95,91,58,244,3,66.7
638,3/21/2018 16:10,113,104,66,283,3,66.7
639,3/21/2018 16:15,99,92,68,259,3,66.7
640,3/21/2018 16:20,97,103,66,266,3,66.7
641,3/21/2018 16:25,93,90,73,256,3,66.7
642,3/21/2018 16:30,93,100,89,282,3,66.7
643,3/21/2018 16:35,91,91,79,261,3,66.7
644,3/21/2018 16:40,99,66,73,238,3,66.7
645,3/21/2018 16:45,102,78,78,258,3,66.7
646,3/21/2018 16:50,92,61,53,206,3,66.7
647,3/21/2018 16:55,95,69,58,222,3,66.7
648,3/21/2018 17:00,100,53,39,192,3,66.7
649,3/21/2018 17:05,88,53,31,172,3,66.7
650,3/21/2018 17:10,100,63,46,209,3,66.7
651,3/21/2018 17:15,105,56,45,206,3,66.7
652,3/21/2018 17:20,90,84,88,262,3,66.7
653,3/21/2018 17:25,88,71,64,223,3,66.7
654,3/21/2018 17:30,90,70,70,230,3,66.7
655,3/21/2018 17:35,87,76,73,236,3,66.7
656,3/21/2018 17:40,89,68,67,224,3,66.7
657,3/21/2018 17:45,92,70,74,236,3,66.7
658,3/21/2018 17:50,96,63,58,217,3,66.7
659,3/21/2018 17:55,97,54,46,197,3,66.7
660,3/21/2018 18:00,92,88,83,263,3,66.7
661,3/21/2018 18:05,95,97,85,277,3,66.7
662,3/21/2018 18:10,97,81,77,255,3,66.7
663,3/21/2018 18:15,91,80,63,234,3,66.7
664,3/21/2018 18:20,98,85,79,262,3,66.7
665,3/21/2018 18:25,85,80,56,221,3,66.7
666,3/21/2018 18:30,88,75,47,210,3,66.7
667,3/21/2018 18:35,83,74,50,207,3,66.7
668,3/21/2018 18:40,74,66,51,191,3,66.7
669,3/21/2018 18:45,74,76,45,195,3,66.7
670,3/21/2018 18:50,77,80,51,208,3,66.7
671,3/21/2018 18:55,81,80,55,216,3,66.7
672,3/21/2018 19:00,84,78,61,223,3,66.7
673,3/21/2018 19:05,85,78,42,205,3,66.7
674,3/21/2018 19:10,77,103,59,239,3,66.7
675,3/21/2018 19:15,81,88,56,225,3,66.7
676,3/21/2018 19:20,85,88,47,220,3,66.7
677,3/21/2018 19:25,80,89,48,217,3,66.7
678,3/21/2018 19:30,86,94,66,246,3,66.7
679,3/21/2018 19:35,89,109,63,261,3,66.7
680,3/21/2018 19:40,90,93,53,236,3,66.7
681,3/21/2018 19:45,89,95,62,246,3,66.7
682,3/21/2018 19:50,82,102,55,239,3,66.7
683,3/21/2018 19:55,83,100,50,233,3,66.7
684,3/21/2018 20:00,65,84,55,204,3,66.7
685,3/21/2018 20:05,86,100,51,237,3,66.7
686,3/21/2018 20:10,86,102,56,244,3,66.7
687,3/21/2018 20:15,77,92,56,225,3,66.7
688,3/21/2018 20:20,82,93,54,229,3,66.7
689,3/21/2018 20:25,78,98,59,235,3,66.7
690,3/21/2018 20:30,74,91,61,226,3,66.7
691,3/21/2018 20:35,83,92,64,239,3,66.7
692,3/21/2018 20:40,85,89,63,237,3,66.7
693,3/21/2018 20:45,92,85,63,240,3,66.7
694,3/21/2018 20:50,87,77,67,231,3,66.7
695,3/21/2018 20:55,81,98,65,244,3,66.7
696,3/21/2018 21:00,84,100,62,246,3,66.7
697,3/21/2018 21:05,81,95,63,239,3,66.7
698,3/21/2018 21:10,80,84,62,226,3,66.7
699,3/21/2018 21:15,84,91,61,236,3,66.7
700,3/21/2018 21:20,86,106,60,252,3,66.7
701,3/21/2018 21:25,71,94,60,225,3,66.7
702,3/21/2018 21:30,75,82,57,214,3,66.7
703,3/21/2018 21:35,82,110,59,251,3,66.7
704,3/21/2018 21:40,75,84,44,203,3,66.7
705,3/21/2018 21:45,76,88,47,211,3,66.7
706,3/21/2018 21:50,65,86,59,210,3,66.7
707,3/21/2018 21:55,65,85,44,194,3,66.7
708,3/21/2018 22:00,78,84,63,225,3,66.7
709,3/21/2018 22:05,62,79,55,196,3,66.7
710,3/21/2018 22:10,79,96,69,244,3,66.7
711,3/21/2018 22:15,89,94,65,248,3,66.7
712,3/21/2018 22:20,84,75,58,217,3,66.7
713,3/21/2018 22:25,68,104,64,236,3,66.7
714,3/21/2018 22:30,68,96,60,224,3,66.7
715,3/21/2018 22:35,73,88,52,213,3,66.7
716,3/21/2018 22:40,79,105,56,240,3,66.7
717,3/21/2018 22:45,67,84,55,206,3,66.7
718,3/21/2018 22:50,69,87,53,209,3,66.7
719,3/21/2018 22:55,70,83,45,198,3,66.7
720,3/21/2018 23:00,55,82,42,179,3,66.7
721,3/21/2018 23:05,65,73,46,184,3,66.7
722,3/21/2018 23:10,69,66,45,180,3,66.7
723,3/21/2018 23:15,62,76,52,190,3,66.7
724,3/21/2018 23:20,60,64,37,161,3,66.7
725,3/21/2018 23:25,62,70,37,169,3,66.7
726,3/21/2018 23:30,49,58,42,149,3,66.7
727,3/21/2018 23:35,44,51,29,124,3,66.7
728,3/21/2018 23:40,54,83,44,181,3,66.7
729,3/21/2018 23:45,58,71,44,173,3,66.7
730,3/21/2018 23:50,48,63,38,149,3,66.7
731,3/21/2018 23:55,42,52,34,128,3,66.7
732,3/22/2018 0:00,48,59,34,141,3,66.7
733,3/22/2018 0:05,46,43,29,118,3,66.7
734,3/22/2018 0:10,51,70,40,161,3,66.7
735,3/22/2018 0:15,55,62,35,152,3,66.7
736,3/22/2018 0:20,55,63,36,154,3,66.7
737,3/22/2018 0:25,46,66,32,144,3,66.7
738,3/22/2018 0:30,44,45,25,114,3,66.7
739,3/22/2018 0:35,45,58,37,140,3,66.7
740,3/22/2018 0:40,39,53,27,119,3,66.7
741,3/22/2018 0:45,40,48,23,111,3,66.7
742,3/22/2018 0:50,40,58,21,119,3,66.7
743,3/22/2018 0:55,39,49,29,117,3,66.7
744,3/22/2018 1:00,45,48,25,118,3,66.7
745,3/22/2018 1:05,40,47,23,110,3,66.7
746,3/22/2018 1:10,35,46,18,99,3,66.7
747,3/22/2018 1:15,42,49,27,118,3,66.7
748,3/22/2018 1:20,40,44,19,103,3,66.7
749,3/22/2018 1:25,30,38,17,85,3,66.7
750,3/22/2018 1:30,42,48,21,111,3,66.7
751,3/22/2018 1:35,40,47,17,104,3,66.7
752,3/22/2018 1:40,44,51,21,116,3,66.7
753,3/22/2018 1:45,39,45,22,106,3,66.7
754,3/22/2018 1:50,37,29,22,88,3,66.7
755,3/22/2018 1:55,33,37,18,88,3,66.7
756,3/22/2018 2:00,35,40,30,105,3,66.7
757,3/22/2018 2:05,34,32,19,85,3,66.7
758,3/22/2018 2:10,27,24,15,66,3,66.7
759,3/22/2018 2:15,33,34,20,87,3,66.7
760,3/22/2018 2:20,37,37,27,101,3,66.7
761,3/22/2018 2:25,29,30,20,79,3,66.7
762,3/22/2018 2:30,31,44,20,95,3,66.7
763,3/22/2018 2:35,35,36,21,92,3,66.7
764,3/22/2018 2:40,29,36,20,85,3,66.7
765,3/22/2018 2:45,30,31,18,79,3,66.7
766,3/22/2018 2:50,19,26,9,54,3,66.7
767,3/22/2018 2:55,27,24,9,60,3,66.7
768,3/22/2018 3:00,29,25,16,70,3,66.7
769,3/22/2018 3:05,21,20,13,54,3,66.7
770,3/22/2018 3:10,23,18,13,54,3,66.7
771,3/22/2018 3:15,25,23,13,61,3,66.7
772,3/22/2018 3:20,25,24,15,64,3,66.7
773,3/22/2018 3:25,22,21,9,52,3,66.7
774,3/22/2018 3:30,23,22,14,59,3,66.7
775,3/22/2018 3:35,27,22,17,66,3,66.7
776,3/22/2018 3:40,30,29,15,74,3,66.7
777,3/22/2018 3:45,24,23,8,55,3,66.7
778,3/22/2018 3:50,26,25,11,62,3,66.7
779,3/22/2018 3:55,26,24,15,65,3,66.7
780,3/22/2018 4:00,27,28,17,72,3,66.7
781,3/22/2018 4:05,26,27,15,68,3,66.7
782,3/22/2018 4:10,28,31,12,71,3,66.7
783,3/22/2018 4:15,29,34,14,77,3,66.7
784,3/22/2018 4:20,34,32,13,79,3,66.7
785,3/22/2018 4:25,32,31,10,73,3,66.7
786,3/22/2018 4:30,38,39,15,92,3,66.7
787,3/22/2018 4:35,32,32,12,76,3,66.7
788,3/22/2018 4:40,43,39,17,99,3,66.7
789,3/22/2018 4:45,46,50,31,127,3,66.7
790,3/22/2018 4:50,45,45,14,104,3,66.7
791,3/22/2018 4:55,41,47,21,109,3,66.7
792,3/22/2018 5:00,45,40,14,99,3,66.7
793,3/22/2018 5:05,37,38,18,93,3,66.7
794,3/22/2018 5:10,48,46,20,114,3,66.7
795,3/22/2018 5:15,47,52,30,129,3,66.7
796,3/22/2018 5:20,48,48,25,121,3,66.7
797,3/22/2018 5:25,55,50,26,131,3,66.7
798,3/22/2018 5:30,51,54,20,125,3,66.7
799,3/22/2018 5:35,49,54,24,127,3,66.7
800,3/22/2018 5:40,58,64,22,144,3,66.7
801,3/22/2018 5:45,71,73,37,181,3,66.7
802,3/22/2018 5:50,50,57,38,145,3,66.7
803,3/22/2018 5:55,50,54,18,122,3,66.7
804,3/22/2018 6:00,59,63,28,150,3,66.7
805,3/22/2018 6:05,65,65,36,166,3,66.7
806,3/22/2018 6:10,63,68,45,176,3,66.7
807,3/22/2018 6:15,81,82,42,205,3,66.7
808,3/22/2018 6:20,66,82,34,182,3,66.7
809,3/22/2018 6:25,73,75,44,192,3,66.7
810,3/22/2018 6:30,75,77,35,187,3,66.7
811,3/22/2018 6:35,83,78,46,207,3,66.7
812,3/22/2018 6:40,81,86,45,212,3,66.7
813,3/22/2018 6:45,92,91,55,238,3,66.7
814,3/22/2018 6:50,88,90,54,232,3,66.7
815,3/22/2018 6:55,88,92,59,239,3,66.7
816,3/22/2018 7:00,74,95,47,216,3,66.7
817,3/22/2018 7:05,77,84,62,223,3,66.7
818,3/22/2018 7:10,77,78,62,217,3,66.7
819,3/22/2018 7:15,85,98,69,252,3,66.7
820,3/22/2018 7:20,80,107,61,248,3,66.7
821,3/22/2018 7:25,88,98,62,248,3,66.7
822,3/22/2018 7:30,86,86,75,247,3,66.7
823,3/22/2018 7:35,92,90,63,245,3,66.7
824,3/22/2018 7:40,82,103,62,247,3,66.7
825,3/22/2018 7:45,83,99,63,245,3,66.7
826,3/22/2018 7:50,86,98,66,250,3,66.7
827,3/22/2018 7:55,76,70,48,194,3,66.7
828,3/22/2018 8:00,82,92,59,233,3,66.7
829,3/22/2018 8:05,82,103,65,250,3,66.7
830,3/22/2018 8:10,88,92,59,239,3,66.7
831,3/22/2018 8:15,86,92,60,238,3,66.7
832,3/22/2018 8:20,89,88,71,248,3,66.7
833,3/22/2018 8:25,85,78,59,222,3,66.7
834,3/22/2018 8:30,73,85,52,210,3,66.7
835,3/22/2018 8:35,87,95,66,248,3,66.7
836,3/22/2018 8:40,80,86,58,224,3,66.7
837,3/22/2018 8:45,83,97,60,240,3,66.7
838,3/22/2018 8:50,87,87,61,235,3,66.7
839,3/22/2018 8:55,89,93,55,237,3,66.7
840,3/22/2018 9:00,84,92,52,228,3,66.7
841,3/22/2018 9:05,80,89,59,228,3,66.7
842,3/22/2018 9:10,73,85,55,213,3,66.7
843,3/22/2018 9:15,79,89,55,223,3,66.7
844,3/22/2018 9:20,76,99,57,232,3,66.7
845,3/22/2018 9:25,81,84,52,217,3,66.7
846,3/22/2018 9:30,73,87,51,211,3,66.7
847,3/22/2018 9:35,84,87,49,220,3,66.7
848,3/22/2018 9:40,73,88,57,218,3,66.7
849,3/22/2018 9:45,85,91,51,227,3,66.7
850,3/22/2018 9:50,75,81,52,208,3,66.7
851,3/22/2018 9:55,75,78,51,204,3,66.7
852,3/22/2018 10:00,66,80,54,200,3,66.7
853,3/22/2018 10:05,65,67,51,183,3,66.7
854,3/22/2018 10:10,69,81,60,210,3,66.7
855,3/22/2018 10:15,78,84,51,213,3,66.7
856,3/22/2018 10:20,83,95,52,230,3,66.7
857,3/22/2018 10:25,79,79,52,210,3,66.7
858,3/22/2018 10:30,73,93,54,220,3,66.7
859,3/22/2018 10:35,69,81,50,200,3,66.7
860,3/22/2018 10:40,78,80,61,219,3,66.7
861,3/22/2018 10:45,69,84,55,208,3,66.7
862,3/22/2018 10:50,66,97,59,222,3,66.7
863,3/22/2018 10:55,73,93,62,228,3,66.7
864,3/22/2018 11:00,71,82,64,217,3,66.7
865,3/22/2018 11:05,71,84,57,212,3,66.7
866,3/22/2018 11:10,76,89,56,221,3,66.7
867,3/22/2018 11:15,73,76,48,197,3,66.7
868,3/22/2018 11:20,74,95,47,216,3,66.7
869,3/22/2018 11:25,79,93,56,228,3,66.7
870,3/22/2018 11:30,82,87,54,223,3,66.7
871,3/22/2018 11:35,80,69,44,193,3,66.7
872,3/22/2018 11:40,69,86,56,211,3,66.7
873,3/22/2018 11:45,74,96,60,230,3,66.7
874,3/22/2018 11:50,73,79,50,202,3,66.7
875,3/22/2018 11:55,72,74,62,208,3,66.7
876,3/22/2018 12:00,84,82,49,215,3,66.7
877,3/22/2018 12:05,70,82,50,202,3,66.7
878,3/22/2018 12:10,85,86,56,227,3,66.7
879,3/22/2018 12:15,80,95,62,237,3,66.7
880,3/22/2018 12:20,78,87,67,232,3,66.7
881,3/22/2018 12:25,85,96,59,240,3,66.7
882,3/22/2018 12:30,83,93,52,228,3,66.7
883,3/22/2018 12:35,78,90,57,225,3,66.7
884,3/22/2018 12:40,66,84,45,195,3,66.7
885,3/22/2018 12:45,84,87,58,229,3,66.7
886,3/22/2018 12:50,90,88,55,233,3,66.7
887,3/22/2018 12:55,78,76,60,214,3,66.7
888,3/22/2018 13:00,89,91,43,223,3,66.7
889,3/22/2018 13:05,81,88,61,230,3,66.7
890,3/22/2018 13:10,82,82,56,220,3,66.7
891,3/22/2018 13:15,88,82,55,225,3,66.7
892,3/22/2018 13:20,96,91,65,252,3,66.7
893,3/22/2018 13:25,79,86,49,214,3,66.7
894,3/22/2018 13:30,98,98,71,267,3,66.7
895,3/22/2018 13:35,94,88,72,254,3,66.7
896,3/22/2018 13:40,96,96,53,245,3,66.7
897,3/22/2018 13:45,90,110,56,256,3,66.7
898,3/22/2018 13:50,93,95,63,251,3,66.7
899,3/22/2018 13:55,100,106,78,284,3,66.7
900,3/22/2018 14:00,89,104,60,253,3,66.7
901,3/22/2018 14:05,87,119,69,275,3,66.7
902,3/22/2018 14:10,91,99,64,254,3,66.7
903,3/22/2018 14:15,109,95,69,273,3,66.7
904,3/22/2018 14:20,106,108,69,283,3,66.7
905,3/22/2018 14:25,99,98,68,265,3,66.7
906,3/22/2018 14:30,101,90,61,252,3,66.7
907,3/22/2018 14:35,92,91,52,235,3,66.7
908,3/22/2018 14:40,99,102,73,274,3,66.7
909,3/22/2018 14:45,101,90,68,259,3,66.7
910,3/22/2018 14:50,97,96,53,246,3,66.7
911,3/22/2018 14:55,99,80,67,246,3,66.7
912,3/22/2018 15:00,94,71,69,234,3,66.7
913,3/22/2018 15:05,82,77,60,219,3,66.7
914,3/22/2018 15:10,89,82,69,240,3,66.7
915,3/22/2018 15:15,90,85,55,230,3,66.7
916,3/22/2018 15:20,96,87,53,236,3,66.7
917,3/22/2018 15:25,89,93,59,241,3,66.7
918,3/22/2018 15:30,86,90,61,237,3,66.7
919,3/22/2018 15:35,98,92,67,257,3,66.7
920,3/22/2018 15:40,93,107,72,272,3,66.7
921,3/22/2018 15:45,97,90,58,245,3,66.7
922,3/22/2018 15:50,106,106,82,294,3,66.7
923,3/22/2018 15:55,96,94,57,247,3,66.7
924,3/22/2018 16:00,92,90,59,241,3,66.7
925,3/22/2018 16:05,90,91,55,236,3,66.7
926,3/22/2018 16:10,91,89,67,247,3,66.7
927,3/22/2018 16:15,98,85,70,253,3,66.7
928,3/22/2018 16:20,86,85,76,247,3,66.7
929,3/22/2018 16:25,92,83,57,232,3,66.7
930,3/22/2018 16:30,94,83,72,249,3,66.7
931,3/22/2018 16:35,94,90,73,257,3,66.7
932,3/22/2018 16:40,81,84,65,230,3,66.7
933,3/22/2018 16:45,88,87,64,239,3,66.7
934,3/22/2018 16:50,94,98,67,259,3,66.7
935,3/22/2018 16:55,87,76,62,225,3,66.7
936,3/22/2018 17:00,88,83,57,228,3,66.7
937,3/22/2018 17:05,86,84,51,221,3,66.7
938,3/22/2018 17:10,86,81,63,230,3,66.7
939,3/22/2018 17:15,91,91,58,240,3,66.7
940,3/22/2018 17:20,93,81,74,248,3,66.7
941,3/22/2018 17:25,90,98,63,251,3,66.7
942,3/22/2018 17:30,92,87,62,241,3,66.7
943,3/22/2018 17:35,83,84,60,227,3,66.7
944,3/22/2018 17:40,78,78,57,213,3,66.7
945,3/22/2018 17:45,90,94,53,237,3,66.7
946,3/22/2018 17:50,88,85,57,230,3,66.7
947,3/22/2018 17:55,84,85,53,222,3,66.7
948,3/22/2018 18:00,80,77,50,207,3,66.7
949,3/22/2018 18:05,77,79,52,208,3,66.7
950,3/22/2018 18:10,81,76,59,216,3,66.7
951,3/22/2018 18:15,90,86,59,235,3,66.7
952,3/22/2018 18:20,77,77,47,201,3,66.7
953,3/22/2018 18:25,85,80,62,227,3,66.7
954,3/22/2018 18:30,85,86,51,222,3,66.7
955,3/22/2018 18:35,94,97,56,247,3,66.7
956,3/22/2018 18:40,88,85,63,236,3,66.7
957,3/22/2018 18:45,86,95,60,241,3,66.7
958,3/22/2018 18:50,83,87,56,226,3,66.7
959,3/22/2018 18:55,92,87,65,244,3,66.7
960,3/22/2018 19:00,89,87,65,241,3,66.7
961,3/22/2018 19:05,88,91,64,243,3,66.7
962,3/22/2018 19:10,86,90,66,242,3,66.7
963,3/22/2018 19:15,87,90,59,236,3,66.7
964,3/22/2018 19:20,86,95,53,234,3,66.7
965,3/22/2018 19:25,82,93,59,234,3,66.7
966,3/22/2018 19:30,81,74,60,215,3,66.7
967,3/22/2018 19:35,92,85,57,234,3,66.7
968,3/22/2018 19:40,89,93,52,234,3,66.7
969,3/22/2018 19:45,87,99,57,243,3,66.7
970,3/22/2018 19:50,86,99,64,249,3,66.7
971,3/22/2018 19:55,88,96,65,249,3,66.7
972,3/22/2018 20:00,86,89,57,232,3,66.7
973,3/22/2018 20:05,82,89,54,225,3,66.7
974,3/22/2018 20:10,85,87,54,226,3,66.7
975,3/22/2018 20:15,87,93,57,237,3,66.7
976,3/22/2018 20:20,77,100,64,241,3,66.7
977,3/22/2018 20:25,85,97,63,245,3,66.7
978,3/22/2018 20:30,76,88,56,220,3,66.7
979,3/22/2018 20:35,71,84,61,216,3,66.7
980,3/22/2018 20:40,71,85,63,219,3,66.7
981,3/22/2018 20:45,85,95,52,232,3,66.7
982,3/22/2018 20:50,70,89,58,217,3,66.7
983,3/22/2018 20:55,72,84,54,210,3,66.7
984,3/22/2018 21:00,81,91,65,237,3,66.7
985,3/22/2018 21:05,79,85,48,212,3,66.7
986,3/22/2018 21:10,69,93,45,207,3,66.7
987,3/22/2018 21:15,86,93,72,251,3,66.7
988,3/22/2018 21:20,74,93,60,227,3,66.7
989,3/22/2018 21:25,75,89,68,232,3,66.7
990,3/22/2018 21:30,73,103,53,229,3,66.7
991,3/22/2018 21:35,69,81,51,201,3,66.7
992,3/22/2018 21:40,77,90,56,223,3,66.7
993,3/22/2018 21:45,73,84,51,208,3,66.7
994,3/22/2018 21:50,79,82,62,223,3,66.7
995,3/22/2018 21:55,65,83,56,204,3,66.7
996,3/22/2018 22:00,71,84,60,215,3,66.7
997,3/22/2018 22:05,71,70,43,184,3,66.7
998,3/22/2018 22:10,78,92,64,234,3,66.7
999,3/22/2018 22:15,86,92,73,251,3,66.7
1000,3/22/2018 22:20,68,100,61,229,3,66.7
1001,3/22/2018 22:25,73,75,50,198,3,66.7
1002,3/22/2018 22:30,85,100,65,250,3,66.7
1003,3/22/2018 22:35,67,79,49,195,3,66.7
1004,3/22/2018 22:40,69,99,46,214,3,66.7
1005,3/22/2018 22:45,72,87,63,222,3,66.7
1006,3/22/2018 22:50,67,85,46,198,3,66.7
1007,3/22/2018 22:55,57,81,40,178,3,66.7
1008,3/22/2018 23:00,60,92,49,201,3,66.7
1009,3/22/2018 23:05,72,72,60,204,3,66.7
1010,3/22/2018 23:10,60,82,40,182,3,66.7
1011,3/22/2018 23:15,55,79,47,181,3,66.7
1012,3/22/2018 23:20,58,72,35,165,3,66.7
1013,3/22/2018 23:25,58,81,51,190,3,66.7
1014,3/22/2018 23:30,52,89,44,185,3,66.7
1015,3/22/2018 23:35,69,75,52,196,3,66.7
1016,3/22/2018 23:40,54,80,52,186,3,66.7
1017,3/22/2018 23:45,62,86,52,200,3,66.7
1018,3/22/2018 23:50,55,72,50,177,3,66.7
1019,3/22/2018 23:55,52,60,27,139,3,66.7
1020,3/23/2018 0:00,52,65,39,156,3,66.7
1021,3/23/2018 0:05,57,62,41,160,3,66.7
1022,3/23/2018 0:10,57,74,35,166,3,66.7
1023,3/23/2018 0:15,50,58,47,155,3,66.7
1024,3/23/2018 0:20,62,66,44,172,3,66.7
1025,3/23/2018 0:25,44,59,30,133,3,66.7
1026,3/23/2018 0:30,56,64,41,161,3,66.7
1027,3/23/2018 0:35,48,69,31,148,3,66.7
1028,3/23/2018 0:40,40,55,27,122,3,66.7
1029,3/23/2018 0:45,38,51,31,120,3,66.7
1030,3/23/2018 0:50,44,51,28,123,3,66.7
1031,3/23/2018 0:55,44,62,35,141,3,66.7
1032,3/23/2018 1:00,39,50,21,110,3,66.7
1033,3/23/2018 1:05,39,42,21,102,3,66.7
1034,3/23/2018 1:10,38,49,26,113,3,66.7
1035,3/23/2018 1:15,46,47,27,120,3,66.7
1036,3/23/2018 1:20,39,50,26,115,3,66.7
1037,3/23/2018 1:25,40,50,24,114,3,66.7
1038,3/23/2018 1:30,41,42,26,109,3,66.7
1039,3/23/2018 1:35,39,51,27,117,3,66.7
1040,3/23/2018 1:40,40,49,23,112,3,66.7
1041,3/23/2018 1:45,42,56,23,121,3,66.7
1042,3/23/2018 1:50,37,43,23,103,3,66.7
1043,3/23/2018 1:55,40,46,23,109,3,66.7
1044,3/23/2018 2:00,39,35,29,103,3,66.7
1045,3/23/2018 2:05,40,41,20,101,3,66.7
1046,3/23/2018 2:10,34,38,22,94,3,66.7
1047,3/23/2018 2:15,40,42,16,98,3,66.7
1048,3/23/2018 2:20,29,33,14,76,3,66.7
1049,3/23/2018 2:25,41,47,25,113,3,66.7
1050,3/23/2018 2:30,35,43,21,99,3,66.7
1051,3/23/2018 2:35,37,34,14,85,3,66.7
1052,3/23/2018 2:40,38,44,24,106,3,66.7
1053,3/23/2018 2:45,38,35,17,90,3,66.7
1054,3/23/2018 2:50,33,34,18,85,3,66.7
1055,3/23/2018 2:55,32,34,20,86,3,66.7
1056,3/23/2018 3:00,31,34,18,83,3,66.7
1057,3/23/2018 3:05,33,38,16,87,3,66.7
1058,3/23/2018 3:10,29,26,19,74,3,66.7
1059,3/23/2018 3:15,28,23,11,62,3,66.7
1060,3/23/2018 3:20,26,28,10,64,3,66.7
1061,3/23/2018 3:25,28,29,18,75,3,66.7
1062,3/23/2018 3:30,25,27,8,60,3,66.7
1063,3/23/2018 3:35,20,26,14,60,3,66.7
1064,3/23/2018 3:40,30,29,16,75,3,66.7
1065,3/23/2018 3:45,29,31,15,75,3,66.7
1066,3/23/2018 3:50,21,26,11,58,3,66.7
1067,3/23/2018 3:55,31,31,14,76,3,66.7
1068,3/23/2018 4:00,39,30,26,95,3,66.7
1069,3/23/2018 4:05,18,30,15,63,3,0.0
1070,3/23/2018 4:10,20,29,19,68,3,0.0
1071,3/23/2018 4:15,40,36,16,92,3,66.7
1072,3/23/2018 4:20,24,32,13,69,3,66.7
1073,3/23/2018 4:25,32,29,17,78,3,66.7
1074,3/23/2018 4:30,32,33,16,81,3,66.7
1075,3/23/2018 4:35,39,48,17,104,3,66.7
1076,3/23/2018 4:40,49,49,18,116,3,66.7
1077,3/23/2018 4:45,48,46,34,128,3,66.7
1078,3/23/2018 4:50,41,40,20,101,3,66.7
1079,3/23/2018 4:55,37,35,22,94,3,66.7
1080,3/23/2018 5:00,36,37,24,97,3,66.7
1081,3/23/2018 5:05,41,36,15,92,3,66.7
1082,3/23/2018 5:10,41,47,16,104,3,66.7
1083,3/23/2018 5:15,43,45,21,109,3,66.7
1084,3/23/2018 5:20,57,55,32,144,3,66.7
1085,3/23/2018 5:25,54,48,29,131,3,66.7
1086,3/23/2018 5:30,59,58,27,144,3,66.7
1087,3/23/2018 5:35,65,69,32,166,3,66.7
1088,3/23/2018 5:40,62,61,29,152,3,66.7
1089,3/23/2018 5:45,65,68,27,160,3,66.7
1090,3/23/2018 5:50,60,58,27,145,3,66.7
1091,3/23/2018 5:55,55,70,37,162,3,66.7
1092,3/23/2018 6:00,49,66,33,148,3,66.7
1093,3/23/2018 6:05,56,53,23,132,3,66.7
1094,3/23/2018 6:10,72,77,41,190,3,66.7
1095,3/23/2018 6:15,71,67,40,178,3,66.7
1096,3/23/2018 6:20,75,77,37,189,3,66.7
1097,3/23/2018 6:25,75,84,43,202,3,66.7
1098,3/23/2018 6:30,74,78,34,186,3,66.7
1099,3/23/2018 6:35,73,87,41,201,3,66.7
1100,3/23/2018 6:40,86,87,50,223,3,66.7
1101,3/23/2018 6:45,84,93,51,228,3,66.7
1102,3/23/2018 6:50,94,99,56,249,3,66.7
1103,3/23/2018 6:55,79,94,52,225,3,66.7
1104,3/23/2018 7:00,79,89,52,220,3,66.7
1105,3/23/2018 7:05,84,100,78,262,3,66.7
1106,3/23/2018 7:10,85,99,64,248,3,66.7
1107,3/23/2018 7:15,90,97,61,248,3,66.7
1108,3/23/2018 7:20,75,97,78,250,3,66.7
1109,3/23/2018 7:25,86,95,58,239,3,66.7
1110,3/23/2018 7:30,88,103,69,260,3,66.7
1111,3/23/2018 7:35,91,102,51,244,3,66.7
1112,3/23/2018 7:40,92,87,65,244,3,66.7
1113,3/23/2018 7:45,94,101,62,257,3,66.7
1114,3/23/2018 7:50,88,98,46,232,3,66.7
1115,3/23/2018 7:55,84,86,65,235,3,66.7
1116,3/23/2018 8:00,89,98,58,245,3,66.7
1117,3/23/2018 8:05,86,93,54,233,3,66.7
1118,3/23/2018 8:10,92,108,68,268,3,66.7
1119,3/23/2018 8:15,90,85,55,230,3,66.7
1120,3/23/2018 8:20,84,87,53,224,3,66.7
1121,3/23/2018 8:25,97,104,66,267,3,66.7
1122,3/23/2018 8:30,94,96,68,258,3,66.7
1123,3/23/2018 8:35,84,87,49,220,3,66.7
1124,3/23/2018 8:40,94,100,65,259,3,66.7
1125,3/23/2018 8:45,90,98,55,243,3,66.7
1126,3/23/2018 8:50,87,78,51,216,3,66.7
1127,3/23/2018 8:55,78,103,69,250,3,66.7
1128,3/23/2018 9:00,89,74,56,219,3,66.7
1129,3/23/2018 9:05,96,110,72,278,3,66.7
1130,3/23/2018 9:10,77,76,49,202,3,66.7
1131,3/23/2018 9:15,85,86,54,225,3,66.7
1132,3/23/2018 9:20,83,117,65,265,3,66.7
1133,3/23/2018 9:25,73,96,50,219,3,66.7
1134,3/23/2018 9:30,85,98,59,242,3,66.7
1135,3/23/2018 9:35,80,83,54,217,3,66.7
1136,3/23/2018 9:40,76,91,58,225,3,66.7
1137,3/23/2018 9:45,92,97,57,246,3,66.7
1138,3/23/2018 9:50,92,102,66,260,3,66.7
1139,3/23/2018 9:55,86,87,47,220,3,66.7
1140,3/23/2018 10:00,78,95,57,230,3,66.7
1141,3/23/2018 10:05,75,108,59,242,3,66.7
1142,3/23/2018 10:10,72,99,61,232,3,66.7
1143,3/23/2018 10:15,90,103,54,247,3,66.7
1144,3/23/2018 10:20,80,80,62,222,3,66.7
1145,3/23/2018 10:25,92,85,60,237,3,66.7
1146,3/23/2018 10:30,87,83,63,233,3,66.7
1147,3/23/2018 10:35,79,79,53,211,3,66.7
1148,3/23/2018 10:40,86,92,63,241,3,66.7
1149,3/23/2018 10:45,81,75,52,208,3,66.7
1150,3/23/2018 10:50,86,89,59,234,3,66.7
1151,3/23/2018 10:55,75,89,59,223,3,66.7
1152,3/23/2018 11:00,88,95,53,236,3,66.7
1153,3/23/2018 11:05,90,106,54,250,3,66.7
1154,3/23/2018 11:10,85,99,59,243,3,66.7
1155,3/23/2018 11:15,93,113,65,271,3,66.7
1156,3/23/2018 11:20,101,101,62,264,3,66.7
1157,3/23/2018 11:25,96,107,63,266,3,66.7
1158,3/23/2018 11:30,90,103,64,257,3,66.7
1159,3/23/2018 11:35,87,106,72,265,3,66.7
1160,3/23/2018 11:40,92,97,55,244,3,66.7
1161,3/23/2018 11:45,83,84,54,221,3,66.7
1162,3/23/2018 11:50,97,98,62,257,3,66.7
1163,3/23/2018 11:55,93,99,53,245,3,66.7
1164,3/23/2018 12:00,96,99,76,271,3,66.7
1165,3/23/2018 12:05,97,102,62,261,3,66.7
1166,3/23/2018 12:10,104,113,83,300,3,66.7
1167,3/23/2018 12:15,93,109,70,272,3,66.7
1168,3/23/2018 12:20,90,106,66,262,3,66.7
1169,3/23/2018 12:25,93,104,74,271,3,66.7
1170,3/23/2018 12:30,93,96,86,275,3,66.7
1171,3/23/2018 12:35,102,100,70,272,3,66.7
1172,3/23/2018 12:40,84,89,61,234,3,66.7
1173,3/23/2018 12:45,97,100,70,267,3,66.7
1174,3/23/2018 12:50,91,89,65,245,3,66.7
1175,3/23/2018 12:55,96,88,76,260,3,66.7
1176,3/23/2018 13:00,83,86,61,230,3,66.7
1177,3/23/2018 13:05,97,95,66,258,3,66.7
1178,3/23/2018 13:10,105,93,64,262,3,66.7
1179,3/23/2018 13:15,87,98,66,251,3,66.7
1180,3/23/2018 13:20,97,99,61,257,3,66.7
1181,3/23/2018 13:25,99,89,53,241,3,66.7
1182,3/23/2018 13:30,86,96,59,241,3,66.7
1183,3/23/2018 13:35,75,82,57,214,3,66.7
1184,3/23/2018 13:40,77,76,51,204,3,66.7
1185,3/23/2018 13:45,95,95,64,254,3,66.7
1186,3/23/2018 13:50,94,106,74,274,3,66.7
1187,3/23/2018 13:55,98,102,68,268,3,66.7
1188,3/23/2018 14:00,101,92,77,270,3,66.7
1189,3/23/2018 14:05,84,68,70,222,3,66.7
1190,3/23/2018 14:10,92,98,84,274,3,66.7
1191,3/23/2018 14:15,85,77,59,221,3,66.7
1192,3/23/2018 14:20,95,63,63,221,3,66.7
1193,3/23/2018 14:25,96,77,68,241,3,66.7
1194,3/23/2018 14:30,106,58,48,212,3,66.7
1195,3/23/2018 14:35,87,59,53,199,3,66.7
1196,3/23/2018 14:40,98,79,74,251,3,66.7
1197,3/23/2018 14:45,100,55,67,222,3,66.7
1198,3/23/2018 14:50,86,79,70,235,3,66.7
1199,3/23/2018 14:55,103,77,69,249,3,66.7
1200,3/23/2018 15:00,100,94,63,257,3,66.7
1201,3/23/2018 15:05,93,68,71,232,3,66.7
1202,3/23/2018 15:10,93,67,49,209,3,66.7
1203,3/23/2018 15:15,87,93,73,253,3,66.7
1204,3/23/2018 15:20,91,73,53,217,3,66.7
1205,3/23/2018 15:25,93,68,47,208,3,66.7
1206,3/23/2018 15:30,100,66,47,213,3,66.7
1207,3/23/2018 15:35,82,56,31,169,3,66.7
1208,3/23/2018 15:40,68,61,55,184,3,66.7
1209,3/23/2018 15:45,68,56,52,176,3,66.7
1210,3/23/2018 15:50,84,70,63,217,3,66.7
1211,3/23/2018 15:55,98,49,48,195,3,66.7
1212,3/23/2018 16:00,101,61,61,223,3,66.7
1213,3/23/2018 16:05,91,56,56,203,3,66.7
1214,3/23/2018 16:10,100,68,66,234,3,66.7
1215,3/23/2018 16:15,89,61,58,208,3,66.7
1216,3/23/2018 16:20,84,63,62,209,3,66.7
1217,3/23/2018 16:25,89,59,59,207,3,66.7
1218,3/23/2018 16:30,92,63,51,206,3,66.7
1219,3/23/2018 16:35,86,53,57,196,3,66.7
1220,3/23/2018 16:40,83,57,45,185,3,66.7
1221,3/23/2018 16:45,69,65,67,201,3,66.7
1222,3/23/2018 16:50,64,56,53,173,3,66.7
1223,3/23/2018 16:55,58,62,60,180,3,66.7
1224,3/23/2018 17:00,63,52,44,159,3,66.7
1225,3/23/2018 17:05,61,62,64,187,3,66.7
1226,3/23/2018 17:10,61,55,47,163,3,66.7
1227,3/23/2018 17:15,57,54,38,149,3,66.7
1228,3/23/2018 17:20,67,69,43,179,3,66.7
1229,3/23/2018 17:25,54,60,48,162,3,66.7
1230,3/23/2018 17:30,70,77,44,191,3,66.7
1231,3/23/2018 17:35,73,78,56,207,3,66.7
1232,3/23/2018 17:40,79,79,61,219,3,66.7
1233,3/23/2018 17:45,96,76,66,238,3,66.7
1234,3/23/2018 17:50,95,76,62,233,3,66.7
1235,3/23/2018 17:55,93,62,52,207,3,66.7
1236,3/23/2018 18:00,101,59,51,211,3,66.7
1237,3/23/2018 18:05,81,65,63,209,3,66.7
1238,3/23/2018 18:10,94,63,50,207,3,66.7
1239,3/23/2018 18:15,80,72,80,232,3,66.7
1240,3/23/2018 18:20,88,66,53,207,3,66.7
1241,3/23/2018 18:25,87,64,48,199,3,66.7
1242,3/23/2018 18:30,86,55,39,180,3,66.7
1243,3/23/2018 18:35,87,68,58,213,3,66.7
1244,3/23/2018 18:40,94,56,48,198,3,66.7
1245,3/23/2018 18:45,89,63,56,208,3,66.7
1246,3/23/2018 18:50,89,82,78,249,3,66.7
1247,3/23/2018 18:55,94,79,82,255,3,66.7
1248,3/23/2018 19:00,89,87,80,256,3,66.7
1249,3/23/2018 19:05,91,71,59,221,3,66.7
1250,3/23/2018 19:10,91,76,50,217,3,66.7
1251,3/23/2018 19:15,87,73,54,214,3,66.7
1252,3/23/2018 19:20,70,78,41,189,3,66.7
1253,3/23/2018 19:25,77,73,34,184,3,66.7
1254,3/23/2018 19:30,87,88,64,239,3,66.7
1255,3/23/2018 19:35,84,83,68,235,3,66.7
1256,3/23/2018 19:40,87,87,60,234,3,66.7
1257,3/23/2018 19:45,83,91,54,228,3,66.7
1258,3/23/2018 19:50,83,94,52,229,3,66.7
1259,3/23/2018 19:55,92,87,68,247,3,66.7
1260,3/23/2018 20:00,83,86,49,218,3,66.7
1261,3/23/2018 20:05,85,88,49,222,3,66.7
1262,3/23/2018 20:10,87,88,63,238,3,66.7
1263,3/23/2018 20:15,80,80,67,227,3,66.7
1264,3/23/2018 20:20,80,78,47,205,3,66.7
1265,3/23/2018 20:25,81,84,54,219,3,66.7
1266,3/23/2018 20:30,89,84,64,237,3,66.7
1267,3/23/2018 20:35,76,76,50,202,3,66.7
1268,3/23/2018 20:40,83,67,67,217,3,66.7
1269,3/23/2018 20:45,85,83,62,230,3,66.7
1270,3/23/2018 20:50,93,85,53,231,3,66.7
1271,3/23/2018 20:55,87,78,57,222,3,66.7
1272,3/23/2018 21:00,69,79,44,192,3,66.7
1273,3/23/2018 21:05,86,83,53,222,3,66.7
1274,3/23/2018 21:10,80,86,64,230,3,66.7
1275,3/23/2018 21:15,78,84,55,217,3,66.7
1276,3/23/2018 21:20,81,91,76,248,3,66.7
1277,3/23/2018 21:25,81,91,54,226,3,66.7
1278,3/23/2018 21:30,88,89,63,240,3,66.7
1279,3/23/2018 21:35,90,103,54,247,3,66.7
1280,3/23/2018 21:40,91,99,62,252,3,66.7
1281,3/23/2018 21:45,95,98,61,254,3,66.7
1282,3/23/2018 21:50,97,103,80,280,3,66.7
1283,3/23/2018 21:55,84,106,64,254,3,66.7
1284,3/23/2018 22:00,83,99,60,242,3,66.7
1285,3/23/2018 22:05,93,104,72,269,3,66.7
1286,3/23/2018 22:10,79,109,59,247,3,66.7
1287,3/23/2018 22:15,87,102,63,252,3,66.7
1288,3/23/2018 22:20,86,106,58,250,3,66.7
1289,3/23/2018 22:25,78,100,48,226,3,66.7
1290,3/23/2018 22:30,81,96,81,258,3,66.7
1291,3/23/2018 22:35,77,91,69,237,3,66.7
1292,3/23/2018 22:40,85,92,60,237,3,66.7
1293,3/23/2018 22:45,78,93,61,232,3,66.7
1294,3/23/2018 22:50,79,85,47,211,3,66.7
1295,3/23/2018 22:55,74,86,58,218,3,66.7
1296,3/23/2018 23:00,85,105,60,250,3,66.7
1297,3/23/2018 23:05,62,82,44,188,3,66.7
1298,3/23/2018 23:10,75,86,45,206,3,66.7
1299,3/23/2018 23:15,68,91,56,215,3,66.7
1300,3/23/2018 23:20,56,83,55,194,3,66.7
1301,3/23/2018 23:25,62,89,46,197,3,66.7
1302,3/23/2018 23:30,68,90,48,206,3,66.7
1303,3/23/2018 23:35,78,85,60,223,3,66.7
1304,3/23/2018 23:40,67,74,41,182,3,66.7
1305,3/23/2018 23:45,69,86,50,205,3,66.7
1306,3/23/2018 23:50,56,77,44,177,3,66.7
1307,3/23/2018 23:55,49,54,32,135,3,66.7
1308,3/24/2018 0:00,59,54,38,151,3,66.7
1309,3/24/2018 0:05,51,67,40,158,3,66.7
1310,3/24/2018 0:10,55,64,31,150,3,66.7
1311,3/24/2018 0:15,45,48,23,116,3,66.7
1312,3/24/2018 0:20,49,48,20,117,3,66.7
1313,3/24/2018 0:25,42,48,14,104,3,66.7
1314,3/24/2018 0:30,44,47,15,106,3,66.7
1315,3/24/2018 0:35,45,48,15,108,3,66.7
1316,3/24/2018 0:40,42,60,23,125,3,66.7
1317,3/24/2018 0:45,45,42,20,107,3,66.7
1318,3/24/2018 0:50,39,46,17,102,3,66.7
1319,3/24/2018 0:55,40,44,16,100,3,66.7
1320,3/24/2018 1:00,44,49,21,114,3,66.7
1321,3/24/2018 1:05,42,54,29,125,3,66.7
1322,3/24/2018 1:10,45,47,20,112,3,66.7
1323,3/24/2018 1:15,39,42,17,98,3,66.7
1324,3/24/2018 1:20,41,51,18,110,3,66.7
1325,3/24/2018 1:25,47,48,21,116,3,66.7
1326,3/24/2018 1:30,38,48,21,107,3,66.7
1327,3/24/2018 1:35,39,51,17,107,3,66.7
1328,3/24/2018 1:40,49,52,22,123,3,66.7
1329,3/24/2018 1:45,47,51,22,120,3,66.7
1330,3/24/2018 1:50,38,39,20,97,3,66.7
1331,3/24/2018 1:55,40,39,16,95,3,66.7
1332,3/24/2018 2:00,39,45,15,99,3,66.7
1333,3/24/2018 2:05,35,48,14,97,3,66.7
1334,3/24/2018 2:10,41,41,14,96,3,66.7
1335,3/24/2018 2:15,34,39,22,95,3,66.7
1336,3/24/2018 2:20,28,39,17,84,3,66.7
1337,3/24/2018 2:25,39,49,11,99,3,66.7
1338,3/24/2018 2:30,35,38,13,86,3,66.7
1339,3/24/2018 2:35,29,29,13,71,3,66.7
1340,3/24/2018 2:40,37,37,13,87,3,66.7
1341,3/24/2018 2:45,35,42,13,90,3,66.7
1342,3/24/2018 2:50,31,36,7,74,3,66.7
1343,3/24/2018 2:55,29,33,14,76,3,66.7
1344,3/24/2018 3:00,25,25,11,61,3,66.7
1345,3/24/2018 3:05,29,30,12,71,3,66.7
1346,3/24/2018 3:10,32,34,9,75,3,66.7
1347,3/24/2018 3:15,34,32,15,81,3,66.7
1348,3/24/2018 3:20,29,25,14,68,3,66.7
1349,3/24/2018 3:25,24,25,14,63,3,66.7
1350,3/24/2018 3:30,23,24,9,56,3,66.7
1351,3/24/2018 3:35,20,20,10,50,3,66.7
1352,3/24/2018 3:40,29,24,15,68,3,66.7
1353,3/24/2018 3:45,25,27,6,58,3,66.7
1354,3/24/2018 3:50,21,25,9,55,3,66.7
1355,3/24/2018 3:55,26,22,13,61,3,66.7
1356,3/24/2018 4:00,22,31,14,67,3,66.7
1357,3/24/2018 4:05,22,25,9,56,3,66.7
1358,3/24/2018 4:10,26,25,12,63,3,66.7
1359,3/24/2018 4:15,24,27,8,59,3,66.7
1360,3/24/2018 4:20,20,22,13,55,3,66.7
1361,3/24/2018 4:25,22,26,11,59,3,66.7
1362,3/24/2018 4:30,26,27,11,64,3,66.7
1363,3/24/2018 4:35,23,28,10,61,3,66.7
1364,3/24/2018 4:40,26,28,10,64,3,66.7
1365,3/24/2018 4:45,38,36,11,85,3,66.7
1366,3/24/2018 4:50,28,33,12,73,3,66.7
1367,3/24/2018 4:55,34,34,19,87,3,66.7
1368,3/24/2018 5:00,32,25,18,75,3,66.7
1369,3/24/2018 5:05,38,42,14,94,3,66.7
1370,3/24/2018 5:10,37,42,20,99,3,66.7
1371,3/24/2018 5:15,36,37,15,88,3,66.7
1372,3/24/2018 5:20,37,36,19,92,3,66.7
1373,3/24/2018 5:25,39,43,22,104,3,66.7
1374,3/24/2018 5:30,38,40,19,97,3,66.7
1375,3/24/2018 5:35,43,47,26,116,3,66.7
1376,3/24/2018 5:40,48,55,32,135,3,66.7
1377,3/24/2018 5:45,43,50,29,122,3,66.7
1378,3/24/2018 5:50,40,42,19,101,3,66.7
1379,3/24/2018 5:55,42,40,25,107,3,66.7
1380,3/24/2018 6:00,39,46,17,102,3,66.7
1381,3/24/2018 6:05,51,47,21,119,3,66.7
1382,3/24/2018 6:10,51,57,29,137,3,66.7
1383,3/24/2018 6:15,48,55,27,130,3,66.7
1384,3/24/2018 6:20,52,66,30,148,3,66.7
1385,3/24/2018 6:25,54,56,36,146,3,66.7
1386,3/24/2018 6:30,55,62,22,139,3,66.7
1387,3/24/2018 6:35,55,67,31,153,3,66.7
1388,3/24/2018 6:40,67,69,36,172,3,66.7
1389,3/24/2018 6:45,61,64,38,163,3,66.7
1390,3/24/2018 6:50,65,68,41,174,3,66.7
1391,3/24/2018 6:55,55,65,36,156,3,66.7
1392,3/24/2018 7:00,54,64,37,155,3,66.7
1393,3/24/2018 7:05,60,70,33,163,3,66.7
1394,3/24/2018 7:10,60,71,50,181,3,66.7
1395,3/24/2018 7:15,72,77,39,188,3,66.7
1396,3/24/2018 7:20,69,72,34,175,3,66.7
1397,3/24/2018 7:25,63,77,42,182,3,66.7
1398,3/24/2018 7:30,76,90,51,217,3,66.7
1399,3/24/2018 7:35,73,90,53,216,3,66.7
1400,3/24/2018 7:40,70,87,51,208,3,66.7
1401,3/24/2018 7:45,71,88,54,213,3,66.7
1402,3/24/2018 7:50,70,89,48,207,3,66.7
1403,3/24/2018 7:55,69,89,56,214,3,66.7
1404,3/24/2018 8:00,72,87,45,204,3,66.7
1405,3/24/2018 8:05,74,81,50,205,3,66.7
1406,3/24/2018 8:10,76,96,53,225,3,66.7
1407,3/24/2018 8:15,71,76,48,195,3,66.7
1408,3/24/2018 8:20,79,97,59,235,3,66.7
1409,3/24/2018 8:25,78,92,60,230,3,66.7
1410,3/24/2018 8:30,84,99,55,238,3,66.7
1411,3/24/2018 8:35,80,98,56,234,3,66.7
1412,3/24/2018 8:40,78,99,51,228,3,66.7
1413,3/24/2018 8:45,83,101,57,241,3,66.7
1414,3/24/2018 8:50,68,105,61,234,3,66.7
1415,3/24/2018 8:55,79,93,51,223,3,66.7
1416,3/24/2018 9:00,86,98,63,247,3,66.7
1417,3/24/2018 9:05,82,98,49,229,3,66.7
1418,3/24/2018 9:10,84,100,65,249,3,66.7
1419,3/24/2018 9:15,80,95,54,229,3,66.7
1420,3/24/2018 9:20,87,103,69,259,3,66.7
1421,3/24/2018 9:25,81,109,65,255,3,66.7
1422,3/24/2018 9:30,83,107,73,263,3,66.7
1423,3/24/2018 9:35,89,111,65,265,3,66.7
1424,3/24/2018 9:40,86,102,64,252,3,66.7
1425,3/24/2018 9:45,88,103,70,261,3,66.7
1426,3/24/2018 9:50,94,96,54,244,3,66.7
1427,3/24/2018 9:55,88,98,56,242,3,66.7
1428,3/24/2018 10:00,87,91,56,234,3,66.7
1429,3/24/2018 10:05,88,89,55,232,3,66.7
1430,3/24/2018 10:10,94,91,54,239,3,66.7
1431,3/24/2018 10:15,97,105,61,263,3,66.7
1432,3/24/2018 10:20,94,100,76,270,3,66.7
1433,3/24/2018 10:25,86,103,54,243,3,66.7
1434,3/24/2018 10:30,98,99,70,267,3,66.7
1435,3/24/2018 10:35,87,90,59,236,3,66.7
1436,3/24/2018 10:40,90,97,69,256,3,66.7
1437,3/24/2018 10:45,85,95,62,242,3,66.7
1438,3/24/2018 10:50,93,95,62,250,3,66.7
1439,3/24/2018 10:55,92,93,74,259,3,66.7
1440,3/24/2018 11:00,94,87,61,242,3,66.7
1441,3/24/2018 11:05,89,100,70,259,3,66.7
1442,3/24/2018 11:10,83,80,59,222,3,66.7
1443,3/24/2018 11:15,100,106,70,276,3,66.7
1444,3/24/2018 11:20,96,111,67,274,3,66.7
1445,3/24/2018 11:25,104,98,74,276,3,66.7
1446,3/24/2018 11:30,95,110,57,262,3,66.7
1447,3/24/2018 11:35,103,99,72,274,3,66.7
1448,3/24/2018 11:40,90,105,54,249,3,66.7
1449,3/24/2018 11:45,89,96,59,244,3,66.7
1450,3/24/2018 11:50,96,100,64,260,3,66.7
1451,3/24/2018 11:55,95,84,74,253,3,66.7
1452,3/24/2018 12:00,90,104,58,252,3,66.7
1453,3/24/2018 12:05,96,78,64,238,3,66.7
1454,3/24/2018 12:10,94,102,56,252,3,66.7
1455,3/24/2018 12:15,93,84,63,240,3,66.7
1456,3/24/2018 12:20,92,105,64,261,3,66.7
1457,3/24/2018 12:25,88,91,60,239,3,66.7
1458,3/24/2018 12:30,104,104,81,289,3,66.7
1459,3/24/2018 12:35,95,103,79,277,3,66.7
1460,3/24/2018 12:40,91,107,81,279,3,66.7
1461,3/24/2018 12:45,109,105,71,285,3,66.7
1462,3/24/2018 12:50,99,104,88,291,3,66.7
1463,3/24/2018 12:55,96,105,69,270,3,66.7
1464,3/24/2018 13:00,100,96,68,264,3,66.7
1465,3/24/2018 13:05,92,88,61,241,3,66.7
1466,3/24/2018 13:10,95,87,58,240,3,66.7
1467,3/24/2018 13:15,90,90,55,235,3,66.7
1468,3/24/2018 13:20,101,92,59,252,3,66.7
1469,3/24/2018 13:25,93,96,62,251,3,66.7
1470,3/24/2018 13:30,83,93,64,240,3,66.7
1471,3/24/2018 13:35,94,83,69,246,3,66.7
1472,3/24/2018 13:40,82,86,72,240,3,66.7
1473,3/24/2018 13:45,97,104,68,269,3,66.7
1474,3/24/2018 13:50,100,92,69,261,3,66.7
1475,3/24/2018 13:55,89,89,67,245,3,66.7
1476,3/24/2018 14:00,96,107,73,276,3,66.7
1477,3/24/2018 14:05,96,88,73,257,3,66.7
1478,3/24/2018 14:10,108,108,67,283,3,66.7
1479,3/24/2018 14:15,94,95,66,255,3,66.7
1480,3/24/2018 14:20,95,88,69,252,3,66.7
1481,3/24/2018 14:25,84,92,67,243,3,66.7
1482,3/24/2018 14:30,95,100,68,263,3,66.7
1483,3/24/2018 14:35,98,93,72,263,3,66.7
1484,3/24/2018 14:40,109,105,70,284,3,66.7
1485,3/24/2018 14:45,98,90,71,259,3,66.7
1486,3/24/2018 14:50,100,109,68,277,3,66.7
1487,3/24/2018 14:55,90,95,64,249,3,66.7
1488,3/24/2018 15:00,98,100,77,275,3,66.7
1489,3/24/2018 15:05,86,94,75,255,3,66.7
1490,3/24/2018 15:10,97,102,76,275,3,66.7
1491,3/24/2018 15:15,86,77,70,233,3,66.7
1492,3/24/2018 15:20,88,87,71,246,3,66.7
1493,3/24/2018 15:25,99,99,84,282,3,66.7
1494,3/24/2018 15:30,90,92,64,246,3,66.7
1495,3/24/2018 15:35,93,104,71,268,3,66.7
1496,3/24/2018 15:40,82,76,64,222,3,66.7
1497,3/24/2018 15:45,94,92,63,249,3,66.7
1498,3/24/2018 15:50,84,94,65,243,3,66.7
1499,3/24/2018 15:55,92,86,67,245,3,66.7
1500,3/24/2018 16:00,100,108,59,267,3,66.7
1501,3/24/2018 16:05,92,88,79,259,3,66.7
1502,3/24/2018 16:10,100,106,81,287,3,66.7
1503,3/24/2018 16:15,91,98,64,253,3,66.7
1504,3/24/2018 16:20,98,101,72,271,3,66.7
1505,3/24/2018 16:25,84,98,69,251,3,66.7
1506,3/24/2018 16:30,81,88,65,234,3,66.7
1507,3/24/2018 16:35,71,84,61,216,3,66.7
1508,3/24/2018 16:40,85,94,73,252,3,66.7
1509,3/24/2018 16:45,95,97,72,264,3,66.7
1510,3/24/2018 16:50,100,100,82,282,3,66.7
1511,3/24/2018 16:55,94,108,69,271,3,66.7
1512,3/24/2018 17:00,79,91,71,241,3,66.7
1513,3/24/2018 17:05,97,99,71,267,3,66.7
1514,3/24/2018 17:10,89,95,81,265,3,66.7
1515,3/24/2018 17:15,88,99,74,261,3,66.7
1516,3/24/2018 17:20,96,101,78,275,3,66.7
1517,3/24/2018 17:25,87,79,69,235,3,66.7
1518,3/24/2018 17:30,103,104,71,278,3,66.7
1519,3/24/2018 17:35,86,86,69,241,3,66.7
1520,3/24/2018 17:40,91,101,71,263,3,66.7
1521,3/24/2018 17:45,98,100,67,265,3,66.7
1522,3/24/2018 17:50,95,92,73,260,3,66.7
1523,3/24/2018 17:55,94,100,74,268,3,66.7
1524,3/24/2018 18:00,86,91,59,236,3,66.7
1525,3/24/2018 18:05,88,89,67,244,3,66.7
1526,3/24/2018 18:10,87,80,69,236,3,66.7
1527,3/24/2018 18:15,90,89,65,244,3,66.7
1528,3/24/2018 18:20,91,87,64,242,3,66.7
1529,3/24/2018 18:25,81,89,47,217,3,66.7
1530,3/24/2018 18:30,89,100,61,250,3,66.7
1531,3/24/2018 18:35,93,91,60,244,3,66.7
1532,3/24/2018 18:40,86,91,67,244,3,66.7
1533,3/24/2018 18:45,88,85,67,240,3,66.7
1534,3/24/2018 18:50,86,93,69,248,3,66.7
1535,3/24/2018 18:55,95,100,83,278,3,66.7
1536,3/24/2018 19:00,94,104,77,275,3,66.7
1537,3/24/2018 19:05,86,104,83,273,3,66.7
1538,3/24/2018 19:10,87,99,64,250,3,66.7
1539,3/24/2018 19:15,104,114,76,294,3,66.7
1540,3/24/2018 19:20,90,97,69,256,3,66.7
1541,3/24/2018 19:25,84,98,71,253,3,66.7
1542,3/24/2018 19:30,86,87,65,238,3,66.7
1543,3/24/2018 19:35,95,94,73,262,3,66.7
1544,3/24/2018 19:40,94,97,64,255,3,66.7
1545,3/24/2018 19:45,85,90,55,230,3,66.7
1546,3/24/2018 19:50,85,78,62,225,3,66.7
1547,3/24/2018 19:55,84,81,59,224,3,66.7
1548,3/24/2018 20:00,93,90,53,236,3,66.7
1549,3/24/2018 20:05,85,84,55,224,3,66.7
1550,3/24/2018 20:10,88,91,50,229,3,66.7
1551,3/24/2018 20:15,70,86,53,209,3,66.7
1552,3/24/2018 20:20,77,94,59,230,3,66.7
1553,3/24/2018 20:25,87,99,54,240,3,66.7
1554,3/24/2018 20:30,75,86,69,230,3,66.7
1555,3/24/2018 20:35,87,95,60,242,3,66.7
1556,3/24/2018 20:40,75,96,78,249,3,66.7
1557,3/24/2018 20:45,75,91,45,211,3,66.7
1558,3/24/2018 20:50,84,109,61,254,3,66.7
1559,3/24/2018 20:55,77,103,73,253,3,66.7
1560,3/24/2018 21:00,78,95,63,236,3,66.7
1561,3/24/2018 21:05,82,95,59,236,3,66.7
1562,3/24/2018 21:10,86,90,59,235,3,66.7
1563,3/24/2018 21:15,74,99,60,233,3,66.7
1564,3/24/2018 21:20,93,101,76,270,3,66.7
1565,3/24/2018 21:25,86,96,63,245,3,66.7
1566,3/24/2018 21:30,84,99,62,245,3,66.7
1567,3/24/2018 21:35,82,93,63,238,3,66.7
1568,3/24/2018 21:40,81,110,66,257,3,66.7
1569,3/24/2018 21:45,89,83,67,239,3,66.7
1570,3/24/2018 21:50,78,82,55,215,3,66.7
1571,3/24/2018 21:55,88,82,48,218,3,66.7
1572,3/24/2018 22:00,82,100,65,247,3,66.7
1573,3/24/2018 22:05,78,91,68,237,3,66.7
1574,3/24/2018 22:10,85,93,66,244,3,66.7
1575,3/24/2018 22:15,90,107,69,266,3,66.7
1576,3/24/2018 22:20,78,100,60,238,3,66.7
1577,3/24/2018 22:25,74,87,51,212,3,66.7
1578,3/24/2018 22:30,86,100,67,253,3,66.7
1579,3/24/2018 22:35,84,99,61,244,3,66.7
1580,3/24/2018 22:40,79,98,64,241,3,66.7
1581,3/24/2018 22:45,90,100,64,254,3,66.7
1582,3/24/2018 22:50,78,94,70,242,3,66.7
1583,3/24/2018 22:55,77,88,50,215,3,66.7
1584,3/24/2018 23:00,80,96,50,226,3,66.7
1585,3/24/2018 23:05,78,100,61,239,3,66.7
1586,3/24/2018 23:10,75,89,58,222,3,66.7
1587,3/24/2018 23:15,81,90,62,233,3,66.7
1588,3/24/2018 23:20,56,84,42,182,3,66.7
1589,3/24/2018 23:25,68,65,43,176,3,66.7
1590,3/24/2018 23:30,64,76,42,182,3,66.7
1591,3/24/2018 23:35,61,71,40,172,3,66.7
1592,3/24/2018 23:40,61,80,46,187,3,66.7
1593,3/24/2018 23:45,56,63,34,153,3,66.7
1594,3/24/2018 23:50,67,82,58,207,3,66.7
1595,3/24/2018 23:55,51,73,40,164,3,66.7
1596,3/25/2018 0:00,57,81,30,168,3,66.7
1597,3/25/2018 0:05,51,62,34,147,3,66.7
1598,3/25/2018 0:10,47,59,33,139,3,66.7
1599,3/25/2018 0:15,40,59,25,124,3,66.7
1600,3/25/2018 0:20,43,47,19,109,3,66.7
1601,3/25/2018 0:25,43,51,22,116,3,66.7
1602,3/25/2018 0:30,46,67,23,136,3,66.7
1603,3/25/2018 0:35,35,52,22,109,3,66.7
1604,3/25/2018 0:40,44,52,20,116,3,66.7
1605,3/25/2018 0:45,48,45,22,115,3,66.7
1606,3/25/2018 0:50,40,59,20,119,3,66.7
1607,3/25/2018 0:55,47,58,21,126,3,66.7
1608,3/25/2018 1:00,37,60,23,120,3,66.7
1609,3/25/2018 1:05,29,46,17,92,3,66.7
1610,3/25/2018 1:10,39,49,20,108,3,66.7
1611,3/25/2018 1:15,39,54,16,109,3,66.7
1612,3/25/2018 1:20,43,44,19,106,3,66.7
1613,3/25/2018 1:25,46,48,18,112,3,66.7
1614,3/25/2018 1:30,36,44,15,95,3,66.7
1615,3/25/2018 1:35,40,51,12,103,3,66.7
1616,3/25/2018 1:40,34,53,16,103,3,66.7
1617,3/25/2018 1:45,39,38,20,97,3,66.7
1618,3/25/2018 1:50,32,41,9,82,3,66.7
1619,3/25/2018 1:55,38,40,17,95,3,66.7
1620,3/25/2018 2:00,35,34,17,86,3,66.7
1621,3/25/2018 2:05,34,41,4,79,3,66.7
1622,3/25/2018 2:10,34,43,15,92,3,66.7
1623,3/25/2018 2:15,32,36,18,86,3,66.7
1624,3/25/2018 2:20,28,35,14,77,3,66.7
1625,3/25/2018 2:25,30,26,10,66,3,66.7
1626,3/25/2018 2:30,19,25,12,56,3,66.7
1627,3/25/2018 2:35,28,30,14,72,3,66.7
1628,3/25/2018 2:40,33,34,10,77,3,66.7
1629,3/25/2018 2:45,25,18,14,57,3,66.7
1630,3/25/2018 2:50,32,33,14,79,3,66.7
1631,3/25/2018 2:55,28,32,12,72,3,66.7
1632,3/25/2018 3:00,28,31,7,66,3,66.7
1633,3/25/2018 3:05,31,31,8,70,3,66.7
1634,3/25/2018 3:10,25,27,13,65,3,66.7
1635,3/25/2018 3:15,27,26,11,64,3,66.7
1636,3/25/2018 3:20,22,22,2,46,3,66.7
1637,3/25/2018 3:25,24,18,9,51,3,66.7
1638,3/25/2018 3:30,23,18,12,53,3,66.7
1639,3/25/2018 3:35,24,22,6,52,3,66.7
1640,3/25/2018 3:40,25,25,11,61,3,66.7
1641,3/25/2018 3:45,20,21,1,42,3,66.7
1642,3/25/2018 3:50,20,25,12,57,3,66.7
1643,3/25/2018 3:55,23,18,9,50,3,66.7
1644,3/25/2018 4:00,18,26,11,55,3,66.7
1645,3/25/2018 4:05,21,25,5,51,3,66.7
1646,3/25/2018 4:10,22,22,4,48,3,66.7
1647,3/25/2018 4:15,19,25,6,50,3,66.7
1648,3/25/2018 4:20,25,19,9,53,3,66.7
1649,3/25/2018 4:25,16,22,6,44,3,66.7
1650,3/25/2018 4:30,22,16,7,45,3,66.7
1651,3/25/2018 4:35,21,28,8,57,3,66.7
1652,3/25/2018 4:40,29,30,10,69,3,66.7
1653,3/25/2018 4:45,24,29,11,64,3,66.7
1654,3/25/2018 4:50,20,29,10,59,3,66.7
1655,3/25/2018 4:55,23,30,8,61,3,66.7
1656,3/25/2018 5:00,28,24,4,56,3,66.7
1657,3/25/2018 5:05,21,27,5,53,3,66.7
1658,3/25/2018 5:10,24,26,7,57,3,66.7
1659,3/25/2018 5:15,33,30,11,74,3,66.7
1660,3/25/2018 5:20,24,34,13,71,3,66.7
1661,3/25/2018 5:25,28,30,13,71,3,66.7
1662,3/25/2018 5:30,31,34,14,79,3,66.7
1663,3/25/2018 5:35,29,34,16,79,3,66.7
1664,3/25/2018 5:40,39,39,19,97,3,66.7
1665,3/25/2018 5:45,37,31,20,88,3,66.7
1666,3/25/2018 5:50,31,40,20,91,3,66.7
1667,3/25/2018 5:55,31,43,20,94,3,66.7
1668,3/25/2018 6:00,35,28,16,79,3,66.7
1669,3/25/2018 6:05,36,39,20,95,3,66.7
1670,3/25/2018 6:10,41,45,21,107,3,66.7
1671,3/25/2018 6:15,37,57,22,116,3,66.7
1672,3/25/2018 6:20,38,46,28,112,3,66.7
1673,3/25/2018 6:25,39,49,28,116,3,66.7
1674,3/25/2018 6:30,37,41,21,99,3,66.7
1675,3/25/2018 6:35,44,44,33,121,3,66.7
1676,3/25/2018 6:40,46,56,23,125,3,66.7
1677,3/25/2018 6:45,49,56,20,125,3,66.7
1678,3/25/2018 6:50,46,50,30,126,3,66.7
1679,3/25/2018 6:55,46,54,23,123,3,66.7
1680,3/25/2018 7:00,49,59,31,139,3,66.7
1681,3/25/2018 7:05,43,54,31,128,3,66.7
1682,3/25/2018 7:10,49,60,37,146,3,66.7
1683,3/25/2018 7:15,53,50,29,132,3,66.7
1684,3/25/2018 7:20,53,60,35,148,3,66.7
1685,3/25/2018 7:25,56,70,39,165,3,66.7
1686,3/25/2018 7:30,56,63,33,152,3,66.7
1687,3/25/2018 7:35,54,63,46,163,3,66.7
1688,3/25/2018 7:40,61,63,33,157,3,66.7
1689,3/25/2018 7:45,60,68,43,171,3,66.7
1690,3/25/2018 7:50,63,66,40,169,3,66.7
1691,3/25/2018 7:55,62,66,24,152,3,66.7
1692,3/25/2018 8:00,54,59,34,147,3,66.7
1693,3/25/2018 8:05,63,71,30,164,3,66.7
1694,3/25/2018 8:10,57,76,42,175,3,66.7
1695,3/25/2018 8:15,64,73,44,181,3,66.7
1696,3/25/2018 8:20,58,57,38,153,3,66.7
1697,3/25/2018 8:25,67,72,48,187,3,66.7
1698,3/25/2018 8:30,70,73,47,190,3,66.7
1699,3/25/2018 8:35,68,78,45,191,3,66.7
1700,3/25/2018 8:40,60,65,34,159,3,66.7
1701,3/25/2018 8:45,67,81,42,190,3,66.7
1702,3/25/2018 8:50,70,77,42,189,3,66.7
1703,3/25/2018 8:55,59,78,46,183,3,66.7
1704,3/25/2018 9:00,69,67,43,179,3,66.7
1705,3/25/2018 9:05,58,66,37,161,3,66.7
1706,3/25/2018 9:10,72,56,43,171,3,66.7
1707,3/25/2018 9:15,80,91,59,230,3,66.7
1708,3/25/2018 9:20,69,73,50,192,3,66.7
1709,3/25/2018 9:25,77,95,54,226,3,66.7
1710,3/25/2018 9:30,69,80,42,191,3,66.7
1711,3/25/2018 9:35,66,76,47,189,3,66.7
1712,3/25/2018 9:40,83,77,58,218,3,66.7
1713,3/25/2018 9:45,79,85,68,232,3,66.7
1714,3/25/2018 9:50,79,89,52,220,3,66.7
1715,3/25/2018 9:55,80,92,57,229,3,66.7
1716,3/25/2018 10:00,93,92,58,243,3,66.7
1717,3/25/2018 10:05,75,91,60,226,3,66.7
1718,3/25/2018 10:10,77,102,65,244,3,66.7
1719,3/25/2018 10:15,86,99,50,235,3,66.7
1720,3/25/2018 10:20,84,107,71,262,3,66.7
1721,3/25/2018 10:25,95,103,59,257,3,66.7
1722,3/25/2018 10:30,83,94,63,240,3,66.7
1723,3/25/2018 10:35,97,108,75,280,3,66.7
1724,3/25/2018 10:40,90,103,58,251,3,66.7
1725,3/25/2018 10:45,89,106,67,262,3,66.7
1726,3/25/2018 10:50,82,98,58,238,3,66.7
1727,3/25/2018 10:55,83,104,69,256,3,66.7
1728,3/25/2018 11:00,86,96,70,252,3,66.7
1729,3/25/2018 11:05,88,107,76,271,3,66.7
1730,3/25/2018 11:10,91,109,72,272,3,66.7
1731,3/25/2018 11:15,95,110,74,279,3,66.7
1732,3/25/2018 11:20,81,87,58,226,3,66.7
1733,3/25/2018 11:25,82,102,59,243,3,66.7
1734,3/25/2018 11:30,96,92,68,256,3,66.7
1735,3/25/2018 11:35,94,113,68,275,3,66.7
1736,3/25/2018 11:40,94,113,77,284,3,66.7
1737,3/25/2018 11:45,89,113,73,275,3,66.7
1738,3/25/2018 11:50,100,113,79,292,3,66.7
1739,3/25/2018 11:55,88,89,80,257,3,66.7
0,3/25/2018 11:00,86,96,70,252,3,66.7
1,3/25/2018 11:05,88,107,76,271,3,66.7
2,3/25/2018 11:10,91,109,72,272,3,66.7
3,3/25/2018 11:15,95,110,74,279,3,66.7
4,3/25/2018 11:20,81,87,58,226,3,66.7
5,3/25/2018 11:25,82,102,59,243,3,66.7
6,3/25/2018 11:30,96,92,68,256,3,66.7
7,3/25/2018 11:35,94,113,68,275,3,66.7
8,3/25/2018 11:40,94,113,77,284,3,66.7
9,3/25/2018 11:45,89,113,73,275,3,66.7
10,3/25/2018 11:50,100,113,79,292,3,66.7
11,3/25/2018 11:55,88,89,80,257,3,66.7
12,3/25/2018 12:00,85,99,58,242,3,66.7
13,3/25/2018 12:05,100,91,71,262,3,66.7
14,3/25/2018 12:10,92,87,53,232,3,66.7
15,3/25/2018 12:15,72,71,42,185,3,66.7
16,3/25/2018 12:20,64,69,46,179,3,66.7
17,3/25/2018 12:25,67,66,43,176,3,66.7
18,3/25/2018 12:30,80,73,49,202,3,66.7
19,3/25/2018 12:35,84,94,57,235,3,66.7
20,3/25/2018 12:40,100,99,68,267,3,66.7
21,3/25/2018 12:45,94,112,73,279,3,66.7
22,3/25/2018 12:50,98,104,74,276,3,66.7
23,3/25/2018 12:55,86,98,64,248,3,66.7
24,3/25/2018 13:00,93,95,60,248,3,66.7
25,3/25/2018 13:05,85,82,56,223,3,66.7
26,3/25/2018 13:10,96,92,71,259,3,66.7
27,3/25/2018 13:15,85,106,59,250,3,66.7
28,3/25/2018 13:20,89,82,49,220,3,66.7
29,3/25/2018 13:25,84,77,61,222,3,66.7
30,3/25/2018 13:30,93,94,73,260,3,66.7
31,3/25/2018 13:35,97,95,61,253,3,66.7
32,3/25/2018 13:40,97,105,52,254,3,66.7
33,3/25/2018 13:45,95,92,81,268,3,66.7
34,3/25/2018 13:50,87,89,62,238,3,66.7
35,3/25/2018 13:55,100,107,64,271,3,66.7
36,3/25/2018 14:00,97,108,66,271,3,66.7
37,3/25/2018 14:05,106,94,66,266,3,66.7
38,3/25/2018 14:10,95,109,82,286,3,66.7
39,3/25/2018 14:15,88,89,70,247,3,66.7
40,3/25/2018 14:20,79,97,66,242,3,66.7
41,3/25/2018 14:25,79,88,63,230,3,66.7
42,3/25/2018 14:30,82,90,63,235,3,66.7
43,3/25/2018 14:35,96,93,68,257,3,66.7
44,3/25/2018 14:40,78,80,56,214,3,66.7
45,3/25/2018 14:45,85,96,59,240,3,66.7
46,3/25/2018 14:50,96,98,64,258,3,66.7
47,3/25/2018 14:55,92,99,57,248,3,66.7
48,3/25/2018 15:00,91,95,75,261,3,66.7
49,3/25/2018 15:05,97,99,77,273,3,66.7
50,3/25/2018 15:10,94,96,68,258,3,66.7
51,3/25/2018 15:15,98,92,70,260,3,66.7
52,3/25/2018 15:20,92,96,65,253,3,66.7
53,3/25/2018 15:25,93,99,67,259,3,66.7
54,3/25/2018 15:30,103,100,59,262,3,66.7
55,3/25/2018 15:35,87,92,65,244,3,66.7
56,3/25/2018 15:40,90,85,57,232,3,66.7
57,3/25/2018 15:45,94,94,72,260,3,66.7
58,3/25/2018 15:50,94,111,76,281,3,66.7
59,3/25/2018 15:55,87,97,65,249,3,66.7
60,3/25/2018 16:00,80,79,74,233,3,66.7
61,3/25/2018 16:05,68,90,54,212,3,66.7
62,3/25/2018 16:10,91,100,70,261,3,66.7
63,3/25/2018 16:15,97,100,77,274,3,66.7
64,3/25/2018 16:20,85,93,74,252,3,66.7
65,3/25/2018 16:25,81,81,63,225,3,66.7
66,3/25/2018 16:30,78,86,60,224,3,66.7
67,3/25/2018 16:35,93,83,49,225,3,66.7
68,3/25/2018 16:40,89,83,63,235,3,66.7
69,3/25/2018 16:45,95,104,68,267,3,66.7
70,3/25/2018 16:50,90,82,53,225,3,66.7
71,3/25/2018 16:55,83,79,61,223,3,66.7
72,3/25/2018 17:00,83,95,62,240,3,66.7
73,3/25/2018 17:05,88,98,67,253,3,66.7
74,3/25/2018 17:10,86,89,73,248,3,66.7
75,3/25/2018 17:15,95,116,71,282,3,66.7
76,3/25/2018 17:20,83,103,75,261,3,66.7
77,3/25/2018 17:25,87,99,65,251,3,66.7
78,3/25/2018 17:30,85,100,60,245,3,66.7
79,3/25/2018 17:35,89,105,71,265,3,66.7
80,3/25/2018 17:40,90,101,68,259,3,66.7
81,3/25/2018 17:45,88,98,73,259,3,66.7
82,3/25/2018 17:50,94,89,75,258,3,66.7
83,3/25/2018 17:55,83,99,58,240,3,66.7
84,3/25/2018 18:00,87,83,81,251,3,66.7
85,3/25/2018 18:05,84,106,73,263,3,66.7
86,3/25/2018 18:10,88,113,77,278,3,66.7
87,3/25/2018 18:15,78,96,68,242,3,66.7
88,3/25/2018 18:20,91,104,70,265,3,66.7
89,3/25/2018 18:25,94,101,74,269,3,66.7
90,3/25/2018 18:30,86,96,60,242,3,66.7
91,3/25/2018 18:35,79,99,56,234,3,66.7
92,3/25/2018 18:40,93,94,65,252,3,66.7
93,3/25/2018 18:45,86,101,63,250,3,66.7
94,3/25/2018 18:50,86,91,57,234,3,66.7
95,3/25/2018 18:55,85,95,68,248,3,66.7
96,3/25/2018 19:00,95,96,71,262,3,66.7
97,3/25/2018 19:05,76,94,62,232,3,66.7
98,3/25/2018 19:10,80,91,69,240,3,66.7
99,3/25/2018 19:15,79,82,66,227,3,66.7
100,3/25/2018 19:20,80,82,57,219,3,66.7
101,3/25/2018 19:25,84,91,71,246,3,66.7
102,3/25/2018 19:30,77,102,55,234,3,66.7
103,3/25/2018 19:35,93,92,73,258,3,66.7
104,3/25/2018 19:40,86,90,63,239,3,66.7
105,3/25/2018 19:45,87,89,68,244,3,66.7
106,3/25/2018 19:50,92,114,75,281,3,66.7
107,3/25/2018 19:55,84,85,67,236,3,66.7
108,3/25/2018 20:00,77,87,51,215,3,66.7
109,3/25/2018 20:05,72,99,59,230,3,66.7
110,3/25/2018 20:10,72,85,60,217,3,66.7
111,3/25/2018 20:15,88,105,66,259,3,66.7
112,3/25/2018 20:20,79,98,67,244,3,66.7
113,3/25/2018 20:25,78,82,66,226,3,66.7
114,3/25/2018 20:30,80,95,58,233,3,66.7
115,3/25/2018 20:35,75,86,48,209,3,66.7
116,3/25/2018 20:40,81,91,62,234,3,66.7
117,3/25/2018 20:45,84,81,58,223,3,66.7
118,3/25/2018 20:50,89,94,72,255,3,66.7
119,3/25/2018 20:55,77,104,59,240,3,66.7
120,3/25/2018 21:00,81,96,57,234,3,66.7
121,3/25/2018 21:05,70,96,52,218,3,66.7
122,3/25/2018 21:10,80,93,55,228,3,66.7
123,3/25/2018 21:15,80,94,60,234,3,66.7
124,3/25/2018 21:20,75,104,55,234,3,66.7
125,3/25/2018 21:25,85,99,52,236,3,66.7
126,3/25/2018 21:30,83,112,71,266,3,66.7
127,3/25/2018 21:35,71,86,55,212,3,66.7
128,3/25/2018 21:40,69,100,61,230,3,66.7
129,3/25/2018 21:45,68,95,62,225,3,66.7
130,3/25/2018 21:50,72,79,59,210,3,66.7
131,3/25/2018 21:55,77,96,66,239,3,66.7
132,3/25/2018 22:00,64,87,46,197,3,66.7
133,3/25/2018 22:05,74,92,56,222,3,66.7
134,3/25/2018 22:10,75,88,52,215,3,66.7
135,3/25/2018 22:15,76,100,54,230,3,66.7
136,3/25/2018 22:20,60,86,48,194,3,66.7
137,3/25/2018 22:25,71,88,54,213,3,66.7
138,3/25/2018 22:30,78,90,59,227,3,66.7
139,3/25/2018 22:35,76,96,62,234,3,66.7
140,3/25/2018 22:40,71,86,54,211,3,66.7
141,3/25/2018 22:45,79,101,63,243,3,66.7
142,3/25/2018 22:50,63,72,48,183,3,66.7
143,3/25/2018 22:55,60,71,43,174,3,66.7
144,3/25/2018 23:00,63,75,44,182,3,66.7
145,3/25/2018 23:05,71,75,55,201,3,66.7
146,3/25/2018 23:10,66,87,51,204,3,66.7
147,3/25/2018 23:15,65,73,56,194,3,66.7
148,3/25/2018 23:20,61,77,50,188,3,66.7
149,3/25/2018 23:25,56,73,43,172,3,66.7
150,3/25/2018 23:30,54,71,31,156,3,66.7
151,3/25/2018 23:35,53,51,37,141,3,66.7
152,3/25/2018 23:40,59,84,44,187,3,66.7
153,3/25/2018 23:45,50,64,27,141,3,66.7
154,3/25/2018 23:50,62,87,47,196,3,66.7
155,3/25/2018 23:55,58,67,40,165,3,66.7
156,3/26/2018 0:00,54,63,28,145,3,66.7
157,3/26/2018 0:05,40,60,28,128,3,66.7
158,3/26/2018 0:10,49,52,34,135,3,66.7
159,3/26/2018 0:15,54,61,35,150,3,66.7
160,3/26/2018 0:20,46,50,29,125,3,66.7
161,3/26/2018 0:25,49,51,45,145,3,66.7
162,3/26/2018 0:30,52,56,32,140,3,66.7
163,3/26/2018 0:35,39,50,29,118,3,66.7
164,3/26/2018 0:40,44,55,22,121,3,66.7
165,3/26/2018 0:45,39,39,21,99,3,66.7
166,3/26/2018 0:50,38,40,25,103,3,66.7
167,3/26/2018 0:55,37,40,19,96,3,66.7
168,3/26/2018 1:00,33,43,22,98,3,66.7
169,3/26/2018 1:05,36,44,21,101,3,66.7
170,3/26/2018 1:10,17,24,10,51,3,66.7
171,3/26/2018 1:15,19,12,8,39,3,66.7
172,3/26/2018 1:20,13,10,7,30,3,66.7
173,3/26/2018 1:25,61,56,35,152,3,66.7
174,3/26/2018 1:30,52,98,39,189,3,66.7
175,3/26/2018 1:35,21,34,17,72,3,66.7
176,3/26/2018 1:40,30,33,18,81,3,66.7
177,3/26/2018 1:45,34,35,14,83,3,66.7
178,3/26/2018 1:50,33,29,18,80,3,66.7
179,3/26/2018 1:55,36,37,12,85,3,66.7
180,3/26/2018 2:00,25,24,16,65,3,66.7
181,3/26/2018 2:05,28,34,15,77,3,66.7
182,3/26/2018 2:10,26,22,13,61,3,66.7
183,3/26/2018 2:15,25,29,12,66,3,66.7
184,3/26/2018 2:20,25,28,15,68,3,66.7
185,3/26/2018 2:25,24,18,13,55,3,66.7
186,3/26/2018 2:30,21,26,13,60,3,66.7
187,3/26/2018 2:35,23,17,12,52,3,66.7
188,3/26/2018 2:40,21,16,16,53,3,66.7
189,3/26/2018 2:45,17,14,10,41,3,66.7
190,3/26/2018 2:50,25,25,9,59,3,66.7
191,3/26/2018 2:55,27,27,16,70,3,66.7
192,3/26/2018 3:00,21,17,10,48,3,66.7
193,3/26/2018 3:05,20,20,11,51,3,66.7
194,3/26/2018 3:10,23,21,14,58,3,66.7
195,3/26/2018 3:15,19,19,8,46,3,66.7
196,3/26/2018 3:20,20,18,7,45,3,66.7
197,3/26/2018 3:25,22,18,14,54,3,66.7
198,3/26/2018 3:30,25,28,14,67,3,66.7
199,3/26/2018 3:35,21,20,9,50,3,66.7
200,3/26/2018 3:40,23,26,6,55,3,66.7
201,3/26/2018 3:45,22,20,10,52,3,66.7
202,3/26/2018 3:50,22,23,11,56,3,66.7
203,3/26/2018 3:55,28,18,13,59,3,66.7
204,3/26/2018 4:00,28,27,14,69,3,66.7
205,3/26/2018 4:05,22,24,11,57,3,66.7
206,3/26/2018 4:10,28,25,11,64,3,66.7
207,3/26/2018 4:15,30,33,11,74,3,66.7
208,3/26/2018 4:20,29,29,14,72,3,66.7
209,3/26/2018 4:25,28,33,18,79,3,66.7
210,3/26/2018 4:30,31,34,20,85,3,66.7
211,3/26/2018 4:35,37,29,21,87,3,66.7
212,3/26/2018 4:40,35,35,18,88,3,66.7
213,3/26/2018 4:45,33,38,11,82,3,66.7
214,3/26/2018 4:50,46,41,19,106,3,66.7
215,3/26/2018 4:55,36,41,20,97,3,66.7
216,3/26/2018 5:00,39,49,11,99,3,66.7
217,3/26/2018 5:05,46,49,17,112,3,66.7
218,3/26/2018 5:10,40,37,20,97,3,66.7
219,3/26/2018 5:15,47,47,20,114,3,66.7
220,3/26/2018 5:20,46,52,20,118,3,66.7
221,3/26/2018 5:25,60,67,28,155,3,66.7
222,3/26/2018 5:30,54,57,35,146,3,66.7
223,3/26/2018 5:35,62,56,28,146,3,66.7
224,3/26/2018 5:40,62,66,30,158,3,66.7
225,3/26/2018 5:45,60,57,31,148,3,66.7
226,3/26/2018 5:50,50,51,30,131,3,66.7
227,3/26/2018 5:55,59,55,36,150,3,66.7
228,3/26/2018 6:00,59,59,31,149,3,66.7
229,3/26/2018 6:05,56,60,32,148,3,66.7
230,3/26/2018 6:10,66,61,40,167,3,66.7
231,3/26/2018 6:15,75,78,37,190,3,66.7
232,3/26/2018 6:20,67,81,41,189,3,66.7
233,3/26/2018 6:25,70,76,40,186,3,66.7
234,3/26/2018 6:30,73,77,32,182,3,66.7
235,3/26/2018 6:35,73,74,33,180,3,66.7
236,3/26/2018 6:40,74,75,34,183,3,66.7
237,3/26/2018 6:45,64,68,52,184,3,66.7
238,3/26/2018 6:50,75,79,41,195,3,66.7
239,3/26/2018 6:55,67,74,45,186,3,66.7
240,3/26/2018 7:00,68,65,36,169,3,66.7
241,3/26/2018 7:05,76,86,45,207,3,66.7
242,3/26/2018 7:10,72,73,49,194,3,66.7
243,3/26/2018 7:15,91,99,47,237,3,66.7
244,3/26/2018 7:20,88,88,56,232,3,66.7
245,3/26/2018 7:25,91,86,60,237,3,66.7
246,3/26/2018 7:30,95,107,45,247,3,66.7
247,3/26/2018 7:35,93,91,60,244,3,66.7
248,3/26/2018 7:40,89,95,59,243,3,66.7
249,3/26/2018 7:45,73,89,58,220,3,66.7
250,3/26/2018 7:50,83,83,48,214,3,66.7
251,3/26/2018 7:55,92,102,45,239,3,66.7
252,3/26/2018 8:00,80,76,39,195,3,66.7
253,3/26/2018 8:05,86,90,49,225,3,66.7
254,3/26/2018 8:10,89,90,45,224,3,66.7
255,3/26/2018 8:15,99,90,49,238,3,66.7
256,3/26/2018 8:20,94,93,58,245,3,66.7
257,3/26/2018 8:25,92,96,56,244,3,66.7
258,3/26/2018 8:30,78,90,55,223,3,66.7
259,3/26/2018 8:35,81,79,50,210,3,66.7
260,3/26/2018 8:40,82,82,51,215,3,66.7
261,3/26/2018 8:45,86,98,59,243,3,66.7
262,3/26/2018 8:50,77,83,45,205,3,66.7
263,3/26/2018 8:55,71,70,50,191,3,66.7
264,3/26/2018 9:00,86,87,46,219,3,66.7
265,3/26/2018 9:05,81,74,47,202,3,66.7
266,3/26/2018 9:10,81,89,45,215,3,66.7
267,3/26/2018 9:15,79,84,40,203,3,66.7
268,3/26/2018 9:20,76,84,54,214,3,66.7
269,3/26/2018 9:25,93,90,53,236,3,66.7
270,3/26/2018 9:30,84,100,53,237,3,66.7
271,3/26/2018 9:35,79,112,59,250,3,66.7
272,3/26/2018 9:40,77,96,44,217,3,66.7
273,3/26/2018 9:45,85,102,64,251,3,66.7
274,3/26/2018 9:50,81,103,61,245,3,66.7
275,3/26/2018 9:55,79,76,48,203,3,66.7
276,3/26/2018 10:00,85,97,49,231,3,66.7
277,3/26/2018 10:05,78,85,50,213,3,66.7
278,3/26/2018 10:10,77,102,54,233,3,66.7
279,3/26/2018 10:15,73,94,46,213,3,66.7
280,3/26/2018 10:20,82,112,64,258,3,66.7
281,3/26/2018 10:25,88,106,55,249,3,66.7
282,3/26/2018 10:30,80,95,60,235,3,66.7
283,3/26/2018 10:35,83,105,46,234,3,66.7
284,3/26/2018 10:40,90,99,67,256,3,66.7
285,3/26/2018 10:45,85,96,65,246,3,66.7
286,3/26/2018 10:50,92,105,67,264,3,66.7
287,3/26/2018 10:55,75,92,53,220,3,66.7
288,3/26/2018 11:00,78,94,61,233,3,66.7
289,3/26/2018 11:05,84,91,67,242,3,66.7
290,3/26/2018 11:10,82,97,60,239,3,66.7
291,3/26/2018 11:15,87,89,70,246,3,66.7
292,3/26/2018 11:20,88,99,66,253,3,66.7
293,3/26/2018 11:25,88,96,62,246,3,66.7
294,3/26/2018 11:30,89,111,69,269,3,66.7
295,3/26/2018 11:35,82,103,63,248,3,66.7
296,3/26/2018 11:40,86,93,60,239,3,66.7
297,3/26/2018 11:45,103,108,56,267,3,66.7
298,3/26/2018 11:50,85,93,54,232,3,66.7
299,3/26/2018 11:55,91,97,66,254,3,66.7
300,3/26/2018 12:00,83,85,58,226,3,66.7
301,3/26/2018 12:05,81,79,60,220,3,66.7
302,3/26/2018 12:10,85,82,56,223,3,66.7
303,3/26/2018 12:15,88,94,67,249,3,66.7
304,3/26/2018 12:20,84,89,59,232,3,66.7
305,3/26/2018 12:25,91,100,67,258,3,66.7
306,3/26/2018 12:30,93,94,66,253,3,66.7
307,3/26/2018 12:35,83,102,70,255,3,66.7
308,3/26/2018 12:40,89,91,62,242,3,66.7
309,3/26/2018 12:45,93,99,70,262,3,66.7
310,3/26/2018 12:50,88,99,63,250,3,66.7
311,3/26/2018 12:55,98,101,63,262,3,66.7
312,3/26/2018 13:00,86,86,54,226,3,66.7
313,3/26/2018 13:05,84,95,54,233,3,66.7
314,3/26/2018 13:10,85,86,68,239,3,66.7
315,3/26/2018 13:15,89,87,57,233,3,66.7
316,3/26/2018 13:20,78,90,61,229,3,66.7
317,3/26/2018 13:25,80,86,59,225,3,66.7
318,3/26/2018 13:30,90,87,55,232,3,66.7
319,3/26/2018 13:35,90,102,65,257,3,66.7
320,3/26/2018 13:40,91,95,65,251,3,66.7
321,3/26/2018 13:45,90,97,65,252,3,66.7
322,3/26/2018 13:50,92,94,73,259,3,66.7
323,3/26/2018 13:55,100,98,67,265,3,66.7
324,3/26/2018 14:00,96,100,79,275,3,66.7
325,3/26/2018 14:05,83,97,67,247,3,66.7
326,3/26/2018 14:10,87,75,55,217,3,66.7
327,3/26/2018 14:15,95,94,60,249,3,66.7
328,3/26/2018 14:20,98,88,78,264,3,66.7
329,3/26/2018 14:25,107,110,68,285,3,66.7
330,3/26/2018 14:30,101,106,68,275,3,66.7
331,3/26/2018 14:35,92,93,67,252,3,66.7
332,3/26/2018 14:40,104,99,66,269,3,66.7
333,3/26/2018 14:45,103,105,79,287,3,66.7
334,3/26/2018 14:50,91,100,74,265,3,66.7
335,3/26/2018 14:55,89,97,72,258,3,66.7
336,3/26/2018 15:00,90,97,91,278,3,66.7
337,3/26/2018 15:05,96,97,77,270,3,66.7
338,3/26/2018 15:10,69,77,47,193,3,66.7
339,3/26/2018 15:15,102,83,72,257,3,66.7
340,3/26/2018 15:20,103,109,71,283,3,66.7
341,3/26/2018 15:25,100,87,63,250,3,66.7
342,3/26/2018 15:30,104,100,67,271,3,66.7
343,3/26/2018 15:35,94,98,81,273,3,66.7
344,3/26/2018 15:40,107,107,70,284,3,66.7
345,3/26/2018 15:45,104,97,71,272,3,66.7
346,3/26/2018 15:50,105,77,77,259,3,66.7
347,3/26/2018 15:55,107,76,69,252,3,66.7
348,3/26/2018 16:00,86,68,58,212,3,66.7
349,3/26/2018 16:05,90,81,69,240,3,66.7
350,3/26/2018 16:10,102,69,71,242,3,66.7
351,3/26/2018 16:15,89,69,57,215,3,66.7
352,3/26/2018 16:20,92,77,59,228,3,66.7
353,3/26/2018 16:25,100,98,80,278,3,66.7
354,3/26/2018 16:30,102,79,80,261,3,66.7
355,3/26/2018 16:35,100,73,62,235,3,66.7
356,3/26/2018 16:40,103,89,76,268,3,66.7
357,3/26/2018 16:45,92,62,62,216,3,66.7
358,3/26/2018 16:50,97,72,69,238,3,66.7
359,3/26/2018 16:55,107,94,78,279,3,66.7
360,3/26/2018 17:00,88,71,73,232,3,66.7
361,3/26/2018 17:05,86,81,60,227,3,66.7
362,3/26/2018 17:10,86,98,86,270,3,66.7
363,3/26/2018 17:15,89,64,78,231,3,66.7
364,3/26/2018 17:20,90,76,83,249,3,66.7
365,3/26/2018 17:25,95,62,64,221,3,66.7
366,3/26/2018 17:30,90,73,61,224,3,66.7
367,3/26/2018 17:35,91,77,69,237,3,66.7
368,3/26/2018 17:40,84,71,71,226,3,66.7
369,3/26/2018 17:45,85,71,61,217,3,66.7
370,3/26/2018 17:50,87,88,63,238,3,66.7
371,3/26/2018 17:55,89,96,73,258,3,66.7
372,3/26/2018 18:00,99,69,49,217,3,66.7
373,3/26/2018 18:05,92,62,63,217,3,66.7
374,3/26/2018 18:10,99,88,68,255,3,66.7
375,3/26/2018 18:15,90,77,87,254,3,66.7
376,3/26/2018 18:20,84,76,71,231,3,66.7
377,3/26/2018 18:25,101,82,57,240,3,66.7
378,3/26/2018 18:30,97,88,61,246,3,66.7
379,3/26/2018 18:35,88,80,57,225,3,66.7
380,3/26/2018 18:40,88,92,66,246,3,66.7
381,3/26/2018 18:45,90,88,67,245,3,66.7
382,3/26/2018 18:50,98,100,64,262,3,66.7
383,3/26/2018 18:55,92,92,70,254,3,66.7
384,3/26/2018 19:00,94,93,72,259,3,66.7
385,3/26/2018 19:05,89,73,60,222,3,66.7
386,3/26/2018 19:10,84,82,55,221,3,66.7
387,3/26/2018 19:15,94,86,60,240,3,66.7
388,3/26/2018 19:20,95,91,55,241,3,66.7
389,3/26/2018 19:25,87,97,67,251,3,66.7
390,3/26/2018 19:30,92,86,60,238,3,66.7
391,3/26/2018 19:35,91,77,67,235,3,66.7
392,3/26/2018 19:40,97,107,78,282,3,66.7
393,3/26/2018 19:45,82,84,57,223,3,66.7
394,3/26/2018 19:50,92,115,56,263,3,66.7
395,3/26/2018 19:55,88,94,62,244,3,66.7
396,3/26/2018 20:00,93,102,70,265,3,66.7
397,3/26/2018 20:05,83,97,67,247,3,66.7
398,3/26/2018 20:10,93,105,70,268,3,66.7
399,3/26/2018 20:15,83,101,54,238,3,66.7
400,3/26/2018 20:20,86,98,57,241,3,66.7
401,3/26/2018 20:25,95,111,77,283,3,66.7
402,3/26/2018 20:30,79,111,62,252,3,66.7
403,3/26/2018 20:35,76,81,62,219,3,66.7
404,3/26/2018 20:40,83,81,71,235,3,66.7
405,3/26/2018 20:45,87,98,64,249,3,66.7
406,3/26/2018 20:50,86,96,66,248,3,66.7
407,3/26/2018 20:55,78,92,64,234,3,66.7
408,3/26/2018 21:00,82,103,69,254,3,66.7
409,3/26/2018 21:05,85,82,64,231,3,66.7
410,3/26/2018 21:10,74,95,66,235,3,66.7
411,3/26/2018 21:15,87,91,73,251,3,66.7
412,3/26/2018 21:20,84,96,63,243,3,66.7
413,3/26/2018 21:25,78,99,58,235,3,66.7
414,3/26/2018 21:30,83,102,60,245,3,66.7
415,3/26/2018 21:35,80,99,54,233,3,66.7
416,3/26/2018 21:40,64,86,56,206,3,66.7
417,3/26/2018 21:45,75,88,66,229,3,66.7
418,3/26/2018 21:50,71,88,53,212,3,66.7
419,3/26/2018 21:55,63,100,50,213,3,66.7
420,3/26/2018 22:00,74,86,46,206,3,66.7
421,3/26/2018 22:05,71,87,62,220,3,66.7
422,3/26/2018 22:10,62,82,50,194,3,66.7
423,3/26/2018 22:15,78,97,54,229,3,66.7
424,3/26/2018 22:20,71,98,50,219,3,66.7
425,3/26/2018 22:25,79,95,53,227,3,66.7
426,3/26/2018 22:30,68,88,54,210,3,66.7
427,3/26/2018 22:35,67,91,54,212,3,66.7
428,3/26/2018 22:40,73,105,65,243,3,66.7
429,3/26/2018 22:45,53,69,34,156,3,66.7
430,3/26/2018 22:50,55,74,42,171,3,66.7
431,3/26/2018 22:55,59,72,41,172,3,66.7
432,3/26/2018 23:00,57,71,31,159,3,66.7
433,3/26/2018 23:05,47,74,26,147,3,66.7
434,3/26/2018 23:10,52,78,32,162,3,66.7
435,3/26/2018 23:15,58,77,47,182,3,66.7
436,3/26/2018 23:20,61,67,36,164,3,66.7
437,3/26/2018 23:25,54,65,43,162,3,66.7
438,3/26/2018 23:30,54,70,39,163,3,66.7
439,3/26/2018 23:35,54,65,42,161,3,66.7
440,3/26/2018 23:40,56,70,26,152,3,66.7
441,3/26/2018 23:45,52,62,34,148,3,66.7
442,3/26/2018 23:50,53,61,22,136,3,66.7
443,3/26/2018 23:55,42,63,32,137,3,66.7
444,3/27/2018 0:00,50,55,27,132,3,66.7
445,3/27/2018 0:05,39,55,16,110,3,66.7
446,3/27/2018 0:10,41,72,27,140,3,66.7
447,3/27/2018 0:15,45,57,30,132,3,66.7
448,3/27/2018 0:20,46,52,36,134,3,66.7
449,3/27/2018 0:25,47,63,29,139,3,66.7
450,3/27/2018 0:30,48,48,25,121,3,66.7
451,3/27/2018 0:35,44,55,21,120,3,66.7
452,3/27/2018 0:40,38,47,20,105,3,66.7
453,3/27/2018 0:45,43,50,20,113,3,66.7
454,3/27/2018 0:50,38,50,23,111,3,66.7
455,3/27/2018 0:55,36,49,24,109,3,66.7
456,3/27/2018 1:00,41,50,29,120,3,66.7
457,3/27/2018 1:05,39,47,22,108,3,66.7
458,3/27/2018 1:10,40,48,22,110,3,66.7
459,3/27/2018 1:15,38,47,22,107,3,66.7
460,3/27/2018 1:20,35,50,19,104,3,66.7
461,3/27/2018 1:25,26,26,17,69,3,66.7
462,3/27/2018 1:30,34,39,20,93,3,66.7
463,3/27/2018 1:35,39,39,18,96,3,66.7
464,3/27/2018 1:40,38,48,19,105,3,66.7
465,3/27/2018 1:45,35,42,25,102,3,66.7
466,3/27/2018 1:50,35,35,18,88,3,66.7
467,3/27/2018 1:55,29,30,13,72,3,66.7
468,3/27/2018 2:00,27,34,14,75,3,66.7
469,3/27/2018 2:05,27,28,17,72,3,66.7
470,3/27/2018 2:10,36,39,14,89,3,66.7
471,3/27/2018 2:15,29,31,13,73,3,66.7
472,3/27/2018 2:20,25,30,15,70,3,66.7
473,3/27/2018 2:25,26,31,16,73,3,66.7
474,3/27/2018 2:30,28,27,15,70,3,66.7
475,3/27/2018 2:35,30,31,16,77,3,66.7
476,3/27/2018 2:40,31,25,15,71,3,66.7
477,3/27/2018 2:45,22,32,10,64,3,66.7
478,3/27/2018 2:50,20,20,8,48,3,66.7
479,3/27/2018 2:55,25,30,18,73,3,66.7
480,3/27/2018 3:00,19,18,12,49,3,66.7
481,3/27/2018 3:05,25,21,12,58,3,66.7
482,3/27/2018 3:10,24,22,12,58,3,66.7
483,3/27/2018 3:15,25,25,14,64,3,66.7
484,3/27/2018 3:20,18,18,15,51,3,66.7
485,3/27/2018 3:25,19,25,10,54,3,66.7
486,3/27/2018 3:30,24,21,11,56,3,66.7
487,3/27/2018 3:35,28,31,15,74,3,66.7
488,3/27/2018 3:40,28,35,8,71,3,66.7
489,3/27/2018 3:45,22,21,12,55,3,66.7
490,3/27/2018 3:50,25,24,11,60,3,66.7
491,3/27/2018 3:55,22,22,12,56,3,66.7
492,3/27/2018 4:00,24,20,13,57,3,66.7
493,3/27/2018 4:05,33,34,22,89,3,66.7
494,3/27/2018 4:10,29,27,14,70,3,66.7
495,3/27/2018 4:15,29,27,20,76,3,66.7
496,3/27/2018 4:20,24,22,18,64,3,66.7
497,3/27/2018 4:25,37,41,19,97,3,66.7
498,3/27/2018 4:30,37,35,19,91,3,66.7
499,3/27/2018 4:35,40,48,14,102,3,66.7
500,3/27/2018 4:40,46,45,27,118,3,66.7
501,3/27/2018 4:45,43,40,29,112,3,66.7
502,3/27/2018 4:50,36,38,19,93,3,66.7
503,3/27/2018 4:55,46,45,26,117,3,66.7
504,3/27/2018 5:00,34,39,21,94,3,66.7
505,3/27/2018 5:05,50,48,21,119,3,66.7
506,3/27/2018 5:10,43,49,19,111,3,66.7
507,3/27/2018 5:15,55,54,30,139,3,66.7
508,3/27/2018 5:20,65,60,27,152,3,66.7
509,3/27/2018 5:25,53,59,35,147,3,66.7
510,3/27/2018 5:30,48,47,27,122,3,66.7
511,3/27/2018 5:35,55,61,27,143,3,66.7
512,3/27/2018 5:40,66,63,35,164,3,66.7
513,3/27/2018 5:45,58,67,26,151,3,66.7
514,3/27/2018 5:50,62,78,30,170,3,66.7
515,3/27/2018 5:55,58,57,30,145,3,66.7
516,3/27/2018 6:00,62,70,33,165,3,66.7
517,3/27/2018 6:05,66,70,37,173,3,66.7
518,3/27/2018 6:10,74,80,43,197,3,66.7
519,3/27/2018 6:15,73,79,41,193,3,66.7
520,3/27/2018 6:20,76,90,42,208,3,66.7
521,3/27/2018 6:25,68,84,50,202,3,66.7
522,3/27/2018 6:30,63,82,48,193,3,66.7
523,3/27/2018 6:35,70,79,33,182,3,66.7
524,3/27/2018 6:40,76,87,54,217,3,66.7
525,3/27/2018 6:45,87,96,47,230,3,66.7
526,3/27/2018 6:50,93,95,50,238,3,66.7
527,3/27/2018 6:55,73,97,53,223,3,66.7
528,3/27/2018 7:00,76,79,41,196,3,66.7
529,3/27/2018 7:05,84,83,47,214,3,66.7
530,3/27/2018 7:10,77,91,49,217,3,66.7
531,3/27/2018 7:15,82,98,44,224,3,66.7
532,3/27/2018 7:20,89,96,62,247,3,66.7
533,3/27/2018 7:25,83,107,61,251,3,66.7
534,3/27/2018 7:30,99,93,64,256,3,66.7
535,3/27/2018 7:35,97,104,56,257,3,66.7
536,3/27/2018 7:40,103,109,58,270,3,66.7
537,3/27/2018 7:45,88,102,52,242,3,66.7
538,3/27/2018 7:50,88,82,48,218,3,66.7
539,3/27/2018 7:55,79,87,48,214,3,66.7
540,3/27/2018 8:00,97,92,50,239,3,66.7
541,3/27/2018 8:05,87,105,50,242,3,66.7
542,3/27/2018 8:10,82,94,47,223,3,66.7
543,3/27/2018 8:15,87,96,50,233,3,66.7
544,3/27/2018 8:20,103,96,65,264,3,66.7
545,3/27/2018 8:25,96,113,61,270,3,66.7
546,3/27/2018 8:30,88,100,52,240,3,66.7
547,3/27/2018 8:35,85,99,63,247,3,66.7
548,3/27/2018 8:40,88,81,56,225,3,66.7
549,3/27/2018 8:45,93,90,54,237,3,66.7
550,3/27/2018 8:50,92,104,54,250,3,66.7
551,3/27/2018 8:55,90,96,64,250,3,66.7
552,3/27/2018 9:00,81,93,47,221,3,66.7
553,3/27/2018 9:05,78,95,55,228,3,66.7
554,3/27/2018 9:10,86,86,56,228,3,66.7
555,3/27/2018 9:15,90,89,53,232,3,66.7
556,3/27/2018 9:20,82,97,55,234,3,66.7
557,3/27/2018 9:25,78,99,59,236,3,66.7
558,3/27/2018 9:30,88,107,61,256,3,66.7
559,3/27/2018 9:35,77,94,56,227,3,66.7
560,3/27/2018 9:40,80,96,58,234,3,66.7
561,3/27/2018 9:45,78,87,69,234,3,66.7
562,3/27/2018 9:50,79,86,63,228,3,66.7
563,3/27/2018 9:55,86,100,61,247,3,66.7
564,3/27/2018 10:00,74,97,51,222,3,66.7
565,3/27/2018 10:05,74,86,49,209,3,66.7
566,3/27/2018 10:10,74,84,52,210,3,66.7
567,3/27/2018 10:15,77,87,48,212,3,66.7
568,3/27/2018 10:20,90,86,54,230,3,66.7
569,3/27/2018 10:25,82,93,56,231,3,66.7
570,3/27/2018 10:30,88,92,58,238,3,66.7
571,3/27/2018 10:35,81,88,56,225,3,66.7
572,3/27/2018 10:40,78,99,62,239,3,66.7
573,3/27/2018 10:45,87,95,77,259,3,66.7
574,3/27/2018 10:50,91,102,91,284,3,66.7
575,3/27/2018 10:55,85,121,77,283,3,66.7
576,3/27/2018 11:00,81,88,49,218,3,66.7
577,3/27/2018 11:05,82,101,70,253,3,66.7
578,3/27/2018 11:10,81,98,73,252,3,66.7
579,3/27/2018 11:15,86,110,68,264,3,66.7
580,3/27/2018 11:20,79,103,70,252,3,66.7
581,3/27/2018 11:25,94,108,75,277,3,66.7
582,3/27/2018 11:30,82,88,62,232,3,66.7
583,3/27/2018 11:35,88,82,60,230,3,66.7
584,3/27/2018 11:40,97,90,59,246,3,0.0
585,3/27/2018 11:45,99,88,59,246,3,0.0
586,3/27/2018 11:50,97,92,64,253,3,0.0
587,3/27/2018 11:55,95,91,53,239,3,0.0
588,3/27/2018 12:00,97,88,58,243,3,0.0
589,3/27/2018 12:05,98,88,62,248,3,0.0
590,3/27/2018 12:10,100,102,64,266,3,0.0
591,3/27/2018 12:15,100,104,68,272,3,0.0
592,3/27/2018 12:20,101,95,57,253,3,0.0
593,3/27/2018 12:25,101,94,64,259,3,0.0
594,3/27/2018 12:30,100,87,69,256,3,0.0
595,3/27/2018 12:35,101,102,67,270,3,0.0
596,3/27/2018 12:40,101,90,61,252,3,0.0
597,3/27/2018 12:45,102,101,71,274,3,0.0
598,3/27/2018 12:50,102,101,64,267,3,0.0
599,3/27/2018 12:55,101,99,70,270,3,0.0
600,3/27/2018 13:00,99,83,62,244,3,0.0
601,3/27/2018 13:05,101,98,68,267,3,0.0
602,3/27/2018 13:10,100,94,65,259,3,0.0
603,3/27/2018 13:15,102,101,62,265,3,0.0
604,3/27/2018 13:20,104,97,62,263,3,0.0
605,3/27/2018 13:25,104,98,57,259,3,0.0
606,3/27/2018 13:30,105,98,63,266,3,0.0
607,3/27/2018 13:35,106,96,61,263,3,0.0
608,3/27/2018 13:40,107,98,62,267,3,0.0
609,3/27/2018 13:45,107,105,64,276,3,0.0
610,3/27/2018 13:50,107,109,69,285,3,0.0
611,3/27/2018 13:55,106,104,71,281,3,0.0
612,3/27/2018 14:00,107,99,61,267,3,0.0
613,3/27/2018 14:05,107,78,50,235,3,0.0
614,3/27/2018 14:10,109,89,72,270,3,0.0
615,3/27/2018 14:15,110,87,70,267,3,0.0
616,3/27/2018 14:20,113,100,71,284,3,0.0
617,3/27/2018 14:25,111,91,71,273,3,0.0
618,3/27/2018 14:30,113,93,74,280,3,0.0
619,3/27/2018 14:35,115,86,71,272,3,0.0
620,3/27/2018 14:40,117,103,72,292,3,0.0
621,3/27/2018 14:45,118,98,62,278,3,0.0
622,3/27/2018 14:50,116,93,80,289,3,0.0
623,3/27/2018 14:55,116,85,71,272,3,0.0
624,3/27/2018 15:00,114,79,70,263,3,0.0
625,3/27/2018 15:05,110,83,81,274,3,0.0
626,3/27/2018 15:10,105,84,62,251,3,0.0
627,3/27/2018 15:15,109,80,66,255,3,0.0
628,3/27/2018 15:20,116,66,64,246,3,0.0
629,3/27/2018 15:25,116,89,57,262,3,0.0
630,3/27/2018 15:30,116,80,70,266,3,0.0
631,3/27/2018 15:35,121,69,60,250,3,0.0
632,3/27/2018 15:40,121,86,59,266,3,0.0
633,3/27/2018 15:45,119,86,62,267,3,0.0
634,3/27/2018 15:50,112,72,61,245,3,0.0
635,3/27/2018 15:55,106,76,61,243,3,0.0
636,3/27/2018 16:00,116,90,67,273,3,0.0
637,3/27/2018 16:05,116,67,57,240,3,0.0
638,3/27/2018 16:10,119,70,70,259,3,0.0
639,3/27/2018 16:15,119,81,75,275,3,0.0
640,3/27/2018 16:20,117,81,74,272,3,0.0
641,3/27/2018 16:25,115,66,65,246,3,0.0
642,3/27/2018 16:30,111,76,66,253,3,0.0
643,3/27/2018 16:35,117,80,74,271,3,0.0
644,3/27/2018 16:40,118,72,61,251,3,0.0
645,3/27/2018 16:45,120,73,59,252,3,0.0
646,3/27/2018 16:50,119,67,60,246,3,0.0
647,3/27/2018 16:55,112,63,54,229,3,0.0
648,3/27/2018 17:00,111,57,54,222,3,0.0
649,3/27/2018 17:05,118,59,50,227,3,0.0
650,3/27/2018 17:10,122,70,55,247,3,0.0
651,3/27/2018 17:15,118,68,49,235,3,0.0
652,3/27/2018 17:20,117,74,58,249,3,0.0
653,3/27/2018 17:25,117,69,54,240,3,0.0
654,3/27/2018 17:30,122,65,59,246,3,0.0
655,3/27/2018 17:35,126,70,53,249,3,0.0
656,3/27/2018 17:40,124,61,68,253,3,0.0
657,3/27/2018 17:45,114,74,56,244,3,0.0
658,3/27/2018 17:50,111,75,59,245,3,0.0
659,3/27/2018 17:55,110,62,64,236,3,0.0
660,3/27/2018 18:00,110,64,56,230,3,0.0
661,3/27/2018 18:05,106,68,60,234,3,0.0
662,3/27/2018 18:10,105,69,59,233,3,0.0
663,3/27/2018 18:15,105,60,52,217,3,0.0
664,3/27/2018 18:20,108,78,66,252,3,0.0
665,3/27/2018 18:25,107,62,54,223,3,0.0
666,3/27/2018 18:30,104,70,55,229,3,0.0
667,3/27/2018 18:35,103,82,66,251,3,0.0
668,3/27/2018 18:40,104,83,78,265,3,0.0
669,3/27/2018 18:45,98,82,65,245,3,0.0
670,3/27/2018 18:50,96,85,47,228,3,0.0
671,3/27/2018 18:55,89,88,55,232,3,0.0
672,3/27/2018 19:00,101,85,66,252,3,0.0
673,3/27/2018 19:05,102,101,66,269,3,0.0
674,3/27/2018 19:10,103,92,59,254,3,0.0
675,3/27/2018 19:15,93,91,60,244,3,0.0
676,3/27/2018 19:20,91,88,54,233,3,0.0
677,3/27/2018 19:25,88,87,57,232,3,0.0
678,3/27/2018 19:30,84,89,57,230,3,0.0
679,3/27/2018 19:35,82,87,53,222,3,0.0
680,3/27/2018 19:40,82,84,55,221,3,0.0
681,3/27/2018 19:45,80,92,67,239,3,0.0
682,3/27/2018 19:50,78,85,63,226,3,0.0
683,3/27/2018 19:55,74,88,58,220,3,0.0
684,3/27/2018 20:00,73,90,56,219,3,0.0
685,3/27/2018 20:05,72,108,61,241,3,0.0
686,3/27/2018 20:10,72,112,65,249,3,0.0
687,3/27/2018 20:15,71,97,65,233,3,0.0
688,3/27/2018 20:20,70,110,77,257,3,0.0
689,3/27/2018 20:25,69,97,66,232,3,0.0
690,3/27/2018 20:30,68,102,62,232,3,0.0
691,3/27/2018 20:35,66,90,61,217,3,0.0
692,3/27/2018 20:40,66,90,63,219,3,0.0
693,3/27/2018 20:45,65,101,57,223,3,0.0
694,3/27/2018 20:50,64,92,63,219,3,0.0
695,3/27/2018 20:55,63,94,58,215,3,0.0
696,3/27/2018 21:00,62,93,54,209,3,0.0
697,3/27/2018 21:05,63,90,57,210,3,0.0
698,3/27/2018 21:10,64,103,59,226,3,0.0
699,3/27/2018 21:15,65,100,66,231,3,0.0
700,3/27/2018 21:20,65,95,62,222,3,0.0
701,3/27/2018 21:25,62,98,59,219,3,0.0
702,3/27/2018 21:30,61,91,57,209,3,0.0
703,3/27/2018 21:35,60,101,53,214,3,0.0
704,3/27/2018 21:40,60,98,51,209,3,0.0
705,3/27/2018 21:45,59,103,55,217,3,0.0
706,3/27/2018 21:50,63,101,55,219,3,0.0
707,3/27/2018 21:55,62,84,46,192,3,0.0
708,3/27/2018 22:00,55,80,59,194,3,0.0
709,3/27/2018 22:05,53,87,48,188,3,0.0
710,3/27/2018 22:10,56,91,46,193,3,0.0
711,3/27/2018 22:15,56,96,56,208,3,0.0
712,3/27/2018 22:20,52,94,62,208,3,0.0
713,3/27/2018 22:25,50,96,61,207,3,0.0
714,3/27/2018 22:30,48,92,58,198,3,0.0
715,3/27/2018 22:35,47,83,54,184,3,0.0
716,3/27/2018 22:40,44,81,49,174,3,0.0
717,3/27/2018 22:45,43,84,60,187,3,0.0
718,3/27/2018 22:50,40,79,52,171,3,0.0
719,3/27/2018 22:55,37,84,47,168,3,0.0
720,3/27/2018 23:00,35,76,43,154,3,0.0
721,3/27/2018 23:05,39,67,30,136,3,0.0
722,3/27/2018 23:10,43,74,46,163,3,0.0
723,3/27/2018 23:15,38,75,46,159,3,0.0
724,3/27/2018 23:20,33,62,32,127,3,0.0
725,3/27/2018 23:25,31,59,41,131,3,0.0
726,3/27/2018 23:30,29,65,38,132,3,0.0
727,3/27/2018 23:35,31,66,30,127,3,0.0
728,3/27/2018 23:40,29,63,39,131,3,0.0
729,3/27/2018 23:45,28,64,38,130,3,0.0
730,3/27/2018 23:50,26,68,38,132,3,0.0
731,3/27/2018 23:55,24,51,29,104,3,0.0
732,3/28/2018 0:00,30,53,32,115,3,0.0
733,3/28/2018 0:05,29,61,34,124,3,0.0
734,3/28/2018 0:10,29,68,32,129,3,0.0
735,3/28/2018 0:15,29,56,40,125,3,0.0
736,3/28/2018 0:20,27,61,38,126,3,0.0
737,3/28/2018 0:25,25,56,32,113,3,0.0
738,3/28/2018 0:30,24,61,27,112,3,0.0
739,3/28/2018 0:35,23,53,30,106,3,0.0
740,3/28/2018 0:40,23,60,33,116,3,0.0
741,3/28/2018 0:45,22,52,28,102,3,0.0
742,3/28/2018 0:50,20,43,27,90,3,0.0
743,3/28/2018 0:55,19,43,25,87,3,0.0
744,3/28/2018 1:00,18,34,22,74,3,0.0
745,3/28/2018 1:05,18,39,19,76,3,0.0
746,3/28/2018 1:10,18,50,26,94,3,0.0
747,3/28/2018 1:15,18,36,20,74,3,0.0
748,3/28/2018 1:20,17,36,17,70,3,0.0
749,3/28/2018 1:25,16,41,16,73,3,0.0
750,3/28/2018 1:30,16,34,22,72,3,0.0
751,3/28/2018 1:35,16,30,20,66,3,0.0
752,3/28/2018 1:40,16,46,21,83,3,0.0
753,3/28/2018 1:45,16,39,24,79,3,0.0
754,3/28/2018 1:50,16,35,18,69,3,0.0
755,3/28/2018 1:55,14,32,13,59,3,0.0
756,3/28/2018 2:00,14,33,13,60,3,0.0
757,3/28/2018 2:05,14,32,15,61,3,0.0
758,3/28/2018 2:10,15,38,18,71,3,0.0
759,3/28/2018 2:15,13,30,19,62,3,0.0
760,3/28/2018 2:20,12,31,16,59,3,0.0
761,3/28/2018 2:25,14,36,14,64,3,0.0
762,3/28/2018 2:30,14,23,14,51,3,0.0
763,3/28/2018 2:35,10,27,9,46,3,0.0
764,3/28/2018 2:40,12,33,20,65,3,0.0
765,3/28/2018 2:45,10,25,13,48,3,0.0
766,3/28/2018 2:50,11,30,10,51,3,0.0
767,3/28/2018 2:55,9,24,12,45,3,0.0
768,3/28/2018 3:00,9,24,9,42,3,0.0
769,3/28/2018 3:05,10,19,10,39,3,0.0
770,3/28/2018 3:10,10,25,14,49,3,0.0
771,3/28/2018 3:15,11,20,11,42,3,0.0
772,3/28/2018 3:20,11,19,9,39,3,0.0
773,3/28/2018 3:25,12,20,12,44,3,0.0
774,3/28/2018 3:30,12,20,12,44,3,0.0
775,3/28/2018 3:35,13,26,12,51,3,0.0
776,3/28/2018 3:40,15,26,17,58,3,0.0
777,3/28/2018 3:45,15,20,12,47,3,0.0
778,3/28/2018 3:50,15,23,15,53,3,0.0
779,3/28/2018 3:55,14,23,10,47,3,0.0
780,3/28/2018 4:00,14,20,13,47,3,0.0
781,3/28/2018 4:05,15,31,15,61,3,0.0
782,3/28/2018 4:10,18,35,17,70,3,0.0
783,3/28/2018 4:15,18,32,15,65,3,0.0
784,3/28/2018 4:20,19,24,15,58,3,0.0
785,3/28/2018 4:25,22,24,18,64,3,0.0
786,3/28/2018 4:30,24,32,22,78,3,0.0
787,3/28/2018 4:35,28,42,15,85,3,0.0
788,3/28/2018 4:40,32,31,16,79,3,0.0
789,3/28/2018 4:45,35,42,14,91,3,0.0
790,3/28/2018 4:50,34,42,25,101,3,0.0
791,3/28/2018 4:55,36,45,23,104,3,0.0
792,3/28/2018 5:00,39,38,17,94,3,0.0
793,3/28/2018 5:05,48,39,20,107,3,0.0
794,3/28/2018 5:10,48,45,25,118,3,0.0
795,3/28/2018 5:15,54,54,29,137,3,0.0
796,3/28/2018 5:20,62,50,29,141,3,0.0
797,3/28/2018 5:25,67,54,25,146,3,0.0
798,3/28/2018 5:30,75,56,32,163,3,0.0
799,3/28/2018 5:35,84,65,31,180,3,0.0
800,3/28/2018 5:40,90,70,31,191,3,0.0
801,3/28/2018 5:45,90,61,32,183,3,0.0
802,3/28/2018 5:50,95,56,27,178,3,0.0
803,3/28/2018 5:55,90,64,35,189,3,0.0
804,3/28/2018 6:00,89,59,35,183,3,0.0
805,3/28/2018 6:05,101,73,45,219,3,0.0
806,3/28/2018 6:10,112,74,40,226,3,0.0
807,3/28/2018 6:15,115,78,45,238,3,0.0
808,3/28/2018 6:20,118,81,44,243,3,0.0
809,3/28/2018 6:25,112,80,44,236,3,0.0
810,3/28/2018 6:30,111,87,42,240,3,0.0
811,3/28/2018 6:35,116,75,50,241,3,0.0
812,3/28/2018 6:40,117,92,59,268,3,0.0
813,3/28/2018 6:45,120,103,56,279,3,0.0
814,3/28/2018 6:50,122,98,59,279,3,0.0
815,3/28/2018 6:55,118,89,56,263,3,0.0
816,3/28/2018 7:00,120,95,64,279,3,0.0
817,3/28/2018 7:05,127,99,58,284,3,0.0
818,3/28/2018 7:10,124,101,61,286,3,0.0
819,3/28/2018 7:15,152,105,63,320,3,0.0
820,3/28/2018 7:20,148,112,71,331,3,0.0
821,3/28/2018 7:25,128,108,67,303,3,0.0
822,3/28/2018 7:30,155,106,65,326,3,0.0
823,3/28/2018 7:35,155,94,56,305,3,0.0
824,3/28/2018 7:40,153,105,62,320,3,0.0
825,3/28/2018 7:45,153,100,60,313,3,0.0
826,3/28/2018 7:50,151,105,57,313,3,0.0
827,3/28/2018 7:55,144,97,66,307,3,0.0
828,3/28/2018 8:00,145,97,57,299,3,0.0
829,3/28/2018 8:05,145,96,57,298,3,0.0
830,3/28/2018 8:10,132,105,66,303,3,0.0
831,3/28/2018 8:15,145,99,68,312,3,0.0
832,3/28/2018 8:20,129,108,67,304,3,0.0
833,3/28/2018 8:25,125,99,65,289,3,0.0
834,3/28/2018 8:30,124,100,60,284,3,0.0
835,3/28/2018 8:35,133,89,59,281,3,0.0
836,3/28/2018 8:40,140,94,61,295,3,0.0
837,3/28/2018 8:45,132,98,65,295,3,0.0
838,3/28/2018 8:50,134,99,65,298,3,0.0
839,3/28/2018 8:55,136,100,55,291,3,0.0
840,3/28/2018 9:00,128,89,55,272,3,0.0
841,3/28/2018 9:05,132,92,58,282,3,0.0
842,3/28/2018 9:10,137,95,54,286,3,0.0
843,3/28/2018 9:15,135,97,60,292,3,0.0
844,3/28/2018 9:20,104,93,64,261,3,0.0
845,3/28/2018 9:25,104,104,59,267,3,0.0
846,3/28/2018 9:30,136,96,54,286,3,0.0
847,3/28/2018 9:35,134,77,45,256,3,0.0
848,3/28/2018 9:40,127,89,54,270,3,0.0
849,3/28/2018 9:45,138,93,50,281,3,0.0
850,3/28/2018 9:50,125,93,62,280,3,0.0
851,3/28/2018 9:55,133,84,55,272,3,0.0
852,3/28/2018 10:00,133,94,48,275,3,0.0
853,3/28/2018 10:05,132,89,53,274,3,0.0
854,3/28/2018 10:10,132,92,54,278,3,0.0
855,3/28/2018 10:15,133,98,58,289,3,0.0
856,3/28/2018 10:20,132,89,61,282,3,0.0
857,3/28/2018 10:25,133,92,52,277,3,0.0
858,3/28/2018 10:30,132,97,67,296,3,0.0
859,3/28/2018 10:35,132,99,61,292,3,0.0
860,3/28/2018 10:40,120,97,62,279,3,0.0
861,3/28/2018 10:45,102,88,57,247,3,0.0
862,3/28/2018 10:50,106,89,55,250,3,0.0
863,3/28/2018 10:55,108,95,64,267,3,0.0
864,3/28/2018 11:00,128,93,59,280,3,0.0
865,3/28/2018 11:05,130,95,59,284,3,0.0
866,3/28/2018 11:10,131,99,65,295,3,0.0
867,3/28/2018 11:15,129,98,65,292,3,0.0
868,3/28/2018 11:20,132,100,60,292,3,0.0
869,3/28/2018 11:25,133,101,61,295,3,0.0
870,3/28/2018 11:30,133,99,61,293,3,0.0
871,3/28/2018 11:35,134,95,59,288,3,0.0
872,3/28/2018 11:40,135,96,56,287,3,0.0
873,3/28/2018 11:45,133,88,54,275,3,0.0
874,3/28/2018 11:50,134,84,58,276,3,0.0
875,3/28/2018 11:55,131,83,64,278,3,0.0
876,3/28/2018 12:00,131,109,56,296,3,0.0
877,3/28/2018 12:05,106,88,54,248,3,0.0
878,3/28/2018 12:10,107,87,68,262,3,0.0
879,3/28/2018 12:15,108,74,59,241,3,0.0
880,3/28/2018 12:20,110,93,64,267,3,0.0
881,3/28/2018 12:25,132,84,64,280,3,0.0
882,3/28/2018 12:30,133,89,50,272,3,0.0
883,3/28/2018 12:35,135,85,67,287,3,0.0
884,3/28/2018 12:40,135,85,59,279,3,0.0
885,3/28/2018 12:45,134,90,57,281,3,0.0
886,3/28/2018 12:50,134,87,58,279,3,0.0
887,3/28/2018 12:55,134,95,71,300,3,0.0
888,3/28/2018 13:00,134,92,63,289,3,0.0
889,3/28/2018 13:05,134,97,61,292,3,0.0
890,3/28/2018 13:10,109,94,61,264,3,0.0
891,3/28/2018 13:15,112,102,69,283,3,0.0
892,3/28/2018 13:20,114,87,58,259,3,0.0
893,3/28/2018 13:25,139,96,60,295,3,0.0
894,3/28/2018 13:30,138,101,71,310,3,0.0
895,3/28/2018 13:35,139,95,66,300,3,0.0
896,3/28/2018 13:40,142,91,58,291,3,0.0
897,3/28/2018 13:45,142,96,70,308,3,0.0
898,3/28/2018 13:50,140,86,63,289,3,0.0
899,3/28/2018 13:55,140,85,64,289,3,0.0
900,3/28/2018 14:00,138,98,74,310,3,0.0
901,3/28/2018 14:05,142,82,65,289,3,0.0
902,3/28/2018 14:10,146,102,68,316,3,0.0
903,3/28/2018 14:15,147,88,64,299,3,0.0
904,3/28/2018 14:20,148,94,63,305,3,0.0
905,3/28/2018 14:25,148,102,64,314,3,0.0
906,3/28/2018 14:30,146,92,62,300,3,0.0
907,3/28/2018 14:35,149,98,69,316,3,0.0
908,3/28/2018 14:40,154,102,72,328,3,0.0
909,3/28/2018 14:45,154,101,80,335,3,0.0
910,3/28/2018 14:50,152,94,72,318,3,0.0
911,3/28/2018 14:55,149,80,75,304,3,0.0
912,3/28/2018 15:00,147,80,78,305,3,0.0
913,3/28/2018 15:05,148,69,70,287,3,0.0
914,3/28/2018 15:10,150,67,68,285,3,0.0
915,3/28/2018 15:15,126,64,54,244,3,0.0
916,3/28/2018 15:20,125,74,59,258,3,0.0
917,3/28/2018 15:25,150,75,72,297,3,0.0
918,3/28/2018 15:30,149,74,69,292,3,0.0
919,3/28/2018 15:35,152,96,84,332,3,0.0
920,3/28/2018 15:40,154,86,90,330,3,0.0
921,3/28/2018 15:45,155,81,78,314,3,0.0
922,3/28/2018 15:50,153,78,67,298,3,0.0
923,3/28/2018 15:55,148,83,59,290,3,0.0
924,3/28/2018 16:00,147,70,67,284,3,0.0
925,3/28/2018 16:05,148,71,64,283,3,0.0
926,3/28/2018 16:10,149,90,66,305,3,0.0
927,3/28/2018 16:15,150,85,68,303,3,0.0
928,3/28/2018 16:20,145,64,48,257,3,0.0
929,3/28/2018 16:25,147,61,73,281,3,0.0
930,3/28/2018 16:30,146,59,66,271,3,0.0
931,3/28/2018 16:35,150,68,64,282,3,0.0
932,3/28/2018 16:40,143,66,70,279,3,0.0
933,3/28/2018 16:45,135,77,66,278,3,0.0
934,3/28/2018 16:50,129,61,53,243,3,0.0
935,3/28/2018 16:55,135,69,58,262,3,0.0
936,3/28/2018 17:00,138,53,39,230,3,0.0
937,3/28/2018 17:05,149,67,40,256,3,0.0
938,3/28/2018 17:10,134,63,46,243,3,0.0
939,3/28/2018 17:15,133,56,45,234,3,0.0
940,3/28/2018 17:20,130,67,74,271,3,0.0
941,3/28/2018 17:25,121,49,47,217,3,0.0
942,3/28/2018 17:30,124,70,65,259,3,0.0
943,3/28/2018 17:35,129,69,65,263,3,0.0
944,3/28/2018 17:40,115,54,47,216,3,0.0
945,3/28/2018 17:45,117,60,50,227,3,0.0
946,3/28/2018 17:50,117,54,53,224,3,0.0
947,3/28/2018 17:55,112,57,48,217,3,0.0
948,3/28/2018 18:00,112,62,62,236,3,0.0
949,3/28/2018 18:05,113,57,60,230,3,0.0
950,3/28/2018 18:10,117,59,60,236,3,0.0
951,3/28/2018 18:15,120,64,63,247,3,0.0
952,3/28/2018 18:20,117,62,63,242,3,0.0
953,3/28/2018 18:25,117,60,59,236,3,0.0
954,3/28/2018 18:30,115,62,47,224,3,0.0
955,3/28/2018 18:35,117,61,55,233,3,0.0
956,3/28/2018 18:40,112,64,50,226,3,0.0
957,3/28/2018 18:45,110,72,61,243,3,0.0
958,3/28/2018 18:50,108,75,51,234,3,0.0
959,3/28/2018 18:55,107,72,55,234,3,0.0
960,3/28/2018 19:00,106,74,61,241,3,0.0
961,3/28/2018 19:05,105,78,42,225,3,0.0
962,3/28/2018 19:10,103,69,59,231,3,0.0
963,3/28/2018 19:15,102,88,56,246,3,0.0
964,3/28/2018 19:20,100,87,59,246,3,0.0
965,3/28/2018 19:25,98,89,52,239,3,0.0
966,3/28/2018 19:30,94,86,57,237,3,0.0
967,3/28/2018 19:35,92,95,54,241,3,0.0
968,3/28/2018 19:40,89,92,57,238,3,0.0
969,3/28/2018 19:45,86,95,63,244,3,0.0
970,3/28/2018 19:50,83,102,58,243,3,0.0
971,3/28/2018 19:55,80,100,58,238,3,0.0
972,3/28/2018 20:00,77,103,63,243,3,0.0
973,3/28/2018 20:05,76,98,56,230,3,0.0
974,3/28/2018 20:10,77,102,61,240,3,0.0
975,3/28/2018 20:15,75,91,63,229,3,0.0
976,3/28/2018 20:20,72,93,54,219,3,0.0
977,3/28/2018 20:25,72,101,64,237,3,0.0
978,3/28/2018 20:30,71,102,61,234,3,0.0
979,3/28/2018 20:35,71,92,67,230,3,0.0
980,3/28/2018 20:40,67,101,74,242,3,0.0
981,3/28/2018 20:45,67,99,58,224,3,0.0
982,3/28/2018 20:50,67,86,67,220,3,0.0
983,3/28/2018 20:55,65,96,65,226,3,0.0
984,3/28/2018 21:00,65,100,62,227,3,0.0
985,3/28/2018 21:05,66,95,61,222,3,0.0
986,3/28/2018 21:10,69,95,63,227,3,0.0
987,3/28/2018 21:15,72,96,61,229,3,0.0
988,3/28/2018 21:20,70,91,60,221,3,0.0
989,3/28/2018 21:25,69,94,61,224,3,0.0
990,3/28/2018 21:30,65,82,57,204,3,0.0
991,3/28/2018 21:35,66,97,59,222,3,0.0
992,3/28/2018 21:40,67,84,58,209,3,0.0
993,3/28/2018 21:45,64,101,59,224,3,0.0
994,3/28/2018 21:50,58,90,59,207,3,0.0
995,3/28/2018 21:55,60,100,46,206,3,0.0
996,3/28/2018 22:00,59,90,60,209,3,0.0
997,3/28/2018 22:05,59,95,61,215,3,0.0
998,3/28/2018 22:10,62,93,64,219,3,0.0
999,3/28/2018 22:15,67,94,65,226,3,0.0
1000,3/28/2018 22:20,58,87,58,203,3,0.0
1001,3/28/2018 22:25,61,104,64,229,3,0.0
1002,3/28/2018 22:30,54,83,51,188,3,0.0
1003,3/28/2018 22:35,58,88,52,198,3,0.0
1004,3/28/2018 22:40,52,93,62,207,3,0.0
1005,3/28/2018 22:45,50,93,62,205,3,0.0
1006,3/28/2018 22:50,50,87,53,190,3,0.0
1007,3/28/2018 22:55,46,83,45,174,3,0.0
1008,3/28/2018 23:00,44,82,42,168,3,0.0
1009,3/28/2018 23:05,45,73,46,164,3,0.0
1010,3/28/2018 23:10,44,77,47,168,3,0.0
1011,3/28/2018 23:15,43,76,42,161,3,0.0
1012,3/28/2018 23:20,40,67,42,149,3,0.0
1013,3/28/2018 23:25,39,75,37,151,3,0.0
1014,3/28/2018 23:30,37,60,39,136,3,0.0
1015,3/28/2018 23:35,35,62,34,131,3,0.0
1016,3/28/2018 23:40,36,59,33,128,3,0.0
1017,3/28/2018 23:45,32,70,44,146,3,0.0
1018,3/28/2018 23:50,30,57,38,125,3,0.0
1019,3/28/2018 23:55,27,57,34,118,3,0.0
1020,3/29/2018 0:00,25,54,35,114,3,0.0
1021,3/29/2018 0:05,26,55,29,110,3,0.0
1022,3/29/2018 0:10,25,67,34,126,3,0.0
1023,3/29/2018 0:15,26,62,36,124,3,0.0
1024,3/29/2018 0:20,22,58,31,111,3,0.0
1025,3/29/2018 0:25,21,63,33,117,3,0.0
1026,3/29/2018 0:30,21,56,27,104,3,0.0
1027,3/29/2018 0:35,20,59,31,110,3,0.0
1028,3/29/2018 0:40,21,56,31,108,3,0.0
1029,3/29/2018 0:45,20,47,22,89,3,0.0
1030,3/29/2018 0:50,17,50,26,93,3,0.0
1031,3/29/2018 0:55,17,45,20,82,3,0.0
1032,3/29/2018 1:00,15,45,23,83,3,0.0
1033,3/29/2018 1:05,15,43,20,78,3,0.0
1034,3/29/2018 1:10,15,44,21,80,3,0.0
1035,3/29/2018 1:15,15,43,26,84,3,0.0
1036,3/29/2018 1:20,15,43,20,78,3,0.0
1037,3/29/2018 1:25,15,39,20,74,3,0.0
1038,3/29/2018 1:30,15,42,20,77,3,0.0
1039,3/29/2018 1:35,14,44,21,79,3,0.0
1040,3/29/2018 1:40,14,43,20,77,3,0.0
1041,3/29/2018 1:45,14,39,19,72,3,0.0
1042,3/29/2018 1:50,14,34,20,68,3,0.0
1043,3/29/2018 1:55,12,34,16,62,3,0.0
1044,3/29/2018 2:00,13,34,17,64,3,0.0
1045,3/29/2018 2:05,12,32,17,61,3,0.0
1046,3/29/2018 2:10,13,31,16,60,3,0.0
1047,3/29/2018 2:15,13,33,16,62,3,0.0
1048,3/29/2018 2:20,12,36,17,65,3,0.0
1049,3/29/2018 2:25,12,35,20,67,3,0.0
1050,3/29/2018 2:30,11,30,13,54,3,0.0
1051,3/29/2018 2:35,12,26,17,55,3,0.0
1052,3/29/2018 2:40,12,36,21,69,3,0.0
1053,3/29/2018 2:45,11,30,16,57,3,0.0
1054,3/29/2018 2:50,11,28,10,49,3,0.0
1055,3/29/2018 2:55,10,25,11,46,3,0.0
1056,3/29/2018 3:00,10,25,15,50,3,0.0
1057,3/29/2018 3:05,10,23,13,46,3,0.0
1058,3/29/2018 3:10,11,21,15,47,3,0.0
1059,3/29/2018 3:15,11,20,12,43,3,0.0
1060,3/29/2018 3:20,12,21,12,45,3,0.0
1061,3/29/2018 3:25,12,17,11,40,3,0.0
1062,3/29/2018 3:30,13,25,14,52,3,0.0
1063,3/29/2018 3:35,13,22,15,50,3,0.0
1064,3/29/2018 3:40,14,26,15,55,3,0.0
1065,3/29/2018 3:45,14,22,13,49,3,0.0
1066,3/29/2018 3:50,15,22,12,49,3,0.0
1067,3/29/2018 3:55,13,23,13,49,3,0.0
1068,3/29/2018 4:00,13,23,16,52,3,0.0
1069,3/29/2018 4:05,14,27,15,56,3,0.0
1070,3/29/2018 4:10,16,31,13,60,3,0.0
1071,3/29/2018 4:15,18,34,13,65,3,0.0
1072,3/29/2018 4:20,20,32,14,66,3,0.0
1073,3/29/2018 4:25,22,34,12,68,3,0.0
1074,3/29/2018 4:30,25,41,19,85,3,0.0
1075,3/29/2018 4:35,28,35,18,81,3,0.0
1076,3/29/2018 4:40,30,40,19,89,3,0.0
1077,3/29/2018 4:45,35,47,18,100,3,0.0
1078,3/29/2018 4:50,37,45,20,102,3,0.0
1079,3/29/2018 4:55,38,47,21,106,3,0.0
1080,3/29/2018 5:00,36,41,21,98,3,0.0
1081,3/29/2018 5:05,41,42,19,102,3,0.0
1082,3/29/2018 5:10,51,49,22,122,3,0.0
1083,3/29/2018 5:15,53,52,25,130,3,0.0
1084,3/29/2018 5:20,59,61,28,148,3,0.0
1085,3/29/2018 5:25,66,56,26,148,3,0.0
1086,3/29/2018 5:30,75,54,20,149,3,0.0
1087,3/29/2018 5:35,81,55,25,161,3,0.0
1088,3/29/2018 5:40,89,64,32,185,3,0.0
1089,3/29/2018 5:45,96,73,37,206,3,0.0
1090,3/29/2018 5:50,94,58,31,183,3,0.0
1091,3/29/2018 5:55,86,63,30,179,3,0.0
1092,3/29/2018 6:00,95,63,33,191,3,0.0
1093,3/29/2018 6:05,99,66,38,203,3,0.0
1094,3/29/2018 6:10,112,72,44,228,3,0.0
1095,3/29/2018 6:15,113,77,42,232,3,0.0
1096,3/29/2018 6:20,110,80,37,227,3,0.0
1097,3/29/2018 6:25,111,75,43,229,3,0.0
1098,3/29/2018 6:30,114,82,46,242,3,0.0
1099,3/29/2018 6:35,117,89,46,252,3,0.0
1100,3/29/2018 6:40,119,92,55,266,3,0.0
1101,3/29/2018 6:45,120,93,55,268,3,0.0
1102,3/29/2018 6:50,120,92,55,267,3,0.0
1103,3/29/2018 6:55,117,90,57,264,3,0.0
1104,3/29/2018 7:00,116,95,57,268,3,0.0
1105,3/29/2018 7:05,117,104,59,280,3,0.0
1106,3/29/2018 7:10,122,97,62,281,3,0.0
1107,3/29/2018 7:15,126,100,67,293,3,0.0
1108,3/29/2018 7:20,129,105,65,299,3,0.0
1109,3/29/2018 7:25,128,93,61,282,3,0.0
1110,3/29/2018 7:30,129,95,71,295,3,0.0
1111,3/29/2018 7:35,131,101,62,294,3,0.0
1112,3/29/2018 7:40,132,96,63,291,3,0.0
1113,3/29/2018 7:45,132,105,63,300,3,0.0
1114,3/29/2018 7:50,132,97,66,295,3,0.0
1115,3/29/2018 7:55,114,103,65,282,3,0.0
1116,3/29/2018 8:00,125,100,58,283,3,0.0
1117,3/29/2018 8:05,124,104,66,294,3,0.0
1118,3/29/2018 8:10,123,101,61,285,3,0.0
1119,3/29/2018 8:15,124,107,62,293,3,0.0
1120,3/29/2018 8:20,124,92,66,282,3,0.0
1121,3/29/2018 8:25,121,104,62,287,3,0.0
1122,3/29/2018 8:30,119,92,58,269,3,0.0
1123,3/29/2018 8:35,118,107,65,290,3,0.0
1124,3/29/2018 8:40,119,103,60,282,3,0.0
1125,3/29/2018 8:45,119,98,57,274,3,0.0
1126,3/29/2018 8:50,117,97,58,272,3,0.0
1127,3/29/2018 8:55,114,89,55,258,3,0.0
1128,3/29/2018 9:00,109,92,56,257,3,0.0
1129,3/29/2018 9:05,108,89,55,252,3,0.0
1130,3/29/2018 9:10,105,88,52,245,3,0.0
1131,3/29/2018 9:15,106,87,55,248,3,0.0
1132,3/29/2018 9:20,107,94,54,255,3,0.0
1133,3/29/2018 9:25,108,84,54,246,3,0.0
1134,3/29/2018 9:30,108,94,57,259,3,0.0
1135,3/29/2018 9:35,109,89,56,254,3,0.0
1136,3/29/2018 9:40,109,91,57,257,3,0.0
1137,3/29/2018 9:45,109,92,60,261,3,0.0
1138,3/29/2018 9:50,106,91,58,255,3,0.0
1139,3/29/2018 9:55,104,89,54,247,3,0.0
1140,3/29/2018 10:00,102,97,62,261,3,0.0
1141,3/29/2018 10:05,101,95,51,247,3,0.0
1142,3/29/2018 10:10,101,86,59,246,3,0.0
1143,3/29/2018 10:15,102,91,53,246,3,0.0
1144,3/29/2018 10:20,102,96,53,251,3,0.0
1145,3/29/2018 10:25,102,95,58,255,3,0.0
1146,3/29/2018 10:30,101,91,57,249,3,0.0
1147,3/29/2018 10:35,107,84,53,244,3,0.0
1148,3/29/2018 10:40,104,94,63,261,3,0.0
1149,3/29/2018 10:45,104,99,58,261,3,0.0
1150,3/29/2018 10:50,104,94,57,255,3,0.0
1151,3/29/2018 10:55,103,94,61,258,3,0.0
1152,3/29/2018 11:00,105,98,63,266,3,0.0
1153,3/29/2018 11:05,105,89,61,255,3,0.0
1154,3/29/2018 11:10,108,93,58,259,3,0.0
1155,3/29/2018 11:15,108,99,56,263,3,0.0
1156,3/29/2018 11:20,108,103,62,273,3,0.0
1157,3/29/2018 11:25,105,93,59,257,3,0.0
1158,3/29/2018 11:30,107,94,57,258,3,0.0
1159,3/29/2018 11:35,106,96,55,257,3,0.0
1160,3/29/2018 11:40,106,104,63,273,3,0.0
1161,3/29/2018 11:45,107,95,62,264,3,0.0
1162,3/29/2018 11:50,108,94,66,268,3,0.0
1163,3/29/2018 11:55,106,89,58,253,3,0.0
1164,3/29/2018 12:00,106,87,59,252,3,0.0
1165,3/29/2018 12:05,107,94,63,264,3,0.0
1166,3/29/2018 12:10,107,93,59,259,3,0.0
1167,3/29/2018 12:15,109,97,64,270,3,0.0
1168,3/29/2018 12:20,109,89,61,259,3,0.0
1169,3/29/2018 12:25,108,97,60,265,3,0.0
1170,3/29/2018 12:30,107,96,61,264,3,0.0
1171,3/29/2018 12:35,110,99,62,271,3,0.0
1172,3/29/2018 12:40,111,90,62,263,3,0.0
1173,3/29/2018 12:45,109,103,65,277,3,0.0
1174,3/29/2018 12:50,109,95,72,276,3,0.0
1175,3/29/2018 12:55,107,96,62,265,3,0.0
1176,3/29/2018 13:00,107,91,64,262,3,0.0
1177,3/29/2018 13:05,108,88,65,261,3,0.0
1178,3/29/2018 13:10,110,93,61,264,3,0.0
1179,3/29/2018 13:15,111,94,61,266,3,0.0
1180,3/29/2018 13:20,113,92,61,266,3,0.0
1181,3/29/2018 13:25,110,96,68,274,3,0.0
1182,3/29/2018 13:30,111,100,59,270,3,0.0
1183,3/29/2018 13:35,112,95,66,273,3,0.0
1184,3/29/2018 13:40,114,95,64,273,3,0.0
1185,3/29/2018 13:45,115,106,65,286,3,0.0
1186,3/29/2018 13:50,114,101,66,281,3,0.0
1187,3/29/2018 13:55,114,96,76,286,3,0.0
1188,3/29/2018 14:00,114,102,77,293,3,0.0
1189,3/29/2018 14:05,115,97,66,278,3,0.0
1190,3/29/2018 14:10,117,92,69,278,3,0.0
1191,3/29/2018 14:15,118,91,68,277,3,0.0
1192,3/29/2018 14:20,119,88,66,273,3,0.0
1193,3/29/2018 14:25,119,92,66,277,3,0.0
1194,3/29/2018 14:30,119,94,61,274,3,0.0
1195,3/29/2018 14:35,123,91,53,267,3,0.0
1196,3/29/2018 14:40,125,89,68,282,3,0.0
1197,3/29/2018 14:45,126,95,68,289,3,0.0
1198,3/29/2018 14:50,124,86,74,284,3,0.0
1199,3/29/2018 14:55,122,78,69,269,3,0.0
1200,3/29/2018 15:00,121,74,68,263,3,0.0
1201,3/29/2018 15:05,122,77,62,261,3,0.0
1202,3/29/2018 15:10,125,72,70,267,3,0.0
1203,3/29/2018 15:15,125,70,66,261,3,0.0
1204,3/29/2018 15:20,124,77,65,266,3,0.0
1205,3/29/2018 15:25,122,76,73,271,3,0.0
1206,3/29/2018 15:30,122,68,64,254,3,0.0
1207,3/29/2018 15:35,126,79,72,277,3,0.0
1208,3/29/2018 15:40,129,82,78,289,3,0.0
1209,3/29/2018 15:45,129,70,60,259,3,0.0
1210,3/29/2018 15:50,127,72,57,256,3,0.0
1211,3/29/2018 15:55,124,63,57,244,3,0.0
1212,3/29/2018 16:00,122,58,62,242,3,0.0
1213,3/29/2018 16:05,123,73,63,259,3,0.0
1214,3/29/2018 16:10,126,67,64,257,3,0.0
1215,3/29/2018 16:15,126,61,66,253,3,0.0
1216,3/29/2018 16:20,126,63,59,248,3,0.0
1217,3/29/2018 16:25,121,64,59,244,3,0.0
1218,3/29/2018 16:30,121,50,58,229,3,0.0
1219,3/29/2018 16:35,124,60,53,237,3,0.0
1220,3/29/2018 16:40,129,61,58,248,3,0.0
1221,3/29/2018 16:45,127,65,69,261,3,0.0
1222,3/29/2018 16:50,129,72,60,261,3,0.0
1223,3/29/2018 16:55,126,67,59,252,3,0.0
1224,3/29/2018 17:00,125,62,48,235,3,0.0
1225,3/29/2018 17:05,128,60,49,237,3,0.0
1226,3/29/2018 17:10,132,67,61,260,3,0.0
1227,3/29/2018 17:15,130,71,58,259,3,0.0
1228,3/29/2018 17:20,135,71,58,264,3,0.0
1229,3/29/2018 17:25,124,67,50,241,3,0.0
1230,3/29/2018 17:30,119,67,55,241,3,0.0
1231,3/29/2018 17:35,124,62,51,237,3,0.0
1232,3/29/2018 17:40,124,73,57,254,3,0.0
1233,3/29/2018 17:45,122,63,50,235,3,0.0
1234,3/29/2018 17:50,123,75,56,254,3,0.0
1235,3/29/2018 17:55,120,62,49,231,3,0.0
1236,3/29/2018 18:00,119,66,57,242,3,0.0
1237,3/29/2018 18:05,119,58,50,227,3,0.0
1238,3/29/2018 18:10,119,65,55,239,3,0.0
1239,3/29/2018 18:15,118,60,55,233,3,0.0
1240,3/29/2018 18:20,118,69,55,242,3,0.0
1241,3/29/2018 18:25,114,58,51,223,3,0.0
1242,3/29/2018 18:30,115,64,52,231,3,0.0
1243,3/29/2018 18:35,113,62,56,231,3,0.0
1244,3/29/2018 18:40,112,77,61,250,3,0.0
1245,3/29/2018 18:45,111,73,60,244,3,0.0
1246,3/29/2018 18:50,109,70,59,238,3,0.0
1247,3/29/2018 18:55,108,72,59,239,3,0.0
1248,3/29/2018 19:00,109,81,61,251,3,0.0
1249,3/29/2018 19:05,110,91,55,256,3,0.0
1250,3/29/2018 19:10,108,77,66,251,3,0.0
1251,3/29/2018 19:15,105,80,51,236,3,0.0
1252,3/29/2018 19:20,104,87,51,242,3,0.0
1253,3/29/2018 19:25,99,81,61,241,3,0.0
1254,3/29/2018 19:30,96,81,63,240,3,0.0
1255,3/29/2018 19:35,94,90,57,241,3,0.0
1256,3/29/2018 19:40,92,91,57,240,3,0.0
1257,3/29/2018 19:45,89,100,61,250,3,0.0
1258,3/29/2018 19:50,88,100,64,252,3,0.0
1259,3/29/2018 19:55,81,96,63,240,3,0.0
1260,3/29/2018 20:00,80,95,63,238,3,0.0
1261,3/29/2018 20:05,79,93,58,230,3,0.0
1262,3/29/2018 20:10,79,92,62,233,3,0.0
1263,3/29/2018 20:15,77,98,60,235,3,0.0
1264,3/29/2018 20:20,77,100,60,237,3,0.0
1265,3/29/2018 20:25,77,97,61,235,3,0.0
1266,3/29/2018 20:30,74,89,56,219,3,0.0
1267,3/29/2018 20:35,72,84,61,217,3,0.0
1268,3/29/2018 20:40,71,92,63,226,3,0.0
1269,3/29/2018 20:45,70,102,58,230,3,0.0
1270,3/29/2018 20:50,70,98,63,231,3,0.0
1271,3/29/2018 20:55,69,98,61,228,3,0.0
1272,3/29/2018 21:00,70,98,63,231,3,0.0
1273,3/29/2018 21:05,72,93,56,221,3,0.0
1274,3/29/2018 21:10,74,95,59,228,3,0.0
1275,3/29/2018 21:15,73,95,70,238,3,0.0
1276,3/29/2018 21:20,73,96,62,231,3,0.0
1277,3/29/2018 21:25,72,107,69,248,3,0.0
1278,3/29/2018 21:30,70,103,55,228,3,0.0
1279,3/29/2018 21:35,68,86,57,211,3,0.0
1280,3/29/2018 21:40,68,96,60,224,3,0.0
1281,3/29/2018 21:45,69,96,63,228,3,0.0
1282,3/29/2018 21:50,67,94,63,224,3,0.0
1283,3/29/2018 21:55,67,104,64,235,3,0.0
1284,3/29/2018 22:00,65,103,60,228,3,0.0
1285,3/29/2018 22:05,68,98,56,222,3,0.0
1286,3/29/2018 22:10,72,100,60,232,3,0.0
1287,3/29/2018 22:15,72,98,63,233,3,0.0
1288,3/29/2018 22:20,67,95,59,221,3,0.0
1289,3/29/2018 22:25,64,91,55,210,3,0.0
1290,3/29/2018 22:30,60,99,64,223,3,0.0
1291,3/29/2018 22:35,56,83,52,191,3,0.0
1292,3/29/2018 22:40,54,92,53,199,3,0.0
1293,3/29/2018 22:45,56,89,65,210,3,0.0
1294,3/29/2018 22:50,51,89,50,190,3,0.0
1295,3/29/2018 22:55,50,87,54,191,3,0.0
1296,3/29/2018 23:00,45,85,45,175,3,0.0
1297,3/29/2018 23:05,43,79,54,176,3,0.0
1298,3/29/2018 23:10,50,85,50,185,3,0.0
1299,3/29/2018 23:15,46,81,50,177,3,0.0
1300,3/29/2018 23:20,42,71,42,155,3,0.0
1301,3/29/2018 23:25,39,84,51,174,3,0.0
1302,3/29/2018 23:30,40,73,42,155,3,0.0
1303,3/29/2018 23:35,38,76,45,159,3,0.0
1304,3/29/2018 23:40,37,77,45,159,3,0.0
1305,3/29/2018 23:45,32,76,43,151,3,0.0
1306,3/29/2018 23:50,33,72,39,144,3,0.0
1307,3/29/2018 23:55,30,64,36,130,3,0.0
1308,3/30/2018 0:00,33,65,36,134,3,0.0
1309,3/30/2018 0:05,34,66,41,141,3,0.0
1310,3/30/2018 0:10,34,74,34,142,3,0.0
1311,3/30/2018 0:15,33,67,34,134,3,0.0
1312,3/30/2018 0:20,32,57,34,123,3,0.0
1313,3/30/2018 0:25,29,60,32,121,3,0.0
1314,3/30/2018 0:30,27,65,32,124,3,0.0
1315,3/30/2018 0:35,26,65,33,124,3,0.0
1316,3/30/2018 0:40,27,57,29,113,3,0.0
1317,3/30/2018 0:45,26,56,33,115,3,0.0
1318,3/30/2018 0:50,24,51,31,106,3,0.0
1319,3/30/2018 0:55,22,52,29,103,3,0.0
1320,3/30/2018 1:00,21,48,21,90,3,0.0
1321,3/30/2018 1:05,21,43,19,83,3,0.0
1322,3/30/2018 1:10,21,48,26,95,3,0.0
1323,3/30/2018 1:15,20,46,24,90,3,0.0
1324,3/30/2018 1:20,19,46,19,84,3,0.0
1325,3/30/2018 1:25,21,48,23,92,3,0.0
1326,3/30/2018 1:30,20,36,24,80,3,0.0
1327,3/30/2018 1:35,20,45,21,86,3,0.0
1328,3/30/2018 1:40,20,54,27,101,3,0.0
1329,3/30/2018 1:45,20,50,23,93,3,0.0
1330,3/30/2018 1:50,20,43,23,86,3,0.0
1331,3/30/2018 1:55,19,41,23,83,3,0.0
1332,3/30/2018 2:00,18,33,14,65,3,0.0
1333,3/30/2018 2:05,18,39,19,76,3,0.0
1334,3/30/2018 2:10,19,38,20,77,3,0.0
1335,3/30/2018 2:15,19,32,18,69,3,0.0
1336,3/30/2018 2:20,18,29,16,63,3,0.0
1337,3/30/2018 2:25,16,40,22,78,3,0.0
1338,3/30/2018 2:30,13,36,21,70,3,0.0
1339,3/30/2018 2:35,17,26,14,57,3,0.0
1340,3/30/2018 2:40,15,36,19,70,3,0.0
1341,3/30/2018 2:45,17,35,21,73,3,0.0
1342,3/30/2018 2:50,14,32,18,64,3,0.0
1343,3/30/2018 2:55,12,34,19,65,3,0.0
1344,3/30/2018 3:00,12,30,12,54,3,0.0
1345,3/30/2018 3:05,14,25,16,55,3,0.0
1346,3/30/2018 3:10,14,25,13,52,3,0.0
1347,3/30/2018 3:15,13,23,11,47,3,0.0
1348,3/30/2018 3:20,16,24,10,50,3,0.0
1349,3/30/2018 3:25,13,29,17,59,3,0.0
1350,3/30/2018 3:30,13,27,11,51,3,0.0
1351,3/30/2018 3:35,15,23,14,52,3,0.0
1352,3/30/2018 3:40,15,29,16,60,3,0.0
1353,3/30/2018 3:45,16,31,12,59,3,0.0
1354,3/30/2018 3:50,16,26,12,54,3,0.0
1355,3/30/2018 3:55,14,25,8,47,3,0.0
1356,3/30/2018 4:00,15,26,22,63,3,0.0
1357,3/30/2018 4:05,18,28,17,63,3,0.0
1358,3/30/2018 4:10,20,32,20,72,3,0.0
1359,3/30/2018 4:15,23,40,17,80,3,0.0
1360,3/30/2018 4:20,22,32,13,67,3,0.0
1361,3/30/2018 4:25,25,33,17,75,3,0.0
1362,3/30/2018 4:30,28,32,21,81,3,0.0
1363,3/30/2018 4:35,31,41,19,91,3,0.0
1364,3/30/2018 4:40,36,47,20,103,3,0.0
1365,3/30/2018 4:45,34,41,26,101,3,0.0
1366,3/30/2018 4:50,37,42,24,103,3,0.0
1367,3/30/2018 4:55,36,37,21,94,3,0.0
1368,3/30/2018 5:00,39,39,24,102,3,0.0
1369,3/30/2018 5:05,41,42,16,99,3,0.0
1370,3/30/2018 5:10,46,48,22,116,3,0.0
1371,3/30/2018 5:15,56,48,22,126,3,0.0
1372,3/30/2018 5:20,71,55,30,156,3,0.0
1373,3/30/2018 5:25,65,52,27,144,3,0.0
1374,3/30/2018 5:30,73,58,27,158,3,0.0
1375,3/30/2018 5:35,86,61,32,179,3,0.0
1376,3/30/2018 5:40,87,61,29,177,3,0.0
1377,3/30/2018 5:45,94,64,32,190,3,0.0
1378,3/30/2018 5:50,88,61,32,181,3,0.0
1379,3/30/2018 5:55,83,64,35,182,3,0.0
1380,3/30/2018 6:00,84,63,28,175,3,0.0
1381,3/30/2018 6:05,89,57,26,172,3,0.0
1382,3/30/2018 6:10,107,60,36,203,3,0.0
1383,3/30/2018 6:15,116,72,42,230,3,0.0
1384,3/30/2018 6:20,112,79,39,230,3,0.0
1385,3/30/2018 6:25,114,80,46,240,3,0.0
1386,3/30/2018 6:30,114,78,37,229,3,0.0
1387,3/30/2018 6:35,114,88,48,250,3,0.0
1388,3/30/2018 6:40,120,87,50,257,3,0.0
1389,3/30/2018 6:45,120,86,51,257,3,0.0
1390,3/30/2018 6:50,119,99,51,269,3,0.0
1391,3/30/2018 6:55,116,92,52,260,3,0.0
1392,3/30/2018 7:00,116,91,57,264,3,0.0
1393,3/30/2018 7:05,127,94,55,276,3,0.0
1394,3/30/2018 7:10,150,99,64,313,3,0.0
1395,3/30/2018 7:15,153,93,61,307,3,0.0
1396,3/30/2018 7:20,158,99,64,321,3,0.0
1397,3/30/2018 7:25,147,102,65,314,3,0.0
1398,3/30/2018 7:30,155,99,63,317,3,0.0
1399,3/30/2018 7:35,132,98,62,292,3,0.0
1400,3/30/2018 7:40,133,90,65,288,3,0.0
1401,3/30/2018 7:45,107,101,62,270,3,0.0
1402,3/30/2018 7:50,140,102,52,294,3,0.0
1403,3/30/2018 7:55,134,90,64,288,3,0.0
1404,3/30/2018 8:00,137,101,59,297,3,0.0
1405,3/30/2018 8:05,149,103,54,306,3,0.0
1406,3/30/2018 8:10,146,100,63,309,3,0.0
1407,3/30/2018 8:15,129,99,58,286,3,0.0
1408,3/30/2018 8:20,138,98,56,292,3,0.0
1409,3/30/2018 8:25,141,100,65,306,3,0.0
1410,3/30/2018 8:30,133,99,68,300,3,0.0
1411,3/30/2018 8:35,135,98,56,289,3,0.0
1412,3/30/2018 8:40,141,99,59,299,3,0.0
1413,3/30/2018 8:45,147,96,60,303,3,0.0
1414,3/30/2018 8:50,137,91,58,286,3,0.0
1415,3/30/2018 8:55,113,97,50,260,3,0.0
1416,3/30/2018 9:00,109,86,55,250,3,0.0
1417,3/30/2018 9:05,108,90,54,252,3,0.0
1418,3/30/2018 9:10,138,92,49,279,3,0.0
1419,3/30/2018 9:15,139,86,54,279,3,0.0
1420,3/30/2018 9:20,139,104,65,308,3,0.0
1421,3/30/2018 9:25,138,96,53,287,3,0.0
1422,3/30/2018 9:30,122,98,53,273,3,0.0
1423,3/30/2018 9:35,139,85,58,282,3,0.0
1424,3/30/2018 9:40,134,91,57,282,3,0.0
1425,3/30/2018 9:45,140,97,55,292,3,0.0
1426,3/30/2018 9:50,136,89,59,284,3,0.0
1427,3/30/2018 9:55,135,87,48,270,3,0.0
1428,3/30/2018 10:00,105,85,57,247,3,0.0
1429,3/30/2018 10:05,105,94,59,258,3,0.0
1430,3/30/2018 10:10,135,89,61,285,3,0.0
1431,3/30/2018 10:15,138,93,54,285,3,0.0
1432,3/30/2018 10:20,139,88,62,289,3,0.0
1433,3/30/2018 10:25,138,85,60,283,3,0.0
1434,3/30/2018 10:30,138,83,60,281,3,0.0
1435,3/30/2018 10:35,138,86,53,277,3,0.0
1436,3/30/2018 10:40,139,92,59,290,3,0.0
1437,3/30/2018 10:45,137,82,59,278,3,0.0
1438,3/30/2018 10:50,107,91,58,256,3,0.0
1439,3/30/2018 10:55,106,90,58,254,3,0.0
1440,3/30/2018 11:00,135,93,60,288,3,0.0
1441,3/30/2018 11:05,135,100,56,291,3,0.0
1442,3/30/2018 11:10,136,87,55,278,3,0.0
1443,3/30/2018 11:15,138,95,59,292,3,0.0
1444,3/30/2018 11:20,140,97,58,295,3,0.0
1445,3/30/2018 11:25,139,99,58,296,3,0.0
1446,3/30/2018 11:30,139,97,55,291,3,0.0
1447,3/30/2018 11:35,140,100,58,298,3,0.0
1448,3/30/2018 11:40,112,88,56,256,3,0.0
1449,3/30/2018 11:45,113,91,61,265,3,0.0
1450,3/30/2018 11:50,142,96,57,295,3,0.0
1451,3/30/2018 11:55,139,96,56,291,3,0.0
1452,3/30/2018 12:00,139,102,74,315,3,0.0
1453,3/30/2018 12:05,140,104,68,312,3,0.0
1454,3/30/2018 12:10,140,103,61,304,3,0.0
1455,3/30/2018 12:15,141,104,67,312,3,0.0
1456,3/30/2018 12:20,143,96,62,301,3,0.0
1457,3/30/2018 12:25,142,86,56,284,3,0.0
1458,3/30/2018 12:30,142,87,53,282,3,0.0
1459,3/30/2018 12:35,115,90,61,266,3,0.0
1460,3/30/2018 12:40,115,96,61,272,3,0.0
1461,3/30/2018 12:45,115,91,56,262,3,0.0
1462,3/30/2018 12:50,142,89,63,294,3,0.0
1463,3/30/2018 12:55,141,88,64,293,3,0.0
1464,3/30/2018 13:00,141,89,63,293,3,0.0
1465,3/30/2018 13:05,143,88,65,296,3,0.0
1466,3/30/2018 13:10,144,94,67,305,3,0.0
1467,3/30/2018 13:15,145,100,66,311,3,0.0
1468,3/30/2018 13:20,145,98,64,307,3,0.0
1469,3/30/2018 13:25,144,92,60,296,3,0.0
1470,3/30/2018 13:30,145,95,62,302,3,0.0
1471,3/30/2018 13:35,144,85,57,286,3,0.0
1472,3/30/2018 13:40,146,81,62,289,3,0.0
1473,3/30/2018 13:45,145,92,62,299,3,0.0
1474,3/30/2018 13:50,147,100,73,320,3,0.0
1475,3/30/2018 13:55,144,100,67,311,3,0.0
1476,3/30/2018 14:00,144,99,67,310,3,0.0
1477,3/30/2018 14:05,146,87,59,292,3,0.0
1478,3/30/2018 14:10,147,90,57,294,3,0.0
1479,3/30/2018 14:15,147,85,59,291,3,0.0
1480,3/30/2018 14:20,145,89,67,301,3,0.0
1481,3/30/2018 14:25,148,90,63,301,3,0.0
1482,3/30/2018 14:30,142,80,58,280,3,0.0
1483,3/30/2018 14:35,124,96,57,277,3,0.0
1484,3/30/2018 14:40,128,81,73,282,3,0.0
1485,3/30/2018 14:45,127,67,69,263,3,0.0
1486,3/30/2018 14:50,126,79,67,272,3,0.0
1487,3/30/2018 14:55,134,83,77,294,3,0.0
1488,3/30/2018 15:00,143,85,71,299,3,0.0
1489,3/30/2018 15:05,142,74,72,288,3,0.0
1490,3/30/2018 15:10,140,79,70,289,3,0.0
1491,3/30/2018 15:15,139,87,73,299,3,0.0
1492,3/30/2018 15:20,137,75,55,267,3,0.0
1493,3/30/2018 15:25,135,79,64,278,3,0.0
1494,3/30/2018 15:30,143,69,72,284,3,0.0
1495,3/30/2018 15:35,144,71,66,281,3,0.0
1496,3/30/2018 15:40,136,68,58,262,3,0.0
1497,3/30/2018 15:45,127,58,53,238,3,0.0
1498,3/30/2018 15:50,126,70,64,260,3,0.0
1499,3/30/2018 15:55,142,67,54,263,3,0.0
1500,3/30/2018 16:00,132,60,61,253,3,0.0
1501,3/30/2018 16:05,124,65,66,255,3,0.0
1502,3/30/2018 16:10,125,69,65,259,3,0.0
1503,3/30/2018 16:15,125,69,61,255,3,0.0
1504,3/30/2018 16:20,133,71,62,266,3,0.0
1505,3/30/2018 16:25,124,68,62,254,3,0.0
1506,3/30/2018 16:30,141,64,53,258,3,0.0
1507,3/30/2018 16:35,145,67,60,272,3,0.0
1508,3/30/2018 16:40,135,66,57,258,3,0.0
1509,3/30/2018 16:45,128,69,56,253,3,0.0
1510,3/30/2018 16:50,139,54,54,247,3,0.0
1511,3/30/2018 16:55,128,63,63,254,3,0.0
1512,3/30/2018 17:00,131,51,53,235,3,0.0
1513,3/30/2018 17:05,131,67,62,260,3,0.0
1514,3/30/2018 17:10,137,58,56,251,3,0.0
1515,3/30/2018 17:15,129,64,55,248,3,0.0
1516,3/30/2018 17:20,129,71,51,251,3,0.0
1517,3/30/2018 17:25,125,62,50,237,3,0.0
1518,3/30/2018 17:30,124,69,53,246,3,0.0
1519,3/30/2018 17:35,123,76,59,258,3,0.0
1520,3/30/2018 17:40,119,75,70,264,3,0.0
1521,3/30/2018 17:45,115,75,63,253,3,0.0
1522,3/30/2018 17:50,121,76,67,264,3,0.0
1523,3/30/2018 17:55,120,62,53,235,3,0.0
1524,3/30/2018 18:00,119,63,52,234,3,0.0
1525,3/30/2018 18:05,119,65,57,241,3,0.0
1526,3/30/2018 18:10,119,69,61,249,3,0.0
1527,3/30/2018 18:15,109,80,70,259,3,0.0
1528,3/30/2018 18:20,119,83,64,266,3,0.0
1529,3/30/2018 18:25,118,69,60,247,3,0.0
1530,3/30/2018 18:30,124,64,42,230,3,0.0
1531,3/30/2018 18:35,116,74,55,245,3,0.0
1532,3/30/2018 18:40,115,69,50,234,3,0.0
1533,3/30/2018 18:45,115,80,61,256,3,0.0
1534,3/30/2018 18:50,123,85,70,278,3,0.0
1535,3/30/2018 18:55,134,80,59,273,3,0.0
1536,3/30/2018 19:00,130,79,58,267,3,0.0
1537,3/30/2018 19:05,112,73,56,241,3,0.0
1538,3/30/2018 19:10,119,79,52,250,3,0.0
1539,3/30/2018 19:15,135,76,51,262,3,0.0
1540,3/30/2018 19:20,135,88,48,271,3,0.0
1541,3/30/2018 19:25,133,85,48,266,3,0.0
1542,3/30/2018 19:30,131,84,55,270,3,0.0
1543,3/30/2018 19:35,127,86,59,272,3,0.0
1544,3/30/2018 19:40,126,92,60,278,3,0.0
1545,3/30/2018 19:45,123,89,61,273,3,0.0
1546,3/30/2018 19:50,100,94,59,253,3,0.0
1547,3/30/2018 19:55,97,85,65,247,3,0.0
1548,3/30/2018 20:00,95,83,50,228,3,0.0
1549,3/30/2018 20:05,114,89,51,254,3,0.0
1550,3/30/2018 20:10,113,88,62,263,3,0.0
1551,3/30/2018 20:15,112,86,60,258,3,0.0
1552,3/30/2018 20:20,111,88,65,264,3,0.0
1553,3/30/2018 20:25,108,84,57,249,3,0.0
1554,3/30/2018 20:30,106,93,63,262,3,0.0
1555,3/30/2018 20:35,105,78,61,244,3,0.0
1556,3/30/2018 20:40,102,88,66,256,3,0.0
1557,3/30/2018 20:45,99,91,56,246,3,0.0
1558,3/30/2018 20:50,97,88,58,243,3,0.0
1559,3/30/2018 20:55,81,79,56,216,3,0.0
1560,3/30/2018 21:00,85,84,48,217,3,0.0
1561,3/30/2018 21:05,84,85,57,226,3,0.0
1562,3/30/2018 21:10,91,88,62,241,3,0.0
1563,3/30/2018 21:15,99,92,52,243,3,0.0
1564,3/30/2018 21:20,99,92,59,250,3,0.0
1565,3/30/2018 21:25,98,96,60,254,3,0.0
1566,3/30/2018 21:30,96,92,60,248,3,0.0
1567,3/30/2018 21:35,94,101,57,252,3,0.0
1568,3/30/2018 21:40,93,97,63,253,3,0.0
1569,3/30/2018 21:45,95,98,61,254,3,0.0
1570,3/30/2018 21:50,93,96,65,254,3,0.0
1571,3/30/2018 21:55,91,88,57,236,3,0.0
1572,3/30/2018 22:00,90,96,60,246,3,0.0
1573,3/30/2018 22:05,81,97,64,242,3,0.0
1574,3/30/2018 22:10,85,94,58,237,3,0.0
1575,3/30/2018 22:15,84,104,68,256,3,0.0
1576,3/30/2018 22:20,85,94,61,240,3,0.0
1577,3/30/2018 22:25,89,88,57,234,3,0.0
1578,3/30/2018 22:30,86,93,63,242,3,0.0
1579,3/30/2018 22:35,84,93,55,232,3,0.0
1580,3/30/2018 22:40,82,97,63,242,3,0.0
1581,3/30/2018 22:45,80,94,56,230,3,0.0
1582,3/30/2018 22:50,77,88,59,224,3,0.0
1583,3/30/2018 22:55,74,87,56,217,3,0.0
1584,3/30/2018 23:00,70,88,59,217,3,0.0
1585,3/30/2018 23:05,70,85,53,208,3,0.0
1586,3/30/2018 23:10,70,97,59,226,3,0.0
1587,3/30/2018 23:15,69,89,58,216,3,0.0
1588,3/30/2018 23:20,67,91,65,223,3,0.0
1589,3/30/2018 23:25,63,90,50,203,3,0.0
1590,3/30/2018 23:30,60,96,53,209,3,0.0
1591,3/30/2018 23:35,61,84,60,205,3,0.0
1592,3/30/2018 23:40,60,83,50,193,3,0.0
1593,3/30/2018 23:45,58,85,57,200,3,0.0
1594,3/30/2018 23:50,55,80,45,180,3,0.0
1595,3/30/2018 23:55,48,67,45,160,3,0.0
1596,3/31/2018 0:00,40,70,42,152,3,0.0
1597,3/31/2018 0:05,40,67,42,149,3,0.0
1598,3/31/2018 0:10,48,74,43,165,3,0.0
1599,3/31/2018 0:15,47,65,43,155,3,0.0
1600,3/31/2018 0:20,46,66,37,149,3,0.0
1601,3/31/2018 0:25,43,61,38,142,3,0.0
1602,3/31/2018 0:30,42,68,34,144,3,0.0
1603,3/31/2018 0:35,40,59,36,135,3,0.0
1604,3/31/2018 0:40,40,63,40,143,3,0.0
1605,3/31/2018 0:45,39,59,32,130,3,0.0
1606,3/31/2018 0:50,38,56,33,127,3,0.0
1607,3/31/2018 0:55,36,45,22,103,3,0.0
1608,3/31/2018 1:00,34,48,27,109,3,0.0
1609,3/31/2018 1:05,33,52,28,113,3,0.0
1610,3/31/2018 1:10,33,55,26,114,3,0.0
1611,3/31/2018 1:15,33,48,30,111,3,0.0
1612,3/31/2018 1:20,33,51,30,114,3,0.0
1613,3/31/2018 1:25,32,49,26,107,3,0.0
1614,3/31/2018 1:30,15,48,23,86,3,0.0
1615,3/31/2018 1:35,25,51,23,99,3,0.0
1616,3/31/2018 1:40,29,52,27,108,3,0.0
1617,3/31/2018 1:45,30,51,31,112,3,0.0
1618,3/31/2018 1:50,30,39,20,89,3,0.0
1619,3/31/2018 1:55,28,39,23,90,3,0.0
1620,3/31/2018 2:00,27,34,20,81,3,0.0
1621,3/31/2018 2:05,28,42,21,91,3,0.0
1622,3/31/2018 2:10,29,41,19,89,3,0.0
1623,3/31/2018 2:15,30,47,27,104,3,0.0
1624,3/31/2018 2:20,28,45,29,102,3,0.0
1625,3/31/2018 2:25,26,43,19,88,3,0.0
1626,3/31/2018 2:30,25,36,17,78,3,0.0
1627,3/31/2018 2:35,24,32,16,72,3,0.0
1628,3/31/2018 2:40,24,38,23,85,3,0.0
1629,3/31/2018 2:45,23,35,23,81,3,0.0
1630,3/31/2018 2:50,22,36,14,72,3,0.0
1631,3/31/2018 2:55,21,31,14,66,3,0.0
1632,3/31/2018 3:00,20,29,19,68,3,0.0
1633,3/31/2018 3:05,19,28,16,63,3,0.0
1634,3/31/2018 3:10,19,28,14,61,3,0.0
1635,3/31/2018 3:15,19,29,16,64,3,0.0
1636,3/31/2018 3:20,20,26,17,63,3,0.0
1637,3/31/2018 3:25,20,19,13,52,3,0.0
1638,3/31/2018 3:30,19,28,15,62,3,0.0
1639,3/31/2018 3:35,19,18,12,49,3,0.0
1640,3/31/2018 3:40,16,24,14,54,3,0.0
1641,3/31/2018 3:45,19,27,10,56,3,0.0
1642,3/31/2018 3:50,18,25,10,53,3,0.0
1643,3/31/2018 3:55,16,21,10,47,3,0.0
1644,3/31/2018 4:00,14,26,14,54,3,0.0
1645,3/31/2018 4:05,17,30,10,57,3,0.0
1646,3/31/2018 4:10,19,28,14,61,3,0.0
1647,3/31/2018 4:15,15,30,13,58,3,0.0
1648,3/31/2018 4:20,16,24,13,53,3,0.0
1649,3/31/2018 4:25,17,21,11,49,3,0.0
1650,3/31/2018 4:30,18,31,13,62,3,0.0
1651,3/31/2018 4:35,19,28,13,60,3,0.0
1652,3/31/2018 4:40,21,30,15,66,3,0.0
1653,3/31/2018 4:45,21,32,15,68,3,0.0
1654,3/31/2018 4:50,22,33,15,70,3,0.0
1655,3/31/2018 4:55,20,36,18,74,3,0.0
1656,3/31/2018 5:00,22,25,17,64,3,0.0
1657,3/31/2018 5:05,24,37,14,75,3,0.0
1658,3/31/2018 5:10,26,39,19,84,3,0.0
1659,3/31/2018 5:15,34,40,21,95,3,0.0
1660,3/31/2018 5:20,34,36,20,90,3,0.0
1661,3/31/2018 5:25,35,43,22,100,3,0.0
1662,3/31/2018 5:30,37,41,19,97,3,0.0
1663,3/31/2018 5:35,39,43,23,105,3,0.0
1664,3/31/2018 5:40,41,50,24,115,3,0.0
1665,3/31/2018 5:45,41,50,25,116,3,0.0
1666,3/31/2018 5:50,39,45,26,110,3,0.0
1667,3/31/2018 5:55,37,44,26,107,3,0.0
1668,3/31/2018 6:00,36,44,24,104,3,0.0
1669,3/31/2018 6:05,43,47,22,112,3,0.0
1670,3/31/2018 6:10,49,53,30,132,3,0.0
1671,3/31/2018 6:15,49,55,27,131,3,0.0
1672,3/31/2018 6:20,52,54,32,138,3,0.0
1673,3/31/2018 6:25,53,57,27,137,3,0.0
1674,3/31/2018 6:30,62,51,33,146,3,0.0
1675,3/31/2018 6:35,61,56,31,148,3,0.0
1676,3/31/2018 6:40,63,70,36,169,3,0.0
1677,3/31/2018 6:45,71,65,41,177,3,0.0
1678,3/31/2018 6:50,71,66,41,178,3,0.0
1679,3/31/2018 6:55,68,68,41,177,3,0.0
1680,3/31/2018 7:00,65,64,35,164,3,0.0
1681,3/31/2018 7:05,67,70,33,170,3,0.0
1682,3/31/2018 7:10,71,71,43,185,3,0.0
1683,3/31/2018 7:15,75,77,43,195,3,0.0
1684,3/31/2018 7:20,79,72,36,187,3,0.0
1685,3/31/2018 7:25,83,77,53,213,3,0.0
1686,3/31/2018 7:30,73,88,45,206,3,0.0
1687,3/31/2018 7:35,73,84,50,207,3,0.0
1688,3/31/2018 7:40,98,85,44,227,3,0.0
1689,3/31/2018 7:45,102,88,51,241,3,0.0
1690,3/31/2018 7:50,101,87,53,241,3,0.0
1691,3/31/2018 7:55,98,81,51,230,3,0.0
1692,3/31/2018 8:00,94,77,45,216,3,0.0
1693,3/31/2018 8:05,95,77,46,218,3,0.0
1694,3/31/2018 8:10,97,86,52,235,3,0.0
1695,3/31/2018 8:15,101,89,47,237,3,0.0
1696,3/31/2018 8:20,102,92,56,250,3,0.0
1697,3/31/2018 8:25,106,93,58,257,3,0.0
1698,3/31/2018 8:30,109,89,55,253,3,0.0
1699,3/31/2018 8:35,115,93,57,265,3,0.0
1700,3/31/2018 8:40,118,80,50,248,3,0.0
1701,3/31/2018 8:45,120,99,58,277,3,0.0
1702,3/31/2018 8:50,120,84,55,259,3,0.0
1703,3/31/2018 8:55,117,89,51,257,3,0.0
1704,3/31/2018 9:00,112,87,56,255,3,0.0
1705,3/31/2018 9:05,97,96,55,248,3,0.0
1706,3/31/2018 9:10,106,87,57,250,3,0.0
1707,3/31/2018 9:15,107,93,55,255,3,0.0
1708,3/31/2018 9:20,120,103,65,288,3,0.0
1709,3/31/2018 9:25,122,102,64,288,3,0.0
1710,3/31/2018 9:30,125,103,59,287,3,0.0
1711,3/31/2018 9:35,126,104,64,294,3,0.0
1712,3/31/2018 9:40,130,94,65,289,3,0.0
1713,3/31/2018 9:45,132,99,59,290,3,0.0
1714,3/31/2018 9:50,128,92,52,272,3,0.0
1715,3/31/2018 9:55,126,91,56,273,3,0.0
1716,3/31/2018 10:00,129,91,60,280,3,0.0
1717,3/31/2018 10:05,127,91,55,273,3,0.0
1718,3/31/2018 10:10,125,94,59,278,3,0.0
1719,3/31/2018 10:15,126,100,61,287,3,0.0
1720,3/31/2018 10:20,129,95,65,289,3,0.0
1721,3/31/2018 10:25,127,95,56,278,3,0.0
1722,3/31/2018 10:30,129,98,68,295,3,0.0
1723,3/31/2018 10:35,130,98,64,292,3,0.0
1724,3/31/2018 10:40,134,100,67,301,3,0.0
1725,3/31/2018 10:45,134,99,68,301,3,0.0
1726,3/31/2018 10:50,135,99,63,297,3,0.0
1727,3/31/2018 10:55,133,93,64,290,3,0.0
1728,3/31/2018 11:00,132,87,64,283,3,0.0
1729,3/31/2018 11:05,133,99,70,302,3,0.0
1730,3/31/2018 11:10,134,89,65,288,3,0.0
1731,3/31/2018 11:15,137,93,62,292,3,0.0
1732,3/31/2018 11:20,137,97,66,300,3,0.0
1733,3/31/2018 11:25,139,94,57,290,3,0.0
1734,3/31/2018 11:30,139,95,66,300,3,0.0
1735,3/31/2018 11:35,140,96,68,304,3,0.0
1736,3/31/2018 11:40,143,97,57,297,3,0.0
1737,3/31/2018 11:45,142,96,63,301,3,0.0
1738,3/31/2018 11:50,140,97,63,300,3,0.0
1739,3/31/2018 11:55,139,95,70,304,3,0.0
