,5 Minutes,Lane 1 Flow (Veh/5 Minutes),Lane 2 Flow (Veh/5 Minutes),Lane 3 Flow (Veh/5 Minutes),Flow (Veh/5 Minutes),# Lane Points,% Observed
1275,3/23/2018 21:15,78,84,55,217,3,66.7
1276,3/23/2018 21:20,81,91,76,248,3,66.7
1277,3/23/2018 21:25,81,91,54,226,3,66.7
1278,3/23/2018 21:30,88,89,63,240,3,66.7
1279,3/23/2018 21:35,90,103,54,247,3,66.7
1280,3/23/2018 21:40,91,99,62,252,3,66.7
1281,3/23/2018 21:45,95,98,61,254,3,66.7
1282,3/23/2018 21:50,97,103,80,280,3,66.7
1283,3/23/2018 21:55,84,106,64,254,3,66.7
1284,3/23/2018 22:00,83,99,60,242,3,66.7
1285,3/23/2018 22:05,93,104,72,269,3,66.7
1286,3/23/2018 22:10,79,109,59,247,3,66.7
1287,3/23/2018 22:15,87,102,63,252,3,66.7
1288,3/23/2018 22:20,86,106,58,250,3,66.7
1289,3/23/2018 22:25,78,100,48,226,3,66.7
1290,3/23/2018 22:30,81,96,81,258,3,66.7
1291,3/23/2018 22:35,77,91,69,237,3,66.7
1292,3/23/2018 22:40,85,92,60,237,3,66.7
1293,3/23/2018 22:45,78,93,61,232,3,66.7
1294,3/23/2018 22:50,79,85,47,211,3,66.7
1295,3/23/2018 22:55,74,86,58,218,3,66.7
1296,3/23/2018 23:00,85,105,60,250,3,66.7
1297,3/23/2018 23:05,62,82,44,188,3,66.7
1298,3/23/2018 23:10,75,86,45,206,3,66.7
1299,3/23/2018 23:15,68,91,56,215,3,66.7
1300,3/23/2018 23:20,56,83,55,194,3,66.7
1301,3/23/2018 23:25,62,89,46,197,3,66.7
1302,3/23/2018 23:30,68,90,48,206,3,66.7
1303,3/23/2018 23:35,78,85,60,223,3,66.7
1304,3/23/2018 23:40,67,74,41,182,3,66.7
1305,3/23/2018 23:45,69,86,50,205,3,66.7
1306,3/23/2018 23:50,56,77,44,177,3,66.7
1307,3/23/2018 23:55,49,54,32,135,3,66.7
1308,3/24/2018 0:00,59,54,38,151,3,66.7
1309,3/24/2018 0:05,51,67,40,158,3,66.7
1310,3/24/2018 0:10,55,64,31,150,3,66.7
1311,3/24/2018 0:15,45,48,23,116,3,66.7
1312,3/24/2018 0:20,49,48,20,117,3,66.7
1313,3/24/2018 0:25,42,48,14,104,3,66.7
1314,3/24/2018 0:30,44,47,15,106,3,66.7
1315,3/24/2018 0:35,45,48,15,108,3,66.7
1316,3/24/2018 0:40,42,60,23,125,3,66.7
1317,3/24/2018 0:45,45,42,20,107,3,66.7
1318,3/24/2018 0:50,39,46,17,102,3,66.7
1319,3/24/2018 0:55,40,44,16,100,3,66.7
1320,3/24/2018 1:00,44,49,21,114,3,66.7
1321,3/24/2018 1:05,42,54,29,125,3,66.7
1322,3/24/2018 1:10,45,47,20,112,3,66.7
1323,3/24/2018 1:15,39,42,17,98,3,66.7
1324,3/24/2018 1:20,41,51,18,110,3,66.7
1325,3/24/2018 1:25,47,48,21,116,3,66.7
1326,3/24/2018 1:30,38,48,21,107,3,66.7
1327,3/24/2018 1:35,39,51,17,107,3,66.7
1328,3/24/2018 1:40,49,52,22,123,3,66.7
1329,3/24/2018 1:45,47,51,22,120,3,66.7
1330,3/24/2018 1:50,38,39,20,97,3,66.7
1331,3/24/2018 1:55,40,39,16,95,3,66.7
1332,3/24/2018 2:00,39,45,15,99,3,66.7
1333,3/24/2018 2:05,35,48,14,97,3,66.7
1334,3/24/2018 2:10,41,41,14,96,3,66.7
1335,3/24/2018 2:15,34,39,22,95,3,66.7
1336,3/24/2018 2:20,28,39,17,84,3,66.7
1337,3/24/2018 2:25,39,49,11,99,3,66.7
1338,3/24/2018 2:30,35,38,13,86,3,66.7
1339,3/24/2018 2:35,29,29,13,71,3,66.7
1340,3/24/2018 2:40,37,37,13,87,3,66.7
1341,3/24/2018 2:45,35,42,13,90,3,66.7
1342,3/24/2018 2:50,31,36,7,74,3,66.7
1343,3/24/2018 2:55,29,33,14,76,3,66.7
1344,3/24/2018 3:00,25,25,11,61,3,66.7
1345,3/24/2018 3:05,29,30,12,71,3,66.7
1346,3/24/2018 3:10,32,34,9,75,3,66.7
1347,3/24/2018 3:15,34,32,15,81,3,66.7
1348,3/24/2018 3:20,29,25,14,68,3,66.7
1349,3/24/2018 3:25,24,25,14,63,3,66.7
1350,3/24/2018 3:30,23,24,9,56,3,66.7
1351,3/24/2018 3:35,20,20,10,50,3,66.7
1352,3/24/2018 3:40,29,24,15,68,3,66.7
1353,3/24/2018 3:45,25,27,6,58,3,66.7
1354,3/24/2018 3:50,21,25,9,55,3,66.7
1355,3/24/2018 3:55,26,22,13,61,3,66.7
1356,3/24/2018 4:00,22,31,14,67,3,66.7
1357,3/24/2018 4:05,22,25,9,56,3,66.7
1358,3/24/2018 4:10,26,25,12,63,3,66.7
1359,3/24/2018 4:15,24,27,8,59,3,66.7
1360,3/24/2018 4:20,20,22,13,55,3,66.7
1361,3/24/2018 4:25,22,26,11,59,3,66.7
1362,3/24/2018 4:30,26,27,11,64,3,66.7
1363,3/24/2018 4:35,23,28,10,61,3,66.7
1364,3/24/2018 4:40,26,28,10,64,3,66.7
1365,3/24/2018 4:45,38,36,11,85,3,66.7
1366,3/24/2018 4:50,28,33,12,73,3,66.7
1367,3/24/2018 4:55,34,34,19,87,3,66.7
1368,3/24/2018 5:00,32,25,18,75,3,66.7
1369,3/24/2018 5:05,38,42,14,94,3,66.7
1370,3/24/2018 5:10,37,42,20,99,3,66.7
1371,3/24/2018 5:15,36,37,15,88,3,66.7
1372,3/24/2018 5:20,37,36,19,92,3,66.7
1373,3/24/2018 5:25,39,43,22,104,3,66.7
1374,3/24/2018 5:30,38,40,19,97,3,66.7
1375,3/24/2018 5:35,43,47,26,116,3,66.7
1376,3/24/2018 5:40,48,55,32,135,3,66.7
1377,3/24/2018 5:45,43,50,29,122,3,66.7
1378,3/24/2018 5:50,40,42,19,101,3,66.7
1379,3/24/2018 5:55,42,40,25,107,3,66.7
1380,3/24/2018 6:00,39,46,17,102,3,66.7
1381,3/24/2018 6:05,51,47,21,119,3,66.7
1382,3/24/2018 6:10,51,57,29,137,3,66.7
1383,3/24/2018 6:15,48,55,27,130,3,66.7
1384,3/24/2018 6:20,52,66,30,148,3,66.7
1385,3/24/2018 6:25,54,56,36,146,3,66.7
1386,3/24/2018 6:30,55,62,22,139,3,66.7
1387,3/24/2018 6:35,55,67,31,153,3,66.7
1388,3/24/2018 6:40,67,69,36,172,3,66.7
1389,3/24/2018 6:45,61,64,38,163,3,66.7
1390,3/24/2018 6:50,65,68,41,174,3,66.7
1391,3/24/2018 6:55,55,65,36,156,3,66.7
1392,3/24/2018 7:00,54,64,37,155,3,66.7
1393,3/24/2018 7:05,60,70,33,163,3,66.7
1394,3/24/2018 7:10,60,71,50,181,3,66.7
1395,3/24/2018 7:15,72,77,39,188,3,66.7
1396,3/24/2018 7:20,69,72,34,175,3,66.7
1397,3/24/2018 7:25,63,77,42,182,3,66.7
1398,3/24/2018 7:30,76,90,51,217,3,66.7
1399,3/24/2018 7:35,73,90,53,216,3,66.7
1400,3/24/2018 7:40,70,87,51,208,3,66.7
1401,3/24/2018 7:45,71,88,54,213,3,66.7
1402,3/24/2018 7:50,70,89,48,207,3,66.7
1403,3/24/2018 7:55,69,89,56,214,3,66.7
1404,3/24/2018 8:00,72,87,45,204,3,66.7
1405,3/24/2018 8:05,74,81,50,205,3,66.7
1406,3/24/2018 8:10,76,96,53,225,3,66.7
1407,3/24/2018 8:15,71,76,48,195,3,66.7
1408,3/24/2018 8:20,79,97,59,235,3,66.7
1409,3/24/2018 8:25,78,92,60,230,3,66.7
1410,3/24/2018 8:30,84,99,55,238,3,66.7
1411,3/24/2018 8:35,80,98,56,234,3,66.7
1412,3/24/2018 8:40,78,99,51,228,3,66.7
1413,3/24/2018 8:45,83,101,57,241,3,66.7
1414,3/24/2018 8:50,68,105,61,234,3,66.7
1415,3/24/2018 8:55,79,93,51,223,3,66.7
1416,3/24/2018 9:00,86,98,63,247,3,66.7
1417,3/24/2018 9:05,82,98,49,229,3,66.7
1418,3/24/2018 9:10,84,100,65,249,3,66.7
1419,3/24/2018 9:15,80,95,54,229,3,66.7
1420,3/24/2018 9:20,87,103,69,259,3,66.7
1421,3/24/2018 9:25,81,109,65,255,3,66.7
1422,3/24/2018 9:30,83,107,73,263,3,66.7
1423,3/24/2018 9:35,89,111,65,265,3,66.7
1424,3/24/2018 9:40,86,102,64,252,3,66.7
1425,3/24/2018 9:45,88,103,70,261,3,66.7
1426,3/24/2018 9:50,94,96,54,244,3,66.7
1427,3/24/2018 9:55,88,98,56,242,3,66.7
1428,3/24/2018 10:00,87,91,56,234,3,66.7
1429,3/24/2018 10:05,88,89,55,232,3,66.7
1430,3/24/2018 10:10,94,91,54,239,3,66.7
1431,3/24/2018 10:15,97,105,61,263,3,66.7
1432,3/24/2018 10:20,94,100,76,270,3,66.7
1433,3/24/2018 10:25,86,103,54,243,3,66.7
1434,3/24/2018 10:30,98,99,70,267,3,66.7
1435,3/24/2018 10:35,87,90,59,236,3,66.7
1436,3/24/2018 10:40,90,97,69,256,3,66.7
1437,3/24/2018 10:45,85,95,62,242,3,66.7
1438,3/24/2018 10:50,93,95,62,250,3,66.7
1439,3/24/2018 10:55,92,93,74,259,3,66.7
1440,3/24/2018 11:00,94,87,61,242,3,66.7
1441,3/24/2018 11:05,89,100,70,259,3,66.7
1442,3/24/2018 11:10,83,80,59,222,3,66.7
1443,3/24/2018 11:15,100,106,70,276,3,66.7
1444,3/24/2018 11:20,96,111,67,274,3,66.7
1445,3/24/2018 11:25,104,98,74,276,3,66.7
1446,3/24/2018 11:30,95,110,57,262,3,66.7
1447,3/24/2018 11:35,103,99,72,274,3,66.7
1448,3/24/2018 11:40,90,105,54,249,3,66.7
1449,3/24/2018 11:45,89,96,59,244,3,66.7
1450,3/24/2018 11:50,96,100,64,260,3,66.7
1451,3/24/2018 11:55,95,84,74,253,3,66.7
1452,3/24/2018 12:00,90,104,58,252,3,66.7
1453,3/24/2018 12:05,96,78,64,238,3,66.7
1454,3/24/2018 12:10,94,102,56,252,3,66.7
1455,3/24/2018 12:15,93,84,63,240,3,66.7
1456,3/24/2018 12:20,92,105,64,261,3,66.7
1457,3/24/2018 12:25,88,91,60,239,3,66.7
1458,3/24/2018 12:30,104,104,81,289,3,66.7
1459,3/24/2018 12:35,95,103,79,277,3,66.7
1460,3/24/2018 12:40,91,107,81,279,3,66.7
1461,3/24/2018 12:45,109,105,71,285,3,66.7
1462,3/24/2018 12:50,99,104,88,291,3,66.7
1463,3/24/2018 12:55,96,105,69,270,3,66.7
1464,3/24/2018 13:00,100,96,68,264,3,66.7
1465,3/24/2018 13:05,92,88,61,241,3,66.7
1466,3/24/2018 13:10,95,87,58,240,3,66.7
1467,3/24/2018 13:15,90,90,55,235,3,66.7
1468,3/24/2018 13:20,101,92,59,252,3,66.7
1469,3/24/2018 13:25,93,96,62,251,3,66.7
1470,3/24/2018 13:30,83,93,64,240,3,66.7
1471,3/24/2018 13:35,94,83,69,246,3,66.7
1472,3/24/2018 13:40,82,86,72,240,3,66.7
1473,3/24/2018 13:45,97,104,68,269,3,66.7
1474,3/24/2018 13:50,100,92,69,261,3,66.7
1475,3/24/2018 13:55,89,89,67,245,3,66.7
1476,3/24/2018 14:00,96,107,73,276,3,66.7
1477,3/24/2018 14:05,96,88,73,257,3,66.7
1478,3/24/2018 14:10,108,108,67,283,3,66.7
1479,3/24/2018 14:15,94,95,66,255,3,66.7
1480,3/24/2018 14:20,95,88,69,252,3,66.7
1481,3/24/2018 14:25,84,92,67,243,3,66.7
1482,3/24/2018 14:30,95,100,68,263,3,66.7
1483,3/24/2018 14:35,98,93,72,263,3,66.7
1484,3/24/2018 14:40,109,105,70,284,3,66.7
1485,3/24/2018 14:45,98,90,71,259,3,66.7
1486,3/24/2018 14:50,100,109,68,277,3,66.7
1487,3/24/2018 14:55,90,95,64,249,3,66.7
1488,3/24/2018 15:00,98,100,77,275,3,66.7
1489,3/24/2018 15:05,86,94,75,255,3,66.7
1490,3/24/2018 15:10,97,102,76,275,3,66.7
1491,3/24/2018 15:15,86,77,70,233,3,66.7
1492,3/24/2018 15:20,88,87,71,246,3,66.7
1493,3/24/2018 15:25,99,99,84,282,3,66.7
1494,3/24/2018 15:30,90,92,64,246,3,66.7
1495,3/24/2018 15:35,93,104,71,268,3,66.7
1496,3/24/2018 15:40,82,76,64,222,3,66.7
1497,3/24/2018 15:45,94,92,63,249,3,66.7
1498,3/24/2018 15:50,84,94,65,243,3,66.7
1499,3/24/2018 15:55,92,86,67,245,3,66.7
1500,3/24/2018 16:00,100,108,59,267,3,66.7
1501,3/24/2018 16:05,92,88,79,259,3,66.7
1502,3/24/2018 16:10,100,106,81,287,3,66.7
1503,3/24/2018 16:15,91,98,64,253,3,66.7
1504,3/24/2018 16:20,98,101,72,271,3,66.7
1505,3/24/2018 16:25,84,98,69,251,3,66.7
1506,3/24/2018 16:30,81,88,65,234,3,66.7
1507,3/24/2018 16:35,71,84,61,216,3,66.7
1508,3/24/2018 16:40,85,94,73,252,3,66.7
1509,3/24/2018 16:45,95,97,72,264,3,66.7
1510,3/24/2018 16:50,100,100,82,282,3,66.7
1511,3/24/2018 16:55,94,108,69,271,3,66.7
1512,3/24/2018 17:00,79,91,71,241,3,66.7
1513,3/24/2018 17:05,97,99,71,267,3,66.7
1514,3/24/2018 17:10,89,95,81,265,3,66.7
1515,3/24/2018 17:15,88,99,74,261,3,66.7
1516,3/24/2018 17:20,96,101,78,275,3,66.7
1517,3/24/2018 17:25,87,79,69,235,3,66.7
1518,3/24/2018 17:30,103,104,71,278,3,66.7
1519,3/24/2018 17:35,86,86,69,241,3,66.7
1520,3/24/2018 17:40,91,101,71,263,3,66.7
1521,3/24/2018 17:45,98,100,67,265,3,66.7
1522,3/24/2018 17:50,95,92,73,260,3,66.7
1523,3/24/2018 17:55,94,100,74,268,3,66.7
1524,3/24/2018 18:00,86,91,59,236,3,66.7
1525,3/24/2018 18:05,88,89,67,244,3,66.7
1526,3/24/2018 18:10,87,80,69,236,3,66.7
1527,3/24/2018 18:15,90,89,65,244,3,66.7
1528,3/24/2018 18:20,91,87,64,242,3,66.7
1529,3/24/2018 18:25,81,89,47,217,3,66.7
1530,3/24/2018 18:30,89,100,61,250,3,66.7
1531,3/24/2018 18:35,93,91,60,244,3,66.7
1532,3/24/2018 18:40,86,91,67,244,3,66.7
1533,3/24/2018 18:45,88,85,67,240,3,66.7
1534,3/24/2018 18:50,86,93,69,248,3,66.7
1535,3/24/2018 18:55,95,100,83,278,3,66.7
1536,3/24/2018 19:00,94,104,77,275,3,66.7
1537,3/24/2018 19:05,86,104,83,273,3,66.7
1538,3/24/2018 19:10,87,99,64,250,3,66.7
1539,3/24/2018 19:15,104,114,76,294,3,66.7
1540,3/24/2018 19:20,90,97,69,256,3,66.7
1541,3/24/2018 19:25,84,98,71,253,3,66.7
1542,3/24/2018 19:30,86,87,65,238,3,66.7
1543,3/24/2018 19:35,95,94,73,262,3,66.7
1544,3/24/2018 19:40,94,97,64,255,3,66.7
1545,3/24/2018 19:45,85,90,55,230,3,66.7
1546,3/24/2018 19:50,85,78,62,225,3,66.7
1547,3/24/2018 19:55,84,81,59,224,3,66.7
1548,3/24/2018 20:00,93,90,53,236,3,66.7
1549,3/24/2018 20:05,85,84,55,224,3,66.7
1550,3/24/2018 20:10,88,91,50,229,3,66.7
1551,3/24/2018 20:15,70,86,53,209,3,66.7
1552,3/24/2018 20:20,77,94,59,230,3,66.7
1553,3/24/2018 20:25,87,99,54,240,3,66.7
1554,3/24/2018 20:30,75,86,69,230,3,66.7
1555,3/24/2018 20:35,87,95,60,242,3,66.7
1556,3/24/2018 20:40,75,96,78,249,3,66.7
1557,3/24/2018 20:45,75,91,45,211,3,66.7
1558,3/24/2018 20:50,84,109,61,254,3,66.7
1559,3/24/2018 20:55,77,103,73,253,3,66.7
1560,3/24/2018 21:00,78,95,63,236,3,66.7
1561,3/24/2018 21:05,82,95,59,236,3,66.7
1562,3/24/2018 21:10,86,90,59,235,3,66.7
1563,3/24/2018 21:15,74,99,60,233,3,66.7
1564,3/24/2018 21:20,93,101,76,270,3,66.7
1565,3/24/2018 21:25,86,96,63,245,3,66.7
1566,3/24/2018 21:30,84,99,62,245,3,66.7
1567,3/24/2018 21:35,82,93,63,238,3,66.7
1568,3/24/2018 21:40,81,110,66,257,3,66.7
1569,3/24/2018 21:45,89,83,67,239,3,66.7
1570,3/24/2018 21:50,78,82,55,215,3,66.7
1571,3/24/2018 21:55,88,82,48,218,3,66.7
1572,3/24/2018 22:00,82,100,65,247,3,66.7
1573,3/24/2018 22:05,78,91,68,237,3,66.7
1574,3/24/2018 22:10,85,93,66,244,3,66.7
1575,3/24/2018 22:15,90,107,69,266,3,66.7
1576,3/24/2018 22:20,78,100,60,238,3,66.7
1577,3/24/2018 22:25,74,87,51,212,3,66.7
1578,3/24/2018 22:30,86,100,67,253,3,66.7
1579,3/24/2018 22:35,84,99,61,244,3,66.7
1580,3/24/2018 22:40,79,98,64,241,3,66.7
1581,3/24/2018 22:45,90,100,64,254,3,66.7
1582,3/24/2018 22:50,78,94,70,242,3,66.7
1583,3/24/2018 22:55,77,88,50,215,3,66.7
1584,3/24/2018 23:00,80,96,50,226,3,66.7
1585,3/24/2018 23:05,78,100,61,239,3,66.7
1586,3/24/2018 23:10,75,89,58,222,3,66.7
1587,3/24/2018 23:15,81,90,62,233,3,66.7
1588,3/24/2018 23:20,56,84,42,182,3,66.7
1589,3/24/2018 23:25,68,65,43,176,3,66.7
1590,3/24/2018 23:30,64,76,42,182,3,66.7
1591,3/24/2018 23:35,61,71,40,172,3,66.7
1592,3/24/2018 23:40,61,80,46,187,3,66.7
1593,3/24/2018 23:45,56,63,34,153,3,66.7
1594,3/24/2018 23:50,67,82,58,207,3,66.7
1595,3/24/2018 23:55,51,73,40,164,3,66.7
1596,3/25/2018 0:00,57,81,30,168,3,66.7
1597,3/25/2018 0:05,51,62,34,147,3,66.7
1598,3/25/2018 0:10,47,59,33,139,3,66.7
1599,3/25/2018 0:15,40,59,25,124,3,66.7
1600,3/25/2018 0:20,43,47,19,109,3,66.7
1601,3/25/2018 0:25,43,51,22,116,3,66.7
1602,3/25/2018 0:30,46,67,23,136,3,66.7
1603,3/25/2018 0:35,35,52,22,109,3,66.7
1604,3/25/2018 0:40,44,52,20,116,3,66.7
1605,3/25/2018 0:45,48,45,22,115,3,66.7
1606,3/25/2018 0:50,40,59,20,119,3,66.7
1607,3/25/2018 0:55,47,58,21,126,3,66.7
1608,3/25/2018 1:00,37,60,23,120,3,66.7
1609,3/25/2018 1:05,29,46,17,92,3,66.7
1610,3/25/2018 1:10,39,49,20,108,3,66.7
1611,3/25/2018 1:15,39,54,16,109,3,66.7
1612,3/25/2018 1:20,43,44,19,106,3,66.7
1613,3/25/2018 1:25,46,48,18,112,3,66.7
1614,3/25/2018 1:30,36,44,15,95,3,66.7
1615,3/25/2018 1:35,40,51,12,103,3,66.7
1616,3/25/2018 1:40,34,53,16,103,3,66.7
1617,3/25/2018 1:45,39,38,20,97,3,66.7
1618,3/25/2018 1:50,32,41,9,82,3,66.7
1619,3/25/2018 1:55,38,40,17,95,3,66.7
1620,3/25/2018 2:00,35,34,17,86,3,66.7
1621,3/25/2018 2:05,34,41,4,79,3,66.7
1622,3/25/2018 2:10,34,43,15,92,3,66.7
1623,3/25/2018 2:15,32,36,18,86,3,66.7
1624,3/25/2018 2:20,28,35,14,77,3,66.7
1625,3/25/2018 2:25,30,26,10,66,3,66.7
1626,3/25/2018 2:30,19,25,12,56,3,66.7
1627,3/25/2018 2:35,28,30,14,72,3,66.7
1628,3/25/2018 2:40,33,34,10,77,3,66.7
1629,3/25/2018 2:45,25,18,14,57,3,66.7
1630,3/25/2018 2:50,32,33,14,79,3,66.7
1631,3/25/2018 2:55,28,32,12,72,3,66.7
1632,3/25/2018 3:00,28,31,7,66,3,66.7
1633,3/25/2018 3:05,31,31,8,70,3,66.7
1634,3/25/2018 3:10,25,27,13,65,3,66.7
1635,3/25/2018 3:15,27,26,11,64,3,66.7
1636,3/25/2018 3:20,22,22,2,46,3,66.7
1637,3/25/2018 3:25,24,18,9,51,3,66.7
1638,3/25/2018 3:30,23,18,12,53,3,66.7
1639,3/25/2018 3:35,24,22,6,52,3,66.7
1640,3/25/2018 3:40,25,25,11,61,3,66.7
1641,3/25/2018 3:45,20,21,1,42,3,66.7
1642,3/25/2018 3:50,20,25,12,57,3,66.7
1643,3/25/2018 3:55,23,18,9,50,3,66.7
1644,3/25/2018 4:00,18,26,11,55,3,66.7
1645,3/25/2018 4:05,21,25,5,51,3,66.7
1646,3/25/2018 4:10,22,22,4,48,3,66.7
1647,3/25/2018 4:15,19,25,6,50,3,66.7
1648,3/25/2018 4:20,25,19,9,53,3,66.7
1649,3/25/2018 4:25,16,22,6,44,3,66.7
1650,3/25/2018 4:30,22,16,7,45,3,66.7
1651,3/25/2018 4:35,21,28,8,57,3,66.7
1652,3/25/2018 4:40,29,30,10,69,3,66.7
1653,3/25/2018 4:45,24,29,11,64,3,66.7
1654,3/25/2018 4:50,20,29,10,59,3,66.7
1655,3/25/2018 4:55,23,30,8,61,3,66.7
1656,3/25/2018 5:00,28,24,4,56,3,66.7
1657,3/25/2018 5:05,21,27,5,53,3,66.7
1658,3/25/2018 5:10,24,26,7,57,3,66.7
1659,3/25/2018 5:15,33,30,11,74,3,66.7
1660,3/25/2018 5:20,24,34,13,71,3,66.7
1661,3/25/2018 5:25,28,30,13,71,3,66.7
1662,3/25/2018 5:30,31,34,14,79,3,66.7
1663,3/25/2018 5:35,29,34,16,79,3,66.7
1664,3/25/2018 5:40,39,39,19,97,3,66.7
1665,3/25/2018 5:45,37,31,20,88,3,66.7
1666,3/25/2018 5:50,31,40,20,91,3,66.7
1667,3/25/2018 5:55,31,43,20,94,3,66.7
1668,3/25/2018 6:00,35,28,16,79,3,66.7
1669,3/25/2018 6:05,36,39,20,95,3,66.7
1670,3/25/2018 6:10,41,45,21,107,3,66.7
1671,3/25/2018 6:15,37,57,22,116,3,66.7
1672,3/25/2018 6:20,38,46,28,112,3,66.7
1673,3/25/2018 6:25,39,49,28,116,3,66.7
1674,3/25/2018 6:30,37,41,21,99,3,66.7
1675,3/25/2018 6:35,44,44,33,121,3,66.7
1676,3/25/2018 6:40,46,56,23,125,3,66.7
1677,3/25/2018 6:45,49,56,20,125,3,66.7
1678,3/25/2018 6:50,46,50,30,126,3,66.7
1679,3/25/2018 6:55,46,54,23,123,3,66.7
1680,3/25/2018 7:00,49,59,31,139,3,66.7
1681,3/25/2018 7:05,43,54,31,128,3,66.7
1682,3/25/2018 7:10,49,60,37,146,3,66.7
1683,3/25/2018 7:15,53,50,29,132,3,66.7
1684,3/25/2018 7:20,53,60,35,148,3,66.7
1685,3/25/2018 7:25,56,70,39,165,3,66.7
1686,3/25/2018 7:30,56,63,33,152,3,66.7
1687,3/25/2018 7:35,54,63,46,163,3,66.7
1688,3/25/2018 7:40,61,63,33,157,3,66.7
1689,3/25/2018 7:45,60,68,43,171,3,66.7
1690,3/25/2018 7:50,63,66,40,169,3,66.7
1691,3/25/2018 7:55,62,66,24,152,3,66.7
1692,3/25/2018 8:00,54,59,34,147,3,66.7
1693,3/25/2018 8:05,63,71,30,164,3,66.7
1694,3/25/2018 8:10,57,76,42,175,3,66.7
1695,3/25/2018 8:15,64,73,44,181,3,66.7
1696,3/25/2018 8:20,58,57,38,153,3,66.7
1697,3/25/2018 8:25,67,72,48,187,3,66.7
1698,3/25/2018 8:30,70,73,47,190,3,66.7
1699,3/25/2018 8:35,68,78,45,191,3,66.7
1700,3/25/2018 8:40,60,65,34,159,3,66.7
1701,3/25/2018 8:45,67,81,42,190,3,66.7
1702,3/25/2018 8:50,70,77,42,189,3,66.7
1703,3/25/2018 8:55,59,78,46,183,3,66.7
1704,3/25/2018 9:00,69,67,43,179,3,66.7
1705,3/25/2018 9:05,58,66,37,161,3,66.7
1706,3/25/2018 9:10,72,56,43,171,3,66.7
1707,3/25/2018 9:15,80,91,59,230,3,66.7
1708,3/25/2018 9:20,69,73,50,192,3,66.7
1709,3/25/2018 9:25,77,95,54,226,3,66.7
1710,3/25/2018 9:30,69,80,42,191,3,66.7
1711,3/25/2018 9:35,66,76,47,189,3,66.7
1712,3/25/2018 9:40,83,77,58,218,3,66.7
1713,3/25/2018 9:45,79,85,68,232,3,66.7
1714,3/25/2018 9:50,79,89,52,220,3,66.7
1715,3/25/2018 9:55,80,92,57,229,3,66.7
1716,3/25/2018 10:00,93,92,58,243,3,66.7
1717,3/25/2018 10:05,75,91,60,226,3,66.7
1718,3/25/2018 10:10,77,102,65,244,3,66.7
1719,3/25/2018 10:15,86,99,50,235,3,66.7
1720,3/25/2018 10:20,84,107,71,262,3,66.7
1721,3/25/2018 10:25,95,103,59,257,3,66.7
1722,3/25/2018 10:30,83,94,63,240,3,66.7
1723,3/25/2018 10:35,97,108,75,280,3,66.7
1724,3/25/2018 10:40,90,103,58,251,3,66.7
1725,3/25/2018 10:45,89,106,67,262,3,66.7
1726,3/25/2018 10:50,82,98,58,238,3,66.7
1727,3/25/2018 10:55,83,104,69,256,3,66.7
1728,3/25/2018 11:00,86,96,70,252,3,66.7
1729,3/25/2018 11:05,88,107,76,271,3,66.7
1730,3/25/2018 11:10,91,109,72,272,3,66.7
1731,3/25/2018 11:15,95,110,74,279,3,66.7
1732,3/25/2018 11:20,81,87,58,226,3,66.7
1733,3/25/2018 11:25,82,102,59,243,3,66.7
1734,3/25/2018 11:30,96,92,68,256,3,66.7
1735,3/25/2018 11:35,94,113,68,275,3,66.7
1736,3/25/2018 11:40,94,113,77,284,3,66.7
1737,3/25/2018 11:45,89,113,73,275,3,66.7
1738,3/25/2018 11:50,100,113,79,292,3,66.7
1739,3/25/2018 11:55,88,89,80,257,3,66.7
0,3/25/2018 11:00,86,96,70,252,3,66.7
1,3/25/2018 11:05,88,107,76,271,3,66.7
2,3/25/2018 11:10,91,109,72,272,3,66.7
3,3/25/2018 11:15,95,110,74,279,3,66.7
4,3/25/2018 11:20,81,87,58,226,3,66.7
5,3/25/2018 11:25,82,102,59,243,3,66.7
6,3/25/2018 11:30,96,92,68,256,3,66.7
7,3/25/2018 11:35,94,113,68,275,3,66.7
8,3/25/2018 11:40,94,113,77,284,3,66.7
9,3/25/2018 11:45,89,113,73,275,3,66.7
10,3/25/2018 11:50,100,113,79,292,3,66.7
11,3/25/2018 11:55,88,89,80,257,3,66.7
12,3/25/2018 12:00,85,99,58,242,3,66.7
13,3/25/2018 12:05,100,91,71,262,3,66.7
14,3/25/2018 12:10,92,87,53,232,3,66.7
15,3/25/2018 12:15,72,71,42,185,3,66.7
16,3/25/2018 12:20,64,69,46,179,3,66.7
17,3/25/2018 12:25,67,66,43,176,3,66.7
18,3/25/2018 12:30,80,73,49,202,3,66.7
19,3/25/2018 12:35,84,94,57,235,3,66.7
20,3/25/2018 12:40,100,99,68,267,3,66.7
21,3/25/2018 12:45,94,112,73,279,3,66.7
22,3/25/2018 12:50,98,104,74,276,3,66.7
23,3/25/2018 12:55,86,98,64,248,3,66.7
24,3/25/2018 13:00,93,95,60,248,3,66.7
25,3/25/2018 13:05,85,82,56,223,3,66.7
26,3/25/2018 13:10,96,92,71,259,3,66.7
27,3/25/2018 13:15,85,106,59,250,3,66.7
28,3/25/2018 13:20,89,82,49,220,3,66.7
29,3/25/2018 13:25,84,77,61,222,3,66.7
30,3/25/2018 13:30,93,94,73,260,3,66.7
31,3/25/2018 13:35,97,95,61,253,3,66.7
32,3/25/2018 13:40,97,105,52,254,3,66.7
33,3/25/2018 13:45,95,92,81,268,3,66.7
34,3/25/2018 13:50,87,89,62,238,3,66.7
35,3/25/2018 13:55,100,107,64,271,3,66.7
36,3/25/2018 14:00,97,108,66,271,3,66.7
37,3/25/2018 14:05,106,94,66,266,3,66.7
38,3/25/2018 14:10,95,109,82,286,3,66.7
39,3/25/2018 14:15,88,89,70,247,3,66.7
40,3/25/2018 14:20,79,97,66,242,3,66.7
41,3/25/2018 14:25,79,88,63,230,3,66.7
42,3/25/2018 14:30,82,90,63,235,3,66.7
43,3/25/2018 14:35,96,93,68,257,3,66.7
44,3/25/2018 14:40,78,80,56,214,3,66.7
45,3/25/2018 14:45,85,96,59,240,3,66.7
46,3/25/2018 14:50,96,98,64,258,3,66.7
47,3/25/2018 14:55,92,99,57,248,3,66.7
48,3/25/2018 15:00,91,95,75,261,3,66.7
49,3/25/2018 15:05,97,99,77,273,3,66.7
50,3/25/2018 15:10,94,96,68,258,3,66.7
51,3/25/2018 15:15,98,92,70,260,3,66.7
52,3/25/2018 15:20,92,96,65,253,3,66.7
53,3/25/2018 15:25,93,99,67,259,3,66.7
54,3/25/2018 15:30,103,100,59,262,3,66.7
55,3/25/2018 15:35,87,92,65,244,3,66.7
56,3/25/2018 15:40,90,85,57,232,3,66.7
57,3/25/2018 15:45,94,94,72,260,3,66.7
58,3/25/2018 15:50,94,111,76,281,3,66.7
59,3/25/2018 15:55,87,97,65,249,3,66.7
60,3/25/2018 16:00,80,79,74,233,3,66.7
61,3/25/2018 16:05,68,90,54,212,3,66.7
62,3/25/2018 16:10,91,100,70,261,3,66.7
63,3/25/2018 16:15,97,100,77,274,3,66.7
64,3/25/2018 16:20,85,93,74,252,3,66.7
65,3/25/2018 16:25,81,81,63,225,3,66.7
66,3/25/2018 16:30,78,86,60,224,3,66.7
67,3/25/2018 16:35,93,83,49,225,3,66.7
68,3/25/2018 16:40,89,83,63,235,3,66.7
69,3/25/2018 16:45,95,104,68,267,3,66.7
70,3/25/2018 16:50,90,82,53,225,3,66.7
71,3/25/2018 16:55,83,79,61,223,3,66.7
72,3/25/2018 17:00,83,95,62,240,3,66.7
73,3/25/2018 17:05,88,98,67,253,3,66.7
74,3/25/2018 17:10,86,89,73,248,3,66.7
75,3/25/2018 17:15,95,116,71,282,3,66.7
76,3/25/2018 17:20,83,103,75,261,3,66.7
77,3/25/2018 17:25,87,99,65,251,3,66.7
78,3/25/2018 17:30,85,100,60,245,3,66.7
79,3/25/2018 17:35,89,105,71,265,3,66.7
80,3/25/2018 17:40,90,101,68,259,3,66.7
81,3/25/2018 17:45,88,98,73,259,3,66.7
82,3/25/2018 17:50,94,89,75,258,3,66.7
83,3/25/2018 17:55,83,99,58,240,3,66.7
84,3/25/2018 18:00,87,83,81,251,3,66.7
85,3/25/2018 18:05,84,106,73,263,3,66.7
86,3/25/2018 18:10,88,113,77,278,3,66.7
87,3/25/2018 18:15,78,96,68,242,3,66.7
88,3/25/2018 18:20,91,104,70,265,3,66.7
89,3/25/2018 18:25,94,101,74,269,3,66.7
90,3/25/2018 18:30,86,96,60,242,3,66.7
91,3/25/2018 18:35,79,99,56,234,3,66.7
92,3/25/2018 18:40,93,94,65,252,3,66.7
93,3/25/2018 18:45,86,101,63,250,3,66.7
94,3/25/2018 18:50,86,91,57,234,3,66.7
95,3/25/2018 18:55,85,95,68,248,3,66.7
96,3/25/2018 19:00,95,96,71,262,3,66.7
97,3/25/2018 19:05,76,94,62,232,3,66.7
98,3/25/2018 19:10,80,91,69,240,3,66.7
99,3/25/2018 19:15,79,82,66,227,3,66.7
100,3/25/2018 19:20,80,82,57,219,3,66.7
101,3/25/2018 19:25,84,91,71,246,3,66.7
102,3/25/2018 19:30,77,102,55,234,3,66.7
103,3/25/2018 19:35,93,92,73,258,3,66.7
104,3/25/2018 19:40,86,90,63,239,3,66.7
105,3/25/2018 19:45,87,89,68,244,3,66.7
106,3/25/2018 19:50,92,114,75,281,3,66.7
107,3/25/2018 19:55,84,85,67,236,3,66.7
108,3/25/2018 20:00,77,87,51,215,3,66.7
109,3/25/2018 20:05,72,99,59,230,3,66.7
110,3/25/2018 20:10,72,85,60,217,3,66.7
111,3/25/2018 20:15,88,105,66,259,3,66.7
112,3/25/2018 20:20,79,98,67,244,3,66.7
113,3/25/2018 20:25,78,82,66,226,3,66.7
114,3/25/2018 20:30,80,95,58,233,3,66.7
115,3/25/2018 20:35,75,86,48,209,3,66.7
116,3/25/2018 20:40,81,91,62,234,3,66.7
117,3/25/2018 20:45,84,81,58,223,3,66.7
118,3/25/2018 20:50,89,94,72,255,3,66.7
119,3/25/2018 20:55,77,104,59,240,3,66.7
120,3/25/2018 21:00,81,96,57,234,3,66.7
121,3/25/2018 21:05,70,96,52,218,3,66.7
122,3/25/2018 21:10,80,93,55,228,3,66.7
123,3/25/2018 21:15,80,94,60,234,3,66.7
124,3/25/2018 21:20,75,104,55,234,3,66.7
125,3/25/2018 21:25,85,99,52,236,3,66.7
126,3/25/2018 21:30,83,112,71,266,3,66.7
127,3/25/2018 21:35,71,86,55,212,3,66.7
128,3/25/2018 21:40,69,100,61,230,3,66.7
129,3/25/2018 21:45,68,95,62,225,3,66.7
130,3/25/2018 21:50,72,79,59,210,3,66.7
131,3/25/2018 21:55,77,96,66,239,3,66.7
132,3/25/2018 22:00,64,87,46,197,3,66.7
133,3/25/2018 22:05,74,92,56,222,3,66.7
134,3/25/2018 22:10,75,88,52,215,3,66.7
135,3/25/2018 22:15,76,100,54,230,3,66.7
136,3/25/2018 22:20,60,86,48,194,3,66.7
137,3/25/2018 22:25,71,88,54,213,3,66.7
138,3/25/2018 22:30,78,90,59,227,3,66.7
139,3/25/2018 22:35,76,96,62,234,3,66.7
140,3/25/2018 22:40,71,86,54,211,3,66.7
141,3/25/2018 22:45,79,101,63,243,3,66.7
142,3/25/2018 22:50,63,72,48,183,3,66.7
143,3/25/2018 22:55,60,71,43,174,3,66.7
144,3/25/2018 23:00,63,75,44,182,3,66.7
145,3/25/2018 23:05,71,75,55,201,3,66.7
146,3/25/2018 23:10,66,87,51,204,3,66.7
147,3/25/2018 23:15,65,73,56,194,3,66.7
148,3/25/2018 23:20,61,77,50,188,3,66.7
149,3/25/2018 23:25,56,73,43,172,3,66.7
150,3/25/2018 23:30,54,71,31,156,3,66.7
151,3/25/2018 23:35,53,51,37,141,3,66.7
152,3/25/2018 23:40,59,84,44,187,3,66.7
153,3/25/2018 23:45,50,64,27,141,3,66.7
154,3/25/2018 23:50,62,87,47,196,3,66.7
155,3/25/2018 23:55,58,67,40,165,3,66.7
156,3/26/2018 0:00,54,63,28,145,3,66.7
157,3/26/2018 0:05,40,60,28,128,3,66.7
158,3/26/2018 0:10,49,52,34,135,3,66.7
159,3/26/2018 0:15,54,61,35,150,3,66.7
160,3/26/2018 0:20,46,50,29,125,3,66.7
161,3/26/2018 0:25,49,51,45,145,3,66.7
162,3/26/2018 0:30,52,56,32,140,3,66.7
163,3/26/2018 0:35,39,50,29,118,3,66.7
164,3/26/2018 0:40,44,55,22,121,3,66.7
165,3/26/2018 0:45,39,39,21,99,3,66.7
166,3/26/2018 0:50,38,40,25,103,3,66.7
167,3/26/2018 0:55,37,40,19,96,3,66.7
168,3/26/2018 1:00,33,43,22,98,3,66.7
169,3/26/2018 1:05,36,44,21,101,3,66.7
170,3/26/2018 1:10,17,24,10,51,3,66.7
171,3/26/2018 1:15,19,12,8,39,3,66.7
172,3/26/2018 1:20,13,10,7,30,3,66.7
173,3/26/2018 1:25,61,56,35,152,3,66.7
174,3/26/2018 1:30,52,98,39,189,3,66.7
175,3/26/2018 1:35,21,34,17,72,3,66.7
176,3/26/2018 1:40,30,33,18,81,3,66.7
177,3/26/2018 1:45,34,35,14,83,3,66.7
178,3/26/2018 1:50,33,29,18,80,3,66.7
179,3/26/2018 1:55,36,37,12,85,3,66.7
180,3/26/2018 2:00,25,24,16,65,3,66.7
181,3/26/2018 2:05,28,34,15,77,3,66.7
182,3/26/2018 2:10,26,22,13,61,3,66.7
183,3/26/2018 2:15,25,29,12,66,3,66.7
184,3/26/2018 2:20,25,28,15,68,3,66.7
185,3/26/2018 2:25,24,18,13,55,3,66.7
186,3/26/2018 2:30,21,26,13,60,3,66.7
187,3/26/2018 2:35,23,17,12,52,3,66.7
188,3/26/2018 2:40,21,16,16,53,3,66.7
189,3/26/2018 2:45,17,14,10,41,3,66.7
190,3/26/2018 2:50,25,25,9,59,3,66.7
191,3/26/2018 2:55,27,27,16,70,3,66.7
192,3/26/2018 3:00,21,17,10,48,3,66.7
193,3/26/2018 3:05,20,20,11,51,3,66.7
194,3/26/2018 3:10,23,21,14,58,3,66.7
195,3/26/2018 3:15,19,19,8,46,3,66.7
196,3/26/2018 3:20,20,18,7,45,3,66.7
197,3/26/2018 3:25,22,18,14,54,3,66.7
198,3/26/2018 3:30,25,28,14,67,3,66.7
199,3/26/2018 3:35,21,20,9,50,3,66.7
200,3/26/2018 3:40,23,26,6,55,3,66.7
201,3/26/2018 3:45,22,20,10,52,3,66.7
202,3/26/2018 3:50,22,23,11,56,3,66.7
203,3/26/2018 3:55,28,18,13,59,3,66.7
204,3/26/2018 4:00,28,27,14,69,3,66.7
205,3/26/2018 4:05,22,24,11,57,3,66.7
206,3/26/2018 4:10,28,25,11,64,3,66.7
207,3/26/2018 4:15,30,33,11,74,3,66.7
208,3/26/2018 4:20,29,29,14,72,3,66.7
209,3/26/2018 4:25,28,33,18,79,3,66.7
210,3/26/2018 4:30,31,34,20,85,3,66.7
211,3/26/2018 4:35,37,29,21,87,3,66.7
212,3/26/2018 4:40,35,35,18,88,3,66.7
213,3/26/2018 4:45,33,38,11,82,3,66.7
214,3/26/2018 4:50,46,41,19,106,3,66.7
215,3/26/2018 4:55,36,41,20,97,3,66.7
216,3/26/2018 5:00,39,49,11,99,3,66.7
217,3/26/2018 5:05,46,49,17,112,3,66.7
218,3/26/2018 5:10,40,37,20,97,3,66.7
219,3/26/2018 5:15,47,47,20,114,3,66.7
220,3/26/2018 5:20,46,52,20,118,3,66.7
221,3/26/2018 5:25,60,67,28,155,3,66.7
222,3/26/2018 5:30,54,57,35,146,3,66.7
223,3/26/2018 5:35,62,56,28,146,3,66.7
224,3/26/2018 5:40,62,66,30,158,3,66.7
225,3/26/2018 5:45,60,57,31,148,3,66.7
226,3/26/2018 5:50,50,51,30,131,3,66.7
227,3/26/2018 5:55,59,55,36,150,3,66.7
228,3/26/2018 6:00,59,59,31,149,3,66.7
229,3/26/2018 6:05,56,60,32,148,3,66.7
230,3/26/2018 6:10,66,61,40,167,3,66.7
231,3/26/2018 6:15,75,78,37,190,3,66.7
232,3/26/2018 6:20,67,81,41,189,3,66.7
233,3/26/2018 6:25,70,76,40,186,3,66.7
234,3/26/2018 6:30,73,77,32,182,3,66.7
235,3/26/2018 6:35,73,74,33,180,3,66.7
236,3/26/2018 6:40,74,75,34,183,3,66.7
237,3/26/2018 6:45,64,68,52,184,3,66.7
238,3/26/2018 6:50,75,79,41,195,3,66.7
239,3/26/2018 6:55,67,74,45,186,3,66.7
240,3/26/2018 7:00,68,65,36,169,3,66.7
241,3/26/2018 7:05,76,86,45,207,3,66.7
242,3/26/2018 7:10,72,73,49,194,3,66.7
243,3/26/2018 7:15,91,99,47,237,3,66.7
244,3/26/2018 7:20,88,88,56,232,3,66.7
245,3/26/2018 7:25,91,86,60,237,3,66.7
246,3/26/2018 7:30,95,107,45,247,3,66.7
247,3/26/2018 7:35,93,91,60,244,3,66.7
248,3/26/2018 7:40,89,95,59,243,3,66.7
249,3/26/2018 7:45,73,89,58,220,3,66.7
250,3/26/2018 7:50,83,83,48,214,3,66.7
251,3/26/2018 7:55,92,102,45,239,3,66.7
252,3/26/2018 8:00,80,76,39,195,3,66.7
253,3/26/2018 8:05,86,90,49,225,3,66.7
254,3/26/2018 8:10,89,90,45,224,3,66.7
255,3/26/2018 8:15,99,90,49,238,3,66.7
256,3/26/2018 8:20,94,93,58,245,3,66.7
257,3/26/2018 8:25,92,96,56,244,3,66.7
258,3/26/2018 8:30,78,90,55,223,3,66.7
259,3/26/2018 8:35,81,79,50,210,3,66.7
260,3/26/2018 8:40,82,82,51,215,3,66.7
261,3/26/2018 8:45,86,98,59,243,3,66.7
262,3/26/2018 8:50,77,83,45,205,3,66.7
263,3/26/2018 8:55,71,70,50,191,3,66.7
264,3/26/2018 9:00,86,87,46,219,3,66.7
265,3/26/2018 9:05,81,74,47,202,3,66.7
266,3/26/2018 9:10,81,89,45,215,3,66.7
267,3/26/2018 9:15,79,84,40,203,3,66.7
268,3/26/2018 9:20,76,84,54,214,3,66.7
269,3/26/2018 9:25,93,90,53,236,3,66.7
270,3/26/2018 9:30,84,100,53,237,3,66.7
271,3/26/2018 9:35,79,112,59,250,3,66.7
272,3/26/2018 9:40,77,96,44,217,3,66.7
273,3/26/2018 9:45,85,102,64,251,3,66.7
274,3/26/2018 9:50,81,103,61,245,3,66.7
275,3/26/2018 9:55,79,76,48,203,3,66.7
276,3/26/2018 10:00,85,97,49,231,3,66.7
277,3/26/2018 10:05,78,85,50,213,3,66.7
278,3/26/2018 10:10,77,102,54,233,3,66.7
279,3/26/2018 10:15,73,94,46,213,3,66.7
280,3/26/2018 10:20,82,112,64,258,3,66.7
281,3/26/2018 10:25,88,106,55,249,3,66.7
282,3/26/2018 10:30,80,95,60,235,3,66.7
283,3/26/2018 10:35,83,105,46,234,3,66.7
284,3/26/2018 10:40,90,99,67,256,3,66.7
285,3/26/2018 10:45,85,96,65,246,3,66.7
286,3/26/2018 10:50,92,105,67,264,3,66.7
287,3/26/2018 10:55,75,92,53,220,3,66.7
288,3/26/2018 11:00,78,94,61,233,3,66.7
289,3/26/2018 11:05,84,91,67,242,3,66.7
290,3/26/2018 11:10,82,97,60,239,3,66.7
291,3/26/2018 11:15,87,89,70,246,3,66.7
292,3/26/2018 11:20,88,99,66,253,3,66.7
293,3/26/2018 11:25,88,96,62,246,3,66.7
294,3/26/2018 11:30,89,111,69,269,3,66.7
295,3/26/2018 11:35,82,103,63,248,3,66.7
296,3/26/2018 11:40,86,93,60,239,3,66.7
297,3/26/2018 11:45,103,108,56,267,3,66.7
298,3/26/2018 11:50,85,93,54,232,3,66.7
299,3/26/2018 11:55,91,97,66,254,3,66.7
300,3/26/2018 12:00,83,85,58,226,3,66.7
301,3/26/2018 12:05,81,79,60,220,3,66.7
302,3/26/2018 12:10,85,82,56,223,3,66.7
303,3/26/2018 12:15,88,94,67,249,3,66.7
304,3/26/2018 12:20,84,89,59,232,3,66.7
305,3/26/2018 12:25,91,100,67,258,3,66.7
306,3/26/2018 12:30,93,94,66,253,3,66.7
307,3/26/2018 12:35,83,102,70,255,3,66.7
308,3/26/2018 12:40,89,91,62,242,3,66.7
309,3/26/2018 12:45,93,99,70,262,3,66.7
310,3/26/2018 12:50,88,99,63,250,3,66.7
311,3/26/2018 12:55,98,101,63,262,3,66.7
312,3/26/2018 13:00,86,86,54,226,3,66.7
313,3/26/2018 13:05,84,95,54,233,3,66.7
314,3/26/2018 13:10,85,86,68,239,3,66.7
315,3/26/2018 13:15,89,87,57,233,3,66.7
316,3/26/2018 13:20,78,90,61,229,3,66.7
317,3/26/2018 13:25,80,86,59,225,3,66.7
318,3/26/2018 13:30,90,87,55,232,3,66.7
319,3/26/2018 13:35,90,102,65,257,3,66.7
320,3/26/2018 13:40,91,95,65,251,3,66.7
321,3/26/2018 13:45,90,97,65,252,3,66.7
322,3/26/2018 13:50,92,94,73,259,3,66.7
323,3/26/2018 13:55,100,98,67,265,3,66.7
324,3/26/2018 14:00,96,100,79,275,3,66.7
325,3/26/2018 14:05,83,97,67,247,3,66.7
326,3/26/2018 14:10,87,75,55,217,3,66.7
327,3/26/2018 14:15,95,94,60,249,3,66.7
328,3/26/2018 14:20,98,88,78,264,3,66.7
329,3/26/2018 14:25,107,110,68,285,3,66.7
330,3/26/2018 14:30,101,106,68,275,3,66.7
331,3/26/2018 14:35,92,93,67,252,3,66.7
332,3/26/2018 14:40,104,99,66,269,3,66.7
333,3/26/2018 14:45,103,105,79,287,3,66.7
334,3/26/2018 14:50,91,100,74,265,3,66.7
335,3/26/2018 14:55,89,97,72,258,3,66.7
336,3/26/2018 15:00,90,97,91,278,3,66.7
337,3/26/2018 15:05,96,97,77,270,3,66.7
338,3/26/2018 15:10,69,77,47,193,3,66.7
339,3/26/2018 15:15,102,83,72,257,3,66.7
340,3/26/2018 15:20,103,109,71,283,3,66.7
341,3/26/2018 15:25,100,87,63,250,3,66.7
342,3/26/2018 15:30,104,100,67,271,3,66.7
343,3/26/2018 15:35,94,98,81,273,3,66.7
344,3/26/2018 15:40,107,107,70,284,3,66.7
345,3/26/2018 15:45,104,97,71,272,3,66.7
346,3/26/2018 15:50,105,77,77,259,3,66.7
347,3/26/2018 15:55,107,76,69,252,3,66.7
348,3/26/2018 16:00,86,68,58,212,3,66.7
349,3/26/2018 16:05,90,81,69,240,3,66.7
350,3/26/2018 16:10,102,69,71,242,3,66.7
351,3/26/2018 16:15,89,69,57,215,3,66.7
352,3/26/2018 16:20,92,77,59,228,3,66.7
353,3/26/2018 16:25,100,98,80,278,3,66.7
354,3/26/2018 16:30,102,79,80,261,3,66.7
355,3/26/2018 16:35,100,73,62,235,3,66.7
356,3/26/2018 16:40,103,89,76,268,3,66.7
357,3/26/2018 16:45,92,62,62,216,3,66.7
358,3/26/2018 16:50,97,72,69,238,3,66.7
359,3/26/2018 16:55,107,94,78,279,3,66.7
360,3/26/2018 17:00,88,71,73,232,3,66.7
361,3/26/2018 17:05,86,81,60,227,3,66.7
362,3/26/2018 17:10,86,98,86,270,3,66.7
363,3/26/2018 17:15,89,64,78,231,3,66.7
364,3/26/2018 17:20,90,76,83,249,3,66.7
365,3/26/2018 17:25,95,62,64,221,3,66.7
366,3/26/2018 17:30,90,73,61,224,3,66.7
367,3/26/2018 17:35,91,77,69,237,3,66.7
368,3/26/2018 17:40,84,71,71,226,3,66.7
369,3/26/2018 17:45,85,71,61,217,3,66.7
370,3/26/2018 17:50,87,88,63,238,3,66.7
371,3/26/2018 17:55,89,96,73,258,3,66.7
372,3/26/2018 18:00,99,69,49,217,3,66.7
373,3/26/2018 18:05,92,62,63,217,3,66.7
374,3/26/2018 18:10,99,88,68,255,3,66.7
375,3/26/2018 18:15,90,77,87,254,3,66.7
376,3/26/2018 18:20,84,76,71,231,3,66.7
377,3/26/2018 18:25,101,82,57,240,3,66.7
378,3/26/2018 18:30,97,88,61,246,3,66.7
379,3/26/2018 18:35,88,80,57,225,3,66.7
380,3/26/2018 18:40,88,92,66,246,3,66.7
381,3/26/2018 18:45,90,88,67,245,3,66.7
382,3/26/2018 18:50,98,100,64,262,3,66.7
383,3/26/2018 18:55,92,92,70,254,3,66.7
384,3/26/2018 19:00,94,93,72,259,3,66.7
385,3/26/2018 19:05,89,73,60,222,3,66.7
386,3/26/2018 19:10,84,82,55,221,3,66.7
387,3/26/2018 19:15,94,86,60,240,3,66.7
388,3/26/2018 19:20,95,91,55,241,3,66.7
389,3/26/2018 19:25,87,97,67,251,3,66.7
390,3/26/2018 19:30,92,86,60,238,3,66.7
391,3/26/2018 19:35,91,77,67,235,3,66.7
392,3/26/2018 19:40,97,107,78,282,3,66.7
393,3/26/2018 19:45,82,84,57,223,3,66.7
394,3/26/2018 19:50,92,115,56,263,3,66.7
395,3/26/2018 19:55,88,94,62,244,3,66.7
396,3/26/2018 20:00,93,102,70,265,3,66.7
397,3/26/2018 20:05,83,97,67,247,3,66.7
398,3/26/2018 20:10,93,105,70,268,3,66.7
399,3/26/2018 20:15,83,101,54,238,3,66.7
400,3/26/2018 20:20,86,98,57,241,3,66.7
401,3/26/2018 20:25,95,111,77,283,3,66.7
402,3/26/2018 20:30,79,111,62,252,3,66.7
403,3/26/2018 20:35,76,81,62,219,3,66.7
404,3/26/2018 20:40,83,81,71,235,3,66.7
405,3/26/2018 20:45,87,98,64,249,3,66.7
406,3/26/2018 20:50,86,96,66,248,3,66.7
407,3/26/2018 20:55,78,92,64,234,3,66.7
408,3/26/2018 21:00,82,103,69,254,3,66.7
409,3/26/2018 21:05,85,82,64,231,3,66.7
410,3/26/2018 21:10,74,95,66,235,3,66.7
411,3/26/2018 21:15,87,91,73,251,3,66.7
412,3/26/2018 21:20,84,96,63,243,3,66.7
413,3/26/2018 21:25,78,99,58,235,3,66.7
414,3/26/2018 21:30,83,102,60,245,3,66.7
415,3/26/2018 21:35,80,99,54,233,3,66.7
416,3/26/2018 21:40,64,86,56,206,3,66.7
417,3/26/2018 21:45,75,88,66,229,3,66.7
418,3/26/2018 21:50,71,88,53,212,3,66.7
419,3/26/2018 21:55,63,100,50,213,3,66.7
420,3/26/2018 22:00,74,86,46,206,3,66.7
421,3/26/2018 22:05,71,87,62,220,3,66.7
422,3/26/2018 22:10,62,82,50,194,3,66.7
423,3/26/2018 22:15,78,97,54,229,3,66.7
424,3/26/2018 22:20,71,98,50,219,3,66.7
425,3/26/2018 22:25,79,95,53,227,3,66.7
426,3/26/2018 22:30,68,88,54,210,3,66.7
427,3/26/2018 22:35,67,91,54,212,3,66.7
428,3/26/2018 22:40,73,105,65,243,3,66.7
429,3/26/2018 22:45,53,69,34,156,3,66.7
430,3/26/2018 22:50,55,74,42,171,3,66.7
431,3/26/2018 22:55,59,72,41,172,3,66.7
432,3/26/2018 23:00,57,71,31,159,3,66.7
433,3/26/2018 23:05,47,74,26,147,3,66.7
434,3/26/2018 23:10,52,78,32,162,3,66.7
435,3/26/2018 23:15,58,77,47,182,3,66.7
436,3/26/2018 23:20,61,67,36,164,3,66.7
437,3/26/2018 23:25,54,65,43,162,3,66.7
438,3/26/2018 23:30,54,70,39,163,3,66.7
439,3/26/2018 23:35,54,65,42,161,3,66.7
440,3/26/2018 23:40,56,70,26,152,3,66.7
441,3/26/2018 23:45,52,62,34,148,3,66.7
442,3/26/2018 23:50,53,61,22,136,3,66.7
443,3/26/2018 23:55,42,63,32,137,3,66.7
444,3/27/2018 0:00,50,55,27,132,3,66.7
445,3/27/2018 0:05,39,55,16,110,3,66.7
446,3/27/2018 0:10,41,72,27,140,3,66.7
447,3/27/2018 0:15,45,57,30,132,3,66.7
448,3/27/2018 0:20,46,52,36,134,3,66.7
449,3/27/2018 0:25,47,63,29,139,3,66.7
450,3/27/2018 0:30,48,48,25,121,3,66.7
451,3/27/2018 0:35,44,55,21,120,3,66.7
452,3/27/2018 0:40,38,47,20,105,3,66.7
453,3/27/2018 0:45,43,50,20,113,3,66.7
454,3/27/2018 0:50,38,50,23,111,3,66.7
455,3/27/2018 0:55,36,49,24,109,3,66.7
456,3/27/2018 1:00,41,50,29,120,3,66.7
457,3/27/2018 1:05,39,47,22,108,3,66.7
458,3/27/2018 1:10,40,48,22,110,3,66.7
459,3/27/2018 1:15,38,47,22,107,3,66.7
460,3/27/2018 1:20,35,50,19,104,3,66.7
461,3/27/2018 1:25,26,26,17,69,3,66.7
462,3/27/2018 1:30,34,39,20,93,3,66.7
463,3/27/2018 1:35,39,39,18,96,3,66.7
464,3/27/2018 1:40,38,48,19,105,3,66.7
465,3/27/2018 1:45,35,42,25,102,3,66.7
466,3/27/2018 1:50,35,35,18,88,3,66.7
467,3/27/2018 1:55,29,30,13,72,3,66.7
468,3/27/2018 2:00,27,34,14,75,3,66.7
469,3/27/2018 2:05,27,28,17,72,3,66.7
470,3/27/2018 2:10,36,39,14,89,3,66.7
471,3/27/2018 2:15,29,31,13,73,3,66.7
472,3/27/2018 2:20,25,30,15,70,3,66.7
473,3/27/2018 2:25,26,31,16,73,3,66.7
474,3/27/2018 2:30,28,27,15,70,3,66.7
475,3/27/2018 2:35,30,31,16,77,3,66.7
476,3/27/2018 2:40,31,25,15,71,3,66.7
477,3/27/2018 2:45,22,32,10,64,3,66.7
478,3/27/2018 2:50,20,20,8,48,3,66.7
479,3/27/2018 2:55,25,30,18,73,3,66.7
480,3/27/2018 3:00,19,18,12,49,3,66.7
481,3/27/2018 3:05,25,21,12,58,3,66.7
482,3/27/2018 3:10,24,22,12,58,3,66.7
483,3/27/2018 3:15,25,25,14,64,3,66.7
484,3/27/2018 3:20,18,18,15,51,3,66.7
485,3/27/2018 3:25,19,25,10,54,3,66.7
486,3/27/2018 3:30,24,21,11,56,3,66.7
487,3/27/2018 3:35,28,31,15,74,3,66.7
488,3/27/2018 3:40,28,35,8,71,3,66.7
489,3/27/2018 3:45,22,21,12,55,3,66.7
490,3/27/2018 3:50,25,24,11,60,3,66.7
491,3/27/2018 3:55,22,22,12,56,3,66.7
492,3/27/2018 4:00,24,20,13,57,3,66.7
493,3/27/2018 4:05,33,34,22,89,3,66.7
494,3/27/2018 4:10,29,27,14,70,3,66.7
495,3/27/2018 4:15,29,27,20,76,3,66.7
496,3/27/2018 4:20,24,22,18,64,3,66.7
497,3/27/2018 4:25,37,41,19,97,3,66.7
498,3/27/2018 4:30,37,35,19,91,3,66.7
499,3/27/2018 4:35,40,48,14,102,3,66.7
500,3/27/2018 4:40,46,45,27,118,3,66.7
501,3/27/2018 4:45,43,40,29,112,3,66.7
502,3/27/2018 4:50,36,38,19,93,3,66.7
503,3/27/2018 4:55,46,45,26,117,3,66.7
504,3/27/2018 5:00,34,39,21,94,3,66.7
505,3/27/2018 5:05,50,48,21,119,3,66.7
506,3/27/2018 5:10,43,49,19,111,3,66.7
507,3/27/2018 5:15,55,54,30,139,3,66.7
508,3/27/2018 5:20,65,60,27,152,3,66.7
509,3/27/2018 5:25,53,59,35,147,3,66.7
510,3/27/2018 5:30,48,47,27,122,3,66.7
511,3/27/2018 5:35,55,61,27,143,3,66.7
512,3/27/2018 5:40,66,63,35,164,3,66.7
513,3/27/2018 5:45,58,67,26,151,3,66.7
514,3/27/2018 5:50,62,78,30,170,3,66.7
515,3/27/2018 5:55,58,57,30,145,3,66.7
516,3/27/2018 6:00,62,70,33,165,3,66.7
517,3/27/2018 6:05,66,70,37,173,3,66.7
518,3/27/2018 6:10,74,80,43,197,3,66.7
519,3/27/2018 6:15,73,79,41,193,3,66.7
520,3/27/2018 6:20,76,90,42,208,3,66.7
521,3/27/2018 6:25,68,84,50,202,3,66.7
522,3/27/2018 6:30,63,82,48,193,3,66.7
523,3/27/2018 6:35,70,79,33,182,3,66.7
524,3/27/2018 6:40,76,87,54,217,3,66.7
525,3/27/2018 6:45,87,96,47,230,3,66.7
526,3/27/2018 6:50,93,95,50,238,3,66.7
527,3/27/2018 6:55,73,97,53,223,3,66.7
528,3/27/2018 7:00,76,79,41,196,3,66.7
529,3/27/2018 7:05,84,83,47,214,3,66.7
530,3/27/2018 7:10,77,91,49,217,3,66.7
531,3/27/2018 7:15,82,98,44,224,3,66.7
532,3/27/2018 7:20,89,96,62,247,3,66.7
533,3/27/2018 7:25,83,107,61,251,3,66.7
534,3/27/2018 7:30,99,93,64,256,3,66.7
535,3/27/2018 7:35,97,104,56,257,3,66.7
536,3/27/2018 7:40,103,109,58,270,3,66.7
537,3/27/2018 7:45,88,102,52,242,3,66.7
538,3/27/2018 7:50,88,82,48,218,3,66.7
539,3/27/2018 7:55,79,87,48,214,3,66.7
540,3/27/2018 8:00,97,92,50,239,3,66.7
541,3/27/2018 8:05,87,105,50,242,3,66.7
542,3/27/2018 8:10,82,94,47,223,3,66.7
543,3/27/2018 8:15,87,96,50,233,3,66.7
544,3/27/2018 8:20,103,96,65,264,3,66.7
545,3/27/2018 8:25,96,113,61,270,3,66.7
546,3/27/2018 8:30,88,100,52,240,3,66.7
547,3/27/2018 8:35,85,99,63,247,3,66.7
548,3/27/2018 8:40,88,81,56,225,3,66.7
549,3/27/2018 8:45,93,90,54,237,3,66.7
550,3/27/2018 8:50,92,104,54,250,3,66.7
551,3/27/2018 8:55,90,96,64,250,3,66.7
552,3/27/2018 9:00,81,93,47,221,3,66.7
553,3/27/2018 9:05,78,95,55,228,3,66.7
554,3/27/2018 9:10,86,86,56,228,3,66.7
555,3/27/2018 9:15,90,89,53,232,3,66.7
556,3/27/2018 9:20,82,97,55,234,3,66.7
557,3/27/2018 9:25,78,99,59,236,3,66.7
558,3/27/2018 9:30,88,107,61,256,3,66.7
559,3/27/2018 9:35,77,94,56,227,3,66.7
560,3/27/2018 9:40,80,96,58,234,3,66.7
561,3/27/2018 9:45,78,87,69,234,3,66.7
562,3/27/2018 9:50,79,86,63,228,3,66.7
563,3/27/2018 9:55,86,100,61,247,3,66.7
564,3/27/2018 10:00,74,97,51,222,3,66.7
565,3/27/2018 10:05,74,86,49,209,3,66.7
566,3/27/2018 10:10,74,84,52,210,3,66.7
567,3/27/2018 10:15,77,87,48,212,3,66.7
568,3/27/2018 10:20,90,86,54,230,3,66.7
569,3/27/2018 10:25,82,93,56,231,3,66.7
570,3/27/2018 10:30,88,92,58,238,3,66.7
571,3/27/2018 10:35,81,88,56,225,3,66.7
572,3/27/2018 10:40,78,99,62,239,3,66.7
573,3/27/2018 10:45,87,95,77,259,3,66.7
574,3/27/2018 10:50,91,102,91,284,3,66.7
575,3/27/2018 10:55,85,121,77,283,3,66.7
576,3/27/2018 11:00,81,88,49,218,3,66.7
577,3/27/2018 11:05,82,101,70,253,3,66.7
578,3/27/2018 11:10,81,98,73,252,3,66.7
579,3/27/2018 11:15,86,110,68,264,3,66.7
580,3/27/2018 11:20,79,103,70,252,3,66.7
581,3/27/2018 11:25,94,108,75,277,3,66.7
582,3/27/2018 11:30,82,88,62,232,3,66.7
583,3/27/2018 11:35,88,82,60,230,3,66.7
584,3/27/2018 11:40,97,90,59,246,3,0.0
585,3/27/2018 11:45,99,88,59,246,3,0.0
586,3/27/2018 11:50,97,92,64,253,3,0.0
587,3/27/2018 11:55,95,91,53,239,3,0.0
588,3/27/2018 12:00,97,88,58,243,3,0.0
589,3/27/2018 12:05,98,88,62,248,3,0.0
590,3/27/2018 12:10,100,102,64,266,3,0.0
591,3/27/2018 12:15,100,104,68,272,3,0.0
592,3/27/2018 12:20,101,95,57,253,3,0.0
593,3/27/2018 12:25,101,94,64,259,3,0.0
594,3/27/2018 12:30,100,87,69,256,3,0.0
595,3/27/2018 12:35,101,102,67,270,3,0.0
596,3/27/2018 12:40,101,90,61,252,3,0.0
597,3/27/2018 12:45,102,101,71,274,3,0.0
598,3/27/2018 12:50,102,101,64,267,3,0.0
599,3/27/2018 12:55,101,99,70,270,3,0.0
600,3/27/2018 13:00,99,83,62,244,3,0.0
601,3/27/2018 13:05,101,98,68,267,3,0.0
602,3/27/2018 13:10,100,94,65,259,3,0.0
603,3/27/2018 13:15,102,101,62,265,3,0.0
604,3/27/2018 13:20,104,97,62,263,3,0.0
605,3/27/2018 13:25,104,98,57,259,3,0.0
606,3/27/2018 13:30,105,98,63,266,3,0.0
607,3/27/2018 13:35,106,96,61,263,3,0.0
608,3/27/2018 13:40,107,98,62,267,3,0.0
609,3/27/2018 13:45,107,105,64,276,3,0.0
610,3/27/2018 13:50,107,109,69,285,3,0.0
611,3/27/2018 13:55,106,104,71,281,3,0.0
612,3/27/2018 14:00,107,99,61,267,3,0.0
613,3/27/2018 14:05,107,78,50,235,3,0.0
614,3/27/2018 14:10,109,89,72,270,3,0.0
615,3/27/2018 14:15,110,87,70,267,3,0.0
616,3/27/2018 14:20,113,100,71,284,3,0.0
617,3/27/2018 14:25,111,91,71,273,3,0.0
618,3/27/2018 14:30,113,93,74,280,3,0.0
619,3/27/2018 14:35,115,86,71,272,3,0.0
620,3/27/2018 14:40,117,103,72,292,3,0.0
621,3/27/2018 14:45,118,98,62,278,3,0.0
622,3/27/2018 14:50,116,93,80,289,3,0.0
623,3/27/2018 14:55,116,85,71,272,3,0.0
624,3/27/2018 15:00,114,79,70,263,3,0.0
625,3/27/2018 15:05,110,83,81,274,3,0.0
626,3/27/2018 15:10,105,84,62,251,3,0.0
627,3/27/2018 15:15,109,80,66,255,3,0.0
628,3/27/2018 15:20,116,66,64,246,3,0.0
629,3/27/2018 15:25,116,89,57,262,3,0.0
630,3/27/2018 15:30,116,80,70,266,3,0.0
631,3/27/2018 15:35,121,69,60,250,3,0.0
632,3/27/2018 15:40,121,86,59,266,3,0.0
633,3/27/2018 15:45,119,86,62,267,3,0.0
634,3/27/2018 15:50,112,72,61,245,3,0.0
635,3/27/2018 15:55,106,76,61,243,3,0.0
636,3/27/2018 16:00,116,90,67,273,3,0.0
637,3/27/2018 16:05,116,67,57,240,3,0.0
638,3/27/2018 16:10,119,70,70,259,3,0.0
639,3/27/2018 16:15,119,81,75,275,3,0.0
640,3/27/2018 16:20,117,81,74,272,3,0.0
641,3/27/2018 16:25,115,66,65,246,3,0.0
642,3/27/2018 16:30,111,76,66,253,3,0.0
643,3/27/2018 16:35,117,80,74,271,3,0.0
644,3/27/2018 16:40,118,72,61,251,3,0.0
645,3/27/2018 16:45,120,73,59,252,3,0.0
646,3/27/2018 16:50,119,67,60,246,3,0.0
647,3/27/2018 16:55,112,63,54,229,3,0.0
648,3/27/2018 17:00,111,57,54,222,3,0.0
649,3/27/2018 17:05,118,59,50,227,3,0.0
650,3/27/2018 17:10,122,70,55,247,3,0.0
651,3/27/2018 17:15,118,68,49,235,3,0.0
652,3/27/2018 17:20,117,74,58,249,3,0.0
653,3/27/2018 17:25,117,69,54,240,3,0.0
654,3/27/2018 17:30,122,65,59,246,3,0.0
655,3/27/2018 17:35,126,70,53,249,3,0.0
656,3/27/2018 17:40,124,61,68,253,3,0.0
657,3/27/2018 17:45,114,74,56,244,3,0.0
658,3/27/2018 17:50,111,75,59,245,3,0.0
659,3/27/2018 17:55,110,62,64,236,3,0.0
660,3/27/2018 18:00,110,64,56,230,3,0.0
661,3/27/2018 18:05,106,68,60,234,3,0.0
662,3/27/2018 18:10,105,69,59,233,3,0.0
663,3/27/2018 18:15,105,60,52,217,3,0.0
664,3/27/2018 18:20,108,78,66,252,3,0.0
665,3/27/2018 18:25,107,62,54,223,3,0.0
666,3/27/2018 18:30,104,70,55,229,3,0.0
667,3/27/2018 18:35,103,82,66,251,3,0.0
668,3/27/2018 18:40,104,83,78,265,3,0.0
669,3/27/2018 18:45,98,82,65,245,3,0.0
670,3/27/2018 18:50,96,85,47,228,3,0.0
671,3/27/2018 18:55,89,88,55,232,3,0.0
672,3/27/2018 19:00,101,85,66,252,3,0.0
673,3/27/2018 19:05,102,101,66,269,3,0.0
674,3/27/2018 19:10,103,92,59,254,3,0.0
675,3/27/2018 19:15,93,91,60,244,3,0.0
676,3/27/2018 19:20,91,88,54,233,3,0.0
677,3/27/2018 19:25,88,87,57,232,3,0.0
678,3/27/2018 19:30,84,89,57,230,3,0.0
679,3/27/2018 19:35,82,87,53,222,3,0.0
680,3/27/2018 19:40,82,84,55,221,3,0.0
681,3/27/2018 19:45,80,92,67,239,3,0.0
682,3/27/2018 19:50,78,85,63,226,3,0.0
683,3/27/2018 19:55,74,88,58,220,3,0.0
684,3/27/2018 20:00,73,90,56,219,3,0.0
685,3/27/2018 20:05,72,108,61,241,3,0.0
686,3/27/2018 20:10,72,112,65,249,3,0.0
687,3/27/2018 20:15,71,97,65,233,3,0.0
688,3/27/2018 20:20,70,110,77,257,3,0.0
689,3/27/2018 20:25,69,97,66,232,3,0.0
690,3/27/2018 20:30,68,102,62,232,3,0.0
691,3/27/2018 20:35,66,90,61,217,3,0.0
692,3/27/2018 20:40,66,90,63,219,3,0.0
693,3/27/2018 20:45,65,101,57,223,3,0.0
694,3/27/2018 20:50,64,92,63,219,3,0.0
695,3/27/2018 20:55,63,94,58,215,3,0.0
696,3/27/2018 21:00,62,93,54,209,3,0.0
697,3/27/2018 21:05,63,90,57,210,3,0.0
698,3/27/2018 21:10,64,103,59,226,3,0.0
699,3/27/2018 21:15,65,100,66,231,3,0.0
700,3/27/2018 21:20,65,95,62,222,3,0.0
701,3/27/2018 21:25,62,98,59,219,3,0.0
702,3/27/2018 21:30,61,91,57,209,3,0.0
703,3/27/2018 21:35,60,101,53,214,3,0.0
704,3/27/2018 21:40,60,98,51,209,3,0.0
705,3/27/2018 21:45,59,103,55,217,3,0.0
706,3/27/2018 21:50,63,101,55,219,3,0.0
707,3/27/2018 21:55,62,84,46,192,3,0.0
708,3/27/2018 22:00,55,80,59,194,3,0.0
709,3/27/2018 22:05,53,87,48,188,3,0.0
710,3/27/2018 22:10,56,91,46,193,3,0.0
711,3/27/2018 22:15,56,96,56,208,3,0.0
712,3/27/2018 22:20,52,94,62,208,3,0.0
713,3/27/2018 22:25,50,96,61,207,3,0.0
714,3/27/2018 22:30,48,92,58,198,3,0.0
715,3/27/2018 22:35,47,83,54,184,3,0.0
716,3/27/2018 22:40,44,81,49,174,3,0.0
717,3/27/2018 22:45,43,84,60,187,3,0.0
718,3/27/2018 22:50,40,79,52,171,3,0.0
719,3/27/2018 22:55,37,84,47,168,3,0.0
720,3/27/2018 23:00,35,76,43,154,3,0.0
721,3/27/2018 23:05,39,67,30,136,3,0.0
722,3/27/2018 23:10,43,74,46,163,3,0.0
723,3/27/2018 23:15,38,75,46,159,3,0.0
724,3/27/2018 23:20,33,62,32,127,3,0.0
725,3/27/2018 23:25,31,59,41,131,3,0.0
726,3/27/2018 23:30,29,65,38,132,3,0.0
727,3/27/2018 23:35,31,66,30,127,3,0.0
728,3/27/2018 23:40,29,63,39,131,3,0.0
729,3/27/2018 23:45,28,64,38,130,3,0.0
730,3/27/2018 23:50,26,68,38,132,3,0.0
731,3/27/2018 23:55,24,51,29,104,3,0.0
732,3/28/2018 0:00,30,53,32,115,3,0.0
733,3/28/2018 0:05,29,61,34,124,3,0.0
734,3/28/2018 0:10,29,68,32,129,3,0.0
735,3/28/2018 0:15,29,56,40,125,3,0.0
736,3/28/2018 0:20,27,61,38,126,3,0.0
737,3/28/2018 0:25,25,56,32,113,3,0.0
738,3/28/2018 0:30,24,61,27,112,3,0.0
739,3/28/2018 0:35,23,53,30,106,3,0.0
740,3/28/2018 0:40,23,60,33,116,3,0.0
741,3/28/2018 0:45,22,52,28,102,3,0.0
742,3/28/2018 0:50,20,43,27,90,3,0.0
743,3/28/2018 0:55,19,43,25,87,3,0.0
744,3/28/2018 1:00,18,34,22,74,3,0.0
745,3/28/2018 1:05,18,39,19,76,3,0.0
746,3/28/2018 1:10,18,50,26,94,3,0.0
747,3/28/2018 1:15,18,36,20,74,3,0.0
748,3/28/2018 1:20,17,36,17,70,3,0.0
749,3/28/2018 1:25,16,41,16,73,3,0.0
750,3/28/2018 1:30,16,34,22,72,3,0.0
751,3/28/2018 1:35,16,30,20,66,3,0.0
752,3/28/2018 1:40,16,46,21,83,3,0.0
753,3/28/2018 1:45,16,39,24,79,3,0.0
754,3/28/2018 1:50,16,35,18,69,3,0.0
755,3/28/2018 1:55,14,32,13,59,3,0.0
756,3/28/2018 2:00,14,33,13,60,3,0.0
757,3/28/2018 2:05,14,32,15,61,3,0.0
758,3/28/2018 2:10,15,38,18,71,3,0.0
759,3/28/2018 2:15,13,30,19,62,3,0.0
760,3/28/2018 2:20,12,31,16,59,3,0.0
761,3/28/2018 2:25,14,36,14,64,3,0.0
762,3/28/2018 2:30,14,23,14,51,3,0.0
763,3/28/2018 2:35,10,27,9,46,3,0.0
764,3/28/2018 2:40,12,33,20,65,3,0.0
765,3/28/2018 2:45,10,25,13,48,3,0.0
766,3/28/2018 2:50,11,30,10,51,3,0.0
767,3/28/2018 2:55,9,24,12,45,3,0.0
768,3/28/2018 3:00,9,24,9,42,3,0.0
769,3/28/2018 3:05,10,19,10,39,3,0.0
770,3/28/2018 3:10,10,25,14,49,3,0.0
771,3/28/2018 3:15,11,20,11,42,3,0.0
772,3/28/2018 3:20,11,19,9,39,3,0.0
773,3/28/2018 3:25,12,20,12,44,3,0.0
774,3/28/2018 3:30,12,20,12,44,3,0.0
775,3/28/2018 3:35,13,26,12,51,3,0.0
776,3/28/2018 3:40,15,26,17,58,3,0.0
777,3/28/2018 3:45,15,20,12,47,3,0.0
778,3/28/2018 3:50,15,23,15,53,3,0.0
779,3/28/2018 3:55,14,23,10,47,3,0.0
780,3/28/2018 4:00,14,20,13,47,3,0.0
781,3/28/2018 4:05,15,31,15,61,3,0.0
782,3/28/2018 4:10,18,35,17,70,3,0.0
783,3/28/2018 4:15,18,32,15,65,3,0.0
784,3/28/2018 4:20,19,24,15,58,3,0.0
785,3/28/2018 4:25,22,24,18,64,3,0.0
786,3/28/2018 4:30,24,32,22,78,3,0.0
787,3/28/2018 4:35,28,42,15,85,3,0.0
788,3/28/2018 4:40,32,31,16,79,3,0.0
789,3/28/2018 4:45,35,42,14,91,3,0.0
790,3/28/2018 4:50,34,42,25,101,3,0.0
791,3/28/2018 4:55,36,45,23,104,3,0.0
792,3/28/2018 5:00,39,38,17,94,3,0.0
793,3/28/2018 5:05,48,39,20,107,3,0.0
794,3/28/2018 5:10,48,45,25,118,3,0.0
795,3/28/2018 5:15,54,54,29,137,3,0.0
796,3/28/2018 5:20,62,50,29,141,3,0.0
797,3/28/2018 5:25,67,54,25,146,3,0.0
798,3/28/2018 5:30,75,56,32,163,3,0.0
799,3/28/2018 5:35,84,65,31,180,3,0.0
800,3/28/2018 5:40,90,70,31,191,3,0.0
801,3/28/2018 5:45,90,61,32,183,3,0.0
802,3/28/2018 5:50,95,56,27,178,3,0.0
803,3/28/2018 5:55,90,64,35,189,3,0.0
804,3/28/2018 6:00,89,59,35,183,3,0.0
805,3/28/2018 6:05,101,73,45,219,3,0.0
806,3/28/2018 6:10,112,74,40,226,3,0.0
807,3/28/2018 6:15,115,78,45,238,3,0.0
808,3/28/2018 6:20,118,81,44,243,3,0.0
809,3/28/2018 6:25,112,80,44,236,3,0.0
810,3/28/2018 6:30,111,87,42,240,3,0.0
811,3/28/2018 6:35,116,75,50,241,3,0.0
812,3/28/2018 6:40,117,92,59,268,3,0.0
813,3/28/2018 6:45,120,103,56,279,3,0.0
814,3/28/2018 6:50,122,98,59,279,3,0.0
815,3/28/2018 6:55,118,89,56,263,3,0.0
816,3/28/2018 7:00,120,95,64,279,3,0.0
817,3/28/2018 7:05,127,99,58,284,3,0.0
818,3/28/2018 7:10,124,101,61,286,3,0.0
819,3/28/2018 7:15,152,105,63,320,3,0.0
820,3/28/2018 7:20,148,112,71,331,3,0.0
821,3/28/2018 7:25,128,108,67,303,3,0.0
822,3/28/2018 7:30,155,106,65,326,3,0.0
823,3/28/2018 7:35,155,94,56,305,3,0.0
824,3/28/2018 7:40,153,105,62,320,3,0.0
825,3/28/2018 7:45,153,100,60,313,3,0.0
826,3/28/2018 7:50,151,105,57,313,3,0.0
827,3/28/2018 7:55,144,97,66,307,3,0.0
828,3/28/2018 8:00,145,97,57,299,3,0.0
829,3/28/2018 8:05,145,96,57,298,3,0.0
830,3/28/2018 8:10,132,105,66,303,3,0.0
831,3/28/2018 8:15,145,99,68,312,3,0.0
832,3/28/2018 8:20,129,108,67,304,3,0.0
833,3/28/2018 8:25,125,99,65,289,3,0.0
834,3/28/2018 8:30,124,100,60,284,3,0.0
835,3/28/2018 8:35,133,89,59,281,3,0.0
836,3/28/2018 8:40,140,94,61,295,3,0.0
837,3/28/2018 8:45,132,98,65,295,3,0.0
838,3/28/2018 8:50,134,99,65,298,3,0.0
839,3/28/2018 8:55,136,100,55,291,3,0.0
840,3/28/2018 9:00,128,89,55,272,3,0.0
841,3/28/2018 9:05,132,92,58,282,3,0.0
842,3/28/2018 9:10,137,95,54,286,3,0.0
843,3/28/2018 9:15,135,97,60,292,3,0.0
844,3/28/2018 9:20,104,93,64,261,3,0.0
845,3/28/2018 9:25,104,104,59,267,3,0.0
846,3/28/2018 9:30,136,96,54,286,3,0.0
847,3/28/2018 9:35,134,77,45,256,3,0.0
848,3/28/2018 9:40,127,89,54,270,3,0.0
849,3/28/2018 9:45,138,93,50,281,3,0.0
850,3/28/2018 9:50,125,93,62,280,3,0.0
851,3/28/2018 9:55,133,84,55,272,3,0.0
852,3/28/2018 10:00,133,94,48,275,3,0.0
853,3/28/2018 10:05,132,89,53,274,3,0.0
854,3/28/2018 10:10,132,92,54,278,3,0.0
855,3/28/2018 10:15,133,98,58,289,3,0.0
856,3/28/2018 10:20,132,89,61,282,3,0.0
857,3/28/2018 10:25,133,92,52,277,3,0.0
858,3/28/2018 10:30,132,97,67,296,3,0.0
859,3/28/2018 10:35,132,99,61,292,3,0.0
860,3/28/2018 10:40,120,97,62,279,3,0.0
861,3/28/2018 10:45,102,88,57,247,3,0.0
862,3/28/2018 10:50,106,89,55,250,3,0.0
863,3/28/2018 10:55,108,95,64,267,3,0.0
864,3/28/2018 11:00,128,93,59,280,3,0.0
865,3/28/2018 11:05,130,95,59,284,3,0.0
866,3/28/2018 11:10,131,99,65,295,3,0.0
867,3/28/2018 11:15,129,98,65,292,3,0.0
868,3/28/2018 11:20,132,100,60,292,3,0.0
869,3/28/2018 11:25,133,101,61,295,3,0.0
870,3/28/2018 11:30,133,99,61,293,3,0.0
871,3/28/2018 11:35,134,95,59,288,3,0.0
872,3/28/2018 11:40,135,96,56,287,3,0.0
873,3/28/2018 11:45,133,88,54,275,3,0.0
874,3/28/2018 11:50,134,84,58,276,3,0.0
875,3/28/2018 11:55,131,83,64,278,3,0.0
876,3/28/2018 12:00,131,109,56,296,3,0.0
877,3/28/2018 12:05,106,88,54,248,3,0.0
878,3/28/2018 12:10,107,87,68,262,3,0.0
879,3/28/2018 12:15,108,74,59,241,3,0.0
880,3/28/2018 12:20,110,93,64,267,3,0.0
881,3/28/2018 12:25,132,84,64,280,3,0.0
882,3/28/2018 12:30,133,89,50,272,3,0.0
883,3/28/2018 12:35,135,85,67,287,3,0.0
884,3/28/2018 12:40,135,85,59,279,3,0.0
885,3/28/2018 12:45,134,90,57,281,3,0.0
886,3/28/2018 12:50,134,87,58,279,3,0.0
887,3/28/2018 12:55,134,95,71,300,3,0.0
888,3/28/2018 13:00,134,92,63,289,3,0.0
889,3/28/2018 13:05,134,97,61,292,3,0.0
890,3/28/2018 13:10,109,94,61,264,3,0.0
891,3/28/2018 13:15,112,102,69,283,3,0.0
892,3/28/2018 13:20,114,87,58,259,3,0.0
893,3/28/2018 13:25,139,96,60,295,3,0.0
894,3/28/2018 13:30,138,101,71,310,3,0.0
895,3/28/2018 13:35,139,95,66,300,3,0.0
896,3/28/2018 13:40,142,91,58,291,3,0.0
897,3/28/2018 13:45,142,96,70,308,3,0.0
898,3/28/2018 13:50,140,86,63,289,3,0.0
899,3/28/2018 13:55,140,85,64,289,3,0.0
900,3/28/2018 14:00,138,98,74,310,3,0.0
901,3/28/2018 14:05,142,82,65,289,3,0.0
902,3/28/2018 14:10,146,102,68,316,3,0.0
903,3/28/2018 14:15,147,88,64,299,3,0.0
904,3/28/2018 14:20,148,94,63,305,3,0.0
905,3/28/2018 14:25,148,102,64,314,3,0.0
906,3/28/2018 14:30,146,92,62,300,3,0.0
907,3/28/2018 14:35,149,98,69,316,3,0.0
908,3/28/2018 14:40,154,102,72,328,3,0.0
909,3/28/2018 14:45,154,101,80,335,3,0.0
910,3/28/2018 14:50,152,94,72,318,3,0.0
911,3/28/2018 14:55,149,80,75,304,3,0.0
912,3/28/2018 15:00,147,80,78,305,3,0.0
913,3/28/2018 15:05,148,69,70,287,3,0.0
914,3/28/2018 15:10,150,67,68,285,3,0.0
915,3/28/2018 15:15,126,64,54,244,3,0.0
916,3/28/2018 15:20,125,74,59,258,3,0.0
917,3/28/2018 15:25,150,75,72,297,3,0.0
918,3/28/2018 15:30,149,74,69,292,3,0.0
919,3/28/2018 15:35,152,96,84,332,3,0.0
920,3/28/2018 15:40,154,86,90,330,3,0.0
921,3/28/2018 15:45,155,81,78,314,3,0.0
922,3/28/2018 15:50,153,78,67,298,3,0.0
923,3/28/2018 15:55,148,83,59,290,3,0.0
924,3/28/2018 16:00,147,70,67,284,3,0.0
925,3/28/2018 16:05,148,71,64,283,3,0.0
926,3/28/2018 16:10,149,90,66,305,3,0.0
927,3/28/2018 16:15,150,85,68,303,3,0.0
928,3/28/2018 16:20,145,64,48,257,3,0.0
929,3/28/2018 16:25,147,61,73,281,3,0.0
930,3/28/2018 16:30,146,59,66,271,3,0.0
931,3/28/2018 16:35,150,68,64,282,3,0.0
932,3/28/2018 16:40,143,66,70,279,3,0.0
933,3/28/2018 16:45,135,77,66,278,3,0.0
934,3/28/2018 16:50,129,61,53,243,3,0.0
935,3/28/2018 16:55,135,69,58,262,3,0.0
936,3/28/2018 17:00,138,53,39,230,3,0.0
937,3/28/2018 17:05,149,67,40,256,3,0.0
938,3/28/2018 17:10,134,63,46,243,3,0.0
939,3/28/2018 17:15,133,56,45,234,3,0.0
940,3/28/2018 17:20,130,67,74,271,3,0.0
941,3/28/2018 17:25,121,49,47,217,3,0.0
942,3/28/2018 17:30,124,70,65,259,3,0.0
943,3/28/2018 17:35,129,69,65,263,3,0.0
944,3/28/2018 17:40,115,54,47,216,3,0.0
945,3/28/2018 17:45,117,60,50,227,3,0.0
946,3/28/2018 17:50,117,54,53,224,3,0.0
947,3/28/2018 17:55,112,57,48,217,3,0.0
948,3/28/2018 18:00,112,62,62,236,3,0.0
949,3/28/2018 18:05,113,57,60,230,3,0.0
950,3/28/2018 18:10,117,59,60,236,3,0.0
951,3/28/2018 18:15,120,64,63,247,3,0.0
952,3/28/2018 18:20,117,62,63,242,3,0.0
953,3/28/2018 18:25,117,60,59,236,3,0.0
954,3/28/2018 18:30,115,62,47,224,3,0.0
955,3/28/2018 18:35,117,61,55,233,3,0.0
956,3/28/2018 18:40,112,64,50,226,3,0.0
957,3/28/2018 18:45,110,72,61,243,3,0.0
958,3/28/2018 18:50,108,75,51,234,3,0.0
959,3/28/2018 18:55,107,72,55,234,3,0.0
960,3/28/2018 19:00,106,74,61,241,3,0.0
961,3/28/2018 19:05,105,78,42,225,3,0.0
962,3/28/2018 19:10,103,69,59,231,3,0.0
963,3/28/2018 19:15,102,88,56,246,3,0.0
964,3/28/2018 19:20,100,87,59,246,3,0.0
965,3/28/2018 19:25,98,89,52,239,3,0.0
966,3/28/2018 19:30,94,86,57,237,3,0.0
967,3/28/2018 19:35,92,95,54,241,3,0.0
968,3/28/2018 19:40,89,92,57,238,3,0.0
969,3/28/2018 19:45,86,95,63,244,3,0.0
970,3/28/2018 19:50,83,102,58,243,3,0.0
971,3/28/2018 19:55,80,100,58,238,3,0.0
972,3/28/2018 20:00,77,103,63,243,3,0.0
973,3/28/2018 20:05,76,98,56,230,3,0.0
974,3/28/2018 20:10,77,102,61,240,3,0.0
975,3/28/2018 20:15,75,91,63,229,3,0.0
976,3/28/2018 20:20,72,93,54,219,3,0.0
977,3/28/2018 20:25,72,101,64,237,3,0.0
978,3/28/2018 20:30,71,102,61,234,3,0.0
979,3/28/2018 20:35,71,92,67,230,3,0.0
980,3/28/2018 20:40,67,101,74,242,3,0.0
981,3/28/2018 20:45,67,99,58,224,3,0.0
982,3/28/2018 20:50,67,86,67,220,3,0.0
983,3/28/2018 20:55,65,96,65,226,3,0.0
984,3/28/2018 21:00,65,100,62,227,3,0.0
985,3/28/2018 21:05,66,95,61,222,3,0.0
986,3/28/2018 21:10,69,95,63,227,3,0.0
987,3/28/2018 21:15,72,96,61,229,3,0.0
988,3/28/2018 21:20,70,91,60,221,3,0.0
989,3/28/2018 21:25,69,94,61,224,3,0.0
990,3/28/2018 21:30,65,82,57,204,3,0.0
991,3/28/2018 21:35,66,97,59,222,3,0.0
992,3/28/2018 21:40,67,84,58,209,3,0.0
993,3/28/2018 21:45,64,101,59,224,3,0.0
994,3/28/2018 21:50,58,90,59,207,3,0.0
995,3/28/2018 21:55,60,100,46,206,3,0.0
996,3/28/2018 22:00,59,90,60,209,3,0.0
997,3/28/2018 22:05,59,95,61,215,3,0.0
998,3/28/2018 22:10,62,93,64,219,3,0.0
999,3/28/2018 22:15,67,94,65,226,3,0.0
1000,3/28/2018 22:20,58,87,58,203,3,0.0
1001,3/28/2018 22:25,61,104,64,229,3,0.0
1002,3/28/2018 22:30,54,83,51,188,3,0.0
1003,3/28/2018 22:35,58,88,52,198,3,0.0
1004,3/28/2018 22:40,52,93,62,207,3,0.0
1005,3/28/2018 22:45,50,93,62,205,3,0.0
1006,3/28/2018 22:50,50,87,53,190,3,0.0
1007,3/28/2018 22:55,46,83,45,174,3,0.0
1008,3/28/2018 23:00,44,82,42,168,3,0.0
1009,3/28/2018 23:05,45,73,46,164,3,0.0
1010,3/28/2018 23:10,44,77,47,168,3,0.0
1011,3/28/2018 23:15,43,76,42,161,3,0.0
1012,3/28/2018 23:20,40,67,42,149,3,0.0
1013,3/28/2018 23:25,39,75,37,151,3,0.0
1014,3/28/2018 23:30,37,60,39,136,3,0.0
1015,3/28/2018 23:35,35,62,34,131,3,0.0
1016,3/28/2018 23:40,36,59,33,128,3,0.0
1017,3/28/2018 23:45,32,70,44,146,3,0.0
1018,3/28/2018 23:50,30,57,38,125,3,0.0
1019,3/28/2018 23:55,27,57,34,118,3,0.0
1020,3/29/2018 0:00,25,54,35,114,3,0.0
1021,3/29/2018 0:05,26,55,29,110,3,0.0
1022,3/29/2018 0:10,25,67,34,126,3,0.0
1023,3/29/2018 0:15,26,62,36,124,3,0.0
1024,3/29/2018 0:20,22,58,31,111,3,0.0
1025,3/29/2018 0:25,21,63,33,117,3,0.0
1026,3/29/2018 0:30,21,56,27,104,3,0.0
1027,3/29/2018 0:35,20,59,31,110,3,0.0
1028,3/29/2018 0:40,21,56,31,108,3,0.0
1029,3/29/2018 0:45,20,47,22,89,3,0.0
1030,3/29/2018 0:50,17,50,26,93,3,0.0
1031,3/29/2018 0:55,17,45,20,82,3,0.0
1032,3/29/2018 1:00,15,45,23,83,3,0.0
1033,3/29/2018 1:05,15,43,20,78,3,0.0
1034,3/29/2018 1:10,15,44,21,80,3,0.0
1035,3/29/2018 1:15,15,43,26,84,3,0.0
1036,3/29/2018 1:20,15,43,20,78,3,0.0
1037,3/29/2018 1:25,15,39,20,74,3,0.0
1038,3/29/2018 1:30,15,42,20,77,3,0.0
1039,3/29/2018 1:35,14,44,21,79,3,0.0
1040,3/29/2018 1:40,14,43,20,77,3,0.0
1041,3/29/2018 1:45,14,39,19,72,3,0.0
1042,3/29/2018 1:50,14,34,20,68,3,0.0
1043,3/29/2018 1:55,12,34,16,62,3,0.0
1044,3/29/2018 2:00,13,34,17,64,3,0.0
1045,3/29/2018 2:05,12,32,17,61,3,0.0
1046,3/29/2018 2:10,13,31,16,60,3,0.0
1047,3/29/2018 2:15,13,33,16,62,3,0.0
1048,3/29/2018 2:20,12,36,17,65,3,0.0
1049,3/29/2018 2:25,12,35,20,67,3,0.0
1050,3/29/2018 2:30,11,30,13,54,3,0.0
1051,3/29/2018 2:35,12,26,17,55,3,0.0
1052,3/29/2018 2:40,12,36,21,69,3,0.0
1053,3/29/2018 2:45,11,30,16,57,3,0.0
1054,3/29/2018 2:50,11,28,10,49,3,0.0
1055,3/29/2018 2:55,10,25,11,46,3,0.0
1056,3/29/2018 3:00,10,25,15,50,3,0.0
1057,3/29/2018 3:05,10,23,13,46,3,0.0
1058,3/29/2018 3:10,11,21,15,47,3,0.0
1059,3/29/2018 3:15,11,20,12,43,3,0.0
1060,3/29/2018 3:20,12,21,12,45,3,0.0
1061,3/29/2018 3:25,12,17,11,40,3,0.0
1062,3/29/2018 3:30,13,25,14,52,3,0.0
1063,3/29/2018 3:35,13,22,15,50,3,0.0
1064,3/29/2018 3:40,14,26,15,55,3,0.0
1065,3/29/2018 3:45,14,22,13,49,3,0.0
1066,3/29/2018 3:50,15,22,12,49,3,0.0
1067,3/29/2018 3:55,13,23,13,49,3,0.0
1068,3/29/2018 4:00,13,23,16,52,3,0.0
1069,3/29/2018 4:05,14,27,15,56,3,0.0
1070,3/29/2018 4:10,16,31,13,60,3,0.0
1071,3/29/2018 4:15,18,34,13,65,3,0.0
1072,3/29/2018 4:20,20,32,14,66,3,0.0
1073,3/29/2018 4:25,22,34,12,68,3,0.0
1074,3/29/2018 4:30,25,41,19,85,3,0.0
1075,3/29/2018 4:35,28,35,18,81,3,0.0
1076,3/29/2018 4:40,30,40,19,89,3,0.0
1077,3/29/2018 4:45,35,47,18,100,3,0.0
1078,3/29/2018 4:50,37,45,20,102,3,0.0
1079,3/29/2018 4:55,38,47,21,106,3,0.0
1080,3/29/2018 5:00,36,41,21,98,3,0.0
1081,3/29/2018 5:05,41,42,19,102,3,0.0
1082,3/29/2018 5:10,51,49,22,122,3,0.0
1083,3/29/2018 5:15,53,52,25,130,3,0.0
1084,3/29/2018 5:20,59,61,28,148,3,0.0
1085,3/29/2018 5:25,66,56,26,148,3,0.0
1086,3/29/2018 5:30,75,54,20,149,3,0.0
1087,3/29/2018 5:35,81,55,25,161,3,0.0
1088,3/29/2018 5:40,89,64,32,185,3,0.0
1089,3/29/2018 5:45,96,73,37,206,3,0.0
1090,3/29/2018 5:50,94,58,31,183,3,0.0
1091,3/29/2018 5:55,86,63,30,179,3,0.0
1092,3/29/2018 6:00,95,63,33,191,3,0.0
1093,3/29/2018 6:05,99,66,38,203,3,0.0
1094,3/29/2018 6:10,112,72,44,228,3,0.0
1095,3/29/2018 6:15,113,77,42,232,3,0.0
1096,3/29/2018 6:20,110,80,37,227,3,0.0
1097,3/29/2018 6:25,111,75,43,229,3,0.0
1098,3/29/2018 6:30,114,82,46,242,3,0.0
1099,3/29/2018 6:35,117,89,46,252,3,0.0
1100,3/29/2018 6:40,119,92,55,266,3,0.0
1101,3/29/2018 6:45,120,93,55,268,3,0.0
1102,3/29/2018 6:50,120,92,55,267,3,0.0
1103,3/29/2018 6:55,117,90,57,264,3,0.0
1104,3/29/2018 7:00,116,95,57,268,3,0.0
1105,3/29/2018 7:05,117,104,59,280,3,0.0
1106,3/29/2018 7:10,122,97,62,281,3,0.0
1107,3/29/2018 7:15,126,100,67,293,3,0.0
1108,3/29/2018 7:20,129,105,65,299,3,0.0
1109,3/29/2018 7:25,128,93,61,282,3,0.0
1110,3/29/2018 7:30,129,95,71,295,3,0.0
1111,3/29/2018 7:35,131,101,62,294,3,0.0
1112,3/29/2018 7:40,132,96,63,291,3,0.0
1113,3/29/2018 7:45,132,105,63,300,3,0.0
1114,3/29/2018 7:50,132,97,66,295,3,0.0
1115,3/29/2018 7:55,114,103,65,282,3,0.0
1116,3/29/2018 8:00,125,100,58,283,3,0.0
1117,3/29/2018 8:05,124,104,66,294,3,0.0
1118,3/29/2018 8:10,123,101,61,285,3,0.0
1119,3/29/2018 8:15,124,107,62,293,3,0.0
1120,3/29/2018 8:20,124,92,66,282,3,0.0
1121,3/29/2018 8:25,121,104,62,287,3,0.0
1122,3/29/2018 8:30,119,92,58,269,3,0.0
1123,3/29/2018 8:35,118,107,65,290,3,0.0
1124,3/29/2018 8:40,119,103,60,282,3,0.0
1125,3/29/2018 8:45,119,98,57,274,3,0.0
1126,3/29/2018 8:50,117,97,58,272,3,0.0
1127,3/29/2018 8:55,114,89,55,258,3,0.0
1128,3/29/2018 9:00,109,92,56,257,3,0.0
1129,3/29/2018 9:05,108,89,55,252,3,0.0
1130,3/29/2018 9:10,105,88,52,245,3,0.0
1131,3/29/2018 9:15,106,87,55,248,3,0.0
1132,3/29/2018 9:20,107,94,54,255,3,0.0
1133,3/29/2018 9:25,108,84,54,246,3,0.0
1134,3/29/2018 9:30,108,94,57,259,3,0.0
1135,3/29/2018 9:35,109,89,56,254,3,0.0
1136,3/29/2018 9:40,109,91,57,257,3,0.0
1137,3/29/2018 9:45,109,92,60,261,3,0.0
1138,3/29/2018 9:50,106,91,58,255,3,0.0
1139,3/29/2018 9:55,104,89,54,247,3,0.0
1140,3/29/2018 10:00,102,97,62,261,3,0.0
1141,3/29/2018 10:05,101,95,51,247,3,0.0
1142,3/29/2018 10:10,101,86,59,246,3,0.0
1143,3/29/2018 10:15,102,91,53,246,3,0.0
1144,3/29/2018 10:20,102,96,53,251,3,0.0
1145,3/29/2018 10:25,102,95,58,255,3,0.0
1146,3/29/2018 10:30,101,91,57,249,3,0.0
1147,3/29/2018 10:35,107,84,53,244,3,0.0
1148,3/29/2018 10:40,104,94,63,261,3,0.0
1149,3/29/2018 10:45,104,99,58,261,3,0.0
1150,3/29/2018 10:50,104,94,57,255,3,0.0
1151,3/29/2018 10:55,103,94,61,258,3,0.0
1152,3/29/2018 11:00,105,98,63,266,3,0.0
1153,3/29/2018 11:05,105,89,61,255,3,0.0
1154,3/29/2018 11:10,108,93,58,259,3,0.0
1155,3/29/2018 11:15,108,99,56,263,3,0.0
1156,3/29/2018 11:20,108,103,62,273,3,0.0
1157,3/29/2018 11:25,105,93,59,257,3,0.0
1158,3/29/2018 11:30,107,94,57,258,3,0.0
1159,3/29/2018 11:35,106,96,55,257,3,0.0
1160,3/29/2018 11:40,106,104,63,273,3,0.0
1161,3/29/2018 11:45,107,95,62,264,3,0.0
1162,3/29/2018 11:50,108,94,66,268,3,0.0
1163,3/29/2018 11:55,106,89,58,253,3,0.0
1164,3/29/2018 12:00,106,87,59,252,3,0.0
1165,3/29/2018 12:05,107,94,63,264,3,0.0
1166,3/29/2018 12:10,107,93,59,259,3,0.0
1167,3/29/2018 12:15,109,97,64,270,3,0.0
1168,3/29/2018 12:20,109,89,61,259,3,0.0
1169,3/29/2018 12:25,108,97,60,265,3,0.0
1170,3/29/2018 12:30,107,96,61,264,3,0.0
1171,3/29/2018 12:35,110,99,62,271,3,0.0
1172,3/29/2018 12:40,111,90,62,263,3,0.0
1173,3/29/2018 12:45,109,103,65,277,3,0.0
1174,3/29/2018 12:50,109,95,72,276,3,0.0
1175,3/29/2018 12:55,107,96,62,265,3,0.0
1176,3/29/2018 13:00,107,91,64,262,3,0.0
1177,3/29/2018 13:05,108,88,65,261,3,0.0
1178,3/29/2018 13:10,110,93,61,264,3,0.0
1179,3/29/2018 13:15,111,94,61,266,3,0.0
1180,3/29/2018 13:20,113,92,61,266,3,0.0
1181,3/29/2018 13:25,110,96,68,274,3,0.0
1182,3/29/2018 13:30,111,100,59,270,3,0.0
1183,3/29/2018 13:35,112,95,66,273,3,0.0
1184,3/29/2018 13:40,114,95,64,273,3,0.0
1185,3/29/2018 13:45,115,106,65,286,3,0.0
1186,3/29/2018 13:50,114,101,66,281,3,0.0
1187,3/29/2018 13:55,114,96,76,286,3,0.0
1188,3/29/2018 14:00,114,102,77,293,3,0.0
1189,3/29/2018 14:05,115,97,66,278,3,0.0
1190,3/29/2018 14:10,117,92,69,278,3,0.0
1191,3/29/2018 14:15,118,91,68,277,3,0.0
1192,3/29/2018 14:20,119,88,66,273,3,0.0
1193,3/29/2018 14:25,119,92,66,277,3,0.0
1194,3/29/2018 14:30,119,94,61,274,3,0.0
1195,3/29/2018 14:35,123,91,53,267,3,0.0
1196,3/29/2018 14:40,125,89,68,282,3,0.0
1197,3/29/2018 14:45,126,95,68,289,3,0.0
1198,3/29/2018 14:50,124,86,74,284,3,0.0
1199,3/29/2018 14:55,122,78,69,269,3,0.0
1200,3/29/2018 15:00,121,74,68,263,3,0.0
1201,3/29/2018 15:05,122,77,62,261,3,0.0
1202,3/29/2018 15:10,125,72,70,267,3,0.0
1203,3/29/2018 15:15,125,70,66,261,3,0.0
1204,3/29/2018 15:20,124,77,65,266,3,0.0
1205,3/29/2018 15:25,122,76,73,271,3,0.0
1206,3/29/2018 15:30,122,68,64,254,3,0.0
1207,3/29/2018 15:35,126,79,72,277,3,0.0
1208,3/29/2018 15:40,129,82,78,289,3,0.0
1209,3/29/2018 15:45,129,70,60,259,3,0.0
1210,3/29/2018 15:50,127,72,57,256,3,0.0
1211,3/29/2018 15:55,124,63,57,244,3,0.0
1212,3/29/2018 16:00,122,58,62,242,3,0.0
1213,3/29/2018 16:05,123,73,63,259,3,0.0
1214,3/29/2018 16:10,126,67,64,257,3,0.0
1215,3/29/2018 16:15,126,61,66,253,3,0.0
1216,3/29/2018 16:20,126,63,59,248,3,0.0
1217,3/29/2018 16:25,121,64,59,244,3,0.0
1218,3/29/2018 16:30,121,50,58,229,3,0.0
1219,3/29/2018 16:35,124,60,53,237,3,0.0
1220,3/29/2018 16:40,129,61,58,248,3,0.0
1221,3/29/2018 16:45,127,65,69,261,3,0.0
1222,3/29/2018 16:50,129,72,60,261,3,0.0
1223,3/29/2018 16:55,126,67,59,252,3,0.0
1224,3/29/2018 17:00,125,62,48,235,3,0.0
1225,3/29/2018 17:05,128,60,49,237,3,0.0
1226,3/29/2018 17:10,132,67,61,260,3,0.0
1227,3/29/2018 17:15,130,71,58,259,3,0.0
1228,3/29/2018 17:20,135,71,58,264,3,0.0
1229,3/29/2018 17:25,124,67,50,241,3,0.0
1230,3/29/2018 17:30,119,67,55,241,3,0.0
1231,3/29/2018 17:35,124,62,51,237,3,0.0
1232,3/29/2018 17:40,124,73,57,254,3,0.0
1233,3/29/2018 17:45,122,63,50,235,3,0.0
1234,3/29/2018 17:50,123,75,56,254,3,0.0
1235,3/29/2018 17:55,120,62,49,231,3,0.0
1236,3/29/2018 18:00,119,66,57,242,3,0.0
1237,3/29/2018 18:05,119,58,50,227,3,0.0
1238,3/29/2018 18:10,119,65,55,239,3,0.0
1239,3/29/2018 18:15,118,60,55,233,3,0.0
1240,3/29/2018 18:20,118,69,55,242,3,0.0
1241,3/29/2018 18:25,114,58,51,223,3,0.0
1242,3/29/2018 18:30,115,64,52,231,3,0.0
1243,3/29/2018 18:35,113,62,56,231,3,0.0
1244,3/29/2018 18:40,112,77,61,250,3,0.0
1245,3/29/2018 18:45,111,73,60,244,3,0.0
1246,3/29/2018 18:50,109,70,59,238,3,0.0
1247,3/29/2018 18:55,108,72,59,239,3,0.0
1248,3/29/2018 19:00,109,81,61,251,3,0.0
1249,3/29/2018 19:05,110,91,55,256,3,0.0
1250,3/29/2018 19:10,108,77,66,251,3,0.0
1251,3/29/2018 19:15,105,80,51,236,3,0.0
1252,3/29/2018 19:20,104,87,51,242,3,0.0
1253,3/29/2018 19:25,99,81,61,241,3,0.0
1254,3/29/2018 19:30,96,81,63,240,3,0.0
1255,3/29/2018 19:35,94,90,57,241,3,0.0
1256,3/29/2018 19:40,92,91,57,240,3,0.0
1257,3/29/2018 19:45,89,100,61,250,3,0.0
1258,3/29/2018 19:50,88,100,64,252,3,0.0
1259,3/29/2018 19:55,81,96,63,240,3,0.0
1260,3/29/2018 20:00,80,95,63,238,3,0.0
1261,3/29/2018 20:05,79,93,58,230,3,0.0
1262,3/29/2018 20:10,79,92,62,233,3,0.0
1263,3/29/2018 20:15,77,98,60,235,3,0.0
1264,3/29/2018 20:20,77,100,60,237,3,0.0
1265,3/29/2018 20:25,77,97,61,235,3,0.0
1266,3/29/2018 20:30,74,89,56,219,3,0.0
1267,3/29/2018 20:35,72,84,61,217,3,0.0
1268,3/29/2018 20:40,71,92,63,226,3,0.0
1269,3/29/2018 20:45,70,102,58,230,3,0.0
1270,3/29/2018 20:50,70,98,63,231,3,0.0
1271,3/29/2018 20:55,69,98,61,228,3,0.0
1272,3/29/2018 21:00,70,98,63,231,3,0.0
1273,3/29/2018 21:05,72,93,56,221,3,0.0
1274,3/29/2018 21:10,74,95,59,228,3,0.0
1275,3/29/2018 21:15,73,95,70,238,3,0.0
1276,3/29/2018 21:20,73,96,62,231,3,0.0
1277,3/29/2018 21:25,72,107,69,248,3,0.0
1278,3/29/2018 21:30,70,103,55,228,3,0.0
1279,3/29/2018 21:35,68,86,57,211,3,0.0
1280,3/29/2018 21:40,68,96,60,224,3,0.0
1281,3/29/2018 21:45,69,96,63,228,3,0.0
1282,3/29/2018 21:50,67,94,63,224,3,0.0
1283,3/29/2018 21:55,67,104,64,235,3,0.0
1284,3/29/2018 22:00,65,103,60,228,3,0.0
1285,3/29/2018 22:05,68,98,56,222,3,0.0
1286,3/29/2018 22:10,72,100,60,232,3,0.0
1287,3/29/2018 22:15,72,98,63,233,3,0.0
1288,3/29/2018 22:20,67,95,59,221,3,0.0
1289,3/29/2018 22:25,64,91,55,210,3,0.0
1290,3/29/2018 22:30,60,99,64,223,3,0.0
1291,3/29/2018 22:35,56,83,52,191,3,0.0
1292,3/29/2018 22:40,54,92,53,199,3,0.0
1293,3/29/2018 22:45,56,89,65,210,3,0.0
1294,3/29/2018 22:50,51,89,50,190,3,0.0
1295,3/29/2018 22:55,50,87,54,191,3,0.0
1296,3/29/2018 23:00,45,85,45,175,3,0.0
1297,3/29/2018 23:05,43,79,54,176,3,0.0
1298,3/29/2018 23:10,50,85,50,185,3,0.0
1299,3/29/2018 23:15,46,81,50,177,3,0.0
1300,3/29/2018 23:20,42,71,42,155,3,0.0
1301,3/29/2018 23:25,39,84,51,174,3,0.0
1302,3/29/2018 23:30,40,73,42,155,3,0.0
1303,3/29/2018 23:35,38,76,45,159,3,0.0
1304,3/29/2018 23:40,37,77,45,159,3,0.0
1305,3/29/2018 23:45,32,76,43,151,3,0.0
1306,3/29/2018 23:50,33,72,39,144,3,0.0
1307,3/29/2018 23:55,30,64,36,130,3,0.0
1308,3/30/2018 0:00,33,65,36,134,3,0.0
1309,3/30/2018 0:05,34,66,41,141,3,0.0
1310,3/30/2018 0:10,34,74,34,142,3,0.0
1311,3/30/2018 0:15,33,67,34,134,3,0.0
1312,3/30/2018 0:20,32,57,34,123,3,0.0
1313,3/30/2018 0:25,29,60,32,121,3,0.0
1314,3/30/2018 0:30,27,65,32,124,3,0.0
1315,3/30/2018 0:35,26,65,33,124,3,0.0
1316,3/30/2018 0:40,27,57,29,113,3,0.0
1317,3/30/2018 0:45,26,56,33,115,3,0.0
1318,3/30/2018 0:50,24,51,31,106,3,0.0
1319,3/30/2018 0:55,22,52,29,103,3,0.0
1320,3/30/2018 1:00,21,48,21,90,3,0.0
1321,3/30/2018 1:05,21,43,19,83,3,0.0
1322,3/30/2018 1:10,21,48,26,95,3,0.0
1323,3/30/2018 1:15,20,46,24,90,3,0.0
1324,3/30/2018 1:20,19,46,19,84,3,0.0
1325,3/30/2018 1:25,21,48,23,92,3,0.0
1326,3/30/2018 1:30,20,36,24,80,3,0.0
1327,3/30/2018 1:35,20,45,21,86,3,0.0
1328,3/30/2018 1:40,20,54,27,101,3,0.0
1329,3/30/2018 1:45,20,50,23,93,3,0.0
1330,3/30/2018 1:50,20,43,23,86,3,0.0
1331,3/30/2018 1:55,19,41,23,83,3,0.0
1332,3/30/2018 2:00,18,33,14,65,3,0.0
1333,3/30/2018 2:05,18,39,19,76,3,0.0
1334,3/30/2018 2:10,19,38,20,77,3,0.0
1335,3/30/2018 2:15,19,32,18,69,3,0.0
1336,3/30/2018 2:20,18,29,16,63,3,0.0
1337,3/30/2018 2:25,16,40,22,78,3,0.0
1338,3/30/2018 2:30,13,36,21,70,3,0.0
1339,3/30/2018 2:35,17,26,14,57,3,0.0
1340,3/30/2018 2:40,15,36,19,70,3,0.0
1341,3/30/2018 2:45,17,35,21,73,3,0.0
1342,3/30/2018 2:50,14,32,18,64,3,0.0
1343,3/30/2018 2:55,12,34,19,65,3,0.0
1344,3/30/2018 3:00,12,30,12,54,3,0.0
1345,3/30/2018 3:05,14,25,16,55,3,0.0
1346,3/30/2018 3:10,14,25,13,52,3,0.0
1347,3/30/2018 3:15,13,23,11,47,3,0.0
1348,3/30/2018 3:20,16,24,10,50,3,0.0
1349,3/30/2018 3:25,13,29,17,59,3,0.0
1350,3/30/2018 3:30,13,27,11,51,3,0.0
1351,3/30/2018 3:35,15,23,14,52,3,0.0
1352,3/30/2018 3:40,15,29,16,60,3,0.0
1353,3/30/2018 3:45,16,31,12,59,3,0.0
1354,3/30/2018 3:50,16,26,12,54,3,0.0
1355,3/30/2018 3:55,14,25,8,47,3,0.0
1356,3/30/2018 4:00,15,26,22,63,3,0.0
1357,3/30/2018 4:05,18,28,17,63,3,0.0
1358,3/30/2018 4:10,20,32,20,72,3,0.0
1359,3/30/2018 4:15,23,40,17,80,3,0.0
1360,3/30/2018 4:20,22,32,13,67,3,0.0
1361,3/30/2018 4:25,25,33,17,75,3,0.0
1362,3/30/2018 4:30,28,32,21,81,3,0.0
1363,3/30/2018 4:35,31,41,19,91,3,0.0
1364,3/30/2018 4:40,36,47,20,103,3,0.0
1365,3/30/2018 4:45,34,41,26,101,3,0.0
1366,3/30/2018 4:50,37,42,24,103,3,0.0
1367,3/30/2018 4:55,36,37,21,94,3,0.0
1368,3/30/2018 5:00,39,39,24,102,3,0.0
1369,3/30/2018 5:05,41,42,16,99,3,0.0
1370,3/30/2018 5:10,46,48,22,116,3,0.0
1371,3/30/2018 5:15,56,48,22,126,3,0.0
1372,3/30/2018 5:20,71,55,30,156,3,0.0
1373,3/30/2018 5:25,65,52,27,144,3,0.0
1374,3/30/2018 5:30,73,58,27,158,3,0.0
1375,3/30/2018 5:35,86,61,32,179,3,0.0
1376,3/30/2018 5:40,87,61,29,177,3,0.0
1377,3/30/2018 5:45,94,64,32,190,3,0.0
1378,3/30/2018 5:50,88,61,32,181,3,0.0
1379,3/30/2018 5:55,83,64,35,182,3,0.0
1380,3/30/2018 6:00,84,63,28,175,3,0.0
1381,3/30/2018 6:05,89,57,26,172,3,0.0
1382,3/30/2018 6:10,107,60,36,203,3,0.0
1383,3/30/2018 6:15,116,72,42,230,3,0.0
1384,3/30/2018 6:20,112,79,39,230,3,0.0
1385,3/30/2018 6:25,114,80,46,240,3,0.0
1386,3/30/2018 6:30,114,78,37,229,3,0.0
1387,3/30/2018 6:35,114,88,48,250,3,0.0
1388,3/30/2018 6:40,120,87,50,257,3,0.0
1389,3/30/2018 6:45,120,86,51,257,3,0.0
1390,3/30/2018 6:50,119,99,51,269,3,0.0
1391,3/30/2018 6:55,116,92,52,260,3,0.0
1392,3/30/2018 7:00,116,91,57,264,3,0.0
1393,3/30/2018 7:05,127,94,55,276,3,0.0
1394,3/30/2018 7:10,150,99,64,313,3,0.0
1395,3/30/2018 7:15,153,93,61,307,3,0.0
1396,3/30/2018 7:20,158,99,64,321,3,0.0
1397,3/30/2018 7:25,147,102,65,314,3,0.0
1398,3/30/2018 7:30,155,99,63,317,3,0.0
1399,3/30/2018 7:35,132,98,62,292,3,0.0
1400,3/30/2018 7:40,133,90,65,288,3,0.0
1401,3/30/2018 7:45,107,101,62,270,3,0.0
1402,3/30/2018 7:50,140,102,52,294,3,0.0
1403,3/30/2018 7:55,134,90,64,288,3,0.0
1404,3/30/2018 8:00,137,101,59,297,3,0.0
1405,3/30/2018 8:05,149,103,54,306,3,0.0
1406,3/30/2018 8:10,146,100,63,309,3,0.0
1407,3/30/2018 8:15,129,99,58,286,3,0.0
1408,3/30/2018 8:20,138,98,56,292,3,0.0
1409,3/30/2018 8:25,141,100,65,306,3,0.0
1410,3/30/2018 8:30,133,99,68,300,3,0.0
1411,3/30/2018 8:35,135,98,56,289,3,0.0
1412,3/30/2018 8:40,141,99,59,299,3,0.0
1413,3/30/2018 8:45,147,96,60,303,3,0.0
1414,3/30/2018 8:50,137,91,58,286,3,0.0
1415,3/30/2018 8:55,113,97,50,260,3,0.0
1416,3/30/2018 9:00,109,86,55,250,3,0.0
1417,3/30/2018 9:05,108,90,54,252,3,0.0
1418,3/30/2018 9:10,138,92,49,279,3,0.0
1419,3/30/2018 9:15,139,86,54,279,3,0.0
1420,3/30/2018 9:20,139,104,65,308,3,0.0
1421,3/30/2018 9:25,138,96,53,287,3,0.0
1422,3/30/2018 9:30,122,98,53,273,3,0.0
1423,3/30/2018 9:35,139,85,58,282,3,0.0
1424,3/30/2018 9:40,134,91,57,282,3,0.0
1425,3/30/2018 9:45,140,97,55,292,3,0.0
1426,3/30/2018 9:50,136,89,59,284,3,0.0
1427,3/30/2018 9:55,135,87,48,270,3,0.0
1428,3/30/2018 10:00,105,85,57,247,3,0.0
1429,3/30/2018 10:05,105,94,59,258,3,0.0
1430,3/30/2018 10:10,135,89,61,285,3,0.0
1431,3/30/2018 10:15,138,93,54,285,3,0.0
1432,3/30/2018 10:20,139,88,62,289,3,0.0
1433,3/30/2018 10:25,138,85,60,283,3,0.0
1434,3/30/2018 10:30,138,83,60,281,3,0.0
1435,3/30/2018 10:35,138,86,53,277,3,0.0
1436,3/30/2018 10:40,139,92,59,290,3,0.0
1437,3/30/2018 10:45,137,82,59,278,3,0.0
1438,3/30/2018 10:50,107,91,58,256,3,0.0
1439,3/30/2018 10:55,106,90,58,254,3,0.0
1440,3/30/2018 11:00,135,93,60,288,3,0.0
1441,3/30/2018 11:05,135,100,56,291,3,0.0
1442,3/30/2018 11:10,136,87,55,278,3,0.0
1443,3/30/2018 11:15,138,95,59,292,3,0.0
1444,3/30/2018 11:20,140,97,58,295,3,0.0
1445,3/30/2018 11:25,139,99,58,296,3,0.0
1446,3/30/2018 11:30,139,97,55,291,3,0.0
1447,3/30/2018 11:35,140,100,58,298,3,0.0
1448,3/30/2018 11:40,112,88,56,256,3,0.0
1449,3/30/2018 11:45,113,91,61,265,3,0.0
1450,3/30/2018 11:50,142,96,57,295,3,0.0
1451,3/30/2018 11:55,139,96,56,291,3,0.0
1452,3/30/2018 12:00,139,102,74,315,3,0.0
1453,3/30/2018 12:05,140,104,68,312,3,0.0
1454,3/30/2018 12:10,140,103,61,304,3,0.0
1455,3/30/2018 12:15,141,104,67,312,3,0.0
1456,3/30/2018 12:20,143,96,62,301,3,0.0
1457,3/30/2018 12:25,142,86,56,284,3,0.0
1458,3/30/2018 12:30,142,87,53,282,3,0.0
1459,3/30/2018 12:35,115,90,61,266,3,0.0
1460,3/30/2018 12:40,115,96,61,272,3,0.0
1461,3/30/2018 12:45,115,91,56,262,3,0.0
1462,3/30/2018 12:50,142,89,63,294,3,0.0
1463,3/30/2018 12:55,141,88,64,293,3,0.0
1464,3/30/2018 13:00,141,89,63,293,3,0.0
1465,3/30/2018 13:05,143,88,65,296,3,0.0
1466,3/30/2018 13:10,144,94,67,305,3,0.0
1467,3/30/2018 13:15,145,100,66,311,3,0.0
1468,3/30/2018 13:20,145,98,64,307,3,0.0
1469,3/30/2018 13:25,144,92,60,296,3,0.0
1470,3/30/2018 13:30,145,95,62,302,3,0.0
1471,3/30/2018 13:35,144,85,57,286,3,0.0
1472,3/30/2018 13:40,146,81,62,289,3,0.0
1473,3/30/2018 13:45,145,92,62,299,3,0.0
1474,3/30/2018 13:50,147,100,73,320,3,0.0
1475,3/30/2018 13:55,144,100,67,311,3,0.0
1476,3/30/2018 14:00,144,99,67,310,3,0.0
1477,3/30/2018 14:05,146,87,59,292,3,0.0
1478,3/30/2018 14:10,147,90,57,294,3,0.0
1479,3/30/2018 14:15,147,85,59,291,3,0.0
1480,3/30/2018 14:20,145,89,67,301,3,0.0
1481,3/30/2018 14:25,148,90,63,301,3,0.0
1482,3/30/2018 14:30,142,80,58,280,3,0.0
1483,3/30/2018 14:35,124,96,57,277,3,0.0
1484,3/30/2018 14:40,128,81,73,282,3,0.0
1485,3/30/2018 14:45,127,67,69,263,3,0.0
1486,3/30/2018 14:50,126,79,67,272,3,0.0
1487,3/30/2018 14:55,134,83,77,294,3,0.0
1488,3/30/2018 15:00,143,85,71,299,3,0.0
1489,3/30/2018 15:05,142,74,72,288,3,0.0
1490,3/30/2018 15:10,140,79,70,289,3,0.0
1491,3/30/2018 15:15,139,87,73,299,3,0.0
1492,3/30/2018 15:20,137,75,55,267,3,0.0
1493,3/30/2018 15:25,135,79,64,278,3,0.0
1494,3/30/2018 15:30,143,69,72,284,3,0.0
1495,3/30/2018 15:35,144,71,66,281,3,0.0
1496,3/30/2018 15:40,136,68,58,262,3,0.0
1497,3/30/2018 15:45,127,58,53,238,3,0.0
1498,3/30/2018 15:50,126,70,64,260,3,0.0
1499,3/30/2018 15:55,142,67,54,263,3,0.0
1500,3/30/2018 16:00,132,60,61,253,3,0.0
1501,3/30/2018 16:05,124,65,66,255,3,0.0
1502,3/30/2018 16:10,125,69,65,259,3,0.0
1503,3/30/2018 16:15,125,69,61,255,3,0.0
1504,3/30/2018 16:20,133,71,62,266,3,0.0
1505,3/30/2018 16:25,124,68,62,254,3,0.0
1506,3/30/2018 16:30,141,64,53,258,3,0.0
1507,3/30/2018 16:35,145,67,60,272,3,0.0
1508,3/30/2018 16:40,135,66,57,258,3,0.0
1509,3/30/2018 16:45,128,69,56,253,3,0.0
1510,3/30/2018 16:50,139,54,54,247,3,0.0
1511,3/30/2018 16:55,128,63,63,254,3,0.0
1512,3/30/2018 17:00,131,51,53,235,3,0.0
1513,3/30/2018 17:05,131,67,62,260,3,0.0
1514,3/30/2018 17:10,137,58,56,251,3,0.0
1515,3/30/2018 17:15,129,64,55,248,3,0.0
1516,3/30/2018 17:20,129,71,51,251,3,0.0
1517,3/30/2018 17:25,125,62,50,237,3,0.0
1518,3/30/2018 17:30,124,69,53,246,3,0.0
1519,3/30/2018 17:35,123,76,59,258,3,0.0
1520,3/30/2018 17:40,119,75,70,264,3,0.0
1521,3/30/2018 17:45,115,75,63,253,3,0.0
1522,3/30/2018 17:50,121,76,67,264,3,0.0
1523,3/30/2018 17:55,120,62,53,235,3,0.0
1524,3/30/2018 18:00,119,63,52,234,3,0.0
1525,3/30/2018 18:05,119,65,57,241,3,0.0
1526,3/30/2018 18:10,119,69,61,249,3,0.0
1527,3/30/2018 18:15,109,80,70,259,3,0.0
1528,3/30/2018 18:20,119,83,64,266,3,0.0
1529,3/30/2018 18:25,118,69,60,247,3,0.0
1530,3/30/2018 18:30,124,64,42,230,3,0.0
1531,3/30/2018 18:35,116,74,55,245,3,0.0
1532,3/30/2018 18:40,115,69,50,234,3,0.0
1533,3/30/2018 18:45,115,80,61,256,3,0.0
1534,3/30/2018 18:50,123,85,70,278,3,0.0
1535,3/30/2018 18:55,134,80,59,273,3,0.0
1536,3/30/2018 19:00,130,79,58,267,3,0.0
1537,3/30/2018 19:05,112,73,56,241,3,0.0
1538,3/30/2018 19:10,119,79,52,250,3,0.0
1539,3/30/2018 19:15,135,76,51,262,3,0.0
1540,3/30/2018 19:20,135,88,48,271,3,0.0
1541,3/30/2018 19:25,133,85,48,266,3,0.0
1542,3/30/2018 19:30,131,84,55,270,3,0.0
1543,3/30/2018 19:35,127,86,59,272,3,0.0
1544,3/30/2018 19:40,126,92,60,278,3,0.0
1545,3/30/2018 19:45,123,89,61,273,3,0.0
1546,3/30/2018 19:50,100,94,59,253,3,0.0
1547,3/30/2018 19:55,97,85,65,247,3,0.0
1548,3/30/2018 20:00,95,83,50,228,3,0.0
1549,3/30/2018 20:05,114,89,51,254,3,0.0
1550,3/30/2018 20:10,113,88,62,263,3,0.0
1551,3/30/2018 20:15,112,86,60,258,3,0.0
1552,3/30/2018 20:20,111,88,65,264,3,0.0
1553,3/30/2018 20:25,108,84,57,249,3,0.0
1554,3/30/2018 20:30,106,93,63,262,3,0.0
1555,3/30/2018 20:35,105,78,61,244,3,0.0
1556,3/30/2018 20:40,102,88,66,256,3,0.0
1557,3/30/2018 20:45,99,91,56,246,3,0.0
1558,3/30/2018 20:50,97,88,58,243,3,0.0
1559,3/30/2018 20:55,81,79,56,216,3,0.0
1560,3/30/2018 21:00,85,84,48,217,3,0.0
1561,3/30/2018 21:05,84,85,57,226,3,0.0
1562,3/30/2018 21:10,91,88,62,241,3,0.0
1563,3/30/2018 21:15,99,92,52,243,3,0.0
1564,3/30/2018 21:20,99,92,59,250,3,0.0
1565,3/30/2018 21:25,98,96,60,254,3,0.0
1566,3/30/2018 21:30,96,92,60,248,3,0.0
1567,3/30/2018 21:35,94,101,57,252,3,0.0
1568,3/30/2018 21:40,93,97,63,253,3,0.0
1569,3/30/2018 21:45,95,98,61,254,3,0.0
1570,3/30/2018 21:50,93,96,65,254,3,0.0
1571,3/30/2018 21:55,91,88,57,236,3,0.0
1572,3/30/2018 22:00,90,96,60,246,3,0.0
1573,3/30/2018 22:05,81,97,64,242,3,0.0
1574,3/30/2018 22:10,85,94,58,237,3,0.0
1575,3/30/2018 22:15,84,104,68,256,3,0.0
1576,3/30/2018 22:20,85,94,61,240,3,0.0
1577,3/30/2018 22:25,89,88,57,234,3,0.0
1578,3/30/2018 22:30,86,93,63,242,3,0.0
1579,3/30/2018 22:35,84,93,55,232,3,0.0
1580,3/30/2018 22:40,82,97,63,242,3,0.0
1581,3/30/2018 22:45,80,94,56,230,3,0.0
1582,3/30/2018 22:50,77,88,59,224,3,0.0
1583,3/30/2018 22:55,74,87,56,217,3,0.0
1584,3/30/2018 23:00,70,88,59,217,3,0.0
1585,3/30/2018 23:05,70,85,53,208,3,0.0
1586,3/30/2018 23:10,70,97,59,226,3,0.0
1587,3/30/2018 23:15,69,89,58,216,3,0.0
1588,3/30/2018 23:20,67,91,65,223,3,0.0
1589,3/30/2018 23:25,63,90,50,203,3,0.0
1590,3/30/2018 23:30,60,96,53,209,3,0.0
1591,3/30/2018 23:35,61,84,60,205,3,0.0
1592,3/30/2018 23:40,60,83,50,193,3,0.0
1593,3/30/2018 23:45,58,85,57,200,3,0.0
1594,3/30/2018 23:50,55,80,45,180,3,0.0
1595,3/30/2018 23:55,48,67,45,160,3,0.0
1596,3/31/2018 0:00,40,70,42,152,3,0.0
1597,3/31/2018 0:05,40,67,42,149,3,0.0
1598,3/31/2018 0:10,48,74,43,165,3,0.0
1599,3/31/2018 0:15,47,65,43,155,3,0.0
1600,3/31/2018 0:20,46,66,37,149,3,0.0
1601,3/31/2018 0:25,43,61,38,142,3,0.0
1602,3/31/2018 0:30,42,68,34,144,3,0.0
1603,3/31/2018 0:35,40,59,36,135,3,0.0
1604,3/31/2018 0:40,40,63,40,143,3,0.0
1605,3/31/2018 0:45,39,59,32,130,3,0.0
1606,3/31/2018 0:50,38,56,33,127,3,0.0
1607,3/31/2018 0:55,36,45,22,103,3,0.0
1608,3/31/2018 1:00,34,48,27,109,3,0.0
1609,3/31/2018 1:05,33,52,28,113,3,0.0
1610,3/31/2018 1:10,33,55,26,114,3,0.0
1611,3/31/2018 1:15,33,48,30,111,3,0.0
1612,3/31/2018 1:20,33,51,30,114,3,0.0
1613,3/31/2018 1:25,32,49,26,107,3,0.0
1614,3/31/2018 1:30,15,48,23,86,3,0.0
1615,3/31/2018 1:35,25,51,23,99,3,0.0
1616,3/31/2018 1:40,29,52,27,108,3,0.0
1617,3/31/2018 1:45,30,51,31,112,3,0.0
1618,3/31/2018 1:50,30,39,20,89,3,0.0
1619,3/31/2018 1:55,28,39,23,90,3,0.0
1620,3/31/2018 2:00,27,34,20,81,3,0.0
1621,3/31/2018 2:05,28,42,21,91,3,0.0
1622,3/31/2018 2:10,29,41,19,89,3,0.0
1623,3/31/2018 2:15,30,47,27,104,3,0.0
1624,3/31/2018 2:20,28,45,29,102,3,0.0
1625,3/31/2018 2:25,26,43,19,88,3,0.0
1626,3/31/2018 2:30,25,36,17,78,3,0.0
1627,3/31/2018 2:35,24,32,16,72,3,0.0
1628,3/31/2018 2:40,24,38,23,85,3,0.0
1629,3/31/2018 2:45,23,35,23,81,3,0.0
1630,3/31/2018 2:50,22,36,14,72,3,0.0
1631,3/31/2018 2:55,21,31,14,66,3,0.0
1632,3/31/2018 3:00,20,29,19,68,3,0.0
1633,3/31/2018 3:05,19,28,16,63,3,0.0
1634,3/31/2018 3:10,19,28,14,61,3,0.0
1635,3/31/2018 3:15,19,29,16,64,3,0.0
1636,3/31/2018 3:20,20,26,17,63,3,0.0
1637,3/31/2018 3:25,20,19,13,52,3,0.0
1638,3/31/2018 3:30,19,28,15,62,3,0.0
1639,3/31/2018 3:35,19,18,12,49,3,0.0
1640,3/31/2018 3:40,16,24,14,54,3,0.0
1641,3/31/2018 3:45,19,27,10,56,3,0.0
1642,3/31/2018 3:50,18,25,10,53,3,0.0
1643,3/31/2018 3:55,16,21,10,47,3,0.0
1644,3/31/2018 4:00,14,26,14,54,3,0.0
1645,3/31/2018 4:05,17,30,10,57,3,0.0
1646,3/31/2018 4:10,19,28,14,61,3,0.0
1647,3/31/2018 4:15,15,30,13,58,3,0.0
1648,3/31/2018 4:20,16,24,13,53,3,0.0
1649,3/31/2018 4:25,17,21,11,49,3,0.0
1650,3/31/2018 4:30,18,31,13,62,3,0.0
1651,3/31/2018 4:35,19,28,13,60,3,0.0
1652,3/31/2018 4:40,21,30,15,66,3,0.0
1653,3/31/2018 4:45,21,32,15,68,3,0.0
1654,3/31/2018 4:50,22,33,15,70,3,0.0
1655,3/31/2018 4:55,20,36,18,74,3,0.0
1656,3/31/2018 5:00,22,25,17,64,3,0.0
1657,3/31/2018 5:05,24,37,14,75,3,0.0
1658,3/31/2018 5:10,26,39,19,84,3,0.0
1659,3/31/2018 5:15,34,40,21,95,3,0.0
1660,3/31/2018 5:20,34,36,20,90,3,0.0
1661,3/31/2018 5:25,35,43,22,100,3,0.0
1662,3/31/2018 5:30,37,41,19,97,3,0.0
1663,3/31/2018 5:35,39,43,23,105,3,0.0
1664,3/31/2018 5:40,41,50,24,115,3,0.0
1665,3/31/2018 5:45,41,50,25,116,3,0.0
1666,3/31/2018 5:50,39,45,26,110,3,0.0
1667,3/31/2018 5:55,37,44,26,107,3,0.0
1668,3/31/2018 6:00,36,44,24,104,3,0.0
1669,3/31/2018 6:05,43,47,22,112,3,0.0
1670,3/31/2018 6:10,49,53,30,132,3,0.0
1671,3/31/2018 6:15,49,55,27,131,3,0.0
1672,3/31/2018 6:20,52,54,32,138,3,0.0
1673,3/31/2018 6:25,53,57,27,137,3,0.0
1674,3/31/2018 6:30,62,51,33,146,3,0.0
1675,3/31/2018 6:35,61,56,31,148,3,0.0
1676,3/31/2018 6:40,63,70,36,169,3,0.0
1677,3/31/2018 6:45,71,65,41,177,3,0.0
1678,3/31/2018 6:50,71,66,41,178,3,0.0
1679,3/31/2018 6:55,68,68,41,177,3,0.0
1680,3/31/2018 7:00,65,64,35,164,3,0.0
1681,3/31/2018 7:05,67,70,33,170,3,0.0
1682,3/31/2018 7:10,71,71,43,185,3,0.0
1683,3/31/2018 7:15,75,77,43,195,3,0.0
1684,3/31/2018 7:20,79,72,36,187,3,0.0
1685,3/31/2018 7:25,83,77,53,213,3,0.0
1686,3/31/2018 7:30,73,88,45,206,3,0.0
1687,3/31/2018 7:35,73,84,50,207,3,0.0
1688,3/31/2018 7:40,98,85,44,227,3,0.0
1689,3/31/2018 7:45,102,88,51,241,3,0.0
1690,3/31/2018 7:50,101,87,53,241,3,0.0
1691,3/31/2018 7:55,98,81,51,230,3,0.0
1692,3/31/2018 8:00,94,77,45,216,3,0.0
1693,3/31/2018 8:05,95,77,46,218,3,0.0
1694,3/31/2018 8:10,97,86,52,235,3,0.0
1695,3/31/2018 8:15,101,89,47,237,3,0.0
1696,3/31/2018 8:20,102,92,56,250,3,0.0
1697,3/31/2018 8:25,106,93,58,257,3,0.0
1698,3/31/2018 8:30,109,89,55,253,3,0.0
1699,3/31/2018 8:35,115,93,57,265,3,0.0
1700,3/31/2018 8:40,118,80,50,248,3,0.0
1701,3/31/2018 8:45,120,99,58,277,3,0.0
1702,3/31/2018 8:50,120,84,55,259,3,0.0
1703,3/31/2018 8:55,117,89,51,257,3,0.0
1704,3/31/2018 9:00,112,87,56,255,3,0.0
1705,3/31/2018 9:05,97,96,55,248,3,0.0
1706,3/31/2018 9:10,106,87,57,250,3,0.0
1707,3/31/2018 9:15,107,93,55,255,3,0.0
1708,3/31/2018 9:20,120,103,65,288,3,0.0
1709,3/31/2018 9:25,122,102,64,288,3,0.0
1710,3/31/2018 9:30,125,103,59,287,3,0.0
1711,3/31/2018 9:35,126,104,64,294,3,0.0
1712,3/31/2018 9:40,130,94,65,289,3,0.0
1713,3/31/2018 9:45,132,99,59,290,3,0.0
1714,3/31/2018 9:50,128,92,52,272,3,0.0
1715,3/31/2018 9:55,126,91,56,273,3,0.0
1716,3/31/2018 10:00,129,91,60,280,3,0.0
1717,3/31/2018 10:05,127,91,55,273,3,0.0
1718,3/31/2018 10:10,125,94,59,278,3,0.0
1719,3/31/2018 10:15,126,100,61,287,3,0.0
1720,3/31/2018 10:20,129,95,65,289,3,0.0
1721,3/31/2018 10:25,127,95,56,278,3,0.0
1722,3/31/2018 10:30,129,98,68,295,3,0.0
1723,3/31/2018 10:35,130,98,64,292,3,0.0
1724,3/31/2018 10:40,134,100,67,301,3,0.0
1725,3/31/2018 10:45,134,99,68,301,3,0.0
1726,3/31/2018 10:50,135,99,63,297,3,0.0
1727,3/31/2018 10:55,133,93,64,290,3,0.0
1728,3/31/2018 11:00,132,87,64,283,3,0.0
1729,3/31/2018 11:05,133,99,70,302,3,0.0
1730,3/31/2018 11:10,134,89,65,288,3,0.0
1731,3/31/2018 11:15,137,93,62,292,3,0.0
1732,3/31/2018 11:20,137,97,66,300,3,0.0
1733,3/31/2018 11:25,139,94,57,290,3,0.0
1734,3/31/2018 11:30,139,95,66,300,3,0.0
1735,3/31/2018 11:35,140,96,68,304,3,0.0
1736,3/31/2018 11:40,143,97,57,297,3,0.0
1737,3/31/2018 11:45,142,96,63,301,3,0.0
1738,3/31/2018 11:50,140,97,63,300,3,0.0
1739,3/31/2018 11:55,139,95,70,304,3,0.0
