,5 Minutes,Lane 1 Flow (Veh/5 Minutes),Lane 2 Flow (Veh/5 Minutes),Lane 3 Flow (Veh/5 Minutes),Lane 4 Flow (Veh/5 Minutes),Lane 5 Flow (Veh/5 Minutes),Flow (Veh/5 Minutes),# Lane Points,% Observed
0,3/01/2018 0:00,26,31,35,17,28,137,5,100
1,3/01/2018 0:05,27,35,43,27,25,157,5,100
2,3/01/2018 0:10,42,43,45,18,31,179,5,100
3,3/01/2018 0:15,25,40,42,12,32,151,5,100
4,3/01/2018 0:20,26,28,32,14,28,128,5,100
5,3/01/2018 0:25,22,33,37,21,33,146,5,100
6,3/01/2018 0:30,28,31,43,20,32,154,5,100
7,3/01/2018 0:35,20,35,35,19,34,143,5,100
8,3/01/2018 0:40,16,29,45,13,29,132,5,100
9,3/01/2018 0:45,18,26,26,12,24,106,5,100
10,3/01/2018 0:50,14,19,31,14,21,99,5,100
11,3/01/2018 0:55,20,31,31,12,28,122,5,100
12,3/01/2018 1:00,16,26,19,11,24,96,5,100
13,3/01/2018 1:05,14,23,22,21,20,100,5,100
14,3/01/2018 1:10,14,23,16,15,20,88,5,100
15,3/01/2018 1:15,21,30,24,17,25,117,5,100
16,3/01/2018 1:20,13,18,26,11,11,79,5,100
17,3/01/2018 1:25,14,23,22,6,17,82,5,100
18,3/01/2018 1:30,11,16,20,7,20,74,5,100
19,3/01/2018 1:35,9,18,17,10,14,68,5,100
20,3/01/2018 1:40,10,17,16,13,22,78,5,100
21,3/01/2018 1:45,9,15,20,5,8,57,5,100
22,3/01/2018 1:50,7,14,22,8,17,68,5,100
23,3/01/2018 1:55,8,17,23,7,13,68,5,100
24,3/01/2018 2:00,9,17,24,8,12,70,5,100
25,3/01/2018 2:05,11,15,13,8,11,58,5,100
26,3/01/2018 2:10,14,15,10,4,19,62,5,100
27,3/01/2018 2:15,10,14,15,5,14,58,5,100
28,3/01/2018 2:20,5,13,11,8,10,47,5,100
29,3/01/2018 2:25,13,16,13,6,13,61,5,100
30,3/01/2018 2:30,7,15,9,7,15,53,5,100
31,3/01/2018 2:35,8,13,13,10,12,56,5,100
32,3/01/2018 2:40,10,14,15,7,11,57,5,100
33,3/01/2018 2:45,11,15,18,3,12,59,5,100
34,3/01/2018 2:50,9,12,13,6,9,49,5,100
35,3/01/2018 2:55,6,8,9,4,5,32,5,100
36,3/01/2018 3:00,6,10,7,3,17,43,5,100
37,3/01/2018 3:05,5,12,6,6,7,36,5,100
38,3/01/2018 3:10,7,13,9,3,11,43,5,100
39,3/01/2018 3:15,6,10,9,3,9,37,5,100
40,3/01/2018 3:20,6,14,12,5,8,45,5,100
41,3/01/2018 3:25,5,13,12,4,11,45,5,100
42,3/01/2018 3:30,12,15,19,4,10,60,5,100
43,3/01/2018 3:35,7,18,13,7,13,58,5,100
44,3/01/2018 3:40,6,20,8,6,15,55,5,100
45,3/01/2018 3:45,9,10,15,5,16,55,5,100
46,3/01/2018 3:50,11,18,16,6,12,63,5,100
47,3/01/2018 3:55,7,16,16,12,13,64,5,100
48,3/01/2018 4:00,9,14,19,7,15,64,5,100
49,3/01/2018 4:05,8,25,17,6,10,66,5,100
50,3/01/2018 4:10,15,17,24,7,13,76,5,100
51,3/01/2018 4:15,10,19,23,5,17,74,5,100
52,3/01/2018 4:20,16,21,19,8,15,79,5,100
53,3/01/2018 4:25,18,30,27,10,16,101,5,100
54,3/01/2018 4:30,20,19,30,7,18,94,5,100
55,3/01/2018 4:35,25,43,28,16,30,142,5,100
56,3/01/2018 4:40,16,24,28,17,26,111,5,100
57,3/01/2018 4:45,29,33,34,10,26,132,5,100
58,3/01/2018 4:50,26,34,38,24,29,151,5,100
59,3/01/2018 4:55,32,38,34,17,24,145,5,100
60,3/01/2018 5:00,38,39,50,18,33,178,5,100
61,3/01/2018 5:05,36,35,33,13,22,139,5,100
62,3/01/2018 5:10,49,42,51,19,30,191,5,100
63,3/01/2018 5:15,50,46,45,8,36,185,5,100
64,3/01/2018 5:20,66,42,56,22,41,227,5,100
65,3/01/2018 5:25,54,43,62,37,45,241,5,100
66,3/01/2018 5:30,68,56,74,24,41,263,5,100
67,3/01/2018 5:35,66,54,71,39,43,273,5,100
68,3/01/2018 5:40,80,57,83,35,54,309,5,100
69,3/01/2018 5:45,89,64,68,38,60,319,5,100
70,3/01/2018 5:50,75,61,79,33,50,298,5,100
71,3/01/2018 5:55,95,72,74,35,49,325,5,100
72,3/01/2018 6:00,88,57,74,37,47,303,5,100
73,3/01/2018 6:05,78,59,76,38,49,300,5,100
74,3/01/2018 6:10,106,74,94,52,71,397,5,100
75,3/01/2018 6:15,86,71,91,41,51,340,5,100
76,3/01/2018 6:20,97,77,96,37,50,357,5,100
77,3/01/2018 6:25,113,83,100,57,67,420,5,100
78,3/01/2018 6:30,103,76,92,39,71,381,5,100
79,3/01/2018 6:35,118,78,112,59,84,451,5,100
80,3/01/2018 6:40,110,81,92,62,71,416,5,100
81,3/01/2018 6:45,120,85,105,50,75,435,5,100
82,3/01/2018 6:50,106,91,100,44,76,417,5,100
83,3/01/2018 6:55,130,81,107,46,79,443,5,100
84,3/01/2018 7:00,122,86,111,57,86,462,5,100
85,3/01/2018 7:05,124,87,116,56,84,467,5,100
86,3/01/2018 7:10,135,104,121,64,102,526,5,100
87,3/01/2018 7:15,135,108,138,68,96,545,5,100
88,3/01/2018 7:20,155,99,130,70,89,543,5,100
89,3/01/2018 7:25,172,115,145,75,104,611,5,100
90,3/01/2018 7:30,143,114,138,91,90,576,5,100
91,3/01/2018 7:35,184,111,153,77,122,647,5,100
92,3/01/2018 7:40,181,121,131,68,114,615,5,100
93,3/01/2018 7:45,157,111,138,98,111,615,5,100
94,3/01/2018 7:50,144,87,146,81,102,560,5,100
95,3/01/2018 7:55,164,111,133,86,88,582,5,100
96,3/01/2018 8:00,148,88,123,74,84,517,5,100
97,3/01/2018 8:05,136,112,138,80,97,563,5,100
98,3/01/2018 8:10,145,102,143,70,99,559,5,100
99,3/01/2018 8:15,123,107,130,87,98,545,5,100
100,3/01/2018 8:20,116,124,121,94,104,559,5,100
101,3/01/2018 8:25,121,100,113,83,105,522,5,100
102,3/01/2018 8:30,136,114,122,91,104,567,5,100
103,3/01/2018 8:35,137,109,139,75,89,549,5,100
104,3/01/2018 8:40,133,87,119,67,73,479,5,100
105,3/01/2018 8:45,151,103,121,70,83,528,5,100
106,3/01/2018 8:50,148,103,138,69,78,536,5,100
107,3/01/2018 8:55,138,101,130,76,98,543,5,100
108,3/01/2018 9:00,133,90,114,75,78,490,5,100
109,3/01/2018 9:05,120,86,116,71,68,461,5,100
110,3/01/2018 9:10,130,96,119,51,82,478,5,100
111,3/01/2018 9:15,123,92,113,52,81,461,5,100
112,3/01/2018 9:20,120,88,120,59,81,468,5,100
113,3/01/2018 9:25,131,107,117,58,91,504,5,100
114,3/01/2018 9:30,152,117,124,60,88,541,5,100
115,3/01/2018 9:35,136,99,141,51,81,508,5,100
116,3/01/2018 9:40,135,114,123,63,93,528,5,100
117,3/01/2018 9:45,119,102,112,57,86,476,5,100
118,3/01/2018 9:50,120,87,115,65,78,465,5,100
119,3/01/2018 9:55,128,101,119,64,69,481,5,100
120,3/01/2018 10:00,112,85,109,50,93,449,5,100
121,3/01/2018 10:05,121,94,110,63,80,468,5,100
122,3/01/2018 10:10,124,96,120,47,66,453,5,100
123,3/01/2018 10:15,109,94,106,61,84,454,5,100
124,3/01/2018 10:20,112,93,97,58,90,450,5,100
125,3/01/2018 10:25,108,92,120,58,81,459,5,100
126,3/01/2018 10:30,118,98,114,67,76,473,5,100
127,3/01/2018 10:35,113,96,105,48,76,438,5,100
128,3/01/2018 10:40,108,94,98,65,74,439,5,100
129,3/01/2018 10:45,118,91,106,61,78,454,5,100
130,3/01/2018 10:50,129,95,106,53,79,462,5,100
131,3/01/2018 10:55,120,88,105,66,86,465,5,100
132,3/01/2018 11:00,106,87,117,61,80,451,5,100
133,3/01/2018 11:05,126,91,114,49,88,468,5,100
134,3/01/2018 11:10,117,96,102,49,79,443,5,100
135,3/01/2018 11:15,113,78,110,56,84,441,5,100
136,3/01/2018 11:20,118,100,110,54,77,459,5,100
137,3/01/2018 11:25,124,76,107,52,112,471,5,100
138,3/01/2018 11:30,118,100,119,69,92,498,5,100
139,3/01/2018 11:35,121,104,121,64,91,501,5,100
140,3/01/2018 11:40,135,81,123,61,95,495,5,100
141,3/01/2018 11:45,134,93,128,57,92,504,5,100
142,3/01/2018 11:50,126,100,113,55,75,469,5,100
143,3/01/2018 11:55,114,98,115,58,90,475,5,100
144,3/01/2018 12:00,136,95,124,61,107,523,5,100
145,3/01/2018 12:05,124,106,116,58,89,493,5,100
146,3/01/2018 12:10,123,100,129,54,67,473,5,100
147,3/01/2018 12:15,135,90,126,68,100,519,5,100
148,3/01/2018 12:20,131,94,120,66,92,503,5,100
149,3/01/2018 12:25,134,103,114,50,82,483,5,100
150,3/01/2018 12:30,148,118,132,62,90,550,5,100
151,3/01/2018 12:35,142,100,126,68,81,517,5,100
152,3/01/2018 12:40,133,100,121,59,87,500,5,100
153,3/01/2018 12:45,140,117,125,75,92,549,5,100
154,3/01/2018 12:50,142,101,129,57,89,518,5,100
155,3/01/2018 12:55,131,107,130,61,106,535,5,100
156,3/01/2018 13:00,145,106,120,64,106,541,5,100
157,3/01/2018 13:05,142,93,117,56,78,486,5,100
158,3/01/2018 13:10,131,96,122,76,98,523,5,100
159,3/01/2018 13:15,145,113,131,63,98,550,5,100
160,3/01/2018 13:20,126,113,123,50,79,491,5,100
161,3/01/2018 13:25,154,92,131,69,100,546,5,100
162,3/01/2018 13:30,164,101,129,79,91,564,5,100
163,3/01/2018 13:35,141,107,121,71,104,544,5,100
164,3/01/2018 13:40,121,97,128,59,102,507,5,100
165,3/01/2018 13:45,136,111,133,74,105,559,5,100
166,3/01/2018 13:50,125,81,114,69,81,470,5,100
167,3/01/2018 13:55,152,92,143,65,90,542,5,100
168,3/01/2018 14:00,132,99,123,64,93,511,5,100
169,3/01/2018 14:05,126,103,121,72,82,504,5,100
170,3/01/2018 14:10,130,97,131,81,100,539,5,100
171,3/01/2018 14:15,150,113,124,82,92,561,5,100
172,3/01/2018 14:20,133,104,133,85,93,548,5,100
173,3/01/2018 14:25,123,98,136,96,81,534,5,100
174,3/01/2018 14:30,140,109,142,92,108,591,5,100
175,3/01/2018 14:35,121,103,121,99,91,535,5,100
176,3/01/2018 14:40,114,101,112,90,98,515,5,100
177,3/01/2018 14:45,97,79,110,102,75,463,5,100
178,3/01/2018 14:50,96,104,100,108,91,499,5,100
179,3/01/2018 14:55,88,76,86,108,86,444,5,100
180,3/01/2018 15:00,93,83,87,103,90,456,5,100
181,3/01/2018 15:05,96,90,103,99,85,473,5,100
182,3/01/2018 15:10,98,97,103,90,89,477,5,100
183,3/01/2018 15:15,99,84,98,96,75,452,5,100
184,3/01/2018 15:20,81,74,79,97,70,401,5,100
185,3/01/2018 15:25,68,46,62,91,64,331,5,100
186,3/01/2018 15:30,76,60,62,87,70,355,5,100
187,3/01/2018 15:35,87,92,96,120,97,492,5,100
188,3/01/2018 15:40,72,58,64,95,86,375,5,100
189,3/01/2018 15:45,88,77,80,114,86,445,5,100
190,3/01/2018 15:50,77,80,78,96,93,424,5,100
191,3/01/2018 15:55,77,77,72,97,78,401,5,100
192,3/01/2018 16:00,69,66,63,86,74,358,5,100
193,3/01/2018 16:05,65,66,60,94,73,358,5,100
194,3/01/2018 16:10,69,73,77,83,71,373,5,100
195,3/01/2018 16:15,80,67,71,108,77,403,5,100
196,3/01/2018 16:20,64,67,57,98,74,360,5,100
197,3/01/2018 16:25,58,51,59,100,75,343,5,100
198,3/01/2018 16:30,76,65,74,106,80,401,5,100
199,3/01/2018 16:35,84,87,82,114,74,441,5,100
200,3/01/2018 16:40,79,80,76,97,75,407,5,100
201,3/01/2018 16:45,66,60,61,93,70,350,5,100
202,3/01/2018 16:50,61,43,54,69,51,278,5,100
203,3/01/2018 16:55,69,68,67,93,75,372,5,100
204,3/01/2018 17:00,88,86,85,124,98,481,5,100
205,3/01/2018 17:05,74,82,72,110,74,412,5,100
206,3/01/2018 17:10,60,53,56,102,70,341,5,100
207,3/01/2018 17:15,68,41,54,80,59,302,5,100
208,3/01/2018 17:20,83,75,75,118,92,443,5,100
209,3/01/2018 17:25,60,56,54,96,75,341,5,100
210,3/01/2018 17:30,52,50,48,100,69,319,5,100
211,3/01/2018 17:35,68,54,59,102,70,353,5,100
212,3/01/2018 17:40,70,57,59,105,62,353,5,100
213,3/01/2018 17:45,77,69,71,102,81,400,5,100
214,3/01/2018 17:50,69,51,61,90,66,337,5,100
215,3/01/2018 17:55,62,51,55,100,69,337,5,100
216,3/01/2018 18:00,63,55,54,113,71,356,5,100
217,3/01/2018 18:05,80,81,76,104,78,419,5,100
218,3/01/2018 18:10,73,59,66,107,78,383,5,100
219,3/01/2018 18:15,69,72,69,91,71,372,5,100
220,3/01/2018 18:20,68,62,77,92,66,365,5,100
221,3/01/2018 18:25,66,67,83,102,72,390,5,100
222,3/01/2018 18:30,80,61,74,92,67,374,5,100
223,3/01/2018 18:35,77,62,83,85,80,387,5,100
224,3/01/2018 18:40,65,76,80,95,74,390,5,100
225,3/01/2018 18:45,65,78,84,84,68,379,5,100
226,3/01/2018 18:50,76,78,92,84,79,409,5,100
227,3/01/2018 18:55,46,78,68,73,67,332,5,100
228,3/01/2018 19:00,46,61,61,77,71,316,5,100
229,3/01/2018 19:05,38,72,59,59,75,303,5,100
230,3/01/2018 19:10,40,90,70,63,77,340,5,100
231,3/01/2018 19:15,152,103,150,82,103,590,5,100
232,3/01/2018 19:20,136,114,127,94,91,562,5,100
233,3/01/2018 19:25,117,102,118,71,84,492,5,100
234,3/01/2018 19:30,91,87,94,79,76,427,5,100
235,3/01/2018 19:35,92,90,86,104,94,466,5,100
236,3/01/2018 19:40,88,68,87,92,85,420,5,100
237,3/01/2018 19:45,84,65,77,99,66,391,5,100
238,3/01/2018 19:50,86,73,86,96,79,420,5,100
239,3/01/2018 19:55,102,85,97,117,85,486,5,100
240,3/01/2018 20:00,108,78,83,92,96,457,5,100
241,3/01/2018 20:05,106,98,98,96,102,500,5,100
242,3/01/2018 20:10,95,87,100,97,89,468,5,100
243,3/01/2018 20:15,109,96,120,78,73,476,5,100
244,3/01/2018 20:20,122,106,120,58,87,493,5,0
245,3/01/2018 20:25,118,87,113,55,81,454,5,0
246,3/01/2018 20:30,119,94,110,57,86,466,5,0
247,3/01/2018 20:35,107,86,106,56,79,434,5,0
248,3/01/2018 20:40,126,103,120,52,86,487,5,0
249,3/01/2018 20:45,126,92,113,52,82,465,5,0
250,3/01/2018 20:50,130,85,132,67,77,491,5,100
251,3/01/2018 20:55,101,89,92,47,71,400,5,100
252,3/01/2018 21:00,118,95,111,54,80,458,5,100
253,3/01/2018 21:05,124,96,116,56,88,480,5,100
254,3/01/2018 21:10,106,101,111,51,67,436,5,100
255,3/01/2018 21:15,99,73,108,61,89,430,5,100
256,3/01/2018 21:20,109,84,108,53,66,420,5,100
257,3/01/2018 21:25,108,86,102,52,74,422,5,100
258,3/01/2018 21:30,106,83,100,43,71,403,5,0
259,3/01/2018 21:35,150,125,130,85,155,645,5,100
260,3/01/2018 21:40,112,82,113,51,82,440,5,100
261,3/01/2018 21:45,95,82,95,41,66,379,5,100
262,3/01/2018 21:50,83,75,85,42,49,334,5,100
263,3/01/2018 21:55,101,73,91,43,71,379,5,100
264,3/01/2018 22:00,81,71,80,36,64,332,5,100
265,3/01/2018 22:05,87,68,79,49,78,361,5,100
266,3/01/2018 22:10,85,75,87,40,61,348,5,100
267,3/01/2018 22:15,101,70,98,38,61,368,5,100
268,3/01/2018 22:20,90,78,91,47,58,364,5,100
269,3/01/2018 22:25,80,70,91,28,58,327,5,100
270,3/01/2018 22:30,86,67,73,42,63,331,5,100
271,3/01/2018 22:35,65,60,80,39,52,296,5,100
272,3/01/2018 22:40,57,54,78,46,63,298,5,100
273,3/01/2018 22:45,80,65,77,37,55,314,5,100
274,3/01/2018 22:50,65,62,73,30,51,281,5,100
275,3/01/2018 22:55,76,62,77,42,52,309,5,100
276,3/01/2018 23:00,62,59,65,30,44,260,5,100
277,3/01/2018 23:05,64,59,64,40,50,277,5,100
278,3/01/2018 23:10,51,56,55,35,52,249,5,100
279,3/01/2018 23:15,64,60,73,27,48,272,5,100
280,3/01/2018 23:20,51,48,52,25,36,212,5,100
281,3/01/2018 23:25,50,37,53,33,46,219,5,100
282,3/01/2018 23:30,47,55,62,18,48,230,5,100
283,3/01/2018 23:35,48,48,50,25,28,199,5,100
284,3/01/2018 23:40,48,45,52,22,40,207,5,100
285,3/01/2018 23:45,38,54,54,25,46,217,5,100
286,3/01/2018 23:50,35,53,47,21,32,188,5,100
287,3/01/2018 23:55,40,32,43,25,41,181,5,100
288,3/02/2018 0:00,31,37,39,22,27,156,5,100
289,3/02/2018 0:05,23,38,42,24,42,169,5,100
290,3/02/2018 0:10,38,50,50,24,34,196,5,100
291,3/02/2018 0:15,26,37,43,14,37,157,5,100
292,3/02/2018 0:20,36,40,39,15,37,167,5,100
293,3/02/2018 0:25,29,33,41,16,42,161,5,100
294,3/02/2018 0:30,32,47,35,20,35,169,5,100
295,3/02/2018 0:35,26,28,40,23,31,148,5,100
296,3/02/2018 0:40,24,32,35,16,30,137,5,100
297,3/02/2018 0:45,22,36,36,14,33,141,5,100
298,3/02/2018 0:50,22,33,24,16,14,109,5,100
299,3/02/2018 0:55,20,27,23,16,26,112,5,100
300,3/02/2018 1:00,25,28,36,9,28,126,5,100
301,3/02/2018 1:05,19,28,33,9,27,116,5,100
302,3/02/2018 1:10,18,23,27,9,19,96,5,100
303,3/02/2018 1:15,14,31,21,12,16,94,5,100
304,3/02/2018 1:20,16,24,20,8,17,85,5,100
305,3/02/2018 1:25,17,23,23,9,21,93,5,100
306,3/02/2018 1:30,12,20,25,7,29,93,5,100
307,3/02/2018 1:35,14,22,20,10,15,81,5,100
308,3/02/2018 1:40,10,21,18,9,19,77,5,100
309,3/02/2018 1:45,13,19,25,6,11,74,5,100
310,3/02/2018 1:50,7,22,26,7,12,74,5,100
311,3/02/2018 1:55,11,27,21,6,23,88,5,100
312,3/02/2018 2:00,6,19,16,4,17,62,5,100
313,3/02/2018 2:05,16,12,19,12,13,72,5,100
314,3/02/2018 2:10,10,18,23,5,9,65,5,100
315,3/02/2018 2:15,8,11,17,10,13,59,5,100
316,3/02/2018 2:20,11,22,27,9,13,82,5,100
317,3/02/2018 2:25,10,14,16,4,12,56,5,100
318,3/02/2018 2:30,11,15,22,7,8,63,5,100
319,3/02/2018 2:35,5,16,14,7,12,54,5,100
320,3/02/2018 2:40,6,16,14,5,8,49,5,100
321,3/02/2018 2:45,9,12,13,9,13,56,5,100
322,3/02/2018 2:50,5,14,17,3,16,55,5,100
323,3/02/2018 2:55,5,17,13,4,6,45,5,100
324,3/02/2018 3:00,14,16,14,3,10,57,5,100
325,3/02/2018 3:05,7,19,11,4,13,54,5,100
326,3/02/2018 3:10,8,22,8,2,10,50,5,100
327,3/02/2018 3:15,9,15,14,7,10,55,5,100
328,3/02/2018 3:20,7,15,13,2,12,49,5,100
329,3/02/2018 3:25,9,13,15,3,10,50,5,100
330,3/02/2018 3:30,7,12,10,6,11,46,5,100
331,3/02/2018 3:35,7,12,16,5,17,57,5,100
332,3/02/2018 3:40,7,15,17,7,14,60,5,100
333,3/02/2018 3:45,10,19,20,12,13,74,5,100
334,3/02/2018 3:50,8,20,17,6,8,59,5,100
335,3/02/2018 3:55,12,10,11,7,15,55,5,100
336,3/02/2018 4:00,7,10,12,8,14,51,5,100
337,3/02/2018 4:05,14,18,19,7,10,68,5,100
338,3/02/2018 4:10,17,20,18,6,18,79,5,100
339,3/02/2018 4:15,12,17,14,8,14,65,5,100
340,3/02/2018 4:20,12,16,18,8,23,77,5,100
341,3/02/2018 4:25,15,21,26,11,16,89,5,100
342,3/02/2018 4:30,19,21,26,15,19,100,5,100
343,3/02/2018 4:35,23,32,27,11,21,114,5,100
344,3/02/2018 4:40,27,29,32,20,28,136,5,100
345,3/02/2018 4:45,31,40,31,10,32,144,5,100
346,3/02/2018 4:50,28,34,33,14,22,131,5,100
347,3/02/2018 4:55,28,27,33,18,18,124,5,100
348,3/02/2018 5:00,40,31,44,9,26,150,5,100
349,3/02/2018 5:05,25,31,39,18,24,137,5,100
350,3/02/2018 5:10,40,40,36,11,25,152,5,100
351,3/02/2018 5:15,36,32,44,14,26,152,5,100
352,3/02/2018 5:20,38,39,44,18,40,179,5,100
353,3/02/2018 5:25,49,45,51,17,34,196,5,100
354,3/02/2018 5:30,55,56,67,22,46,246,5,100
355,3/02/2018 5:35,56,40,57,26,36,215,5,100
356,3/02/2018 5:40,73,56,76,24,52,281,5,100
357,3/02/2018 5:45,72,64,66,38,43,283,5,100
358,3/02/2018 5:50,58,49,63,27,44,241,5,100
359,3/02/2018 5:55,65,62,68,29,49,273,5,100
360,3/02/2018 6:00,66,54,59,25,38,242,5,100
361,3/02/2018 6:05,82,61,83,31,54,311,5,100
362,3/02/2018 6:10,59,52,62,37,42,252,5,100
363,3/02/2018 6:15,79,59,80,38,48,304,5,100
364,3/02/2018 6:20,64,55,66,35,51,271,5,100
365,3/02/2018 6:25,96,70,84,38,48,336,5,100
366,3/02/2018 6:30,75,66,78,36,56,311,5,100
367,3/02/2018 6:35,97,77,90,42,57,363,5,100
368,3/02/2018 6:40,106,73,103,59,87,428,5,100
369,3/02/2018 6:45,97,70,92,53,67,379,5,100
370,3/02/2018 6:50,103,86,114,67,83,453,5,100
371,3/02/2018 6:55,89,66,92,49,86,382,5,100
372,3/02/2018 7:00,111,78,101,62,66,418,5,100
373,3/02/2018 7:05,104,85,88,37,70,384,5,100
374,3/02/2018 7:10,89,65,95,53,72,374,5,100
375,3/02/2018 7:15,146,99,121,41,97,504,5,100
376,3/02/2018 7:20,150,107,132,69,97,555,5,100
377,3/02/2018 7:25,142,115,122,59,86,524,5,100
378,3/02/2018 7:30,141,113,129,64,95,542,5,100
379,3/02/2018 7:35,151,108,131,78,89,557,5,100
380,3/02/2018 7:40,144,106,137,74,107,568,5,100
381,3/02/2018 7:45,138,104,122,72,82,518,5,100
382,3/02/2018 7:50,142,96,117,79,99,533,5,100
383,3/02/2018 7:55,133,93,128,80,98,532,5,100
384,3/02/2018 8:00,119,87,118,78,89,491,5,100
385,3/02/2018 8:05,114,109,113,85,74,495,5,100
386,3/02/2018 8:10,145,107,131,70,100,553,5,100
387,3/02/2018 8:15,126,102,106,88,99,521,5,100
388,3/02/2018 8:20,139,95,124,64,88,510,5,100
389,3/02/2018 8:25,117,100,119,53,80,469,5,100
390,3/02/2018 8:30,121,100,106,73,90,490,5,100
391,3/02/2018 8:35,132,107,126,60,85,510,5,100
392,3/02/2018 8:40,123,91,112,59,87,472,5,100
393,3/02/2018 8:45,131,88,106,79,87,491,5,100
394,3/02/2018 8:50,134,92,114,58,77,475,5,100
395,3/02/2018 8:55,117,94,105,61,86,463,5,100
396,3/02/2018 9:00,107,88,109,62,84,450,5,100
397,3/02/2018 9:05,120,77,108,59,80,444,5,100
398,3/02/2018 9:10,125,99,111,72,80,487,5,100
399,3/02/2018 9:15,111,96,110,60,74,451,5,100
400,3/02/2018 9:20,116,81,112,55,83,447,5,100
401,3/02/2018 9:25,106,99,112,68,81,466,5,100
402,3/02/2018 9:30,110,97,104,66,89,466,5,100
403,3/02/2018 9:35,110,89,101,71,73,444,5,100
404,3/02/2018 9:40,101,83,94,56,74,408,5,100
405,3/02/2018 9:45,107,80,103,61,90,441,5,100
406,3/02/2018 9:50,84,87,87,50,76,384,5,100
407,3/02/2018 9:55,104,82,86,60,75,407,5,100
408,3/02/2018 10:00,79,87,86,65,71,388,5,100
409,3/02/2018 10:05,121,104,108,57,86,476,5,100
410,3/02/2018 10:10,115,96,111,57,85,464,5,100
411,3/02/2018 10:15,106,107,105,56,76,450,5,100
412,3/02/2018 10:20,104,85,97,57,88,431,5,100
413,3/02/2018 10:25,110,86,104,64,79,443,5,100
414,3/02/2018 10:30,90,74,83,35,72,354,5,100
415,3/02/2018 10:35,99,88,95,45,71,398,5,100
416,3/02/2018 10:40,99,93,101,61,91,445,5,100
417,3/02/2018 10:45,94,84,105,54,70,407,5,100
418,3/02/2018 10:50,119,89,102,51,83,444,5,100
419,3/02/2018 10:55,119,89,115,51,86,460,5,100
420,3/02/2018 11:00,107,91,107,59,83,447,5,100
421,3/02/2018 11:05,110,78,105,50,65,408,5,100
422,3/02/2018 11:10,115,101,112,51,99,478,5,100
423,3/02/2018 11:15,103,91,114,51,74,433,5,100
424,3/02/2018 11:20,121,98,107,63,81,470,5,100
425,3/02/2018 11:25,139,102,115,66,84,506,5,100
426,3/02/2018 11:30,124,94,114,63,90,485,5,100
427,3/02/2018 11:35,113,93,112,64,75,457,5,100
428,3/02/2018 11:40,104,81,86,52,61,384,5,100
429,3/02/2018 11:45,101,93,114,64,79,451,5,100
430,3/02/2018 11:50,102,98,103,55,81,439,5,100
431,3/02/2018 11:55,95,80,99,56,74,404,5,100
432,3/02/2018 12:00,94,78,93,50,69,384,5,100
433,3/02/2018 12:05,98,88,75,62,74,397,5,100
434,3/02/2018 12:10,99,97,102,78,91,467,5,100
435,3/02/2018 12:15,61,74,74,46,69,324,5,100
436,3/02/2018 12:20,125,99,121,65,80,490,5,100
437,3/02/2018 12:25,114,103,119,58,78,472,5,100
438,3/02/2018 12:30,137,96,140,70,91,534,5,100
439,3/02/2018 12:35,137,93,118,51,97,496,5,100
440,3/02/2018 12:40,137,95,129,55,93,509,5,100
441,3/02/2018 12:45,141,98,123,72,104,538,5,100
442,3/02/2018 12:50,139,98,121,71,91,520,5,100
443,3/02/2018 12:55,129,99,114,58,93,493,5,100
444,3/02/2018 13:00,136,101,129,75,95,536,5,100
445,3/02/2018 13:05,129,96,111,71,101,508,5,100
446,3/02/2018 13:10,118,106,113,70,90,497,5,100
447,3/02/2018 13:15,129,95,123,71,92,510,5,100
448,3/02/2018 13:20,116,81,120,74,88,479,5,100
449,3/02/2018 13:25,105,77,114,76,75,447,5,100
450,3/02/2018 13:30,103,93,113,76,92,477,5,100
451,3/02/2018 13:35,102,82,103,73,76,436,5,100
452,3/02/2018 13:40,112,78,104,63,79,436,5,100
453,3/02/2018 13:45,98,83,91,74,84,430,5,100
454,3/02/2018 13:50,113,94,100,88,83,478,5,100
455,3/02/2018 13:55,97,77,89,83,65,411,5,100
456,3/02/2018 14:00,86,68,87,83,75,399,5,100
457,3/02/2018 14:05,90,79,85,94,86,434,5,100
458,3/02/2018 14:10,80,70,81,85,82,398,5,100
459,3/02/2018 14:15,94,90,96,115,93,488,5,100
460,3/02/2018 14:20,82,73,84,109,73,421,5,100
461,3/02/2018 14:25,80,75,79,88,85,407,5,100
462,3/02/2018 14:30,88,77,84,101,81,431,5,100
463,3/02/2018 14:35,92,88,95,118,88,481,5,100
464,3/02/2018 14:40,65,51,65,89,61,331,5,100
465,3/02/2018 14:45,76,66,75,108,86,411,5,100
466,3/02/2018 14:50,94,81,92,121,84,472,5,100
467,3/02/2018 14:55,88,66,79,97,74,404,5,100
468,3/02/2018 15:00,73,56,67,104,87,387,5,100
469,3/02/2018 15:05,82,58,70,98,74,382,5,100
470,3/02/2018 15:10,83,59,66,104,86,398,5,100
471,3/02/2018 15:15,103,90,93,107,85,478,5,100
472,3/02/2018 15:20,118,78,100,81,77,454,5,100
473,3/02/2018 15:25,91,88,94,84,79,436,5,100
474,3/02/2018 15:30,107,92,109,79,76,463,5,100
475,3/02/2018 15:35,82,72,86,88,70,398,5,100
476,3/02/2018 15:40,77,84,78,101,75,415,5,100
477,3/02/2018 15:45,80,78,78,86,71,393,5,100
478,3/02/2018 15:50,66,63,63,79,62,333,5,100
479,3/02/2018 15:55,70,56,60,98,70,354,5,100
480,3/02/2018 16:00,65,44,60,76,59,304,5,100
481,3/02/2018 16:05,79,64,76,88,67,374,5,100
482,3/02/2018 16:10,80,85,82,100,81,428,5,100
483,3/02/2018 16:15,81,68,77,80,65,371,5,100
484,3/02/2018 16:20,75,69,86,56,59,345,5,100
485,3/02/2018 16:25,84,65,90,74,64,377,5,100
486,3/02/2018 16:30,70,69,71,75,60,345,5,100
487,3/02/2018 16:35,67,70,77,81,66,361,5,100
488,3/02/2018 16:40,75,81,70,100,75,401,5,100
489,3/02/2018 16:45,84,81,75,82,76,398,5,100
490,3/02/2018 16:50,59,56,50,92,64,321,5,100
491,3/02/2018 16:55,77,69,62,106,75,389,5,100
492,3/02/2018 17:00,79,77,86,103,88,433,5,100
493,3/02/2018 17:05,88,80,90,112,72,442,5,100
494,3/02/2018 17:10,85,85,76,108,83,437,5,100
495,3/02/2018 17:15,84,79,80,117,87,447,5,100
496,3/02/2018 17:20,91,82,83,114,80,450,5,100
497,3/02/2018 17:25,93,88,97,97,75,450,5,100
498,3/02/2018 17:30,87,85,94,74,77,417,5,100
499,3/02/2018 17:35,91,78,87,77,81,414,5,100
500,3/02/2018 17:40,80,78,95,84,75,412,5,100
501,3/02/2018 17:45,87,77,97,87,71,419,5,100
502,3/02/2018 17:50,87,92,99,92,80,450,5,100
503,3/02/2018 17:55,82,85,87,85,84,423,5,100
504,3/02/2018 18:00,107,92,101,73,71,444,5,100
505,3/02/2018 18:05,101,84,101,72,76,434,5,100
506,3/02/2018 18:10,104,79,110,76,88,457,5,100
507,3/02/2018 18:15,113,88,107,51,62,421,5,100
508,3/02/2018 18:20,113,96,104,61,64,438,5,100
509,3/02/2018 18:25,109,92,113,76,88,478,5,100
510,3/02/2018 18:30,112,91,110,54,78,445,5,100
511,3/02/2018 18:35,113,89,103,71,86,462,5,100
512,3/02/2018 18:40,116,111,108,65,91,491,5,100
513,3/02/2018 18:45,126,100,106,63,82,477,5,100
514,3/02/2018 18:50,91,85,93,58,68,395,5,100
515,3/02/2018 18:55,113,89,110,69,88,469,5,100
516,3/02/2018 19:00,119,89,116,63,81,468,5,100
517,3/02/2018 19:05,109,84,111,74,80,458,5,100
518,3/02/2018 19:10,113,97,114,85,83,492,5,100
519,3/02/2018 19:15,119,75,99,84,86,463,5,100
520,3/02/2018 19:20,115,85,102,87,82,471,5,100
521,3/02/2018 19:25,117,102,116,72,97,504,5,100
522,3/02/2018 19:30,105,94,121,76,84,480,5,100
523,3/02/2018 19:35,127,111,129,66,97,530,5,100
524,3/02/2018 19:40,123,91,123,65,86,488,5,100
525,3/02/2018 19:45,135,94,122,68,71,490,5,100
526,3/02/2018 19:50,125,110,131,64,92,522,5,100
527,3/02/2018 19:55,118,105,127,64,87,501,5,100
528,3/02/2018 20:00,119,110,137,56,101,523,5,100
529,3/02/2018 20:05,134,93,121,47,97,492,5,100
530,3/02/2018 20:10,125,85,107,46,77,440,5,100
531,3/02/2018 20:15,131,100,127,37,95,490,5,100
532,3/02/2018 20:20,115,90,104,42,74,425,5,100
533,3/02/2018 20:25,136,99,113,55,87,490,5,100
534,3/02/2018 20:30,109,86,114,59,84,452,5,100
535,3/02/2018 20:35,124,91,126,38,72,451,5,100
536,3/02/2018 20:40,117,90,109,60,77,453,5,100
537,3/02/2018 20:45,112,81,105,38,64,400,5,100
538,3/02/2018 20:50,99,86,111,50,70,416,5,100
539,3/02/2018 20:55,108,83,91,51,77,410,5,100
540,3/02/2018 21:00,94,80,92,42,63,371,5,100
541,3/02/2018 21:05,84,76,97,32,68,357,5,100
542,3/02/2018 21:10,90,76,88,44,58,356,5,100
543,3/02/2018 21:15,92,77,87,34,83,373,5,100
544,3/02/2018 21:20,107,71,97,37,62,374,5,100
545,3/02/2018 21:25,91,66,85,50,68,360,5,100
546,3/02/2018 21:30,91,71,94,36,61,353,5,100
547,3/02/2018 21:35,91,70,87,42,66,356,5,100
548,3/02/2018 21:40,85,66,93,34,53,331,5,100
549,3/02/2018 21:45,105,83,96,40,67,391,5,100
550,3/02/2018 21:50,92,72,84,36,56,340,5,100
551,3/02/2018 21:55,101,58,83,24,65,331,5,100
552,3/02/2018 22:00,85,74,78,36,55,328,5,100
553,3/02/2018 22:05,81,68,83,32,59,323,5,100
554,3/02/2018 22:10,90,70,85,34,59,338,5,100
555,3/02/2018 22:15,73,62,76,29,56,296,5,100
556,3/02/2018 22:20,81,60,87,35,53,316,5,100
557,3/02/2018 22:25,73,62,96,44,61,336,5,100
558,3/02/2018 22:30,77,58,72,33,51,291,5,100
559,3/02/2018 22:35,80,64,71,28,52,295,5,100
560,3/02/2018 22:40,73,74,78,20,49,294,5,100
561,3/02/2018 22:45,78,70,78,32,49,307,5,100
562,3/02/2018 22:50,84,62,74,35,53,308,5,100
563,3/02/2018 22:55,69,67,75,30,50,291,5,100
564,3/02/2018 23:00,59,46,62,31,50,248,5,100
565,3/02/2018 23:05,68,51,77,33,45,274,5,100
566,3/02/2018 23:10,73,67,74,35,44,293,5,100
567,3/02/2018 23:15,69,67,73,28,59,296,5,100
568,3/02/2018 23:20,55,50,53,31,47,236,5,100
569,3/02/2018 23:25,71,67,78,39,57,312,5,100
570,3/02/2018 23:30,71,65,68,36,50,290,5,100
571,3/02/2018 23:35,48,58,58,30,43,237,5,100
572,3/02/2018 23:40,51,67,64,36,62,280,5,100
573,3/02/2018 23:45,55,56,48,25,44,228,5,100
574,3/02/2018 23:50,58,56,59,23,56,252,5,100
575,3/02/2018 23:55,41,47,46,18,27,179,5,100
576,3/03/2018 0:00,30,56,53,23,39,201,5,100
577,3/03/2018 0:05,41,47,48,30,38,204,5,100
578,3/03/2018 0:10,47,46,46,29,48,216,5,100
579,3/03/2018 0:15,38,45,47,19,37,186,5,100
580,3/03/2018 0:20,38,42,47,30,38,195,5,100
581,3/03/2018 0:25,28,49,49,17,36,179,5,100
582,3/03/2018 0:30,30,38,46,21,33,168,5,100
583,3/03/2018 0:35,40,42,38,26,39,185,5,100
584,3/03/2018 0:40,34,36,40,18,28,156,5,100
585,3/03/2018 0:45,46,46,41,15,33,181,5,100
586,3/03/2018 0:50,29,40,48,17,34,168,5,100
587,3/03/2018 0:55,25,28,37,17,31,138,5,100
588,3/03/2018 1:00,30,34,33,13,38,148,5,100
589,3/03/2018 1:05,27,33,36,14,36,146,5,100
590,3/03/2018 1:10,25,28,42,14,32,141,5,100
591,3/03/2018 1:15,24,26,26,17,28,121,5,100
592,3/03/2018 1:20,17,27,28,12,36,120,5,100
593,3/03/2018 1:25,23,31,31,15,24,124,5,100
594,3/03/2018 1:30,19,24,31,12,27,113,5,100
595,3/03/2018 1:35,20,25,34,15,24,118,5,100
596,3/03/2018 1:40,29,25,35,16,23,128,5,100
597,3/03/2018 1:45,18,27,32,7,22,106,5,100
598,3/03/2018 1:50,21,22,22,12,21,98,5,100
599,3/03/2018 1:55,24,30,28,10,21,113,5,100
600,3/03/2018 2:00,14,19,29,15,17,94,5,100
601,3/03/2018 2:05,17,21,27,11,13,89,5,100
602,3/03/2018 2:10,17,26,35,12,17,107,5,100
603,3/03/2018 2:15,18,20,23,6,16,83,5,100
604,3/03/2018 2:20,24,28,25,10,15,102,5,100
605,3/03/2018 2:25,20,26,31,13,21,111,5,100
606,3/03/2018 2:30,13,24,25,10,19,91,5,100
607,3/03/2018 2:35,23,22,32,7,19,103,5,100
608,3/03/2018 2:40,6,21,16,4,12,59,5,100
609,3/03/2018 2:45,19,23,22,12,16,92,5,100
610,3/03/2018 2:50,12,16,18,5,10,61,5,100
611,3/03/2018 2:55,10,20,19,12,14,75,5,100
612,3/03/2018 3:00,14,21,23,4,19,81,5,100
613,3/03/2018 3:05,12,16,16,5,10,59,5,100
614,3/03/2018 3:10,9,13,20,10,7,59,5,100
615,3/03/2018 3:15,14,23,18,6,13,74,5,100
616,3/03/2018 3:20,9,19,21,6,11,66,5,100
617,3/03/2018 3:25,11,13,18,6,11,59,5,100
618,3/03/2018 3:30,14,20,23,10,21,88,5,100
619,3/03/2018 3:35,12,26,22,8,17,85,5,100
620,3/03/2018 3:40,9,16,8,6,15,54,5,100
621,3/03/2018 3:45,7,16,8,4,14,49,5,100
622,3/03/2018 3:50,13,16,16,7,14,66,5,100
623,3/03/2018 3:55,7,8,20,3,13,51,5,100
624,3/03/2018 4:00,5,8,15,5,11,44,5,100
625,3/03/2018 4:05,7,16,13,5,12,53,5,100
626,3/03/2018 4:10,6,8,14,8,12,48,5,100
627,3/03/2018 4:15,8,13,16,5,10,52,5,100
628,3/03/2018 4:20,7,16,19,10,13,65,5,100
629,3/03/2018 4:25,10,14,18,4,10,56,5,100
630,3/03/2018 4:30,10,17,11,4,14,56,5,100
631,3/03/2018 4:35,8,24,16,10,13,71,5,100
632,3/03/2018 4:40,14,22,17,14,18,85,5,100
633,3/03/2018 4:45,8,17,22,12,24,83,5,100
634,3/03/2018 4:50,16,24,24,8,25,97,5,100
635,3/03/2018 4:55,13,23,15,12,14,77,5,100
636,3/03/2018 5:00,15,22,21,6,15,79,5,100
637,3/03/2018 5:05,16,26,15,8,23,88,5,100
638,3/03/2018 5:10,19,22,21,11,25,98,5,100
639,3/03/2018 5:15,19,22,22,9,23,95,5,100
640,3/03/2018 5:20,14,30,27,13,25,109,5,100
641,3/03/2018 5:25,17,22,31,9,15,94,5,100
642,3/03/2018 5:30,22,21,27,15,24,109,5,100
643,3/03/2018 5:35,35,34,34,19,26,148,5,100
644,3/03/2018 5:40,25,29,31,17,25,127,5,100
645,3/03/2018 5:45,31,35,28,17,20,131,5,100
646,3/03/2018 5:50,24,33,36,14,27,134,5,100
647,3/03/2018 5:55,29,28,27,17,24,125,5,100
648,3/03/2018 6:00,28,32,32,18,22,132,5,100
649,3/03/2018 6:05,27,32,41,13,33,146,5,100
650,3/03/2018 6:10,31,31,38,20,33,153,5,100
651,3/03/2018 6:15,39,36,43,17,38,173,5,100
652,3/03/2018 6:20,40,47,43,23,40,193,5,100
653,3/03/2018 6:25,45,37,52,17,32,183,5,100
654,3/03/2018 6:30,53,50,57,25,33,218,5,100
655,3/03/2018 6:35,43,46,47,20,26,182,5,100
656,3/03/2018 6:40,52,42,54,32,53,233,5,100
657,3/03/2018 6:45,51,44,49,28,56,228,5,100
658,3/03/2018 6:50,61,57,67,28,54,267,5,100
659,3/03/2018 6:55,54,53,66,16,36,225,5,100
660,3/03/2018 7:00,51,53,70,26,46,246,5,100
661,3/03/2018 7:05,47,54,76,20,44,241,5,100
662,3/03/2018 7:10,60,44,68,34,52,258,5,100
663,3/03/2018 7:15,70,63,72,34,50,289,5,100
664,3/03/2018 7:20,70,73,83,36,51,313,5,100
665,3/03/2018 7:25,57,58,79,33,52,279,5,100
666,3/03/2018 7:30,80,54,78,31,55,298,5,100
667,3/03/2018 7:35,92,76,85,42,55,350,5,100
668,3/03/2018 7:40,103,81,91,40,65,380,5,100
669,3/03/2018 7:45,96,74,91,47,63,371,5,100
670,3/03/2018 7:50,93,77,91,38,76,375,5,100
671,3/03/2018 7:55,93,67,85,37,68,350,5,100
672,3/03/2018 8:00,81,64,90,38,57,330,5,100
673,3/03/2018 8:05,92,82,83,53,67,377,5,100
674,3/03/2018 8:10,80,63,95,27,57,322,5,100
675,3/03/2018 8:15,95,81,93,29,73,371,5,100
676,3/03/2018 8:20,98,76,100,51,76,401,5,100
677,3/03/2018 8:25,76,76,102,43,66,363,5,100
678,3/03/2018 8:30,105,91,113,36,67,412,5,100
679,3/03/2018 8:35,105,80,92,43,67,387,5,100
680,3/03/2018 8:40,93,84,96,42,70,385,5,100
681,3/03/2018 8:45,99,84,97,47,80,407,5,100
682,3/03/2018 8:50,84,69,89,40,77,359,5,100
683,3/03/2018 8:55,89,77,82,43,69,360,5,100
684,3/03/2018 9:00,104,100,107,50,90,451,5,100
685,3/03/2018 9:05,90,81,86,47,72,376,5,100
686,3/03/2018 9:10,110,84,99,44,75,412,5,100
687,3/03/2018 9:15,98,101,111,44,78,432,5,100
688,3/03/2018 9:20,120,88,123,48,82,461,5,100
689,3/03/2018 9:25,122,101,112,56,93,484,5,100
690,3/03/2018 9:30,125,96,117,51,90,479,5,100
691,3/03/2018 9:35,140,106,122,47,99,514,5,100
692,3/03/2018 9:40,123,108,124,40,99,494,5,100
693,3/03/2018 9:45,136,108,130,59,89,522,5,100
694,3/03/2018 9:50,138,98,122,61,81,500,5,100
695,3/03/2018 9:55,146,108,116,60,93,523,5,100
696,3/03/2018 10:00,133,119,117,47,79,495,5,100
697,3/03/2018 10:05,139,101,119,39,83,481,5,100
698,3/03/2018 10:10,139,113,120,57,100,529,5,100
699,3/03/2018 10:15,148,99,135,54,98,534,5,100
700,3/03/2018 10:20,150,114,138,44,101,547,5,100
701,3/03/2018 10:25,146,106,136,52,98,538,5,100
702,3/03/2018 10:30,151,109,125,59,78,522,5,100
703,3/03/2018 10:35,148,106,127,66,89,536,5,100
704,3/03/2018 10:40,124,111,123,67,97,522,5,100
705,3/03/2018 10:45,151,104,143,54,96,548,5,100
706,3/03/2018 10:50,154,111,133,60,82,540,5,100
707,3/03/2018 10:55,126,101,128,49,92,496,5,100
708,3/03/2018 11:00,121,105,123,52,100,501,5,100
709,3/03/2018 11:05,133,103,125,49,93,503,5,100
710,3/03/2018 11:10,138,106,130,53,104,531,5,100
711,3/03/2018 11:15,125,108,121,58,93,505,5,100
712,3/03/2018 11:20,123,116,135,54,97,525,5,100
713,3/03/2018 11:25,152,117,130,56,84,539,5,100
714,3/03/2018 11:30,149,111,151,58,109,578,5,100
715,3/03/2018 11:35,143,109,133,62,107,554,5,100
716,3/03/2018 11:40,153,124,141,60,103,581,5,100
717,3/03/2018 11:45,147,106,130,62,87,532,5,100
718,3/03/2018 11:50,138,102,125,58,94,517,5,100
719,3/03/2018 11:55,139,112,134,66,79,530,5,100
720,3/03/2018 12:00,131,100,131,66,94,522,5,100
721,3/03/2018 12:05,121,93,111,52,84,461,5,100
722,3/03/2018 12:10,103,104,121,61,83,472,5,100
723,3/03/2018 12:15,121,83,115,66,88,473,5,100
724,3/03/2018 12:20,115,112,120,64,95,506,5,100
725,3/03/2018 12:25,134,106,105,62,86,493,5,100
726,3/03/2018 12:30,127,105,125,61,95,513,5,100
727,3/03/2018 12:35,144,103,125,61,98,531,5,100
728,3/03/2018 12:40,132,122,134,68,98,554,5,100
729,3/03/2018 12:45,140,115,141,71,99,566,5,100
730,3/03/2018 12:50,137,117,144,65,107,570,5,100
731,3/03/2018 12:55,135,125,132,60,98,550,5,100
732,3/03/2018 13:00,142,112,131,63,94,542,5,100
733,3/03/2018 13:05,125,104,131,62,99,521,5,100
734,3/03/2018 13:10,128,111,144,68,93,544,5,100
735,3/03/2018 13:15,135,112,128,59,102,536,5,100
736,3/03/2018 13:20,137,115,131,54,102,539,5,100
737,3/03/2018 13:25,149,89,134,68,103,543,5,100
738,3/03/2018 13:30,137,121,132,65,109,564,5,100
739,3/03/2018 13:35,133,94,130,66,94,517,5,100
740,3/03/2018 13:40,149,124,124,79,106,582,5,100
741,3/03/2018 13:45,127,106,141,73,91,538,5,100
742,3/03/2018 13:50,141,120,136,69,101,567,5,100
743,3/03/2018 13:55,140,105,136,70,101,552,5,100
744,3/03/2018 14:00,135,108,132,69,105,549,5,100
745,3/03/2018 14:05,144,118,122,68,96,548,5,100
746,3/03/2018 14:10,143,101,118,71,84,517,5,100
747,3/03/2018 14:15,156,117,140,63,94,570,5,100
748,3/03/2018 14:20,132,113,122,46,75,488,5,100
749,3/03/2018 14:25,133,110,126,63,88,520,5,100
750,3/03/2018 14:30,143,112,142,53,96,546,5,100
751,3/03/2018 14:35,124,105,114,64,84,491,5,100
752,3/03/2018 14:40,154,108,121,73,98,554,5,100
753,3/03/2018 14:45,130,106,136,63,92,527,5,100
754,3/03/2018 14:50,137,113,146,66,88,550,5,100
755,3/03/2018 14:55,133,110,129,67,108,547,5,100
756,3/03/2018 15:00,145,113,139,69,95,561,5,100
757,3/03/2018 15:05,143,109,135,68,111,566,5,100
758,3/03/2018 15:10,125,114,123,69,90,521,5,100
759,3/03/2018 15:15,116,110,118,53,88,485,5,100
760,3/03/2018 15:20,129,124,125,67,105,550,5,100
761,3/03/2018 15:25,132,106,119,58,104,519,5,100
762,3/03/2018 15:30,129,111,132,67,97,536,5,100
763,3/03/2018 15:35,124,104,131,57,94,510,5,100
764,3/03/2018 15:40,129,97,136,69,102,533,5,100
765,3/03/2018 15:45,148,102,132,62,88,532,5,100
766,3/03/2018 15:50,138,112,113,59,94,516,5,100
767,3/03/2018 15:55,124,122,120,58,87,511,5,100
768,3/03/2018 16:00,138,111,130,72,87,538,5,100
769,3/03/2018 16:05,125,106,126,48,86,491,5,100
770,3/03/2018 16:10,130,105,118,62,100,515,5,100
771,3/03/2018 16:15,125,110,134,59,100,528,5,100
772,3/03/2018 16:20,117,114,126,48,85,490,5,100
773,3/03/2018 16:25,137,101,126,64,90,518,5,100
774,3/03/2018 16:30,133,113,140,71,84,541,5,100
775,3/03/2018 16:35,139,103,131,55,89,517,5,100
776,3/03/2018 16:40,143,106,139,66,107,561,5,100
777,3/03/2018 16:45,140,110,132,65,108,555,5,100
778,3/03/2018 16:50,150,112,129,62,70,523,5,100
779,3/03/2018 16:55,135,108,118,59,84,504,5,100
780,3/03/2018 17:00,123,93,118,68,95,497,5,100
781,3/03/2018 17:05,127,107,128,60,88,510,5,100
782,3/03/2018 17:10,125,106,119,54,94,498,5,100
783,3/03/2018 17:15,138,106,126,72,85,527,5,100
784,3/03/2018 17:20,125,95,113,62,96,491,5,100
785,3/03/2018 17:25,127,103,128,62,101,521,5,100
786,3/03/2018 17:30,129,102,128,75,86,520,5,100
787,3/03/2018 17:35,148,109,128,54,95,534,5,100
788,3/03/2018 17:40,126,100,127,59,89,501,5,100
789,3/03/2018 17:45,132,112,132,53,86,515,5,100
790,3/03/2018 17:50,132,107,120,65,91,515,5,100
791,3/03/2018 17:55,138,107,126,57,91,519,5,100
792,3/03/2018 18:00,132,101,126,63,87,509,5,100
793,3/03/2018 18:05,123,88,125,50,74,460,5,100
794,3/03/2018 18:10,116,99,113,57,76,461,5,100
795,3/03/2018 18:15,113,95,99,47,77,431,5,100
796,3/03/2018 18:20,118,91,110,53,78,450,5,100
797,3/03/2018 18:25,117,97,113,57,68,452,5,100
798,3/03/2018 18:30,130,92,112,37,79,450,5,100
799,3/03/2018 18:35,104,92,96,46,82,420,5,100
800,3/03/2018 18:40,123,106,117,64,79,489,5,100
801,3/03/2018 18:45,133,111,116,56,86,502,5,100
802,3/03/2018 18:50,117,111,109,54,86,477,5,100
803,3/03/2018 18:55,116,104,112,48,80,460,5,100
804,3/03/2018 19:00,108,82,109,44,60,403,5,100
805,3/03/2018 19:05,112,92,100,36,69,409,5,100
806,3/03/2018 19:10,96,97,100,39,67,399,5,100
807,3/03/2018 19:15,104,88,105,33,70,400,5,100
808,3/03/2018 19:20,112,85,102,53,74,426,5,100
809,3/03/2018 19:25,102,77,111,48,66,404,5,100
810,3/03/2018 19:30,96,84,104,31,75,390,5,100
811,3/03/2018 19:35,88,81,106,34,77,386,5,100
812,3/03/2018 19:40,102,86,108,46,77,419,5,100
813,3/03/2018 19:45,102,77,85,45,60,369,5,100
814,3/03/2018 19:50,113,87,101,55,70,426,5,100
815,3/03/2018 19:55,93,90,100,36,68,387,5,100
816,3/03/2018 20:00,113,75,114,46,72,420,5,100
817,3/03/2018 20:05,97,77,95,43,64,376,5,100
818,3/03/2018 20:10,100,79,99,36,61,375,5,100
819,3/03/2018 20:15,95,83,99,42,75,394,5,100
820,3/03/2018 20:20,91,78,91,45,62,367,5,100
821,3/03/2018 20:25,106,82,91,39,63,381,5,100
822,3/03/2018 20:30,85,68,70,29,54,306,5,100
823,3/03/2018 20:35,92,68,94,38,57,349,5,100
824,3/03/2018 20:40,82,80,78,25,43,308,5,100
825,3/03/2018 20:45,84,81,85,48,61,359,5,100
826,3/03/2018 20:50,87,77,89,39,52,344,5,100
827,3/03/2018 20:55,91,73,92,44,65,365,5,100
828,3/03/2018 21:00,70,62,73,28,54,287,5,100
829,3/03/2018 21:05,82,73,84,25,53,317,5,100
830,3/03/2018 21:10,70,60,84,36,62,312,5,100
831,3/03/2018 21:15,84,67,102,43,68,364,5,100
832,3/03/2018 21:20,84,77,85,39,60,345,5,100
833,3/03/2018 21:25,83,71,88,31,68,341,5,100
834,3/03/2018 21:30,106,81,98,40,58,383,5,100
835,3/03/2018 21:35,98,80,88,21,63,350,5,100
836,3/03/2018 21:40,65,74,87,47,55,328,5,100
837,3/03/2018 21:45,85,77,90,39,64,355,5,100
838,3/03/2018 21:50,77,68,91,31,50,317,5,100
839,3/03/2018 21:55,80,68,77,34,49,308,5,100
840,3/03/2018 22:00,67,65,78,32,55,297,5,100
841,3/03/2018 22:05,83,73,96,34,62,348,5,100
842,3/03/2018 22:10,82,70,88,33,62,335,5,100
843,3/03/2018 22:15,85,73,86,41,59,344,5,100
844,3/03/2018 22:20,71,80,77,40,55,323,5,100
845,3/03/2018 22:25,75,73,89,42,55,334,5,100
846,3/03/2018 22:30,76,75,79,30,59,319,5,100
847,3/03/2018 22:35,77,66,92,29,67,331,5,100
848,3/03/2018 22:40,75,64,88,29,51,307,5,100
849,3/03/2018 22:45,71,69,86,33,50,309,5,100
850,3/03/2018 22:50,63,59,82,32,64,300,5,100
851,3/03/2018 22:55,84,61,85,27,55,312,5,100
852,3/03/2018 23:00,77,61,75,26,52,291,5,100
853,3/03/2018 23:05,63,56,68,24,51,262,5,100
854,3/03/2018 23:10,52,57,73,34,48,264,5,100
855,3/03/2018 23:15,60,54,75,27,48,264,5,100
856,3/03/2018 23:20,72,63,68,37,53,293,5,100
857,3/03/2018 23:25,63,54,70,29,57,273,5,100
858,3/03/2018 23:30,53,49,69,27,54,252,5,100
859,3/03/2018 23:35,61,56,69,21,60,267,5,100
860,3/03/2018 23:40,66,55,64,25,46,256,5,100
861,3/03/2018 23:45,63,62,71,30,47,273,5,100
862,3/03/2018 23:50,57,53,66,27,41,244,5,100
863,3/03/2018 23:55,55,56,54,31,41,237,5,100
864,3/04/2018 0:00,43,43,56,19,39,200,5,100
865,3/04/2018 0:05,51,41,53,31,34,210,5,100
866,3/04/2018 0:10,45,49,59,28,36,217,5,100
867,3/04/2018 0:15,41,44,55,20,44,204,5,100
868,3/04/2018 0:20,46,33,53,15,26,173,5,100
869,3/04/2018 0:25,41,37,52,23,46,199,5,100
870,3/04/2018 0:30,37,42,53,12,33,177,5,100
871,3/04/2018 0:35,27,46,54,22,38,187,5,100
872,3/04/2018 0:40,43,38,44,14,41,180,5,100
873,3/04/2018 0:45,32,36,47,21,34,170,5,100
874,3/04/2018 0:50,36,53,47,28,36,200,5,100
875,3/04/2018 0:55,26,33,44,14,24,141,5,100
876,3/04/2018 1:00,29,47,40,19,35,170,5,100
877,3/04/2018 1:05,30,34,41,27,43,175,5,100
878,3/04/2018 1:10,26,37,30,16,34,143,5,100
879,3/04/2018 1:15,27,26,38,24,25,140,5,100
880,3/04/2018 1:20,24,28,37,17,22,128,5,100
881,3/04/2018 1:25,28,34,40,11,25,138,5,100
882,3/04/2018 1:30,22,33,39,6,24,124,5,100
883,3/04/2018 1:35,28,31,39,12,17,127,5,100
884,3/04/2018 1:40,24,26,28,13,22,113,5,100
885,3/04/2018 1:45,22,38,30,16,20,126,5,100
886,3/04/2018 1:50,18,24,28,13,21,104,5,100
887,3/04/2018 1:55,24,27,29,16,28,124,5,100
888,3/04/2018 2:00,22,26,43,9,22,122,5,100
889,3/04/2018 2:05,16,15,23,15,17,86,5,100
890,3/04/2018 2:10,18,31,28,13,22,112,5,100
891,3/04/2018 2:15,18,29,26,8,13,94,5,100
892,3/04/2018 2:20,23,34,29,10,20,116,5,100
893,3/04/2018 2:25,15,21,20,6,12,74,5,100
894,3/04/2018 2:30,20,21,26,12,18,97,5,100
895,3/04/2018 2:35,12,18,27,8,18,83,5,100
896,3/04/2018 2:40,12,21,23,9,17,82,5,100
897,3/04/2018 2:45,17,24,19,14,16,90,5,100
898,3/04/2018 2:50,10,18,23,6,8,65,5,100
899,3/04/2018 2:55,13,25,17,5,17,77,5,100
900,3/04/2018 3:00,19,20,20,4,18,81,5,100
901,3/04/2018 3:05,12,11,18,4,16,61,5,100
902,3/04/2018 3:10,21,19,24,11,12,87,5,100
903,3/04/2018 3:15,11,13,19,6,11,60,5,100
904,3/04/2018 3:20,14,17,12,8,15,66,5,100
905,3/04/2018 3:25,12,22,13,5,11,63,5,100
906,3/04/2018 3:30,10,18,22,5,13,68,5,100
907,3/04/2018 3:35,6,14,12,9,15,56,5,100
908,3/04/2018 3:40,13,17,21,10,16,77,5,100
909,3/04/2018 3:45,8,17,14,4,9,52,5,100
910,3/04/2018 3:50,7,19,10,11,12,59,5,100
911,3/04/2018 3:55,4,10,10,6,14,44,5,100
912,3/04/2018 4:00,3,15,12,7,5,42,5,100
913,3/04/2018 4:05,2,8,7,6,12,35,5,100
914,3/04/2018 4:10,11,12,14,7,13,57,5,100
915,3/04/2018 4:15,10,22,21,4,14,71,5,100
916,3/04/2018 4:20,7,10,10,1,14,42,5,100
917,3/04/2018 4:25,6,12,11,7,18,54,5,100
918,3/04/2018 4:30,9,13,10,5,15,52,5,100
919,3/04/2018 4:35,9,18,10,7,19,63,5,100
920,3/04/2018 4:40,7,12,11,5,16,51,5,100
921,3/04/2018 4:45,9,19,18,13,20,79,5,100
922,3/04/2018 4:50,13,9,11,10,14,57,5,100
923,3/04/2018 4:55,6,10,12,5,14,47,5,100
924,3/04/2018 5:00,9,10,13,8,13,53,5,100
925,3/04/2018 5:05,10,16,19,13,14,72,5,100
926,3/04/2018 5:10,7,12,14,14,16,63,5,100
927,3/04/2018 5:15,15,18,17,5,28,83,5,100
928,3/04/2018 5:20,6,19,15,5,21,66,5,100
929,3/04/2018 5:25,9,17,19,11,20,76,5,100
930,3/04/2018 5:30,11,18,24,8,22,83,5,100
931,3/04/2018 5:35,14,25,25,13,18,95,5,100
932,3/04/2018 5:40,15,25,23,9,19,91,5,100
933,3/04/2018 5:45,14,28,29,8,34,113,5,100
934,3/04/2018 5:50,23,25,26,5,28,107,5,100
935,3/04/2018 5:55,22,33,24,12,18,109,5,100
936,3/04/2018 6:00,22,28,23,11,26,110,5,100
937,3/04/2018 6:05,18,20,27,9,19,93,5,100
938,3/04/2018 6:10,18,25,18,14,17,92,5,100
939,3/04/2018 6:15,29,27,30,17,20,123,5,100
940,3/04/2018 6:20,21,27,30,7,21,106,5,100
941,3/04/2018 6:25,24,20,36,21,33,134,5,100
942,3/04/2018 6:30,29,36,44,15,32,156,5,100
943,3/04/2018 6:35,24,22,38,20,21,125,5,100
944,3/04/2018 6:40,35,30,41,17,21,144,5,100
945,3/04/2018 6:45,24,36,36,18,26,140,5,100
946,3/04/2018 6:50,21,31,34,13,23,122,5,100
947,3/04/2018 6:55,34,27,44,15,31,151,5,100
948,3/04/2018 7:00,31,35,42,14,33,155,5,100
949,3/04/2018 7:05,42,37,47,12,33,171,5,100
950,3/04/2018 7:10,39,34,60,14,46,193,5,100
951,3/04/2018 7:15,42,35,48,24,37,186,5,100
952,3/04/2018 7:20,37,43,56,15,41,192,5,100
953,3/04/2018 7:25,40,44,51,16,34,185,5,100
954,3/04/2018 7:30,49,41,57,18,46,211,5,100
955,3/04/2018 7:35,53,58,64,23,36,234,5,100
956,3/04/2018 7:40,52,50,64,22,34,222,5,100
957,3/04/2018 7:45,56,43,55,22,49,225,5,100
958,3/04/2018 7:50,58,59,72,27,39,255,5,100
959,3/04/2018 7:55,50,50,62,26,47,235,5,100
960,3/04/2018 8:00,61,50,58,31,48,248,5,100
961,3/04/2018 8:05,66,61,66,22,55,270,5,100
962,3/04/2018 8:10,62,45,66,23,44,240,5,100
963,3/04/2018 8:15,41,48,61,27,49,226,5,100
964,3/04/2018 8:20,69,59,69,30,53,280,5,100
965,3/04/2018 8:25,73,65,78,21,55,292,5,100
966,3/04/2018 8:30,75,67,74,19,64,299,5,100
967,3/04/2018 8:35,67,56,78,33,53,287,5,100
968,3/04/2018 8:40,67,67,86,27,62,309,5,100
969,3/04/2018 8:45,68,70,86,31,61,316,5,100
970,3/04/2018 8:50,82,64,79,31,54,310,5,100
971,3/04/2018 8:55,80,74,90,36,50,330,5,100
972,3/04/2018 9:00,88,71,84,32,62,337,5,100
973,3/04/2018 9:05,77,69,81,29,62,318,5,100
974,3/04/2018 9:10,81,73,84,35,68,341,5,100
975,3/04/2018 9:15,93,78,105,30,54,360,5,100
976,3/04/2018 9:20,89,72,93,42,59,355,5,100
977,3/04/2018 9:25,91,78,97,34,57,357,5,100
978,3/04/2018 9:30,93,93,97,30,70,383,5,100
979,3/04/2018 9:35,106,85,103,37,70,401,5,100
980,3/04/2018 9:40,91,81,111,36,80,399,5,100
981,3/04/2018 9:45,106,84,106,37,79,412,5,100
982,3/04/2018 9:50,101,85,113,45,73,417,5,100
983,3/04/2018 9:55,109,87,116,45,76,433,5,100
984,3/04/2018 10:00,102,95,107,47,78,429,5,100
985,3/04/2018 10:05,102,91,105,41,64,403,5,100
986,3/04/2018 10:10,121,82,109,38,74,424,5,100
987,3/04/2018 10:15,120,96,118,55,71,460,5,100
988,3/04/2018 10:20,122,95,132,39,79,467,5,100
989,3/04/2018 10:25,133,101,123,44,91,492,5,100
990,3/04/2018 10:30,119,115,122,33,96,485,5,100
991,3/04/2018 10:35,109,95,118,53,73,448,5,100
992,3/04/2018 10:40,129,125,137,55,87,533,5,100
993,3/04/2018 10:45,126,95,129,42,88,480,5,100
994,3/04/2018 10:50,124,97,112,41,104,478,5,100
995,3/04/2018 10:55,111,93,112,63,91,470,5,100
996,3/04/2018 11:00,130,101,128,53,87,499,5,100
997,3/04/2018 11:05,119,94,111,51,80,455,5,100
998,3/04/2018 11:10,128,106,131,46,90,501,5,100
999,3/04/2018 11:15,134,96,119,59,86,494,5,100
1000,3/04/2018 11:20,126,92,124,56,77,475,5,100
1001,3/04/2018 11:25,127,110,113,50,91,491,5,100
1002,3/04/2018 11:30,136,108,128,52,105,529,5,100
1003,3/04/2018 11:35,121,104,138,51,80,494,5,100
1004,3/04/2018 11:40,143,102,138,52,90,525,5,100
1005,3/04/2018 11:45,133,106,133,51,96,519,5,100
1006,3/04/2018 11:50,125,109,125,48,104,511,5,100
1007,3/04/2018 11:55,126,109,132,48,92,507,5,100
1008,3/04/2018 12:00,121,107,123,59,95,505,5,100
1009,3/04/2018 12:05,129,107,119,41,92,488,5,100
1010,3/04/2018 12:10,130,105,118,49,90,492,5,100
1011,3/04/2018 12:15,121,120,138,38,102,519,5,100
1012,3/04/2018 12:20,139,104,124,38,81,486,5,100
1013,3/04/2018 12:25,141,118,132,63,102,556,5,100
1014,3/04/2018 12:30,134,110,141,63,99,547,5,100
1015,3/04/2018 12:35,147,116,137,62,109,571,5,100
1016,3/04/2018 12:40,160,138,129,60,108,595,5,100
1017,3/04/2018 12:45,141,105,136,63,104,549,5,100
1018,3/04/2018 12:50,148,116,140,64,99,567,5,100
1019,3/04/2018 12:55,129,122,137,72,100,560,5,100
1020,3/04/2018 13:00,134,110,125,53,101,523,5,100
1021,3/04/2018 13:05,131,106,123,50,102,512,5,100
1022,3/04/2018 13:10,146,106,136,62,106,556,5,100
1023,3/04/2018 13:15,138,107,127,59,93,524,5,100
1024,3/04/2018 13:20,153,109,135,54,89,540,5,100
1025,3/04/2018 13:25,129,107,129,66,102,533,5,100
1026,3/04/2018 13:30,139,115,141,52,109,556,5,100
1027,3/04/2018 13:35,141,113,123,53,91,521,5,100
1028,3/04/2018 13:40,126,117,127,64,99,533,5,100
1029,3/04/2018 13:45,133,106,133,63,103,538,5,100
1030,3/04/2018 13:50,138,120,136,66,90,550,5,100
1031,3/04/2018 13:55,135,118,120,54,88,515,5,100
1032,3/04/2018 14:00,133,117,128,66,94,538,5,100
1033,3/04/2018 14:05,133,104,130,60,95,522,5,100
1034,3/04/2018 14:10,115,94,116,59,98,482,5,100
1035,3/04/2018 14:15,136,106,134,43,99,518,5,100
1036,3/04/2018 14:20,127,107,116,47,90,487,5,100
1037,3/04/2018 14:25,134,105,130,52,91,512,5,100
1038,3/04/2018 14:30,129,98,125,49,84,485,5,100
1039,3/04/2018 14:35,117,93,111,53,69,443,5,100
1040,3/04/2018 14:40,118,118,114,65,98,513,5,100
1041,3/04/2018 14:45,126,107,125,62,95,515,5,100
1042,3/04/2018 14:50,122,99,117,55,86,479,5,100
1043,3/04/2018 14:55,120,109,129,72,93,523,5,100
1044,3/04/2018 15:00,143,110,135,62,93,543,5,100
1045,3/04/2018 15:05,136,108,140,59,103,546,5,100
1046,3/04/2018 15:10,141,112,127,45,94,519,5,100
1047,3/04/2018 15:15,117,104,133,62,105,521,5,100
1048,3/04/2018 15:20,120,111,131,50,95,507,5,100
1049,3/04/2018 15:25,135,119,127,66,105,552,5,100
1050,3/04/2018 15:30,136,118,120,54,98,526,5,100
1051,3/04/2018 15:35,117,103,112,68,83,483,5,100
1052,3/04/2018 15:40,139,109,121,60,92,521,5,100
1053,3/04/2018 15:45,129,95,117,53,100,494,5,100
1054,3/04/2018 15:50,130,110,121,61,89,511,5,100
1055,3/04/2018 15:55,138,118,122,61,88,527,5,100
1056,3/04/2018 16:00,137,122,136,88,99,582,5,100
1057,3/04/2018 16:05,137,108,122,50,83,500,5,100
1058,3/04/2018 16:10,127,95,123,62,103,510,5,100
1059,3/04/2018 16:15,130,111,133,57,89,520,5,100
1060,3/04/2018 16:20,122,86,106,43,80,437,5,100
1061,3/04/2018 16:25,119,120,133,60,95,527,5,100
1062,3/04/2018 16:30,134,110,114,73,91,522,5,100
1063,3/04/2018 16:35,121,98,129,55,85,488,5,100
1064,3/04/2018 16:40,126,98,119,58,81,482,5,100
1065,3/04/2018 16:45,121,116,125,47,94,503,5,100
1066,3/04/2018 16:50,125,100,122,46,100,493,5,100
1067,3/04/2018 16:55,120,88,121,59,76,464,5,100
1068,3/04/2018 17:00,129,101,124,47,82,483,5,100
1069,3/04/2018 17:05,122,96,123,55,75,471,5,100
1070,3/04/2018 17:10,123,102,120,52,87,484,5,100
1071,3/04/2018 17:15,131,91,135,49,86,492,5,100
1072,3/04/2018 17:20,129,98,127,54,85,493,5,100
1073,3/04/2018 17:25,141,102,126,56,99,524,5,100
1074,3/04/2018 17:30,125,91,117,55,75,463,5,100
1075,3/04/2018 17:35,130,100,126,54,69,479,5,100
1076,3/04/2018 17:40,130,118,135,58,84,525,5,100
1077,3/04/2018 17:45,127,105,131,48,84,495,5,100
1078,3/04/2018 17:50,127,93,112,40,76,448,5,100
1079,3/04/2018 17:55,115,98,124,62,69,468,5,100
1080,3/04/2018 18:00,125,104,120,49,64,462,5,100
1081,3/04/2018 18:05,118,82,98,59,90,447,5,100
1082,3/04/2018 18:10,122,98,119,40,67,446,5,100
1083,3/04/2018 18:15,133,94,120,61,58,466,5,100
1084,3/04/2018 18:20,112,112,131,57,87,499,5,100
1085,3/04/2018 18:25,120,98,117,52,76,463,5,100
1086,3/04/2018 18:30,107,100,117,47,85,456,5,100
1087,3/04/2018 18:35,116,81,117,45,65,424,5,100
1088,3/04/2018 18:40,107,82,116,40,75,420,5,100
1089,3/04/2018 18:45,115,96,105,55,72,443,5,100
1090,3/04/2018 18:50,109,86,87,40,68,390,5,100
1091,3/04/2018 18:55,104,97,103,49,84,437,5,100
1092,3/04/2018 19:00,128,88,109,55,75,455,5,100
1093,3/04/2018 19:05,118,93,111,43,76,441,5,100
1094,3/04/2018 19:10,114,88,110,48,62,422,5,100
1095,3/04/2018 19:15,111,89,108,44,77,429,5,100
1096,3/04/2018 19:20,101,92,96,48,60,397,5,100
1097,3/04/2018 19:25,111,75,117,46,63,412,5,100
1098,3/04/2018 19:30,103,80,101,32,64,380,5,100
1099,3/04/2018 19:35,107,82,88,31,63,371,5,100
1100,3/04/2018 19:40,101,79,100,44,58,382,5,100
1101,3/04/2018 19:45,110,77,105,45,76,413,5,100
1102,3/04/2018 19:50,105,77,93,39,56,370,5,100
1103,3/04/2018 19:55,100,73,85,35,63,356,5,100
1104,3/04/2018 20:00,109,88,106,47,67,417,5,100
1105,3/04/2018 20:05,103,74,98,40,52,367,5,100
1106,3/04/2018 20:10,105,81,97,34,69,386,5,100
1107,3/04/2018 20:15,102,68,92,38,66,366,5,100
1108,3/04/2018 20:20,89,72,87,37,64,349,5,100
1109,3/04/2018 20:25,114,74,107,35,62,392,5,100
1110,3/04/2018 20:30,77,75,77,36,62,327,5,100
1111,3/04/2018 20:35,90,68,83,29,72,342,5,100
1112,3/04/2018 20:40,90,70,100,36,56,352,5,100
1113,3/04/2018 20:45,102,60,102,38,59,361,5,100
1114,3/04/2018 20:50,78,70,83,36,44,311,5,100
1115,3/04/2018 20:55,91,60,85,27,62,325,5,100
1116,3/04/2018 21:00,83,71,80,25,59,318,5,100
1117,3/04/2018 21:05,100,73,101,47,67,388,5,100
1118,3/04/2018 21:10,116,88,95,40,65,404,5,100
1119,3/04/2018 21:15,103,78,97,39,67,384,5,100
1120,3/04/2018 21:20,98,78,90,40,68,374,5,100
1121,3/04/2018 21:25,102,72,86,37,72,369,5,100
1122,3/04/2018 21:30,104,71,103,33,54,365,5,100
1123,3/04/2018 21:35,81,75,87,33,64,340,5,100
1124,3/04/2018 21:40,96,69,93,33,70,361,5,100
1125,3/04/2018 21:45,84,78,96,29,55,342,5,100
1126,3/04/2018 21:50,67,64,69,38,43,281,5,100
1127,3/04/2018 21:55,76,69,84,28,49,306,5,100
1128,3/04/2018 22:00,95,78,93,32,60,358,5,100
1129,3/04/2018 22:05,63,68,76,35,49,291,5,100
1130,3/04/2018 22:10,75,60,76,39,50,300,5,100
1131,3/04/2018 22:15,74,56,79,40,52,301,5,100
1132,3/04/2018 22:20,87,64,85,29,52,317,5,100
1133,3/04/2018 22:25,63,63,68,29,52,275,5,100
1134,3/04/2018 22:30,72,61,71,29,59,292,5,100
1135,3/04/2018 22:35,65,57,72,30,46,270,5,100
1136,3/04/2018 22:40,53,57,68,17,42,237,5,100
1137,3/04/2018 22:45,79,70,69,21,43,282,5,100
1138,3/04/2018 22:50,64,54,61,26,46,251,5,100
1139,3/04/2018 22:55,57,56,57,28,48,246,5,100
1140,3/04/2018 23:00,65,51,69,32,48,265,5,100
1141,3/04/2018 23:05,54,40,42,24,37,197,5,100
1142,3/04/2018 23:10,58,50,58,39,41,246,5,100
1143,3/04/2018 23:15,53,59,45,17,32,206,5,100
1144,3/04/2018 23:20,62,50,48,20,36,216,5,100
1145,3/04/2018 23:25,42,39,51,16,32,180,5,100
1146,3/04/2018 23:30,48,53,55,26,47,229,5,100
1147,3/04/2018 23:35,32,40,47,17,33,169,5,100
1148,3/04/2018 23:40,50,43,55,16,43,207,5,100
1149,3/04/2018 23:45,33,48,57,24,54,216,5,100
1150,3/04/2018 23:50,39,33,41,28,25,166,5,100
1151,3/04/2018 23:55,38,31,41,23,29,162,5,100
1152,3/05/2018 0:00,43,44,46,17,35,185,5,100
1153,3/05/2018 0:05,31,41,50,10,36,168,5,100
1154,3/05/2018 0:10,27,36,42,22,28,155,5,100
1155,3/05/2018 0:15,22,37,40,14,24,137,5,100
1156,3/05/2018 0:20,21,34,42,13,26,136,5,100
1157,3/05/2018 0:25,32,36,34,15,27,144,5,100
1158,3/05/2018 0:30,34,40,38,15,34,161,5,100
1159,3/05/2018 0:35,35,26,36,16,30,143,5,100
1160,3/05/2018 0:40,21,24,26,20,21,112,5,100
1161,3/05/2018 0:45,26,25,28,19,26,124,5,100
1162,3/05/2018 0:50,23,32,37,18,33,143,5,100
1163,3/05/2018 0:55,21,21,23,13,21,99,5,100
1164,3/05/2018 1:00,23,27,27,7,22,106,5,100
1165,3/05/2018 1:05,18,22,21,8,23,92,5,100
1166,3/05/2018 1:10,16,21,26,13,18,94,5,100
1167,3/05/2018 1:15,15,18,22,14,15,84,5,100
1168,3/05/2018 1:20,17,26,32,9,20,104,5,100
1169,3/05/2018 1:25,15,18,23,10,18,84,5,100
1170,3/05/2018 1:30,10,12,16,3,19,60,5,100
1171,3/05/2018 1:35,13,18,20,10,14,75,5,100
1172,3/05/2018 1:40,13,18,21,4,18,74,5,100
1173,3/05/2018 1:45,11,22,20,4,23,80,5,100
1174,3/05/2018 1:50,13,16,15,3,21,68,5,100
1175,3/05/2018 1:55,8,13,15,4,19,59,5,100
1176,3/05/2018 2:00,17,17,17,8,19,78,5,100
1177,3/05/2018 2:05,9,14,17,3,19,62,5,100
1178,3/05/2018 2:10,5,15,14,1,11,46,5,100
1179,3/05/2018 2:15,10,11,13,4,11,49,5,100
1180,3/05/2018 2:20,7,26,9,7,10,59,5,100
1181,3/05/2018 2:25,14,12,15,10,11,62,5,100
1182,3/05/2018 2:30,12,11,14,7,9,53,5,100
1183,3/05/2018 2:35,8,15,10,5,9,47,5,100
1184,3/05/2018 2:40,5,11,10,3,17,46,5,100
1185,3/05/2018 2:45,9,13,7,6,14,49,5,100
1186,3/05/2018 2:50,5,10,13,5,8,41,5,100
1187,3/05/2018 2:55,6,12,13,4,8,43,5,100
1188,3/05/2018 3:00,8,17,18,4,13,60,5,100
1189,3/05/2018 3:05,10,9,12,6,9,46,5,100
1190,3/05/2018 3:10,4,12,9,7,6,38,5,100
1191,3/05/2018 3:15,9,14,6,5,14,48,5,100
1192,3/05/2018 3:20,10,8,8,6,11,43,5,100
1193,3/05/2018 3:25,5,11,14,3,8,41,5,100
1194,3/05/2018 3:30,9,11,16,6,9,51,5,100
1195,3/05/2018 3:35,7,14,15,5,17,58,5,100
1196,3/05/2018 3:40,5,9,9,2,6,31,5,100
1197,3/05/2018 3:45,14,11,25,9,18,77,5,100
1198,3/05/2018 3:50,10,15,21,2,11,59,5,100
1199,3/05/2018 3:55,9,19,19,10,15,72,5,100
1200,3/05/2018 4:00,14,24,14,4,16,72,5,100
1201,3/05/2018 4:05,14,14,16,5,17,66,5,100
1202,3/05/2018 4:10,17,19,26,8,15,85,5,100
1203,3/05/2018 4:15,18,16,24,3,22,83,5,100
1204,3/05/2018 4:20,21,28,28,10,24,111,5,100
1205,3/05/2018 4:25,29,26,24,9,20,108,5,100
1206,3/05/2018 4:30,17,18,20,12,14,81,5,100
1207,3/05/2018 4:35,27,22,35,16,25,125,5,100
1208,3/05/2018 4:40,28,28,35,8,24,123,5,100
1209,3/05/2018 4:45,28,25,31,11,19,114,5,100
1210,3/05/2018 4:50,53,32,43,20,24,172,5,100
1211,3/05/2018 4:55,35,29,41,19,33,157,5,100
1212,3/05/2018 5:00,48,36,44,14,41,183,5,100
1213,3/05/2018 5:05,60,39,56,17,24,196,5,100
1214,3/05/2018 5:10,42,47,59,20,36,204,5,100
1215,3/05/2018 5:15,63,41,53,19,38,214,5,100
1216,3/05/2018 5:20,79,53,84,16,53,285,5,100
1217,3/05/2018 5:25,61,49,76,18,40,244,5,100
1218,3/05/2018 5:30,76,57,71,24,42,270,5,100
1219,3/05/2018 5:35,84,57,84,26,51,302,5,100
1220,3/05/2018 5:40,91,74,89,34,56,344,5,100
1221,3/05/2018 5:45,95,75,84,44,55,353,5,100
1222,3/05/2018 5:50,97,58,92,36,57,340,5,100
1223,3/05/2018 5:55,79,57,82,35,51,304,5,100
1224,3/05/2018 6:00,106,63,77,40,60,346,5,100
1225,3/05/2018 6:05,77,67,89,41,48,322,5,100
1226,3/05/2018 6:10,90,69,102,44,57,362,5,100
1227,3/05/2018 6:15,99,59,86,26,62,332,5,100
1228,3/05/2018 6:20,105,65,88,42,60,360,5,100
1229,3/05/2018 6:25,102,71,92,41,71,377,5,100
1230,3/05/2018 6:30,111,90,112,54,76,443,5,100
1231,3/05/2018 6:35,111,75,96,52,68,402,5,100
1232,3/05/2018 6:40,113,93,101,58,88,453,5,100
1233,3/05/2018 6:45,127,86,110,59,86,468,5,100
1234,3/05/2018 6:50,129,84,114,59,80,466,5,100
1235,3/05/2018 6:55,82,69,92,41,61,345,5,100
1236,3/05/2018 7:00,136,94,110,69,92,501,5,100
1237,3/05/2018 7:05,139,108,137,67,85,536,5,100
1238,3/05/2018 7:10,142,112,129,67,81,531,5,100
1239,3/05/2018 7:15,156,112,133,73,84,558,5,100
1240,3/05/2018 7:20,145,109,114,65,88,521,5,100
1241,3/05/2018 7:25,157,112,136,74,93,572,5,100
1242,3/05/2018 7:30,136,94,118,79,94,521,5,100
1243,3/05/2018 7:35,153,120,144,85,101,603,5,100
1244,3/05/2018 7:40,144,123,147,82,99,595,5,100
1245,3/05/2018 7:45,140,118,141,78,92,569,5,100
1246,3/05/2018 7:50,152,113,139,86,104,594,5,100
1247,3/05/2018 7:55,139,118,128,73,102,560,5,100
1248,3/05/2018 8:00,140,104,127,78,83,532,5,100
1249,3/05/2018 8:05,137,124,124,80,91,556,5,100
1250,3/05/2018 8:10,132,100,108,70,74,484,5,100
1251,3/05/2018 8:15,120,99,129,71,84,503,5,100
1252,3/05/2018 8:20,119,102,121,74,93,509,5,100
1253,3/05/2018 8:25,139,111,123,89,91,553,5,100
1254,3/05/2018 8:30,133,96,125,68,90,512,5,100
1255,3/05/2018 8:35,128,111,126,65,82,512,5,100
1256,3/05/2018 8:40,145,100,126,87,92,550,5,100
1257,3/05/2018 8:45,129,97,120,52,94,492,5,100
1258,3/05/2018 8:50,163,101,134,70,88,556,5,100
1259,3/05/2018 8:55,130,96,113,71,76,486,5,100
1260,3/05/2018 9:00,145,96,134,64,84,523,5,100
1261,3/05/2018 9:05,131,106,115,59,82,493,5,100
1262,3/05/2018 9:10,136,90,126,53,95,500,5,100
1263,3/05/2018 9:15,129,90,105,74,78,476,5,100
1264,3/05/2018 9:20,123,96,117,66,84,486,5,100
1265,3/05/2018 9:25,122,103,118,66,92,501,5,100
1266,3/05/2018 9:30,113,81,125,45,91,455,5,100
1267,3/05/2018 9:35,113,92,106,59,81,451,5,100
1268,3/05/2018 9:40,131,98,108,72,98,507,5,100
1269,3/05/2018 9:45,130,84,128,62,104,508,5,100
1270,3/05/2018 9:50,118,90,123,56,81,468,5,100
1271,3/05/2018 9:55,105,89,115,66,86,461,5,100
1272,3/05/2018 10:00,112,100,97,58,79,446,5,100
1273,3/05/2018 10:05,114,94,112,57,87,464,5,100
1274,3/05/2018 10:10,114,100,113,55,76,458,5,100
1275,3/05/2018 10:15,114,84,108,60,81,447,5,100
1276,3/05/2018 10:20,123,111,127,54,96,511,5,100
1277,3/05/2018 10:25,108,78,111,37,74,408,5,100
1278,3/05/2018 10:30,136,99,130,55,85,505,5,100
1279,3/05/2018 10:35,117,88,111,60,73,449,5,100
1280,3/05/2018 10:40,117,89,102,50,69,427,5,100
1281,3/05/2018 10:45,121,96,103,59,80,459,5,100
1282,3/05/2018 10:50,110,92,104,49,77,432,5,100
1283,3/05/2018 10:55,107,85,98,42,70,402,5,100
1284,3/05/2018 11:00,110,95,110,57,81,453,5,100
1285,3/05/2018 11:05,126,92,107,40,92,457,5,100
1286,3/05/2018 11:10,123,96,113,55,85,472,5,100
1287,3/05/2018 11:15,117,96,102,62,75,452,5,100
1288,3/05/2018 11:20,125,99,122,62,91,499,5,100
1289,3/05/2018 11:25,137,87,118,47,92,481,5,100
1290,3/05/2018 11:30,115,97,110,62,74,458,5,100
1291,3/05/2018 11:35,138,101,111,69,81,500,5,100
1292,3/05/2018 11:40,128,103,110,57,90,488,5,100
1293,3/05/2018 11:45,130,106,125,66,90,517,5,100
1294,3/05/2018 11:50,122,98,102,57,81,460,5,100
1295,3/05/2018 11:55,111,89,112,65,75,452,5,100
1296,3/05/2018 12:00,114,99,110,66,79,468,5,100
1297,3/05/2018 12:05,102,92,108,78,76,456,5,100
1298,3/05/2018 12:10,110,95,115,61,91,472,5,100
1299,3/05/2018 12:15,127,88,118,56,88,477,5,100
1300,3/05/2018 12:20,129,102,126,72,113,542,5,100
1301,3/05/2018 12:25,138,96,131,58,87,510,5,100
1302,3/05/2018 12:30,137,97,136,67,99,536,5,100
1303,3/05/2018 12:35,135,103,117,65,95,515,5,100
1304,3/05/2018 12:40,120,107,125,71,108,531,5,100
1305,3/05/2018 12:45,123,100,115,59,92,489,5,100
1306,3/05/2018 12:50,130,109,125,70,85,519,5,100
1307,3/05/2018 12:55,126,96,106,66,86,480,5,100
1308,3/05/2018 13:00,119,97,107,72,93,488,5,100
1309,3/05/2018 13:05,133,86,107,53,92,471,5,100
1310,3/05/2018 13:10,129,105,121,74,105,534,5,100
1311,3/05/2018 13:15,120,99,128,67,97,511,5,100
1312,3/05/2018 13:20,123,101,127,62,84,497,5,100
1313,3/05/2018 13:25,128,111,136,67,95,537,5,100
1314,3/05/2018 13:30,150,107,121,69,86,533,5,100
1315,3/05/2018 13:35,126,104,111,64,95,500,5,100
1316,3/05/2018 13:40,132,108,130,71,105,546,5,100
1317,3/05/2018 13:45,133,105,131,63,101,533,5,100
1318,3/05/2018 13:50,133,88,132,63,95,511,5,100
1319,3/05/2018 13:55,133,114,129,66,77,519,5,100
1320,3/05/2018 14:00,148,110,124,71,99,552,5,100
1321,3/05/2018 14:05,133,103,138,78,102,554,5,100
1322,3/05/2018 14:10,128,117,128,65,87,525,5,100
1323,3/05/2018 14:15,138,118,123,101,103,583,5,100
1324,3/05/2018 14:20,145,108,143,89,104,589,5,100
1325,3/05/2018 14:25,148,98,127,76,103,552,5,100
1326,3/05/2018 14:30,124,106,114,91,119,554,5,100
1327,3/05/2018 14:35,139,114,118,93,90,554,5,100
1328,3/05/2018 14:40,132,98,107,75,85,497,5,100
1329,3/05/2018 14:45,132,105,112,75,96,520,5,100
1330,3/05/2018 14:50,114,106,132,83,96,531,5,100
1331,3/05/2018 14:55,100,77,98,109,88,472,5,100
1332,3/05/2018 15:00,90,75,81,107,91,444,5,100
1333,3/05/2018 15:05,117,98,111,127,94,547,5,100
1334,3/05/2018 15:10,98,93,107,109,106,513,5,100
1335,3/05/2018 15:15,112,102,109,103,94,520,5,100
1336,3/05/2018 15:20,84,83,77,103,77,424,5,100
1337,3/05/2018 15:25,82,66,81,110,86,425,5,100
1338,3/05/2018 15:30,93,78,88,118,93,470,5,100
1339,3/05/2018 15:35,93,91,89,119,81,473,5,100
1340,3/05/2018 15:40,83,76,77,100,80,416,5,100
1341,3/05/2018 15:45,79,79,88,111,95,452,5,100
1342,3/05/2018 15:50,93,76,96,98,92,455,5,100
1343,3/05/2018 15:55,81,74,94,98,64,411,5,100
1344,3/05/2018 16:00,79,80,96,109,84,448,5,100
1345,3/05/2018 16:05,94,76,89,96,67,422,5,100
1346,3/05/2018 16:10,77,78,85,110,74,424,5,100
1347,3/05/2018 16:15,81,88,68,101,72,410,5,100
1348,3/05/2018 16:20,77,82,83,119,93,454,5,100
1349,3/05/2018 16:25,92,97,86,119,99,493,5,100
1350,3/05/2018 16:30,89,91,81,120,74,455,5,100
1351,3/05/2018 16:35,105,99,103,124,94,525,5,100
1352,3/05/2018 16:40,70,84,79,115,93,441,5,100
1353,3/05/2018 16:45,82,90,84,109,89,454,5,100
1354,3/05/2018 16:50,61,53,52,85,76,327,5,100
1355,3/05/2018 16:55,60,52,66,79,67,324,5,100
1356,3/05/2018 17:00,81,67,69,117,78,412,5,100
1357,3/05/2018 17:05,82,77,83,113,81,436,5,100
1358,3/05/2018 17:10,67,60,69,86,65,347,5,100
1359,3/05/2018 17:15,72,62,62,94,67,357,5,100
1360,3/05/2018 17:20,79,74,75,119,88,435,5,100
1361,3/05/2018 17:25,70,61,66,103,76,376,5,100
1362,3/05/2018 17:30,66,45,59,94,50,314,5,100
1363,3/05/2018 17:35,79,70,71,108,78,406,5,100
1364,3/05/2018 17:40,62,56,56,102,64,340,5,100
1365,3/05/2018 17:45,65,60,58,95,60,338,5,100
1366,3/05/2018 17:50,73,62,70,108,85,398,5,100
1367,3/05/2018 17:55,85,72,81,109,92,439,5,100
1368,3/05/2018 18:00,77,58,73,119,91,418,5,100
1369,3/05/2018 18:05,65,56,72,95,72,360,5,100
1370,3/05/2018 18:10,78,77,83,103,70,411,5,100
1371,3/05/2018 18:15,79,68,68,103,82,400,5,100
1372,3/05/2018 18:20,78,69,76,104,74,401,5,100
1373,3/05/2018 18:25,86,89,81,111,88,455,5,100
1374,3/05/2018 18:30,68,72,77,104,80,401,5,100
1375,3/05/2018 18:35,74,67,74,97,66,378,5,100
1376,3/05/2018 18:40,83,68,81,103,75,410,5,100
1377,3/05/2018 18:45,90,75,89,110,80,444,5,100
1378,3/05/2018 18:50,90,66,79,83,61,379,5,100
1379,3/05/2018 18:55,89,61,68,78,71,367,5,100
1380,3/05/2018 19:00,89,69,81,76,69,384,5,100
1381,3/05/2018 19:05,93,66,89,75,75,398,5,100
1382,3/05/2018 19:10,103,80,94,78,81,436,5,100
1383,3/05/2018 19:15,104,85,96,82,72,439,5,100
1384,3/05/2018 19:20,85,91,99,111,97,483,5,100
1385,3/05/2018 19:25,97,81,88,103,91,460,5,100
1386,3/05/2018 19:30,84,72,71,94,71,392,5,100
1387,3/05/2018 19:35,94,88,88,109,88,467,5,100
1388,3/05/2018 19:40,116,89,101,100,97,503,5,100
1389,3/05/2018 19:45,106,85,102,76,93,462,5,100
1390,3/05/2018 19:50,114,102,107,57,76,456,5,100
1391,3/05/2018 19:55,113,91,105,48,78,435,5,100
1392,3/05/2018 20:00,127,84,103,48,82,444,5,100
1393,3/05/2018 20:05,121,99,111,53,73,457,5,100
1394,3/05/2018 20:10,130,85,105,51,72,443,5,100
1395,3/05/2018 20:15,110,91,109,55,86,451,5,100
1396,3/05/2018 20:20,124,97,110,38,76,445,5,100
1397,3/05/2018 20:25,130,86,115,55,80,466,5,100
1398,3/05/2018 20:30,106,96,92,47,77,418,5,100
1399,3/05/2018 20:35,101,90,109,36,75,411,5,100
1400,3/05/2018 20:40,104,82,106,41,73,406,5,100
1401,3/05/2018 20:45,100,78,88,38,63,367,5,100
1402,3/05/2018 20:50,97,78,85,23,61,344,5,100
1403,3/05/2018 20:55,104,65,102,46,72,389,5,100
1404,3/05/2018 21:00,96,61,84,47,63,351,5,100
1405,3/05/2018 21:05,82,73,96,42,54,347,5,100
1406,3/05/2018 21:10,91,78,96,32,67,364,5,100
1407,3/05/2018 21:15,79,72,87,47,55,340,5,100
1408,3/05/2018 21:20,82,71,79,35,61,328,5,100
1409,3/05/2018 21:25,90,77,92,26,49,334,5,100
1410,3/05/2018 21:30,65,67,85,37,57,311,5,100
1411,3/05/2018 21:35,98,54,83,38,48,321,5,100
1412,3/05/2018 21:40,71,56,74,38,56,295,5,100
1413,3/05/2018 21:45,76,68,70,30,54,298,5,100
1414,3/05/2018 21:50,74,69,75,34,62,314,5,100
1415,3/05/2018 21:55,72,65,76,33,55,301,5,100
1416,3/05/2018 22:00,71,69,71,32,57,300,5,100
1417,3/05/2018 22:05,73,62,76,29,51,291,5,100
1418,3/05/2018 22:10,82,55,73,20,60,290,5,100
1419,3/05/2018 22:15,74,61,87,32,52,306,5,100
1420,3/05/2018 22:20,67,56,77,32,45,277,5,100
1421,3/05/2018 22:25,60,61,70,32,46,269,5,100
1422,3/05/2018 22:30,57,50,66,33,45,251,5,100
1423,3/05/2018 22:35,50,49,56,27,39,221,5,100
1424,3/05/2018 22:40,51,54,72,30,46,253,5,100
1425,3/05/2018 22:45,38,57,56,19,40,210,5,100
1426,3/05/2018 22:50,56,57,62,39,53,267,5,100
1427,3/05/2018 22:55,46,50,62,29,41,228,5,100
1428,3/05/2018 23:00,42,47,56,20,38,203,5,100
1429,3/05/2018 23:05,44,49,49,32,32,206,5,100
1430,3/05/2018 23:10,51,55,58,25,37,226,5,100
1431,3/05/2018 23:15,50,42,50,24,44,210,5,100
1432,3/05/2018 23:20,44,37,62,10,48,201,5,100
1433,3/05/2018 23:25,45,51,58,2,41,197,5,100
1434,3/05/2018 23:30,33,48,49,1,41,172,5,100
1435,3/05/2018 23:35,35,53,57,1,35,181,5,100
1436,3/05/2018 23:40,31,38,48,0,37,154,5,100
1437,3/05/2018 23:45,27,38,38,1,41,145,5,100
1438,3/05/2018 23:50,30,47,45,2,40,164,5,100
1439,3/05/2018 23:55,21,36,32,0,29,118,5,100
1440,3/06/2018 0:00,31,35,37,2,34,139,5,100
1441,3/06/2018 0:05,30,40,36,2,32,140,5,100
1442,3/06/2018 0:10,24,42,39,1,38,144,5,100
1443,3/06/2018 0:15,34,45,47,0,33,159,5,100
1444,3/06/2018 0:20,19,32,36,0,30,117,5,100
1445,3/06/2018 0:25,25,41,40,0,28,134,5,100
1446,3/06/2018 0:30,18,27,33,2,29,109,5,100
1447,3/06/2018 0:35,14,25,29,0,26,94,5,100
1448,3/06/2018 0:40,25,42,32,1,19,119,5,100
1449,3/06/2018 0:45,19,32,32,0,20,103,5,100
1450,3/06/2018 0:50,9,24,15,0,29,77,5,100
1451,3/06/2018 0:55,20,21,23,0,25,89,5,100
1452,3/06/2018 1:00,11,29,22,1,10,73,5,100
1453,3/06/2018 1:05,16,21,18,0,22,77,5,100
1454,3/06/2018 1:10,11,22,19,3,22,77,5,100
1455,3/06/2018 1:15,11,23,17,2,20,73,5,100
1456,3/06/2018 1:20,9,16,16,0,19,60,5,100
1457,3/06/2018 1:25,11,23,20,1,21,76,5,100
1458,3/06/2018 1:30,12,27,18,0,14,71,5,100
1459,3/06/2018 1:35,12,16,22,0,15,65,5,100
1460,3/06/2018 1:40,15,25,21,0,16,77,5,100
1461,3/06/2018 1:45,11,25,21,0,18,75,5,100
1462,3/06/2018 1:50,5,20,22,0,11,58,5,100
1463,3/06/2018 1:55,13,25,13,0,10,61,5,100
1464,3/06/2018 2:00,9,25,16,0,12,62,5,100
1465,3/06/2018 2:05,12,23,25,0,8,68,5,100
1466,3/06/2018 2:10,5,20,14,1,15,55,5,100
1467,3/06/2018 2:15,12,17,15,0,9,53,5,100
1468,3/06/2018 2:20,9,17,16,0,12,54,5,100
1469,3/06/2018 2:25,6,19,18,0,11,54,5,100
1470,3/06/2018 2:30,7,22,17,0,17,63,5,100
1471,3/06/2018 2:35,5,17,10,0,5,37,5,100
1472,3/06/2018 2:40,16,15,12,0,14,57,5,100
1473,3/06/2018 2:45,8,15,13,0,10,46,5,100
1474,3/06/2018 2:50,7,12,11,0,10,40,5,100
1475,3/06/2018 2:55,4,13,9,0,13,39,5,100
1476,3/06/2018 3:00,4,8,12,2,10,36,5,100
1477,3/06/2018 3:05,9,19,8,0,9,45,5,100
1478,3/06/2018 3:10,8,12,10,0,7,37,5,100
1479,3/06/2018 3:15,7,15,8,2,7,39,5,100
1480,3/06/2018 3:20,9,20,9,0,15,53,5,100
1481,3/06/2018 3:25,7,23,13,1,8,52,5,100
1482,3/06/2018 3:30,7,18,14,0,5,44,5,100
1483,3/06/2018 3:35,11,18,14,1,9,53,5,100
1484,3/06/2018 3:40,5,19,16,1,16,57,5,100
1485,3/06/2018 3:45,12,23,19,3,14,71,5,100
1486,3/06/2018 3:50,14,19,24,0,9,66,5,100
1487,3/06/2018 3:55,8,14,17,0,9,48,5,100
1488,3/06/2018 4:00,5,18,16,0,9,48,5,100
1489,3/06/2018 4:05,11,17,15,1,18,62,5,100
1490,3/06/2018 4:10,8,30,26,0,11,75,5,100
1491,3/06/2018 4:15,21,29,24,3,17,94,5,100
1492,3/06/2018 4:20,20,21,21,1,10,73,5,100
1493,3/06/2018 4:25,13,26,23,9,19,90,5,100
1494,3/06/2018 4:30,20,19,26,7,26,98,5,100
1495,3/06/2018 4:35,23,26,24,16,21,110,5,100
1496,3/06/2018 4:40,38,38,39,14,20,149,5,100
1497,3/06/2018 4:45,24,32,33,18,26,133,5,100
1498,3/06/2018 4:50,31,41,35,23,30,160,5,100
1499,3/06/2018 4:55,31,37,39,12,30,149,5,100
1500,3/06/2018 5:00,51,41,48,15,26,181,5,100
1501,3/06/2018 5:05,41,38,44,13,26,162,5,100
1502,3/06/2018 5:10,57,39,61,16,25,198,5,100
1503,3/06/2018 5:15,73,48,59,23,37,240,5,100
1504,3/06/2018 5:20,53,46,54,22,41,216,5,100
1505,3/06/2018 5:25,71,48,75,27,45,266,5,100
1506,3/06/2018 5:30,81,57,86,23,48,295,5,100
1507,3/06/2018 5:35,82,54,74,28,55,293,5,100
1508,3/06/2018 5:40,90,56,80,36,51,313,5,100
1509,3/06/2018 5:45,87,66,84,43,53,333,5,100
1510,3/06/2018 5:50,83,63,87,39,56,328,5,100
1511,3/06/2018 5:55,67,52,73,35,46,273,5,100
1512,3/06/2018 6:00,78,64,79,42,58,321,5,100
1513,3/06/2018 6:05,80,68,89,38,51,326,5,100
1514,3/06/2018 6:10,89,73,83,33,54,332,5,100
1515,3/06/2018 6:15,105,69,99,41,63,377,5,100
1516,3/06/2018 6:20,96,63,86,41,52,338,5,100
1517,3/06/2018 6:25,112,62,107,43,74,398,5,100
1518,3/06/2018 6:30,82,71,94,42,61,350,5,100
1519,3/06/2018 6:35,110,75,108,54,74,421,5,100
1520,3/06/2018 6:40,139,97,118,75,86,515,5,100
1521,3/06/2018 6:45,115,86,107,66,74,448,5,100
1522,3/06/2018 6:50,116,88,98,67,92,461,5,100
1523,3/06/2018 6:55,114,102,108,68,91,483,5,100
1524,3/06/2018 7:00,108,72,94,54,65,393,5,100
1525,3/06/2018 7:05,129,107,120,58,89,503,5,100
1526,3/06/2018 7:10,126,102,122,66,84,500,5,100
1527,3/06/2018 7:15,176,116,140,75,95,602,5,100
1528,3/06/2018 7:20,139,111,138,68,88,544,5,100
1529,3/06/2018 7:25,150,112,140,73,96,571,5,100
1530,3/06/2018 7:30,155,112,139,79,105,590,5,100
1531,3/06/2018 7:35,161,99,143,80,102,585,5,100
1532,3/06/2018 7:40,138,98,132,63,98,529,5,100
1533,3/06/2018 7:45,163,120,140,74,106,603,5,100
1534,3/06/2018 7:50,141,99,138,88,80,546,5,100
1535,3/06/2018 7:55,162,109,138,68,91,568,5,100
1536,3/06/2018 8:00,128,94,127,70,91,510,5,100
1537,3/06/2018 8:05,151,96,131,79,98,555,5,100
1538,3/06/2018 8:10,148,117,133,68,92,558,5,100
1539,3/06/2018 8:15,157,108,144,70,103,582,5,100
1540,3/06/2018 8:20,135,108,142,83,94,562,5,100
1541,3/06/2018 8:25,143,92,134,70,92,531,5,100
1542,3/06/2018 8:30,119,87,115,67,78,466,5,100
1543,3/06/2018 8:35,141,109,141,79,101,571,5,100
1544,3/06/2018 8:40,157,106,137,70,92,562,5,100
1545,3/06/2018 8:45,146,87,129,57,87,506,5,100
1546,3/06/2018 8:50,136,101,134,69,102,542,5,100
1547,3/06/2018 8:55,119,94,106,69,75,463,5,100
1548,3/06/2018 9:00,135,87,125,69,97,513,5,100
1549,3/06/2018 9:05,135,101,111,73,78,498,5,100
1550,3/06/2018 9:10,121,87,110,75,91,484,5,100
1551,3/06/2018 9:15,131,95,113,62,79,480,5,100
1552,3/06/2018 9:20,137,91,136,58,91,513,5,100
1553,3/06/2018 9:25,122,98,114,58,98,490,5,100
1554,3/06/2018 9:30,125,86,115,62,80,468,5,100
1555,3/06/2018 9:35,109,100,103,47,76,435,5,100
1556,3/06/2018 9:40,114,85,111,69,76,455,5,100
1557,3/06/2018 9:45,108,88,91,55,80,422,5,100
1558,3/06/2018 9:50,94,98,99,65,98,454,5,100
1559,3/06/2018 9:55,90,96,117,88,98,489,5,100
1560,3/06/2018 10:00,95,92,97,52,78,414,5,100
1561,3/06/2018 10:05,91,101,99,44,76,411,5,100
1562,3/06/2018 10:10,99,90,111,63,88,451,5,100
1563,3/06/2018 10:15,83,98,107,59,78,425,5,100
1564,3/06/2018 10:20,81,81,89,53,69,373,5,100
1565,3/06/2018 10:25,93,93,98,60,73,417,5,100
1566,3/06/2018 10:30,86,91,90,43,67,377,5,100
1567,3/06/2018 10:35,94,86,112,63,84,439,5,100
1568,3/06/2018 10:40,98,80,103,60,80,421,5,100
1569,3/06/2018 10:45,87,87,99,60,89,422,5,100
1570,3/06/2018 10:50,89,74,93,60,68,384,5,100
1571,3/06/2018 10:55,98,89,101,56,79,423,5,100
1572,3/06/2018 11:00,134,101,137,49,94,515,5,100
1573,3/06/2018 11:05,141,119,127,81,110,578,5,100
1574,3/06/2018 11:10,146,117,134,91,123,611,5,100
1575,3/06/2018 11:15,148,120,134,73,111,586,5,100
1576,3/06/2018 11:20,144,108,145,67,110,574,5,100
1577,3/06/2018 11:25,141,113,125,75,109,563,5,100
1578,3/06/2018 11:30,140,114,132,74,99,559,5,100
1579,3/06/2018 11:35,134,113,120,54,99,520,5,100
1580,3/06/2018 11:40,130,103,124,64,91,512,5,100
1581,3/06/2018 11:45,123,100,118,65,96,502,5,100
1582,3/06/2018 11:50,131,101,106,79,99,516,5,100
1583,3/06/2018 11:55,133,119,111,79,92,534,5,100
1584,3/06/2018 12:00,90,94,109,56,88,437,5,100
1585,3/06/2018 12:05,69,91,86,64,97,407,5,100
1586,3/06/2018 12:10,48,81,85,56,92,362,5,100
1587,3/06/2018 12:15,70,94,103,81,112,460,5,100
1588,3/06/2018 12:20,136,118,146,117,111,628,5,100
1589,3/06/2018 12:25,150,107,135,74,107,573,5,100
1590,3/06/2018 12:30,130,87,111,54,85,467,5,100
1591,3/06/2018 12:35,120,94,108,64,87,473,5,100
1592,3/06/2018 12:40,125,93,105,53,79,455,5,100
1593,3/06/2018 12:45,125,97,118,55,73,468,5,100
1594,3/06/2018 12:50,117,96,119,48,87,467,5,100
1595,3/06/2018 12:55,132,116,131,74,87,540,5,100
1596,3/06/2018 13:00,99,77,107,56,83,422,5,100
1597,3/06/2018 13:05,117,106,119,60,88,490,5,100
1598,3/06/2018 13:10,119,104,110,63,90,486,5,100
1599,3/06/2018 13:15,113,98,112,71,93,487,5,100
1600,3/06/2018 13:20,141,121,130,71,98,561,5,100
1601,3/06/2018 13:25,136,99,126,67,108,536,5,100
1602,3/06/2018 13:30,142,99,135,83,100,559,5,100
1603,3/06/2018 13:35,109,94,129,55,80,467,5,100
1604,3/06/2018 13:40,143,107,134,72,90,546,5,100
1605,3/06/2018 13:45,114,98,112,73,88,485,5,100
1606,3/06/2018 13:50,112,104,105,53,79,453,5,100
1607,3/06/2018 13:55,106,98,120,54,87,465,5,100
1608,3/06/2018 14:00,119,105,122,60,98,504,5,100
1609,3/06/2018 14:05,146,104,126,62,89,527,5,100
1610,3/06/2018 14:10,144,109,141,91,111,596,5,100
1611,3/06/2018 14:15,146,121,127,80,106,580,5,100
1612,3/06/2018 14:20,138,102,118,76,94,528,5,100
1613,3/06/2018 14:25,128,107,132,125,105,597,5,100
1614,3/06/2018 14:30,100,92,105,116,104,517,5,100
1615,3/06/2018 14:35,100,91,99,110,91,491,5,100
1616,3/06/2018 14:40,116,97,115,119,103,550,5,100
1617,3/06/2018 14:45,106,98,106,116,103,529,5,100
1618,3/06/2018 14:50,90,84,99,117,92,482,5,100
1619,3/06/2018 14:55,101,88,97,109,87,482,5,100
1620,3/06/2018 15:00,100,84,97,126,89,496,5,100
1621,3/06/2018 15:05,95,79,93,105,99,471,5,100
1622,3/06/2018 15:10,98,89,95,125,87,494,5,100
1623,3/06/2018 15:15,82,98,91,126,95,492,5,100
1624,3/06/2018 15:20,73,68,69,101,93,404,5,100
1625,3/06/2018 15:25,84,77,82,107,82,432,5,100
1626,3/06/2018 15:30,70,52,72,106,67,367,5,100
1627,3/06/2018 15:35,73,64,73,96,80,386,5,100
1628,3/06/2018 15:40,90,82,87,105,86,450,5,100
1629,3/06/2018 15:45,87,69,81,111,93,441,5,100
1630,3/06/2018 15:50,80,58,75,100,86,399,5,100
1631,3/06/2018 15:55,71,50,63,94,80,358,5,100
1632,3/06/2018 16:00,81,68,71,96,80,396,5,100
1633,3/06/2018 16:05,81,79,71,101,88,420,5,100
1634,3/06/2018 16:10,71,56,64,86,62,339,5,100
1635,3/06/2018 16:15,80,68,74,98,80,400,5,100
1636,3/06/2018 16:20,63,68,62,97,81,371,5,100
1637,3/06/2018 16:25,61,57,58,87,68,331,5,100
1638,3/06/2018 16:30,70,56,70,95,78,369,5,100
1639,3/06/2018 16:35,71,67,67,102,77,384,5,100
1640,3/06/2018 16:40,93,89,86,106,89,463,5,100
1641,3/06/2018 16:45,82,78,81,109,76,426,5,100
1642,3/06/2018 16:50,68,57,53,110,71,359,5,100
1643,3/06/2018 16:55,67,45,60,102,75,349,5,100
1644,3/06/2018 17:00,70,56,58,111,63,358,5,100
1645,3/06/2018 17:05,63,55,54,92,71,335,5,100
1646,3/06/2018 17:10,70,53,60,103,63,349,5,100
1647,3/06/2018 17:15,68,57,63,101,67,356,5,100
1648,3/06/2018 17:20,70,47,62,88,66,333,5,100
1649,3/06/2018 17:25,67,55,58,98,72,350,5,100
1650,3/06/2018 17:30,67,42,61,102,83,355,5,100
1651,3/06/2018 17:35,70,42,60,93,71,336,5,100
1652,3/06/2018 17:40,71,43,60,87,57,318,5,100
1653,3/06/2018 17:45,63,51,51,97,67,329,5,100
1654,3/06/2018 17:50,71,58,61,104,73,367,5,100
1655,3/06/2018 17:55,80,71,66,96,80,393,5,100
1656,3/06/2018 18:00,78,66,71,106,73,394,5,100
1657,3/06/2018 18:05,63,52,56,89,57,317,5,100
1658,3/06/2018 18:10,73,49,51,89,62,324,5,100
1659,3/06/2018 18:15,69,48,58,85,57,317,5,100
1660,3/06/2018 18:20,76,64,69,104,82,395,5,100
1661,3/06/2018 18:25,69,64,67,90,83,373,5,100
1662,3/06/2018 18:30,66,54,59,93,57,329,5,100
1663,3/06/2018 18:35,72,57,65,96,71,361,5,100
1664,3/06/2018 18:40,65,52,59,91,56,323,5,100
1665,3/06/2018 18:45,67,45,60,76,54,302,5,100
1666,3/06/2018 18:50,75,62,66,76,65,344,5,100
1667,3/06/2018 18:55,80,79,81,99,84,423,5,100
1668,3/06/2018 19:00,87,74,83,109,82,435,5,100
1669,3/06/2018 19:05,84,76,74,109,78,421,5,100
1670,3/06/2018 19:10,84,67,79,103,63,396,5,100
1671,3/06/2018 19:15,81,65,74,100,69,389,5,100
1672,3/06/2018 19:20,101,89,89,118,89,486,5,100
1673,3/06/2018 19:25,97,73,90,112,96,468,5,100
1674,3/06/2018 19:30,89,75,92,109,75,440,5,100
1675,3/06/2018 19:35,93,87,99,101,86,466,5,100
1676,3/06/2018 19:40,94,94,89,97,76,450,5,100
1677,3/06/2018 19:45,98,78,89,88,87,440,5,100
1678,3/06/2018 19:50,112,104,113,92,93,514,5,100
1679,3/06/2018 19:55,130,104,134,84,90,542,5,100
1680,3/06/2018 20:00,119,89,119,76,78,481,5,100
1681,3/06/2018 20:05,121,84,110,68,81,464,5,100
1682,3/06/2018 20:10,133,113,127,67,88,528,5,100
1683,3/06/2018 20:15,124,106,122,70,92,514,5,100
1684,3/06/2018 20:20,122,101,121,71,94,509,5,100
1685,3/06/2018 20:25,138,94,123,62,78,495,5,100
1686,3/06/2018 20:30,127,93,104,56,75,455,5,100
1687,3/06/2018 20:35,116,85,100,52,65,418,5,100
1688,3/06/2018 20:40,125,86,112,49,77,449,5,100
1689,3/06/2018 20:45,114,78,108,54,80,434,5,100
1690,3/06/2018 20:50,112,94,109,45,76,436,5,100
1691,3/06/2018 20:55,117,78,98,50,71,414,5,100
1692,3/06/2018 21:00,120,76,105,43,63,407,5,100
1693,3/06/2018 21:05,109,90,97,45,72,413,5,100
1694,3/06/2018 21:10,106,81,95,40,70,392,5,100
1695,3/06/2018 21:15,106,84,102,56,62,410,5,100
1696,3/06/2018 21:20,120,81,100,53,74,428,5,100
1697,3/06/2018 21:25,112,87,101,47,72,419,5,100
1698,3/06/2018 21:30,92,71,89,52,62,366,5,100
1699,3/06/2018 21:35,93,79,96,45,52,365,5,100
1700,3/06/2018 21:40,93,77,95,40,63,368,5,100
1701,3/06/2018 21:45,80,69,73,30,49,301,5,100
1702,3/06/2018 21:50,79,76,79,48,57,339,5,100
1703,3/06/2018 21:55,83,67,79,34,53,316,5,100
1704,3/06/2018 22:00,81,65,81,34,60,321,5,100
1705,3/06/2018 22:05,85,66,84,37,59,331,5,100
1706,3/06/2018 22:10,97,72,91,37,60,357,5,100
1707,3/06/2018 22:15,70,66,77,30,60,303,5,100
1708,3/06/2018 22:20,83,81,99,56,58,377,5,100
1709,3/06/2018 22:25,68,61,65,20,53,267,5,100
1710,3/06/2018 22:30,87,63,81,36,63,330,5,100
1711,3/06/2018 22:35,73,66,79,26,53,297,5,100
1712,3/06/2018 22:40,55,58,72,33,56,274,5,100
1713,3/06/2018 22:45,61,48,69,23,44,245,5,100
1714,3/06/2018 22:50,56,51,66,33,42,248,5,100
1715,3/06/2018 22:55,47,51,55,22,44,219,5,100
1716,3/06/2018 23:00,58,47,59,26,43,233,5,100
1717,3/06/2018 23:05,58,44,61,30,40,233,5,100
1718,3/06/2018 23:10,56,57,66,32,39,250,5,100
1719,3/06/2018 23:15,56,48,56,21,39,220,5,100
1720,3/06/2018 23:20,68,46,62,31,40,247,5,100
1721,3/06/2018 23:25,49,38,50,23,36,196,5,100
1722,3/06/2018 23:30,45,42,41,24,41,193,5,100
1723,3/06/2018 23:35,47,37,43,11,37,175,5,100
1724,3/06/2018 23:40,38,42,51,23,40,194,5,100
1725,3/06/2018 23:45,31,47,48,20,34,180,5,100
1726,3/06/2018 23:50,34,39,53,22,30,178,5,100
1727,3/06/2018 23:55,42,33,46,11,36,168,5,100
1728,3/07/2018 0:00,25,29,35,13,29,131,5,100
1729,3/07/2018 0:05,30,38,44,19,26,157,5,100
1730,3/07/2018 0:10,26,39,30,19,27,141,5,100
1731,3/07/2018 0:15,30,36,45,23,32,166,5,100
1732,3/07/2018 0:20,28,42,41,18,29,158,5,100
1733,3/07/2018 0:25,23,39,24,20,28,134,5,100
1734,3/07/2018 0:30,24,31,32,16,25,128,5,100
1735,3/07/2018 0:35,21,28,27,23,36,135,5,100
1736,3/07/2018 0:40,26,42,35,20,36,159,5,100
1737,3/07/2018 0:45,11,21,16,11,17,76,5,100
1738,3/07/2018 0:50,19,24,34,19,25,121,5,100
1739,3/07/2018 0:55,14,23,23,11,20,91,5,100
1740,3/07/2018 1:00,14,18,21,11,21,85,5,100
1741,3/07/2018 1:05,10,17,29,10,18,84,5,100
1742,3/07/2018 1:10,17,23,17,14,17,88,5,100
1743,3/07/2018 1:15,9,17,14,11,18,69,5,100
1744,3/07/2018 1:20,10,24,29,11,14,88,5,100
1745,3/07/2018 1:25,16,18,18,7,15,74,5,100
1746,3/07/2018 1:30,10,21,28,11,18,88,5,100
1747,3/07/2018 1:35,12,18,18,11,17,76,5,100
1748,3/07/2018 1:40,8,16,17,5,22,68,5,100
1749,3/07/2018 1:45,12,20,23,9,17,81,5,100
1750,3/07/2018 1:50,9,23,20,7,16,75,5,100
1751,3/07/2018 1:55,12,15,13,9,18,67,5,100
1752,3/07/2018 2:00,15,16,13,9,14,67,5,100
1753,3/07/2018 2:05,5,15,17,9,19,65,5,100
1754,3/07/2018 2:10,13,19,11,8,12,63,5,100
1755,3/07/2018 2:15,14,23,18,9,18,82,5,100
1756,3/07/2018 2:20,11,11,19,8,18,67,5,100
1757,3/07/2018 2:25,12,14,16,8,12,62,5,100
1758,3/07/2018 2:30,6,17,16,4,10,53,5,100
1759,3/07/2018 2:35,11,18,12,5,7,53,5,100
1760,3/07/2018 2:40,8,11,10,5,10,44,5,100
1761,3/07/2018 2:45,8,20,12,3,12,55,5,100
1762,3/07/2018 2:50,4,15,8,3,10,40,5,100
1763,3/07/2018 2:55,5,17,11,6,12,51,5,100
1764,3/07/2018 3:00,6,11,13,10,7,47,5,100
1765,3/07/2018 3:05,5,11,11,4,17,48,5,100
1766,3/07/2018 3:10,6,8,9,3,9,35,5,100
1767,3/07/2018 3:15,8,11,9,7,6,41,5,100
1768,3/07/2018 3:20,10,13,14,2,18,57,5,100
1769,3/07/2018 3:25,8,17,11,3,11,50,5,100
1770,3/07/2018 3:30,7,9,10,3,12,41,5,100
1771,3/07/2018 3:35,12,18,16,5,17,68,5,100
1772,3/07/2018 3:40,4,12,16,3,20,55,5,100
1773,3/07/2018 3:45,10,18,18,9,14,69,5,100
1774,3/07/2018 3:50,3,23,14,5,13,58,5,100
1775,3/07/2018 3:55,8,23,18,9,15,73,5,100
1776,3/07/2018 4:00,3,9,8,3,11,34,5,100
1777,3/07/2018 4:05,5,12,18,5,10,50,5,100
1778,3/07/2018 4:10,18,13,20,11,10,72,5,100
1779,3/07/2018 4:15,19,19,21,8,9,76,5,100
1780,3/07/2018 4:20,9,20,23,13,22,87,5,100
1781,3/07/2018 4:25,13,14,17,9,16,69,5,100
1782,3/07/2018 4:30,25,22,30,12,27,116,5,100
1783,3/07/2018 4:35,28,33,35,10,25,131,5,100
1784,3/07/2018 4:40,33,32,31,8,24,128,5,100
1785,3/07/2018 4:45,28,36,31,17,16,128,5,100
1786,3/07/2018 4:50,28,33,37,14,27,139,5,100
1787,3/07/2018 4:55,34,33,47,20,29,163,5,100
1788,3/07/2018 5:00,37,35,34,8,26,140,5,100
1789,3/07/2018 5:05,49,47,54,18,25,193,5,100
1790,3/07/2018 5:10,46,35,56,16,29,182,5,100
1791,3/07/2018 5:15,54,41,57,22,39,213,5,100
1792,3/07/2018 5:20,70,43,64,23,46,246,5,100
1793,3/07/2018 5:25,64,48,70,24,43,249,5,100
1794,3/07/2018 5:30,86,59,76,26,40,287,5,100
1795,3/07/2018 5:35,76,65,92,37,60,330,5,100
1796,3/07/2018 5:40,79,72,90,35,63,339,5,100
1797,3/07/2018 5:45,79,70,74,37,59,319,5,100
1798,3/07/2018 5:50,88,65,86,37,58,334,5,100
1799,3/07/2018 5:55,82,54,78,41,47,302,5,100
1800,3/07/2018 6:00,79,66,71,32,53,301,5,100
1801,3/07/2018 6:05,78,71,76,39,40,304,5,100
1802,3/07/2018 6:10,89,72,94,44,44,343,5,100
1803,3/07/2018 6:15,97,78,99,38,67,379,5,100
1804,3/07/2018 6:20,103,68,98,57,67,393,5,100
1805,3/07/2018 6:25,116,74,89,42,66,387,5,100
1806,3/07/2018 6:30,109,76,93,48,69,395,5,100
1807,3/07/2018 6:35,100,81,99,55,77,412,5,100
1808,3/07/2018 6:40,132,80,118,57,87,474,5,100
1809,3/07/2018 6:45,112,97,106,54,82,451,5,100
1810,3/07/2018 6:50,114,82,104,60,77,437,5,100
1811,3/07/2018 6:55,105,87,103,60,71,426,5,100
1812,3/07/2018 7:00,126,103,123,67,79,498,5,100
1813,3/07/2018 7:05,127,81,102,55,83,448,5,100
1814,3/07/2018 7:10,139,103,118,67,81,508,5,100
1815,3/07/2018 7:15,172,115,138,75,87,587,5,100
1816,3/07/2018 7:20,160,109,134,54,96,553,5,100
1817,3/07/2018 7:25,156,114,147,74,99,590,5,100
1818,3/07/2018 7:30,178,105,144,84,99,610,5,100
1819,3/07/2018 7:35,162,98,142,74,106,582,5,100
1820,3/07/2018 7:40,159,120,138,73,100,590,5,100
1821,3/07/2018 7:45,173,126,136,89,115,639,5,100
1822,3/07/2018 7:50,140,119,138,70,90,557,5,100
1823,3/07/2018 7:55,144,105,119,84,102,554,5,100
1824,3/07/2018 8:00,151,110,132,73,108,574,5,100
1825,3/07/2018 8:05,158,105,158,83,96,600,5,100
1826,3/07/2018 8:10,139,105,137,76,94,551,5,100
1827,3/07/2018 8:15,129,92,125,74,92,512,5,100
1828,3/07/2018 8:20,128,105,122,80,104,539,5,100
1829,3/07/2018 8:25,94,107,100,113,102,516,5,100
1830,3/07/2018 8:30,88,84,87,124,82,465,5,100
1831,3/07/2018 8:35,134,117,133,93,99,576,5,100
1832,3/07/2018 8:40,139,98,136,80,97,550,5,100
1833,3/07/2018 8:45,149,102,135,74,88,548,5,100
1834,3/07/2018 8:50,125,100,112,62,88,487,5,100
1835,3/07/2018 8:55,126,88,114,44,79,451,5,100
1836,3/07/2018 9:00,153,94,131,79,100,557,5,100
1837,3/07/2018 9:05,133,94,109,61,85,482,5,100
1838,3/07/2018 9:10,140,108,125,75,105,553,5,100
1839,3/07/2018 9:15,137,105,126,60,90,518,5,0
1840,3/07/2018 9:20,130,96,116,54,81,477,5,100
1841,3/07/2018 9:25,119,83,111,69,82,464,5,100
1842,3/07/2018 9:30,132,95,112,56,84,479,5,100
1843,3/07/2018 9:35,137,111,134,71,92,545,5,100
1844,3/07/2018 9:40,92,78,106,74,63,413,5,100
1845,3/07/2018 9:45,113,105,120,59,93,490,5,100
1846,3/07/2018 9:50,126,94,111,68,78,477,5,100
1847,3/07/2018 9:55,111,90,111,62,77,451,5,100
1848,3/07/2018 10:00,124,87,111,53,81,456,5,100
1849,3/07/2018 10:05,95,72,108,50,86,411,5,100
1850,3/07/2018 10:10,112,90,124,49,74,449,5,100
1851,3/07/2018 10:15,111,96,106,50,72,435,5,100
1852,3/07/2018 10:20,100,88,110,55,72,425,5,100
1853,3/07/2018 10:25,107,89,112,62,81,451,5,100
1854,3/07/2018 10:30,123,84,116,43,84,450,5,100
1855,3/07/2018 10:35,120,98,116,56,81,471,5,100
1856,3/07/2018 10:40,117,96,114,68,81,476,5,100
1857,3/07/2018 10:45,124,83,118,53,88,466,5,100
1858,3/07/2018 10:50,116,81,105,52,75,429,5,100
1859,3/07/2018 10:55,111,92,120,53,76,452,5,100
1860,3/07/2018 11:00,121,85,123,58,84,471,5,100
1861,3/07/2018 11:05,116,79,109,61,77,442,5,100
1862,3/07/2018 11:10,125,95,130,56,95,501,5,100
1863,3/07/2018 11:15,128,103,110,53,90,484,5,100
1864,3/07/2018 11:20,136,109,127,68,87,527,5,100
1865,3/07/2018 11:25,114,86,102,60,76,438,5,100
1866,3/07/2018 11:30,130,101,119,59,101,510,5,100
1867,3/07/2018 11:35,141,92,120,58,87,498,5,100
1868,3/07/2018 11:40,130,93,117,53,90,483,5,100
1869,3/07/2018 11:45,131,88,136,52,86,493,5,100
1870,3/07/2018 11:50,132,98,133,70,99,532,5,100
1871,3/07/2018 11:55,130,92,119,70,76,487,5,100
0,3/07/2018 11:00,121,85,123,58,84,471,5,100
1,3/07/2018 11:05,116,79,109,61,77,442,5,100
2,3/07/2018 11:10,125,95,130,56,95,501,5,100
3,3/07/2018 11:15,128,103,110,53,90,484,5,100
4,3/07/2018 11:20,136,109,127,68,87,527,5,100
5,3/07/2018 11:25,114,86,102,60,76,438,5,100
6,3/07/2018 11:30,130,101,119,59,101,510,5,100
7,3/07/2018 11:35,141,92,120,58,87,498,5,100
8,3/07/2018 11:40,130,93,117,53,90,483,5,100
9,3/07/2018 11:45,131,88,136,52,86,493,5,100
10,3/07/2018 11:50,132,98,133,70,99,532,5,100
11,3/07/2018 11:55,130,92,119,70,76,487,5,100
12,3/07/2018 12:00,123,94,121,74,96,508,5,100
13,3/07/2018 12:05,127,94,111,55,81,468,5,100
14,3/07/2018 12:10,139,110,123,69,89,530,5,100
15,3/07/2018 12:15,131,104,130,79,94,538,5,100
16,3/07/2018 12:20,139,89,121,64,81,494,5,100
17,3/07/2018 12:25,121,105,113,82,90,511,5,100
18,3/07/2018 12:30,138,98,126,59,98,519,5,100
19,3/07/2018 12:35,141,107,123,76,87,534,5,100
20,3/07/2018 12:40,144,116,133,77,87,557,5,100
21,3/07/2018 12:45,136,109,137,60,95,537,5,100
22,3/07/2018 12:50,131,106,125,73,103,538,5,100
23,3/07/2018 12:55,142,99,130,70,106,547,5,100
24,3/07/2018 13:00,134,95,140,62,96,527,5,100
25,3/07/2018 13:05,146,120,124,72,93,555,5,100
26,3/07/2018 13:10,155,106,128,67,99,555,5,100
27,3/07/2018 13:15,155,107,118,61,94,535,5,100
28,3/07/2018 13:20,134,97,133,76,112,552,5,100
29,3/07/2018 13:25,129,90,121,59,90,489,5,100
30,3/07/2018 13:30,134,106,139,76,95,550,5,100
31,3/07/2018 13:35,140,97,115,69,96,517,5,100
32,3/07/2018 13:40,148,118,123,62,101,552,5,100
33,3/07/2018 13:45,148,114,143,87,109,601,5,100
34,3/07/2018 13:50,136,94,129,81,100,540,5,100
35,3/07/2018 13:55,113,105,114,105,97,534,5,100
36,3/07/2018 14:00,118,100,112,102,112,544,5,100
37,3/07/2018 14:05,100,89,103,135,106,533,5,100
38,3/07/2018 14:10,116,106,117,124,101,564,5,100
39,3/07/2018 14:15,106,96,96,128,99,525,5,100
40,3/07/2018 14:20,86,68,83,106,80,423,5,100
41,3/07/2018 14:25,102,82,90,116,91,481,5,100
42,3/07/2018 14:30,90,71,85,104,84,434,5,100
43,3/07/2018 14:35,98,86,85,109,85,463,5,100
44,3/07/2018 14:40,105,102,103,124,99,533,5,100
45,3/07/2018 14:45,86,72,84,104,89,435,5,100
46,3/07/2018 14:50,76,64,66,92,76,374,5,100
47,3/07/2018 14:55,96,96,107,117,90,506,5,100
48,3/07/2018 15:00,98,89,98,109,87,481,5,100
49,3/07/2018 15:05,87,85,90,96,81,439,5,100
50,3/07/2018 15:10,92,89,84,112,91,468,5,100
51,3/07/2018 15:15,89,90,90,114,93,476,5,100
52,3/07/2018 15:20,75,71,73,99,81,399,5,100
53,3/07/2018 15:25,75,73,74,94,74,390,5,100
54,3/07/2018 15:30,74,59,68,88,73,362,5,100
55,3/07/2018 15:35,63,54,60,98,67,342,5,100
56,3/07/2018 15:40,84,86,87,124,93,474,5,100
57,3/07/2018 15:45,90,84,100,105,76,455,5,100
58,3/07/2018 15:50,94,70,90,78,72,404,5,100
59,3/07/2018 15:55,72,70,74,99,71,386,5,100
60,3/07/2018 16:00,78,77,64,83,77,379,5,100
61,3/07/2018 16:05,70,73,80,97,73,393,5,100
62,3/07/2018 16:10,71,89,76,116,71,423,5,100
63,3/07/2018 16:15,53,48,43,92,72,308,5,100
64,3/07/2018 16:20,60,50,60,96,66,332,5,100
65,3/07/2018 16:25,80,73,79,123,84,439,5,100
66,3/07/2018 16:30,84,65,73,114,86,422,5,100
67,3/07/2018 16:35,68,55,65,103,85,376,5,100
68,3/07/2018 16:40,72,74,74,112,100,432,5,100
69,3/07/2018 16:45,54,53,55,102,55,319,5,100
70,3/07/2018 16:50,62,40,42,66,42,252,5,100
71,3/07/2018 16:55,63,72,71,101,78,385,5,100
72,3/07/2018 17:00,84,86,86,112,96,464,5,100
73,3/07/2018 17:05,57,57,49,102,79,344,5,100
74,3/07/2018 17:10,63,53,60,95,66,337,5,100
75,3/07/2018 17:15,57,45,50,73,56,281,5,100
76,3/07/2018 17:20,56,51,46,82,66,301,5,100
77,3/07/2018 17:25,53,47,52,88,72,312,5,100
78,3/07/2018 17:30,62,52,66,101,66,347,5,100
79,3/07/2018 17:35,66,58,57,104,70,355,5,100
80,3/07/2018 17:40,68,51,61,85,70,335,5,100
81,3/07/2018 17:45,63,57,57,105,64,346,5,100
82,3/07/2018 17:50,68,43,53,94,61,319,5,100
83,3/07/2018 17:55,75,54,56,91,72,348,5,100
84,3/07/2018 18:00,72,61,65,95,81,374,5,100
85,3/07/2018 18:05,70,56,57,84,61,328,5,100
86,3/07/2018 18:10,78,64,66,82,74,364,5,100
87,3/07/2018 18:15,66,53,56,80,65,320,5,100
88,3/07/2018 18:20,61,43,47,70,54,275,5,100
89,3/07/2018 18:25,73,62,62,72,62,331,5,100
90,3/07/2018 18:30,85,65,79,102,79,410,5,100
91,3/07/2018 18:35,72,51,53,104,68,348,5,100
92,3/07/2018 18:40,83,67,71,104,71,396,5,100
93,3/07/2018 18:45,82,66,71,94,82,395,5,100
94,3/07/2018 18:50,81,58,73,103,69,384,5,100
95,3/07/2018 18:55,75,49,69,101,69,363,5,100
96,3/07/2018 19:00,78,60,63,96,77,374,5,100
97,3/07/2018 19:05,84,63,71,95,77,390,5,100
98,3/07/2018 19:10,83,64,80,109,82,418,5,100
99,3/07/2018 19:15,88,76,83,113,91,451,5,100
100,3/07/2018 19:20,85,65,71,101,75,397,5,100
101,3/07/2018 19:25,83,70,81,96,71,401,5,100
102,3/07/2018 19:30,77,73,89,74,66,379,5,100
103,3/07/2018 19:35,68,91,85,73,80,397,5,100
104,3/07/2018 19:40,60,78,86,61,76,361,5,100
105,3/07/2018 19:45,66,89,96,68,79,398,5,100
106,3/07/2018 19:50,50,49,67,50,48,264,5,100
107,3/07/2018 19:55,114,92,124,68,97,495,5,100
108,3/07/2018 20:00,125,100,130,70,103,528,5,100
109,3/07/2018 20:05,85,79,72,82,84,402,5,100
110,3/07/2018 20:10,43,29,29,82,47,230,5,100
111,3/07/2018 20:15,91,80,92,106,87,456,5,100
112,3/07/2018 20:20,82,66,82,99,84,413,5,100
113,3/07/2018 20:25,66,53,58,77,66,320,5,100
114,3/07/2018 20:30,79,66,77,107,80,409,5,100
115,3/07/2018 20:35,69,55,68,99,67,358,5,100
116,3/07/2018 20:40,86,81,81,93,79,420,5,100
117,3/07/2018 20:45,88,67,81,85,72,393,5,100
118,3/07/2018 20:50,87,81,91,60,75,394,5,100
119,3/07/2018 20:55,95,79,88,40,65,367,5,100
120,3/07/2018 21:00,93,70,83,43,56,345,5,100
121,3/07/2018 21:05,112,84,92,55,66,409,5,100
122,3/07/2018 21:10,109,90,94,40,60,393,5,100
123,3/07/2018 21:15,95,83,91,52,67,388,5,100
124,3/07/2018 21:20,105,79,95,49,73,401,5,100
125,3/07/2018 21:25,116,87,106,35,65,409,5,100
126,3/07/2018 21:30,104,78,109,49,62,402,5,100
127,3/07/2018 21:35,99,79,80,39,64,361,5,100
128,3/07/2018 21:40,105,78,94,42,57,376,5,100
129,3/07/2018 21:45,104,81,99,45,64,393,5,100
130,3/07/2018 21:50,91,60,90,44,65,350,5,100
131,3/07/2018 21:55,85,81,97,35,67,365,5,100
132,3/07/2018 22:00,88,71,99,31,60,349,5,100
133,3/07/2018 22:05,83,86,99,41,57,366,5,100
134,3/07/2018 22:10,95,60,99,34,64,352,5,100
135,3/07/2018 22:15,84,73,78,43,69,347,5,100
136,3/07/2018 22:20,89,77,96,37,53,352,5,100
137,3/07/2018 22:25,55,56,65,36,53,265,5,100
138,3/07/2018 22:30,92,71,100,13,59,335,5,100
139,3/07/2018 22:35,82,83,84,3,69,321,5,100
140,3/07/2018 22:40,76,73,83,3,72,307,5,100
141,3/07/2018 22:45,63,71,60,3,49,246,5,100
142,3/07/2018 22:50,66,60,69,1,62,258,5,100
143,3/07/2018 22:55,61,61,78,3,55,258,5,100
144,3/07/2018 23:00,61,65,77,5,49,257,5,100
145,3/07/2018 23:05,53,56,83,4,45,241,5,100
146,3/07/2018 23:10,55,58,61,1,44,219,5,100
147,3/07/2018 23:15,55,52,61,2,55,225,5,100
148,3/07/2018 23:20,65,56,72,3,48,244,5,100
149,3/07/2018 23:25,54,67,65,6,55,247,5,100
150,3/07/2018 23:30,41,49,57,2,43,192,5,100
151,3/07/2018 23:35,47,58,68,3,42,218,5,100
152,3/07/2018 23:40,43,35,63,1,47,189,5,100
153,3/07/2018 23:45,42,63,56,1,54,216,5,100
154,3/07/2018 23:50,37,50,50,3,48,188,5,100
155,3/07/2018 23:55,34,38,45,0,27,144,5,100
156,3/08/2018 0:00,38,50,47,1,39,175,5,100
157,3/08/2018 0:05,30,49,50,2,34,165,5,100
158,3/08/2018 0:10,38,41,56,1,38,174,5,100
159,3/08/2018 0:15,31,49,48,0,35,163,5,100
160,3/08/2018 0:20,34,39,51,2,35,161,5,100
161,3/08/2018 0:25,25,43,39,0,42,149,5,100
162,3/08/2018 0:30,27,39,38,1,28,133,5,100
163,3/08/2018 0:35,21,33,36,3,23,116,5,100
164,3/08/2018 0:40,23,36,35,1,22,117,5,100
165,3/08/2018 0:45,15,32,33,0,38,118,5,100
166,3/08/2018 0:50,14,22,26,1,23,86,5,100
167,3/08/2018 0:55,16,35,31,0,26,108,5,100
168,3/08/2018 1:00,18,23,30,2,20,93,5,100
169,3/08/2018 1:05,20,25,30,1,25,101,5,100
170,3/08/2018 1:10,16,19,28,3,23,89,5,100
171,3/08/2018 1:15,14,26,24,2,28,94,5,100
172,3/08/2018 1:20,11,20,19,1,21,72,5,100
173,3/08/2018 1:25,13,23,27,0,7,70,5,100
174,3/08/2018 1:30,20,23,20,0,14,77,5,100
175,3/08/2018 1:35,21,25,26,1,17,90,5,100
176,3/08/2018 1:40,12,23,23,1,19,78,5,100
177,3/08/2018 1:45,18,25,21,0,14,78,5,100
178,3/08/2018 1:50,9,22,27,5,15,78,5,100
179,3/08/2018 1:55,6,18,16,10,21,71,5,100
180,3/08/2018 2:00,14,14,27,8,8,71,5,100
181,3/08/2018 2:05,11,15,14,7,8,55,5,100
182,3/08/2018 2:10,9,14,14,6,8,51,5,100
183,3/08/2018 2:15,14,27,22,1,18,82,5,100
184,3/08/2018 2:20,5,14,9,8,11,47,5,100
185,3/08/2018 2:25,9,12,12,4,8,45,5,100
186,3/08/2018 2:30,8,10,16,4,13,51,5,100
187,3/08/2018 2:35,6,18,16,3,7,50,5,100
188,3/08/2018 2:40,8,12,17,4,9,50,5,100
189,3/08/2018 2:45,11,13,18,4,14,60,5,100
190,3/08/2018 2:50,7,13,16,3,10,49,5,100
191,3/08/2018 2:55,4,13,12,4,9,42,5,100
192,3/08/2018 3:00,9,21,9,7,14,60,5,100
193,3/08/2018 3:05,4,14,10,6,11,45,5,100
194,3/08/2018 3:10,7,16,8,8,12,51,5,100
195,3/08/2018 3:15,9,14,10,4,7,44,5,100
196,3/08/2018 3:20,4,10,16,5,10,45,5,100
197,3/08/2018 3:25,9,13,13,8,14,57,5,100
198,3/08/2018 3:30,4,11,9,2,6,32,5,100
199,3/08/2018 3:35,11,18,17,9,15,70,5,100
200,3/08/2018 3:40,6,21,19,8,15,69,5,100
201,3/08/2018 3:45,6,19,16,6,12,59,5,100
202,3/08/2018 3:50,9,20,17,4,12,62,5,100
203,3/08/2018 3:55,11,21,22,5,23,82,5,100
204,3/08/2018 4:00,8,15,25,8,8,64,5,100
205,3/08/2018 4:05,10,10,19,9,12,60,5,100
206,3/08/2018 4:10,20,16,22,6,14,78,5,100
207,3/08/2018 4:15,15,24,16,9,15,79,5,100
208,3/08/2018 4:20,13,16,28,10,27,94,5,100
209,3/08/2018 4:25,20,21,27,4,14,86,5,100
210,3/08/2018 4:30,23,25,38,11,22,119,5,100
211,3/08/2018 4:35,24,21,32,11,24,112,5,100
212,3/08/2018 4:40,35,33,38,17,25,148,5,100
213,3/08/2018 4:45,31,37,30,11,23,132,5,100
214,3/08/2018 4:50,30,31,28,14,28,131,5,100
215,3/08/2018 4:55,39,37,34,19,22,151,5,100
216,3/08/2018 5:00,44,40,53,15,29,181,5,100
217,3/08/2018 5:05,50,39,56,18,29,192,5,100
218,3/08/2018 5:10,51,32,51,12,35,181,5,100
219,3/08/2018 5:15,54,44,53,20,32,203,5,100
220,3/08/2018 5:20,72,50,68,28,37,255,5,100
221,3/08/2018 5:25,66,51,53,28,36,234,5,100
222,3/08/2018 5:30,84,62,88,23,48,305,5,100
223,3/08/2018 5:35,66,64,88,35,38,291,5,100
224,3/08/2018 5:40,97,63,98,40,49,347,5,100
225,3/08/2018 5:45,88,66,83,40,50,327,5,100
226,3/08/2018 5:50,87,72,77,40,56,332,5,100
227,3/08/2018 5:55,75,57,73,28,55,288,5,100
228,3/08/2018 6:00,78,55,82,40,54,309,5,100
229,3/08/2018 6:05,101,74,87,34,50,346,5,100
230,3/08/2018 6:10,88,67,78,44,44,321,5,100
231,3/08/2018 6:15,103,79,100,47,58,387,5,100
232,3/08/2018 6:20,88,74,78,42,49,331,5,100
233,3/08/2018 6:25,95,78,105,51,62,391,5,100
234,3/08/2018 6:30,109,86,101,42,57,395,5,100
235,3/08/2018 6:35,102,88,97,58,63,408,5,100
236,3/08/2018 6:40,127,82,106,61,88,464,5,100
237,3/08/2018 6:45,146,103,111,66,88,514,5,100
238,3/08/2018 6:50,129,96,105,60,76,466,5,100
239,3/08/2018 6:55,110,72,97,56,77,412,5,100
240,3/08/2018 7:00,117,85,118,56,83,459,5,100
241,3/08/2018 7:05,124,97,117,54,84,476,5,100
242,3/08/2018 7:10,140,99,131,75,96,541,5,100
243,3/08/2018 7:15,134,91,125,68,76,494,5,100
244,3/08/2018 7:20,167,108,144,58,109,586,5,100
245,3/08/2018 7:25,153,116,149,73,96,587,5,100
246,3/08/2018 7:30,167,118,157,86,117,645,5,100
247,3/08/2018 7:35,133,106,125,67,92,523,5,100
248,3/08/2018 7:40,162,126,154,87,106,635,5,100
249,3/08/2018 7:45,161,90,137,68,105,561,5,100
250,3/08/2018 7:50,135,103,129,90,107,564,5,100
251,3/08/2018 7:55,151,100,137,85,90,563,5,100
252,3/08/2018 8:00,139,119,118,76,103,555,5,100
253,3/08/2018 8:05,160,104,143,80,103,590,5,100
254,3/08/2018 8:10,156,96,105,73,98,528,5,100
255,3/08/2018 8:15,160,106,136,82,83,567,5,100
256,3/08/2018 8:20,142,106,135,82,114,579,5,100
257,3/08/2018 8:25,155,112,128,73,71,539,5,100
258,3/08/2018 8:30,128,102,123,72,95,520,5,100
259,3/08/2018 8:35,139,95,125,79,89,527,5,100
260,3/08/2018 8:40,149,95,127,69,78,518,5,100
261,3/08/2018 8:45,146,107,127,91,92,563,5,100
262,3/08/2018 8:50,137,100,133,74,92,536,5,100
263,3/08/2018 8:55,139,92,126,50,85,492,5,100
264,3/08/2018 9:00,130,79,122,67,83,481,5,100
265,3/08/2018 9:05,102,87,110,59,70,428,5,100
266,3/08/2018 9:10,140,85,108,73,74,480,5,100
267,3/08/2018 9:15,117,109,127,59,85,497,5,100
268,3/08/2018 9:20,138,94,118,60,95,505,5,100
269,3/08/2018 9:25,134,104,137,63,94,532,5,100
270,3/08/2018 9:30,138,110,122,74,87,531,5,100
271,3/08/2018 9:35,133,101,113,64,89,500,5,100
272,3/08/2018 9:40,122,92,135,54,87,490,5,100
273,3/08/2018 9:45,122,96,120,64,85,487,5,100
274,3/08/2018 9:50,89,72,86,61,74,382,5,100
275,3/08/2018 9:55,98,72,88,56,68,382,5,100
276,3/08/2018 10:00,70,70,84,45,68,337,5,100
277,3/08/2018 10:05,88,80,97,43,87,395,5,100
278,3/08/2018 10:10,77,74,89,61,68,369,5,100
279,3/08/2018 10:15,60,71,81,47,65,324,5,100
280,3/08/2018 10:20,82,72,89,44,83,370,5,100
281,3/08/2018 10:25,84,72,91,43,73,363,5,100
282,3/08/2018 10:30,97,83,98,53,88,419,5,100
283,3/08/2018 10:35,99,81,102,52,62,396,5,100
284,3/08/2018 10:40,130,92,128,63,98,511,5,100
285,3/08/2018 10:45,160,109,156,69,116,610,5,100
286,3/08/2018 10:50,136,98,120,62,96,512,5,100
287,3/08/2018 10:55,128,107,125,64,77,501,5,100
288,3/08/2018 11:00,142,111,130,53,110,546,5,100
289,3/08/2018 11:05,129,105,125,66,97,522,5,100
290,3/08/2018 11:10,122,86,118,68,96,490,5,100
291,3/08/2018 11:15,126,77,127,57,105,492,5,100
292,3/08/2018 11:20,114,98,112,36,81,441,5,100
293,3/08/2018 11:25,141,103,129,65,92,530,5,100
294,3/08/2018 11:30,118,90,102,63,79,452,5,100
295,3/08/2018 11:35,138,97,119,55,88,497,5,100
296,3/08/2018 11:40,123,93,114,60,98,488,5,100
297,3/08/2018 11:45,126,92,119,59,89,485,5,100
298,3/08/2018 11:50,138,102,124,57,92,513,5,100
299,3/08/2018 11:55,134,113,121,83,92,543,5,100
300,3/08/2018 12:00,140,94,121,53,94,502,5,100
301,3/08/2018 12:05,119,87,112,64,75,457,5,100
302,3/08/2018 12:10,134,98,121,75,100,528,5,100
303,3/08/2018 12:15,137,105,131,75,93,541,5,100
304,3/08/2018 12:20,128,93,110,60,90,481,5,100
305,3/08/2018 12:25,132,106,127,64,94,523,5,100
306,3/08/2018 12:30,137,118,127,74,94,550,5,100
307,3/08/2018 12:35,129,104,131,56,78,498,5,100
308,3/08/2018 12:40,135,111,131,65,90,532,5,100
309,3/08/2018 12:45,138,97,118,68,94,515,5,100
310,3/08/2018 12:50,135,110,112,59,90,506,5,100
311,3/08/2018 12:55,125,87,125,70,95,502,5,100
312,3/08/2018 13:00,118,101,122,64,92,497,5,100
313,3/08/2018 13:05,131,96,132,62,90,511,5,100
314,3/08/2018 13:10,142,90,128,66,99,525,5,100
315,3/08/2018 13:15,132,110,118,57,87,504,5,100
316,3/08/2018 13:20,129,97,129,64,76,495,5,100
317,3/08/2018 13:25,130,87,117,57,90,481,5,100
318,3/08/2018 13:30,140,104,123,71,89,527,5,100
319,3/08/2018 13:35,140,114,128,78,96,556,5,100
320,3/08/2018 13:40,142,108,127,67,95,539,5,100
321,3/08/2018 13:45,150,109,130,87,93,569,5,100
322,3/08/2018 13:50,137,98,125,96,103,559,5,100
323,3/08/2018 13:55,112,109,113,101,93,528,5,100
324,3/08/2018 14:00,101,91,104,102,89,487,5,100
325,3/08/2018 14:05,108,93,103,103,88,495,5,100
326,3/08/2018 14:10,113,89,124,81,95,502,5,100
327,3/08/2018 14:15,128,94,123,75,91,511,5,100
328,3/08/2018 14:20,110,94,97,78,88,467,5,100
329,3/08/2018 14:25,111,85,116,72,79,463,5,100
330,3/08/2018 14:30,109,100,110,105,79,503,5,100
331,3/08/2018 14:35,102,81,108,91,86,468,5,100
332,3/08/2018 14:40,76,75,78,95,89,413,5,100
333,3/08/2018 14:45,87,77,86,120,85,455,5,100
334,3/08/2018 14:50,94,91,93,114,105,497,5,100
335,3/08/2018 14:55,95,88,106,71,99,459,5,100
336,3/08/2018 15:00,113,90,113,82,88,486,5,100
337,3/08/2018 15:05,82,86,91,96,71,426,5,100
338,3/08/2018 15:10,77,74,66,95,78,390,5,100
339,3/08/2018 15:15,70,61,66,94,79,370,5,100
340,3/08/2018 15:20,58,43,54,77,67,299,5,100
341,3/08/2018 15:25,82,70,73,88,73,386,5,100
342,3/08/2018 15:30,83,78,84,107,79,431,5,100
343,3/08/2018 15:35,70,54,65,86,67,342,5,100
344,3/08/2018 15:40,59,49,56,79,61,304,5,100
345,3/08/2018 15:45,88,66,66,80,83,383,5,100
346,3/08/2018 15:50,74,71,59,93,69,366,5,100
347,3/08/2018 15:55,68,42,54,72,58,294,5,100
348,3/08/2018 16:00,66,55,57,84,59,321,5,100
349,3/08/2018 16:05,80,47,65,73,72,337,5,100
350,3/08/2018 16:10,79,75,76,90,83,403,5,100
351,3/08/2018 16:15,61,50,50,89,81,331,5,100
352,3/08/2018 16:20,64,56,60,87,73,340,5,100
353,3/08/2018 16:25,66,63,64,89,81,363,5,100
354,3/08/2018 16:30,71,63,60,100,73,367,5,100
355,3/08/2018 16:35,69,71,69,105,89,403,5,100
356,3/08/2018 16:40,69,57,59,79,74,338,5,100
357,3/08/2018 16:45,60,46,53,80,69,308,5,100
358,3/08/2018 16:50,52,58,47,85,72,314,5,100
359,3/08/2018 16:55,56,51,54,68,61,290,5,100
360,3/08/2018 17:00,67,69,69,94,76,375,5,100
361,3/08/2018 17:05,50,33,53,70,57,263,5,100
362,3/08/2018 17:10,54,39,44,73,55,265,5,100
363,3/08/2018 17:15,57,47,50,89,57,300,5,100
364,3/08/2018 17:20,62,33,50,78,48,271,5,100
365,3/08/2018 17:25,78,64,65,112,86,405,5,100
366,3/08/2018 17:30,78,87,77,109,86,437,5,100
367,3/08/2018 17:35,74,82,73,95,83,407,5,100
368,3/08/2018 17:40,51,40,41,68,52,252,5,100
369,3/08/2018 17:45,63,56,58,85,60,322,5,100
370,3/08/2018 17:50,59,51,56,86,70,322,5,100
371,3/08/2018 17:55,60,49,51,89,50,299,5,100
372,3/08/2018 18:00,63,53,59,102,66,343,5,100
373,3/08/2018 18:05,67,72,71,107,87,404,5,100
374,3/08/2018 18:10,58,58,62,97,73,348,5,100
375,3/08/2018 18:15,68,57,63,101,69,358,5,100
376,3/08/2018 18:20,70,67,69,106,85,397,5,100
377,3/08/2018 18:25,68,63,60,90,71,352,5,100
378,3/08/2018 18:30,65,62,61,93,71,352,5,100
379,3/08/2018 18:35,61,56,48,66,55,286,5,100
380,3/08/2018 18:40,72,68,70,97,69,376,5,100
381,3/08/2018 18:45,78,73,68,87,69,375,5,100
382,3/08/2018 18:50,85,72,83,89,72,401,5,100
383,3/08/2018 18:55,91,82,99,104,75,451,5,100
384,3/08/2018 19:00,81,83,78,77,59,378,5,100
385,3/08/2018 19:05,77,59,66,90,76,368,5,100
386,3/08/2018 19:10,99,93,94,98,83,467,5,100
387,3/08/2018 19:15,83,86,89,103,80,441,5,100
388,3/08/2018 19:20,94,78,93,101,89,455,5,100
389,3/08/2018 19:25,91,93,94,93,84,455,5,100
390,3/08/2018 19:30,91,80,97,83,88,439,5,100
391,3/08/2018 19:35,101,97,94,76,87,455,5,100
392,3/08/2018 19:40,90,98,98,107,96,489,5,100
393,3/08/2018 19:45,77,68,89,88,82,404,5,100
394,3/08/2018 19:50,94,83,92,100,81,450,5,100
395,3/08/2018 19:55,101,86,98,102,97,484,5,100
396,3/08/2018 20:00,98,78,84,110,81,451,5,100
397,3/08/2018 20:05,103,82,102,107,92,486,5,100
398,3/08/2018 20:10,100,83,104,68,83,438,5,100
399,3/08/2018 20:15,90,68,82,49,70,359,5,100
400,3/08/2018 20:20,101,77,94,44,63,379,5,100
401,3/08/2018 20:25,84,78,89,56,63,370,5,100
402,3/08/2018 20:30,85,72,92,40,67,356,5,100
403,3/08/2018 20:35,124,89,121,60,76,470,5,100
404,3/08/2018 20:40,94,83,95,48,68,388,5,100
405,3/08/2018 20:45,145,107,123,63,91,529,5,100
406,3/08/2018 20:50,139,91,136,53,100,519,5,100
407,3/08/2018 20:55,131,101,123,54,71,480,5,100
408,3/08/2018 21:00,139,88,127,65,88,507,5,100
409,3/08/2018 21:05,140,96,119,64,72,491,5,100
410,3/08/2018 21:10,142,107,129,46,83,507,5,100
411,3/08/2018 21:15,115,99,118,57,77,466,5,100
412,3/08/2018 21:20,119,84,113,51,76,443,5,100
413,3/08/2018 21:25,107,94,102,45,62,410,5,100
414,3/08/2018 21:30,122,92,109,52,82,457,5,100
415,3/08/2018 21:35,117,96,108,39,79,439,5,100
416,3/08/2018 21:40,97,85,117,26,74,399,5,100
417,3/08/2018 21:45,97,84,107,55,79,422,5,100
418,3/08/2018 21:50,102,82,103,33,80,400,5,100
419,3/08/2018 21:55,105,84,115,32,85,421,5,100
420,3/08/2018 22:00,91,78,111,32,66,378,5,100
421,3/08/2018 22:05,80,84,105,22,70,361,5,100
422,3/08/2018 22:10,96,74,94,22,70,356,5,100
423,3/08/2018 22:15,92,81,95,10,62,340,5,100
424,3/08/2018 22:20,108,105,105,0,61,379,5,100
425,3/08/2018 22:25,101,79,98,3,61,342,5,100
426,3/08/2018 22:30,89,77,93,0,58,317,5,100
427,3/08/2018 22:35,78,76,99,1,50,304,5,100
428,3/08/2018 22:40,75,80,88,2,59,304,5,100
429,3/08/2018 22:45,82,76,89,0,46,293,5,100
430,3/08/2018 22:50,59,62,67,1,46,235,5,100
431,3/08/2018 22:55,67,74,69,0,62,272,5,100
432,3/08/2018 23:00,68,81,79,0,52,280,5,100
433,3/08/2018 23:05,72,66,91,0,66,295,5,100
434,3/08/2018 23:10,71,78,75,0,61,285,5,100
435,3/08/2018 23:15,80,60,82,0,68,290,5,100
436,3/08/2018 23:20,53,64,65,1,42,225,5,100
437,3/08/2018 23:25,55,66,81,5,33,240,5,100
438,3/08/2018 23:30,53,69,67,1,34,224,5,100
439,3/08/2018 23:35,61,62,70,0,40,233,5,100
440,3/08/2018 23:40,55,66,59,0,24,204,5,100
441,3/08/2018 23:45,51,60,62,1,32,206,5,100
442,3/08/2018 23:50,39,72,70,0,12,193,5,100
443,3/08/2018 23:55,46,62,57,0,11,176,5,100
444,3/09/2018 0:00,48,63,51,0,10,172,5,100
445,3/09/2018 0:05,28,51,59,0,8,146,5,100
446,3/09/2018 0:10,40,68,46,0,13,167,5,100
447,3/09/2018 0:15,42,64,54,0,19,179,5,100
448,3/09/2018 0:20,38,60,51,0,14,163,5,100
449,3/09/2018 0:25,27,47,35,0,13,122,5,100
450,3/09/2018 0:30,40,46,48,1,19,154,5,100
451,3/09/2018 0:35,24,48,42,1,17,132,5,100
452,3/09/2018 0:40,26,43,35,0,14,118,5,100
453,3/09/2018 0:45,23,50,53,0,8,134,5,100
454,3/09/2018 0:50,22,52,54,0,18,146,5,100
455,3/09/2018 0:55,18,37,40,0,6,101,5,100
456,3/09/2018 1:00,11,34,31,0,7,83,5,100
457,3/09/2018 1:05,24,39,44,0,8,115,5,100
458,3/09/2018 1:10,20,33,29,1,14,97,5,100
459,3/09/2018 1:15,17,30,29,0,7,83,5,100
460,3/09/2018 1:20,12,33,40,0,9,94,5,100
461,3/09/2018 1:25,18,33,35,1,13,100,5,100
462,3/09/2018 1:30,11,30,33,0,9,83,5,100
463,3/09/2018 1:35,12,30,22,1,4,69,5,100
464,3/09/2018 1:40,19,35,32,1,17,104,5,100
465,3/09/2018 1:45,15,35,37,0,4,91,5,100
466,3/09/2018 1:50,17,36,20,1,16,90,5,100
467,3/09/2018 1:55,14,37,30,0,8,89,5,100
468,3/09/2018 2:00,10,22,15,0,8,55,5,100
469,3/09/2018 2:05,9,27,20,1,9,66,5,100
470,3/09/2018 2:10,13,34,21,0,6,74,5,100
471,3/09/2018 2:15,10,26,27,0,8,71,5,100
472,3/09/2018 2:20,17,30,19,0,8,74,5,100
473,3/09/2018 2:25,11,26,16,0,7,60,5,100
474,3/09/2018 2:30,13,21,28,0,7,69,5,100
475,3/09/2018 2:35,20,23,21,1,6,71,5,100
476,3/09/2018 2:40,8,24,25,1,4,62,5,100
477,3/09/2018 2:45,14,16,25,0,5,60,5,100
478,3/09/2018 2:50,9,20,14,0,2,45,5,100
479,3/09/2018 2:55,9,17,16,0,3,45,5,100
480,3/09/2018 3:00,9,17,14,0,6,46,5,100
481,3/09/2018 3:05,5,23,16,0,5,49,5,100
482,3/09/2018 3:10,10,16,18,1,6,51,5,100
483,3/09/2018 3:15,10,20,23,0,2,55,5,100
484,3/09/2018 3:20,12,23,22,0,2,59,5,100
485,3/09/2018 3:25,13,26,20,1,7,67,5,100
486,3/09/2018 3:30,11,20,21,0,4,56,5,100
487,3/09/2018 3:35,17,14,18,0,4,53,5,100
488,3/09/2018 3:40,11,24,16,0,8,59,5,100
489,3/09/2018 3:45,7,36,29,0,7,79,5,100
490,3/09/2018 3:50,15,27,21,0,5,68,5,100
491,3/09/2018 3:55,15,22,18,0,5,60,5,100
492,3/09/2018 4:00,12,22,23,0,7,64,5,100
493,3/09/2018 4:05,12,23,25,1,13,74,5,100
494,3/09/2018 4:10,28,29,26,1,9,93,5,100
495,3/09/2018 4:15,14,21,30,0,7,72,5,100
496,3/09/2018 4:20,17,29,32,0,7,85,5,100
497,3/09/2018 4:25,25,33,33,0,6,97,5,100
498,3/09/2018 4:30,26,32,39,1,16,114,5,100
499,3/09/2018 4:35,26,36,33,0,14,109,5,100
500,3/09/2018 4:40,30,42,51,0,12,135,5,100
501,3/09/2018 4:45,39,46,44,0,11,140,5,100
502,3/09/2018 4:50,33,47,47,2,23,152,5,100
503,3/09/2018 4:55,33,44,37,1,26,141,5,100
504,3/09/2018 5:00,31,31,38,22,32,154,5,100
505,3/09/2018 5:05,29,38,37,12,34,150,5,100
506,3/09/2018 5:10,47,36,42,16,26,167,5,100
507,3/09/2018 5:15,40,36,50,23,30,179,5,100
508,3/09/2018 5:20,57,47,47,18,35,204,5,100
509,3/09/2018 5:25,79,48,78,20,36,261,5,100
510,3/09/2018 5:30,70,50,63,27,39,249,5,100
511,3/09/2018 5:35,68,57,70,22,37,254,5,100
512,3/09/2018 5:40,77,64,87,27,57,312,5,100
513,3/09/2018 5:45,76,55,76,36,56,299,5,100
514,3/09/2018 5:50,67,54,70,31,51,273,5,100
515,3/09/2018 5:55,75,55,70,32,50,282,5,100
516,3/09/2018 6:00,72,48,65,24,37,246,5,100
517,3/09/2018 6:05,81,65,82,35,50,313,5,100
518,3/09/2018 6:10,83,65,82,31,46,307,5,100
519,3/09/2018 6:15,91,55,101,40,52,339,5,100
520,3/09/2018 6:20,88,66,101,38,66,359,5,100
521,3/09/2018 6:25,108,65,85,48,72,378,5,100
522,3/09/2018 6:30,83,85,84,41,55,348,5,100
523,3/09/2018 6:35,107,80,112,57,74,430,5,100
524,3/09/2018 6:40,87,74,82,45,70,358,5,100
525,3/09/2018 6:45,132,81,118,57,84,472,5,100
526,3/09/2018 6:50,124,83,95,52,62,416,5,100
527,3/09/2018 6:55,105,76,99,45,74,399,5,100
528,3/09/2018 7:00,97,81,106,50,64,398,5,100
529,3/09/2018 7:05,119,76,105,58,79,437,5,100
530,3/09/2018 7:10,125,99,117,61,80,482,5,100
531,3/09/2018 7:15,130,91,134,44,81,480,5,100
532,3/09/2018 7:20,162,108,146,75,93,584,5,100
533,3/09/2018 7:25,143,99,111,56,93,502,5,100
534,3/09/2018 7:30,159,118,142,84,100,603,5,100
535,3/09/2018 7:35,147,118,141,77,115,598,5,100
536,3/09/2018 7:40,178,118,151,100,117,664,5,100
537,3/09/2018 7:45,161,111,144,84,102,602,5,100
538,3/09/2018 7:50,159,104,146,73,87,569,5,100
539,3/09/2018 7:55,139,99,124,71,106,539,5,100
540,3/09/2018 8:00,143,99,114,71,95,522,5,100
541,3/09/2018 8:05,135,99,133,72,100,539,5,100
542,3/09/2018 8:10,167,103,138,90,109,607,5,100
543,3/09/2018 8:15,139,99,123,78,97,536,5,100
544,3/09/2018 8:20,145,104,115,79,85,528,5,100
545,3/09/2018 8:25,141,105,124,66,88,524,5,100
546,3/09/2018 8:30,129,93,131,55,86,494,5,100
547,3/09/2018 8:35,117,90,119,58,85,469,5,100
548,3/09/2018 8:40,134,110,119,74,77,514,5,100
549,3/09/2018 8:45,135,99,120,66,79,499,5,100
550,3/09/2018 8:50,134,97,137,73,85,526,5,100
551,3/09/2018 8:55,130,92,122,78,85,507,5,100
552,3/09/2018 9:00,131,92,119,68,92,502,5,100
553,3/09/2018 9:05,114,87,113,53,86,453,5,100
554,3/09/2018 9:10,124,102,126,61,87,500,5,100
555,3/09/2018 9:15,138,103,114,66,86,507,5,100
556,3/09/2018 9:20,108,101,106,76,90,481,5,100
557,3/09/2018 9:25,121,83,120,58,90,472,5,100
558,3/09/2018 9:30,133,95,112,57,87,484,5,100
559,3/09/2018 9:35,119,76,105,58,81,439,5,100
560,3/09/2018 9:40,109,95,107,69,90,470,5,100
561,3/09/2018 9:45,137,107,118,59,82,503,5,100
562,3/09/2018 9:50,125,95,117,60,87,484,5,100
563,3/09/2018 9:55,138,88,118,65,99,508,5,100
564,3/09/2018 10:00,118,80,106,53,79,436,5,100
565,3/09/2018 10:05,119,99,125,60,84,487,5,100
566,3/09/2018 10:10,111,99,110,70,92,482,5,100
567,3/09/2018 10:15,124,87,116,57,93,477,5,100
568,3/09/2018 10:20,118,84,117,55,81,455,5,100
569,3/09/2018 10:25,128,88,116,65,82,479,5,100
570,3/09/2018 10:30,150,102,120,69,86,527,5,100
571,3/09/2018 10:35,137,85,132,51,86,491,5,100
572,3/09/2018 10:40,119,86,108,56,72,441,5,100
573,3/09/2018 10:45,115,93,124,53,89,474,5,100
574,3/09/2018 10:50,131,90,121,57,89,488,5,100
575,3/09/2018 10:55,127,97,126,72,97,519,5,100
576,3/09/2018 11:00,128,97,128,64,80,497,5,100
577,3/09/2018 11:05,143,104,122,56,82,507,5,100
578,3/09/2018 11:10,147,99,119,65,103,533,5,100
579,3/09/2018 11:15,120,92,124,65,88,489,5,100
580,3/09/2018 11:20,145,96,127,53,89,510,5,100
581,3/09/2018 11:25,147,109,124,66,98,544,5,100
582,3/09/2018 11:30,138,100,111,61,87,497,5,100
583,3/09/2018 11:35,138,108,112,60,86,504,5,100
584,3/09/2018 11:40,146,102,137,70,94,549,5,100
585,3/09/2018 11:45,139,101,134,67,89,530,5,100
586,3/09/2018 11:50,133,103,124,62,84,506,5,100
587,3/09/2018 11:55,121,93,114,62,74,464,5,100
588,3/09/2018 12:00,136,100,130,56,93,515,5,100
589,3/09/2018 12:05,154,109,136,69,101,569,5,100
590,3/09/2018 12:10,128,89,112,65,87,481,5,100
591,3/09/2018 12:15,139,101,127,61,102,530,5,100
592,3/09/2018 12:20,121,99,122,65,87,494,5,100
593,3/09/2018 12:25,124,101,113,63,81,482,5,100
594,3/09/2018 12:30,140,94,121,67,96,518,5,100
595,3/09/2018 12:35,129,90,123,69,95,506,5,100
596,3/09/2018 12:40,115,98,109,73,94,489,5,100
597,3/09/2018 12:45,81,60,66,105,83,395,5,100
598,3/09/2018 12:50,96,80,90,102,90,458,5,100
599,3/09/2018 12:55,101,81,96,115,95,488,5,100
600,3/09/2018 13:00,87,66,78,101,77,409,5,100
601,3/09/2018 13:05,96,84,92,112,88,472,5,100
602,3/09/2018 13:10,102,84,92,103,91,472,5,100
603,3/09/2018 13:15,100,86,96,97,87,466,5,100
604,3/09/2018 13:20,82,95,86,84,82,429,5,100
605,3/09/2018 13:25,105,100,109,86,95,495,5,100
606,3/09/2018 13:30,111,91,96,94,93,485,5,100
607,3/09/2018 13:35,104,95,116,74,76,465,5,100
608,3/09/2018 13:40,91,85,103,89,92,460,5,100
609,3/09/2018 13:45,113,117,121,107,101,559,5,100
610,3/09/2018 13:50,111,90,103,89,93,486,5,100
611,3/09/2018 13:55,108,96,121,83,89,497,5,100
612,3/09/2018 14:00,25,33,24,44,36,162,5,100
613,3/09/2018 14:05,112,91,113,81,93,490,5,100
614,3/09/2018 14:10,126,94,123,75,84,502,5,100
615,3/09/2018 14:15,105,91,115,74,95,480,5,100
616,3/09/2018 14:20,122,100,110,96,87,515,5,100
617,3/09/2018 14:25,93,88,104,91,80,456,5,100
618,3/09/2018 14:30,82,96,93,107,95,473,5,100
619,3/09/2018 14:35,91,87,93,125,95,491,5,100
620,3/09/2018 14:40,73,74,81,103,80,411,5,100
621,3/09/2018 14:45,105,93,100,126,109,533,5,100
622,3/09/2018 14:50,83,71,80,103,86,423,5,100
623,3/09/2018 14:55,86,83,85,105,85,444,5,100
624,3/09/2018 15:00,76,66,66,97,75,380,5,100
625,3/09/2018 15:05,91,93,92,121,92,489,5,100
626,3/09/2018 15:10,80,91,84,121,93,469,5,100
627,3/09/2018 15:15,84,77,77,113,76,427,5,100
628,3/09/2018 15:20,75,60,71,92,75,373,5,100
629,3/09/2018 15:25,77,81,82,110,86,436,5,100
630,3/09/2018 15:30,86,85,89,117,99,476,5,100
631,3/09/2018 15:35,73,67,58,86,67,351,5,100
632,3/09/2018 15:40,93,79,83,122,88,465,5,100
633,3/09/2018 15:45,61,63,57,106,73,360,5,100
634,3/09/2018 15:50,70,79,69,96,75,389,5,100
635,3/09/2018 15:55,68,63,60,93,73,357,5,100
636,3/09/2018 16:00,72,58,67,103,69,369,5,100
637,3/09/2018 16:05,93,88,94,93,67,435,5,100
638,3/09/2018 16:10,93,78,87,80,76,414,5,100
639,3/09/2018 16:15,77,80,84,83,79,403,5,100
640,3/09/2018 16:20,95,83,102,102,85,467,5,100
641,3/09/2018 16:25,87,73,85,103,83,431,5,100
642,3/09/2018 16:30,91,72,87,108,67,425,5,100
643,3/09/2018 16:35,86,75,94,92,70,417,5,100
644,3/09/2018 16:40,93,76,86,97,67,419,5,100
645,3/09/2018 16:45,84,88,94,106,73,445,5,100
646,3/09/2018 16:50,84,88,89,106,79,446,5,100
647,3/09/2018 16:55,84,74,89,123,68,438,5,100
648,3/09/2018 17:00,77,88,82,99,68,414,5,100
649,3/09/2018 17:05,75,90,89,92,83,429,5,100
650,3/09/2018 17:10,77,75,70,116,80,418,5,100
651,3/09/2018 17:15,90,84,85,125,95,479,5,100
652,3/09/2018 17:20,76,76,75,117,84,428,5,100
653,3/09/2018 17:25,77,95,89,104,66,431,5,100
654,3/09/2018 17:30,95,74,88,95,70,422,5,100
655,3/09/2018 17:35,89,75,95,78,71,408,5,100
656,3/09/2018 17:40,86,86,112,94,77,455,5,100
657,3/09/2018 17:45,94,82,98,91,68,433,5,100
658,3/09/2018 17:50,115,93,106,81,74,469,5,100
659,3/09/2018 17:55,109,78,106,91,83,467,5,100
660,3/09/2018 18:00,108,85,103,74,76,446,5,100
661,3/09/2018 18:05,96,91,96,71,85,439,5,100
662,3/09/2018 18:10,113,80,113,77,87,470,5,100
663,3/09/2018 18:15,97,80,97,73,76,423,5,100
664,3/09/2018 18:20,119,91,110,94,88,502,5,100
665,3/09/2018 18:25,105,93,126,80,91,495,5,100
666,3/09/2018 18:30,101,95,99,94,83,472,5,100
667,3/09/2018 18:35,116,102,114,82,92,506,5,100
668,3/09/2018 18:40,111,89,114,90,84,488,5,100
669,3/09/2018 18:45,119,109,111,84,97,520,5,100
670,3/09/2018 18:50,128,108,121,91,93,541,5,100
671,3/09/2018 18:55,120,106,112,70,91,499,5,100
672,3/09/2018 19:00,123,100,125,77,102,527,5,100
673,3/09/2018 19:05,122,98,121,75,81,497,5,100
674,3/09/2018 19:10,128,111,121,67,88,515,5,100
675,3/09/2018 19:15,133,97,126,64,85,505,5,100
676,3/09/2018 19:20,116,95,107,63,88,469,5,100
677,3/09/2018 19:25,128,99,133,70,95,525,5,100
678,3/09/2018 19:30,127,108,116,68,97,516,5,100
679,3/09/2018 19:35,105,98,104,67,87,461,5,100
680,3/09/2018 19:40,128,108,114,54,93,497,5,100
681,3/09/2018 19:45,121,100,130,75,106,532,5,100
682,3/09/2018 19:50,126,91,132,49,88,486,5,100
683,3/09/2018 19:55,131,98,120,62,83,494,5,100
684,3/09/2018 20:00,130,95,137,59,94,515,5,100
685,3/09/2018 20:05,138,106,120,65,92,521,5,100
686,3/09/2018 20:10,140,94,123,58,91,506,5,100
687,3/09/2018 20:15,146,100,115,56,82,499,5,100
688,3/09/2018 20:20,145,111,122,55,85,518,5,100
689,3/09/2018 20:25,130,111,128,50,80,499,5,100
690,3/09/2018 20:30,144,85,129,56,79,493,5,100
691,3/09/2018 20:35,147,96,113,47,91,494,5,100
692,3/09/2018 20:40,119,94,122,49,76,460,5,100
693,3/09/2018 20:45,128,93,114,57,80,472,5,100
694,3/09/2018 20:50,132,100,114,35,84,465,5,100
695,3/09/2018 20:55,118,97,106,46,79,446,5,100
696,3/09/2018 21:00,135,92,114,51,82,474,5,100
697,3/09/2018 21:05,119,81,107,50,77,434,5,100
698,3/09/2018 21:10,110,84,99,46,76,415,5,100
699,3/09/2018 21:15,114,88,107,47,83,439,5,100
700,3/09/2018 21:20,108,94,114,50,76,442,5,100
701,3/09/2018 21:25,110,84,109,37,82,422,5,100
702,3/09/2018 21:30,97,78,93,43,74,385,5,100
703,3/09/2018 21:35,93,80,95,41,63,372,5,100
704,3/09/2018 21:40,113,91,100,46,62,412,5,100
705,3/09/2018 21:45,108,86,100,44,67,405,5,100
706,3/09/2018 21:50,84,84,88,46,65,367,5,100
707,3/09/2018 21:55,111,92,101,41,69,414,5,100
708,3/09/2018 22:00,92,82,80,45,68,367,5,100
709,3/09/2018 22:05,85,81,90,36,72,364,5,100
710,3/09/2018 22:10,78,69,88,57,48,340,5,100
711,3/09/2018 22:15,79,66,87,48,63,343,5,100
712,3/09/2018 22:20,83,78,87,45,64,357,5,100
713,3/09/2018 22:25,88,87,105,46,63,389,5,100
714,3/09/2018 22:30,89,70,79,48,57,343,5,100
715,3/09/2018 22:35,70,63,80,47,57,317,5,100
716,3/09/2018 22:40,77,68,91,29,59,324,5,100
717,3/09/2018 22:45,68,70,69,49,50,306,5,100
718,3/09/2018 22:50,68,62,71,41,55,297,5,100
719,3/09/2018 22:55,66,67,75,36,47,291,5,100
720,3/09/2018 23:00,75,62,79,27,61,304,5,100
721,3/09/2018 23:05,78,69,84,52,63,346,5,100
722,3/09/2018 23:10,62,62,86,40,49,299,5,100
723,3/09/2018 23:15,48,60,64,30,44,246,5,100
724,3/09/2018 23:20,76,59,78,25,52,290,5,100
725,3/09/2018 23:25,67,57,63,32,43,262,5,100
726,3/09/2018 23:30,57,57,60,48,59,281,5,100
727,3/09/2018 23:35,60,54,74,37,48,273,5,100
728,3/09/2018 23:40,58,56,67,42,57,280,5,100
729,3/09/2018 23:45,47,42,57,24,37,207,5,100
730,3/09/2018 23:50,63,56,57,31,47,254,5,100
731,3/09/2018 23:55,58,59,71,28,48,264,5,100
732,3/10/2018 0:00,49,53,56,26,45,229,5,100
733,3/10/2018 0:05,50,55,46,27,41,219,5,100
734,3/10/2018 0:10,38,45,47,31,46,207,5,100
735,3/10/2018 0:15,54,47,56,23,40,220,5,100
736,3/10/2018 0:20,40,44,48,13,41,186,5,100
737,3/10/2018 0:25,43,53,52,19,43,210,5,100
738,3/10/2018 0:30,42,41,49,21,38,191,5,100
739,3/10/2018 0:35,33,43,50,27,42,195,5,100
740,3/10/2018 0:40,48,49,45,21,38,201,5,100
741,3/10/2018 0:45,41,42,45,24,33,185,5,100
742,3/10/2018 0:50,35,41,43,21,26,166,5,100
743,3/10/2018 0:55,36,44,41,27,42,190,5,100
744,3/10/2018 1:00,25,36,48,19,38,166,5,100
745,3/10/2018 1:05,37,31,44,19,35,166,5,100
746,3/10/2018 1:10,38,40,48,18,38,182,5,100
747,3/10/2018 1:15,24,42,35,11,29,141,5,100
748,3/10/2018 1:20,25,26,32,19,27,129,5,100
749,3/10/2018 1:25,30,27,27,10,33,127,5,100
750,3/10/2018 1:30,23,30,29,13,26,121,5,100
751,3/10/2018 1:35,19,27,28,13,19,106,5,100
752,3/10/2018 1:40,20,21,32,13,30,116,5,100
753,3/10/2018 1:45,14,28,22,18,28,110,5,100
754,3/10/2018 1:50,19,31,31,19,27,127,5,100
755,3/10/2018 1:55,18,35,31,11,23,118,5,100
756,3/10/2018 2:00,22,25,19,14,27,107,5,100
757,3/10/2018 2:05,17,25,25,14,21,102,5,100
758,3/10/2018 2:10,17,27,25,9,18,96,5,100
759,3/10/2018 2:15,23,18,30,12,16,99,5,100
760,3/10/2018 2:20,24,21,26,9,26,106,5,100
761,3/10/2018 2:25,18,26,26,10,19,99,5,100
762,3/10/2018 2:30,21,25,25,12,12,95,5,100
763,3/10/2018 2:35,17,12,26,12,28,95,5,100
764,3/10/2018 2:40,21,23,23,8,16,91,5,100
765,3/10/2018 2:45,19,22,27,7,20,95,5,100
766,3/10/2018 2:50,18,26,18,11,15,88,5,100
767,3/10/2018 2:55,17,17,19,5,12,70,5,100
768,3/10/2018 3:00,16,14,23,7,19,79,5,100
769,3/10/2018 3:05,10,18,19,12,13,72,5,100
770,3/10/2018 3:10,15,28,20,3,15,81,5,100
771,3/10/2018 3:15,17,21,14,14,22,88,5,100
772,3/10/2018 3:20,11,19,10,7,19,66,5,100
773,3/10/2018 3:25,18,14,17,4,10,63,5,100
774,3/10/2018 3:30,19,24,21,6,12,82,5,100
775,3/10/2018 3:35,11,8,9,3,12,43,5,100
776,3/10/2018 3:40,9,15,19,6,21,70,5,100
777,3/10/2018 3:45,14,23,13,5,12,67,5,100
778,3/10/2018 3:50,6,12,11,10,13,52,5,100
779,3/10/2018 3:55,10,13,15,5,12,55,5,100
780,3/10/2018 4:00,15,21,15,4,15,70,5,100
781,3/10/2018 4:05,8,16,8,3,12,47,5,100
782,3/10/2018 4:10,11,16,13,8,12,60,5,100
783,3/10/2018 4:15,15,13,14,11,16,69,5,100
784,3/10/2018 4:20,16,15,17,5,19,72,5,100
785,3/10/2018 4:25,8,20,15,7,16,66,5,100
786,3/10/2018 4:30,13,21,16,7,24,81,5,100
787,3/10/2018 4:35,15,18,18,10,13,74,5,100
788,3/10/2018 4:40,17,19,21,9,15,81,5,100
789,3/10/2018 4:45,24,16,23,12,24,99,5,100
790,3/10/2018 4:50,19,25,19,9,19,91,5,100
791,3/10/2018 4:55,14,12,24,7,19,76,5,100
792,3/10/2018 5:00,12,25,20,8,14,79,5,100
793,3/10/2018 5:05,19,20,23,7,18,87,5,100
794,3/10/2018 5:10,18,25,16,5,19,83,5,100
795,3/10/2018 5:15,21,23,24,6,24,98,5,100
796,3/10/2018 5:20,22,31,32,8,20,113,5,100
797,3/10/2018 5:25,25,29,30,11,22,117,5,100
798,3/10/2018 5:30,24,27,33,11,22,117,5,100
799,3/10/2018 5:35,23,31,33,13,24,124,5,100
800,3/10/2018 5:40,26,39,43,12,29,149,5,100
801,3/10/2018 5:45,30,27,37,13,22,129,5,100
802,3/10/2018 5:50,33,30,34,10,23,130,5,100
803,3/10/2018 5:55,27,33,34,16,27,137,5,100
804,3/10/2018 6:00,31,32,41,10,31,145,5,100
805,3/10/2018 6:05,24,25,33,17,22,121,5,100
806,3/10/2018 6:10,42,31,40,16,36,165,5,100
807,3/10/2018 6:15,48,45,49,14,29,185,5,100
808,3/10/2018 6:20,43,37,46,17,33,176,5,100
809,3/10/2018 6:25,41,45,59,21,34,200,5,100
810,3/10/2018 6:30,56,43,53,15,43,210,5,100
811,3/10/2018 6:35,50,43,46,17,41,197,5,100
812,3/10/2018 6:40,62,40,56,28,35,221,5,100
813,3/10/2018 6:45,49,50,62,25,45,231,5,100
814,3/10/2018 6:50,51,47,50,19,48,215,5,100
815,3/10/2018 6:55,62,47,60,25,44,238,5,100
816,3/10/2018 7:00,52,48,59,42,48,249,5,100
817,3/10/2018 7:05,59,54,73,25,38,249,5,100
818,3/10/2018 7:10,73,51,70,22,36,252,5,100
819,3/10/2018 7:15,67,71,72,30,60,300,5,100
820,3/10/2018 7:20,89,66,84,33,48,320,5,100
821,3/10/2018 7:25,79,67,81,36,62,325,5,100
822,3/10/2018 7:30,84,67,92,42,69,354,5,100
823,3/10/2018 7:35,92,82,96,37,66,373,5,100
824,3/10/2018 7:40,91,69,96,43,77,376,5,100
825,3/10/2018 7:45,107,81,96,44,71,399,5,100
826,3/10/2018 7:50,86,74,98,39,64,361,5,100
827,3/10/2018 7:55,106,68,100,38,54,366,5,100
828,3/10/2018 8:00,93,76,101,49,68,387,5,100
829,3/10/2018 8:05,100,81,101,38,65,385,5,100
830,3/10/2018 8:10,109,85,113,33,81,421,5,100
831,3/10/2018 8:15,97,78,105,31,70,381,5,100
832,3/10/2018 8:20,94,75,109,38,72,388,5,100
833,3/10/2018 8:25,104,81,110,42,75,412,5,100
834,3/10/2018 8:30,109,86,102,46,71,414,5,100
835,3/10/2018 8:35,108,75,117,50,76,426,5,100
836,3/10/2018 8:40,103,88,110,45,76,422,5,100
837,3/10/2018 8:45,113,98,113,46,72,442,5,100
838,3/10/2018 8:50,118,84,102,54,88,446,5,100
839,3/10/2018 8:55,120,94,119,46,70,449,5,100
840,3/10/2018 9:00,112,85,107,47,63,414,5,100
841,3/10/2018 9:05,112,88,108,51,93,452,5,100
842,3/10/2018 9:10,115,91,103,40,72,421,5,100
843,3/10/2018 9:15,135,105,124,64,74,502,5,100
844,3/10/2018 9:20,131,105,125,44,89,494,5,100
845,3/10/2018 9:25,89,87,88,47,78,389,5,100
846,3/10/2018 9:30,127,105,118,46,83,479,5,100
847,3/10/2018 9:35,135,93,113,47,66,454,5,100
848,3/10/2018 9:40,138,101,121,51,94,505,5,100
849,3/10/2018 9:45,138,104,125,63,96,526,5,100
850,3/10/2018 9:50,146,113,142,56,109,566,5,100
851,3/10/2018 9:55,122,99,124,44,103,492,5,100
852,3/10/2018 10:00,119,108,122,50,91,490,5,100
853,3/10/2018 10:05,126,88,118,48,85,465,5,100
854,3/10/2018 10:10,114,111,122,64,81,492,5,100
855,3/10/2018 10:15,135,83,117,55,88,478,5,100
856,3/10/2018 10:20,131,96,120,47,86,480,5,100
857,3/10/2018 10:25,116,98,117,50,92,473,5,100
858,3/10/2018 10:30,133,102,128,63,88,514,5,100
859,3/10/2018 10:35,127,107,133,47,102,516,5,100
860,3/10/2018 10:40,148,97,135,75,114,569,5,100
861,3/10/2018 10:45,130,104,128,60,91,513,5,100
862,3/10/2018 10:50,146,112,128,46,90,522,5,100
863,3/10/2018 10:55,132,103,128,51,94,508,5,100
864,3/10/2018 11:00,123,103,124,45,89,484,5,100
865,3/10/2018 11:05,136,92,126,52,93,499,5,100
866,3/10/2018 11:10,132,85,123,49,93,482,5,100
867,3/10/2018 11:15,115,94,109,57,98,473,5,100
868,3/10/2018 11:20,97,85,97,56,83,418,5,100
869,3/10/2018 11:25,97,80,100,68,72,417,5,100
870,3/10/2018 11:30,116,93,105,56,79,449,5,100
871,3/10/2018 11:35,112,98,115,46,74,445,5,100
872,3/10/2018 11:40,116,99,115,53,71,454,5,100
873,3/10/2018 11:45,112,91,107,46,83,439,5,100
874,3/10/2018 11:50,109,94,118,67,87,475,5,100
875,3/10/2018 11:55,122,102,115,69,87,495,5,100
876,3/10/2018 12:00,129,101,115,44,90,479,5,100
877,3/10/2018 12:05,130,106,120,52,101,509,5,100
878,3/10/2018 12:10,110,110,120,58,105,503,5,100
879,3/10/2018 12:15,123,100,114,60,91,488,5,100
880,3/10/2018 12:20,109,96,119,69,87,480,5,100
881,3/10/2018 12:25,98,96,113,58,71,436,5,100
882,3/10/2018 12:30,112,93,115,62,92,474,5,100
883,3/10/2018 12:35,111,92,109,46,86,444,5,100
884,3/10/2018 12:40,111,95,104,71,93,474,5,100
885,3/10/2018 12:45,127,92,126,55,82,482,5,100
886,3/10/2018 12:50,125,101,123,67,96,512,5,100
887,3/10/2018 12:55,120,99,124,65,90,498,5,100
888,3/10/2018 13:00,118,98,114,69,100,499,5,100
889,3/10/2018 13:05,112,95,114,73,78,472,5,100
890,3/10/2018 13:10,100,89,109,68,98,464,5,100
891,3/10/2018 13:15,92,88,93,95,78,446,5,100
892,3/10/2018 13:20,109,87,114,54,94,458,5,100
893,3/10/2018 13:25,102,87,106,50,76,421,5,100
894,3/10/2018 13:30,111,93,111,69,81,465,5,100
895,3/10/2018 13:35,113,90,100,58,87,448,5,100
896,3/10/2018 13:40,116,98,118,47,101,480,5,100
897,3/10/2018 13:45,100,96,104,66,70,436,5,100
898,3/10/2018 13:50,122,90,114,55,90,471,5,100
899,3/10/2018 13:55,128,95,105,61,93,482,5,100
900,3/10/2018 14:00,122,109,128,47,85,491,5,100
901,3/10/2018 14:05,116,106,116,68,78,484,5,100
902,3/10/2018 14:10,118,109,109,54,77,467,5,100
903,3/10/2018 14:15,120,102,117,69,84,492,5,100
904,3/10/2018 14:20,99,98,117,70,91,475,5,100
905,3/10/2018 14:25,108,100,118,96,91,513,5,100
906,3/10/2018 14:30,100,99,106,81,102,488,5,100
907,3/10/2018 14:35,98,91,101,76,77,443,5,100
908,3/10/2018 14:40,95,92,92,79,88,446,5,100
909,3/10/2018 14:45,106,95,106,84,79,470,5,100
910,3/10/2018 14:50,112,86,109,70,87,464,5,100
911,3/10/2018 14:55,96,87,103,60,83,429,5,100
912,3/10/2018 15:00,110,88,110,68,82,458,5,100
913,3/10/2018 15:05,116,89,112,68,90,475,5,100
914,3/10/2018 15:10,109,90,100,67,79,445,5,100
915,3/10/2018 15:15,113,100,108,54,79,454,5,100
916,3/10/2018 15:20,108,96,114,58,76,452,5,100
917,3/10/2018 15:25,94,90,105,52,82,423,5,100
918,3/10/2018 15:30,119,112,117,67,91,506,5,100
919,3/10/2018 15:35,108,92,111,50,84,445,5,100
920,3/10/2018 15:40,115,87,99,70,85,456,5,100
921,3/10/2018 15:45,111,84,116,65,72,448,5,100
922,3/10/2018 15:50,106,88,109,78,91,472,5,100
923,3/10/2018 15:55,104,94,105,56,86,445,5,100
924,3/10/2018 16:00,106,107,102,68,82,465,5,100
925,3/10/2018 16:05,99,90,102,56,74,421,5,100
926,3/10/2018 16:10,114,92,107,68,88,469,5,100
927,3/10/2018 16:15,115,97,103,50,76,441,5,100
928,3/10/2018 16:20,104,85,105,48,66,408,5,100
929,3/10/2018 16:25,109,91,105,56,88,449,5,100
930,3/10/2018 16:30,110,103,107,62,80,462,5,100
931,3/10/2018 16:35,114,97,113,62,78,464,5,100
932,3/10/2018 16:40,108,90,113,62,81,454,5,100
933,3/10/2018 16:45,92,81,100,78,79,430,5,100
934,3/10/2018 16:50,98,94,94,76,78,440,5,100
935,3/10/2018 16:55,97,84,102,58,87,428,5,100
936,3/10/2018 17:00,93,91,105,54,73,416,5,100
937,3/10/2018 17:05,102,91,105,56,80,434,5,100
938,3/10/2018 17:10,106,92,106,48,81,433,5,100
939,3/10/2018 17:15,103,93,111,59,86,452,5,100
940,3/10/2018 17:20,105,82,105,43,64,399,5,100
941,3/10/2018 17:25,110,90,109,51,88,448,5,100
942,3/10/2018 17:30,106,96,110,83,75,470,5,100
943,3/10/2018 17:35,79,93,84,70,85,411,5,100
944,3/10/2018 17:40,88,96,89,59,85,417,5,100
945,3/10/2018 17:45,89,87,84,78,82,420,5,100
946,3/10/2018 17:50,94,91,89,65,82,421,5,100
947,3/10/2018 17:55,101,99,97,60,101,458,5,100
948,3/10/2018 18:00,96,89,90,65,84,424,5,100
949,3/10/2018 18:05,106,91,102,57,73,429,5,100
950,3/10/2018 18:10,101,89,102,60,75,427,5,100
951,3/10/2018 18:15,94,79,98,40,69,380,5,100
952,3/10/2018 18:20,108,98,96,48,75,425,5,100
953,3/10/2018 18:25,114,96,108,50,73,441,5,100
954,3/10/2018 18:30,96,79,103,37,77,392,5,100
955,3/10/2018 18:35,104,85,108,39,74,410,5,100
956,3/10/2018 18:40,110,96,115,54,80,455,5,100
957,3/10/2018 18:45,102,97,95,59,69,422,5,100
958,3/10/2018 18:50,117,96,104,52,88,457,5,100
959,3/10/2018 18:55,97,101,93,39,75,405,5,100
960,3/10/2018 19:00,104,83,103,48,78,416,5,100
961,3/10/2018 19:05,107,95,93,34,75,404,5,100
962,3/10/2018 19:10,99,98,103,43,73,416,5,100
963,3/10/2018 19:15,96,98,99,48,77,418,5,100
964,3/10/2018 19:20,82,91,81,36,53,343,5,100
965,3/10/2018 19:25,36,54,55,34,47,226,5,100
966,3/10/2018 19:30,72,72,71,35,65,315,5,100
967,3/10/2018 19:35,119,90,118,42,83,452,5,100
968,3/10/2018 19:40,99,91,101,51,76,418,5,100
969,3/10/2018 19:45,119,98,94,36,79,426,5,100
970,3/10/2018 19:50,100,94,103,40,75,412,5,100
971,3/10/2018 19:55,104,85,98,41,62,390,5,100
972,3/10/2018 20:00,87,67,83,41,71,349,5,100
973,3/10/2018 20:05,71,59,70,36,58,294,5,100
974,3/10/2018 20:10,82,68,86,35,58,329,5,100
975,3/10/2018 20:15,78,63,67,37,61,306,5,100
976,3/10/2018 20:20,73,70,77,27,60,307,5,100
977,3/10/2018 20:25,83,65,86,38,61,333,5,100
978,3/10/2018 20:30,67,60,66,31,54,278,5,100
979,3/10/2018 20:35,63,68,81,33,55,300,5,100
980,3/10/2018 20:40,80,68,73,31,70,322,5,100
981,3/10/2018 20:45,77,71,85,37,54,324,5,100
982,3/10/2018 20:50,84,74,69,34,52,313,5,100
983,3/10/2018 20:55,80,66,92,37,61,336,5,100
984,3/10/2018 21:00,70,57,74,28,44,273,5,100
985,3/10/2018 21:05,66,70,85,39,45,305,5,100
986,3/10/2018 21:10,75,71,77,37,53,313,5,100
987,3/10/2018 21:15,76,62,79,23,52,292,5,100
988,3/10/2018 21:20,60,82,83,29,64,318,5,100
989,3/10/2018 21:25,66,53,77,31,49,276,5,100
990,3/10/2018 21:30,86,69,79,25,66,325,5,100
991,3/10/2018 21:35,101,69,86,43,58,357,5,100
992,3/10/2018 21:40,67,77,71,30,43,288,5,100
993,3/10/2018 21:45,85,82,79,32,60,338,5,100
994,3/10/2018 21:50,79,84,75,36,45,319,5,100
995,3/10/2018 21:55,64,58,62,25,44,253,5,100
996,3/10/2018 22:00,77,67,76,35,48,303,5,100
997,3/10/2018 22:05,70,72,65,27,52,286,5,100
998,3/10/2018 22:10,74,71,76,21,53,295,5,100
999,3/10/2018 22:15,51,57,51,29,45,233,5,100
1000,3/10/2018 22:20,79,68,81,30,49,307,5,100
1001,3/10/2018 22:25,89,87,99,41,63,379,5,100
1002,3/10/2018 22:30,100,76,88,31,47,342,5,100
1003,3/10/2018 22:35,60,67,76,30,47,280,5,100
1004,3/10/2018 22:40,62,69,73,44,61,309,5,100
1005,3/10/2018 22:45,82,76,67,38,46,309,5,100
1006,3/10/2018 22:50,64,69,65,26,60,284,5,100
1007,3/10/2018 22:55,64,62,72,33,52,283,5,100
1008,3/10/2018 23:00,79,72,78,25,41,295,5,100
1009,3/10/2018 23:05,73,68,79,31,47,298,5,100
1010,3/10/2018 23:10,79,64,83,28,47,301,5,100
1011,3/10/2018 23:15,77,64,73,26,51,291,5,100
1012,3/10/2018 23:20,71,68,63,34,49,285,5,100
1013,3/10/2018 23:25,66,59,69,32,45,271,5,100
1014,3/10/2018 23:30,68,52,67,31,42,260,5,100
1015,3/10/2018 23:35,61,50,61,16,48,236,5,100
1016,3/10/2018 23:40,54,60,71,33,44,262,5,100
1017,3/10/2018 23:45,62,60,66,24,47,259,5,100
1018,3/10/2018 23:50,55,54,62,20,47,238,5,100
1019,3/10/2018 23:55,46,55,53,28,35,217,5,100
1020,3/11/2018 0:00,56,46,64,26,39,231,5,100
1021,3/11/2018 0:05,53,51,61,24,44,233,5,100
1022,3/11/2018 0:10,42,58,58,26,39,223,5,100
1023,3/11/2018 0:15,43,52,40,21,41,197,5,100
1024,3/11/2018 0:20,40,50,55,22,43,210,5,100
1025,3/11/2018 0:25,40,36,51,21,29,177,5,100
1026,3/11/2018 0:30,33,33,40,14,41,161,5,100
1027,3/11/2018 0:35,37,44,56,15,51,203,5,100
1028,3/11/2018 0:40,35,48,38,21,44,186,5,100
1029,3/11/2018 0:45,36,42,41,17,29,165,5,100
1030,3/11/2018 0:50,34,35,39,18,38,164,5,100
1031,3/11/2018 0:55,36,37,31,9,25,138,5,100
1032,3/11/2018 1:00,29,41,35,17,24,146,5,100
1033,3/11/2018 1:05,31,42,37,11,32,153,5,100
1034,3/11/2018 1:10,35,34,48,11,31,159,5,100
1035,3/11/2018 1:15,33,33,32,15,30,143,5,100
1036,3/11/2018 1:20,23,30,45,14,27,139,5,100
1037,3/11/2018 1:25,24,27,30,16,29,126,5,100
1038,3/11/2018 1:30,18,28,30,9,26,111,5,100
1039,3/11/2018 1:35,22,33,29,17,23,124,5,100
1040,3/11/2018 1:40,20,26,27,7,20,100,5,100
1041,3/11/2018 1:45,16,29,30,14,20,109,5,100
1042,3/11/2018 1:50,13,22,24,16,22,97,5,100
1043,3/11/2018 1:55,19,27,23,18,24,111,5,100
1044,3/11/2018 3:00,20,28,23,13,22,106,5,100
1045,3/11/2018 3:05,17,21,25,16,29,108,5,100
1046,3/11/2018 3:10,16,24,21,8,19,88,5,100
1047,3/11/2018 3:15,20,26,27,10,23,106,5,100
1048,3/11/2018 3:20,15,28,31,8,22,104,5,100
1049,3/11/2018 3:25,26,25,25,10,16,102,5,100
1050,3/11/2018 3:30,17,23,29,10,23,102,5,100
1051,3/11/2018 3:35,20,26,23,12,22,103,5,100
1052,3/11/2018 3:40,17,24,26,10,12,89,5,100
1053,3/11/2018 3:45,18,23,31,8,31,111,5,100
1054,3/11/2018 3:50,14,24,19,9,14,80,5,100
1055,3/11/2018 3:55,18,17,26,2,18,81,5,100
1056,3/11/2018 4:00,20,23,25,10,23,101,5,100
1057,3/11/2018 4:05,5,15,11,7,13,51,5,0
1058,3/11/2018 4:10,7,15,13,6,11,52,5,0
1059,3/11/2018 4:15,14,18,13,7,10,62,5,100
1060,3/11/2018 4:20,11,21,19,7,17,75,5,100
1061,3/11/2018 4:25,9,22,21,7,15,74,5,100
1062,3/11/2018 4:30,9,21,16,5,14,65,5,100
1063,3/11/2018 4:35,10,19,17,10,19,75,5,100
1064,3/11/2018 4:40,6,20,17,5,9,57,5,100
1065,3/11/2018 4:45,19,16,24,4,12,75,5,100
1066,3/11/2018 4:50,9,16,12,8,13,58,5,100
1067,3/11/2018 4:55,11,9,14,8,17,59,5,100
1068,3/11/2018 5:00,9,15,11,8,12,55,5,100
1069,3/11/2018 5:05,12,11,18,5,12,58,5,100
1070,3/11/2018 5:10,16,16,19,4,18,73,5,100
1071,3/11/2018 5:15,13,13,26,6,14,72,5,100
1072,3/11/2018 5:20,14,16,18,2,15,65,5,100
1073,3/11/2018 5:25,11,23,17,5,22,78,5,100
1074,3/11/2018 5:30,12,23,17,8,18,78,5,100
1075,3/11/2018 5:35,15,12,24,10,21,82,5,100
1076,3/11/2018 5:40,18,20,22,7,20,87,5,100
1077,3/11/2018 5:45,19,20,23,12,17,91,5,100
1078,3/11/2018 5:50,13,27,23,10,23,96,5,100
1079,3/11/2018 5:55,18,24,25,8,21,96,5,100
1080,3/11/2018 6:00,20,20,28,10,16,94,5,100
1081,3/11/2018 6:05,24,25,24,15,26,114,5,100
1082,3/11/2018 6:10,10,20,30,9,17,86,5,100
1083,3/11/2018 6:15,28,25,39,10,22,124,5,100
1084,3/11/2018 6:20,22,30,35,7,21,115,5,100
1085,3/11/2018 6:25,20,16,27,11,17,91,5,100
1086,3/11/2018 6:30,33,31,34,17,19,134,5,100
1087,3/11/2018 6:35,32,31,36,11,29,139,5,100
1088,3/11/2018 6:40,38,29,37,14,19,137,5,100
1089,3/11/2018 6:45,34,26,43,12,31,146,5,100
1090,3/11/2018 6:50,36,40,46,15,35,172,5,100
1091,3/11/2018 6:55,29,31,37,8,28,133,5,100
1092,3/11/2018 7:00,37,35,37,11,21,141,5,100
1093,3/11/2018 7:05,23,31,34,9,18,115,5,100
1094,3/11/2018 7:10,32,27,33,16,22,130,5,100
1095,3/11/2018 7:15,36,28,42,13,20,139,5,100
1096,3/11/2018 7:20,43,39,35,17,34,168,5,100
1097,3/11/2018 7:25,35,44,37,18,31,165,5,100
1098,3/11/2018 7:30,40,37,53,10,36,176,5,100
1099,3/11/2018 7:35,45,44,42,8,22,161,5,100
1100,3/11/2018 7:40,46,44,57,17,37,201,5,100
1101,3/11/2018 7:45,50,42,53,24,39,208,5,100
1102,3/11/2018 7:50,37,48,52,21,40,198,5,100
1103,3/11/2018 7:55,46,44,64,22,33,209,5,100
1104,3/11/2018 8:00,44,36,51,20,41,192,5,100
1105,3/11/2018 8:05,54,42,55,16,43,210,5,100
1106,3/11/2018 8:10,38,47,61,25,40,211,5,100
1107,3/11/2018 8:15,42,61,53,30,40,226,5,100
1108,3/11/2018 8:20,54,49,60,24,43,230,5,100
1109,3/11/2018 8:25,63,47,51,19,46,226,5,100
1110,3/11/2018 8:30,64,49,62,18,51,244,5,100
1111,3/11/2018 8:35,57,57,73,26,43,256,5,100
1112,3/11/2018 8:40,65,65,68,29,46,273,5,100
1113,3/11/2018 8:45,68,61,76,20,52,277,5,100
1114,3/11/2018 8:50,52,59,71,32,52,266,5,100
1115,3/11/2018 8:55,58,48,62,29,42,239,5,100
1116,3/11/2018 9:00,58,54,72,27,51,262,5,100
1117,3/11/2018 9:05,75,52,73,33,50,283,5,100
1118,3/11/2018 9:10,77,68,68,34,45,292,5,100
1119,3/11/2018 9:15,71,56,65,21,54,267,5,100
1120,3/11/2018 9:20,64,56,88,34,44,286,5,100
1121,3/11/2018 9:25,75,57,73,28,67,300,5,100
1122,3/11/2018 9:30,79,73,81,27,67,327,5,100
1123,3/11/2018 9:35,71,58,75,24,54,282,5,100
1124,3/11/2018 9:40,77,70,72,41,55,315,5,100
1125,3/11/2018 9:45,81,83,95,38,64,361,5,100
1126,3/11/2018 9:50,89,77,83,41,71,361,5,100
1127,3/11/2018 9:55,84,76,78,37,71,346,5,100
1128,3/11/2018 10:00,75,63,94,34,59,325,5,100
1129,3/11/2018 10:05,81,80,90,24,61,336,5,100
1130,3/11/2018 10:10,88,76,102,30,73,369,5,100
1131,3/11/2018 10:15,102,89,104,43,77,415,5,100
1132,3/11/2018 10:20,108,81,101,43,68,401,5,100
1133,3/11/2018 10:25,99,76,91,51,71,388,5,100
1134,3/11/2018 10:30,104,84,97,36,74,395,5,100
1135,3/11/2018 10:35,107,84,116,36,78,421,5,100
1136,3/11/2018 10:40,93,79,96,40,73,381,5,100
1137,3/11/2018 10:45,82,73,91,41,72,359,5,100
1138,3/11/2018 10:50,109,100,112,45,73,439,5,100
1139,3/11/2018 10:55,103,85,103,50,70,411,5,100
1140,3/11/2018 11:00,104,84,110,44,68,410,5,100
1141,3/11/2018 11:05,97,80,94,58,79,408,5,100
1142,3/11/2018 11:10,93,95,103,51,78,420,5,100
1143,3/11/2018 11:15,77,80,90,46,69,362,5,100
1144,3/11/2018 11:20,108,107,114,62,94,485,5,100
1145,3/11/2018 11:25,104,86,112,55,97,454,5,100
1146,3/11/2018 11:30,123,102,107,40,92,464,5,100
1147,3/11/2018 11:35,120,107,120,51,96,494,5,100
1148,3/11/2018 11:40,130,97,125,55,102,509,5,100
1149,3/11/2018 11:45,123,105,119,50,97,494,5,100
1150,3/11/2018 11:50,128,109,134,64,87,522,5,100
1151,3/11/2018 11:55,114,99,119,49,96,477,5,100
1152,3/11/2018 12:00,132,98,113,44,88,475,5,100
1153,3/11/2018 12:05,116,101,121,69,102,509,5,100
1154,3/11/2018 12:10,93,98,111,56,90,448,5,100
1155,3/11/2018 12:15,91,83,99,55,82,410,5,100
1156,3/11/2018 12:20,113,83,99,55,87,437,5,100
1157,3/11/2018 12:25,96,105,111,55,90,457,5,100
1158,3/11/2018 12:30,111,100,105,54,81,451,5,100
1159,3/11/2018 12:35,141,124,127,57,90,539,5,100
1160,3/11/2018 12:40,137,121,122,56,101,537,5,100
1161,3/11/2018 12:45,117,113,116,53,90,489,5,100
1162,3/11/2018 12:50,128,103,112,54,92,489,5,100
1163,3/11/2018 12:55,117,104,112,53,93,479,5,100
1164,3/11/2018 13:00,133,104,130,52,85,504,5,100
1165,3/11/2018 13:05,126,87,124,60,92,489,5,100
1166,3/11/2018 13:10,126,101,109,48,71,455,5,100
1167,3/11/2018 13:15,122,105,124,49,91,491,5,100
1168,3/11/2018 13:20,131,105,121,69,95,521,5,100
1169,3/11/2018 13:25,136,114,141,60,95,546,5,100
1170,3/11/2018 13:30,140,102,138,58,95,533,5,100
1171,3/11/2018 13:35,138,110,128,57,90,523,5,100
1172,3/11/2018 13:40,144,121,133,72,106,576,5,100
1173,3/11/2018 13:45,135,129,127,62,92,545,5,100
1174,3/11/2018 13:50,138,109,128,63,101,539,5,100
1175,3/11/2018 13:55,127,102,123,64,99,515,5,100
1176,3/11/2018 14:00,125,110,122,61,95,513,5,100
1177,3/11/2018 14:05,120,109,131,59,102,521,5,100
1178,3/11/2018 14:10,135,98,120,55,107,515,5,100
1179,3/11/2018 14:15,134,119,122,46,93,514,5,100
1180,3/11/2018 14:20,146,122,138,52,124,582,5,100
1181,3/11/2018 14:25,143,103,128,60,82,516,5,100
1182,3/11/2018 14:30,144,115,127,53,92,531,5,100
1183,3/11/2018 14:35,132,106,134,65,112,549,5,100
1184,3/11/2018 14:40,124,96,116,53,91,480,5,100
1185,3/11/2018 14:45,119,82,114,34,84,433,5,100
1186,3/11/2018 14:50,140,115,132,61,98,546,5,100
1187,3/11/2018 14:55,126,104,119,65,95,509,5,100
1188,3/11/2018 15:00,132,95,120,65,97,509,5,100
1189,3/11/2018 15:05,134,109,118,70,100,531,5,100
1190,3/11/2018 15:10,121,106,138,76,84,525,5,100
1191,3/11/2018 15:15,137,113,118,51,101,520,5,100
1192,3/11/2018 15:20,122,93,125,57,86,483,5,100
1193,3/11/2018 15:25,127,105,121,47,80,480,5,100
1194,3/11/2018 15:30,134,105,127,64,89,519,5,100
1195,3/11/2018 15:35,133,109,128,50,87,507,5,100
1196,3/11/2018 15:40,131,98,112,59,76,476,5,100
1197,3/11/2018 15:45,140,101,113,60,78,492,5,100
1198,3/11/2018 15:50,125,97,133,52,80,487,5,100
1199,3/11/2018 15:55,119,109,116,60,113,517,5,100
1200,3/11/2018 16:00,142,114,127,71,99,553,5,100
1201,3/11/2018 16:05,135,113,131,61,96,536,5,100
1202,3/11/2018 16:10,134,114,130,60,89,527,5,100
1203,3/11/2018 16:15,114,98,130,48,81,471,5,100
1204,3/11/2018 16:20,135,104,135,52,87,513,5,100
1205,3/11/2018 16:25,124,88,123,56,99,490,5,100
1206,3/11/2018 16:30,122,108,142,65,88,525,5,100
1207,3/11/2018 16:35,139,104,132,67,84,526,5,100
1208,3/11/2018 16:40,121,114,118,44,87,484,5,100
1209,3/11/2018 16:45,126,97,114,54,92,483,5,100
1210,3/11/2018 16:50,119,99,123,53,94,488,5,100
1211,3/11/2018 16:55,123,110,126,63,94,516,5,100
1212,3/11/2018 17:00,127,100,116,53,80,476,5,100
1213,3/11/2018 17:05,130,109,119,39,85,482,5,100
1214,3/11/2018 17:10,127,90,132,53,90,492,5,100
1215,3/11/2018 17:15,131,100,119,47,83,480,5,100
1216,3/11/2018 17:20,119,101,116,55,94,485,5,100
1217,3/11/2018 17:25,124,105,124,52,79,484,5,100
1218,3/11/2018 17:30,124,104,108,61,95,492,5,100
1219,3/11/2018 17:35,114,108,119,46,83,470,5,100
1220,3/11/2018 17:40,111,86,103,66,88,454,5,100
1221,3/11/2018 17:45,148,116,135,57,88,544,5,100
1222,3/11/2018 17:50,119,94,113,58,90,474,5,100
1223,3/11/2018 17:55,120,91,116,61,81,469,5,100
1224,3/11/2018 18:00,127,107,129,47,76,486,5,100
1225,3/11/2018 18:05,114,88,105,45,72,424,5,100
1226,3/11/2018 18:10,123,92,112,55,70,452,5,100
1227,3/11/2018 18:15,121,89,116,58,82,466,5,100
1228,3/11/2018 18:20,123,92,101,44,68,428,5,100
1229,3/11/2018 18:25,109,93,106,38,68,414,5,100
1230,3/11/2018 18:30,107,83,110,48,69,417,5,100
1231,3/11/2018 18:35,119,103,113,54,70,459,5,100
1232,3/11/2018 18:40,114,97,122,53,81,467,5,100
1233,3/11/2018 18:45,121,86,105,47,70,429,5,100
1234,3/11/2018 18:50,97,72,97,45,73,384,5,100
1235,3/11/2018 18:55,119,96,118,51,78,462,5,100
1236,3/11/2018 19:00,126,85,110,36,75,432,5,100
1237,3/11/2018 19:05,99,72,87,50,73,381,5,100
1238,3/11/2018 19:10,102,92,103,40,74,411,5,100
1239,3/11/2018 19:15,115,87,105,50,79,436,5,100
1240,3/11/2018 19:20,111,81,100,35,70,397,5,100
1241,3/11/2018 19:25,94,82,100,39,68,383,5,100
1242,3/11/2018 19:30,108,83,103,36,68,398,5,100
1243,3/11/2018 19:35,113,92,113,50,80,448,5,100
1244,3/11/2018 19:40,104,85,100,55,78,422,5,100
1245,3/11/2018 19:45,108,80,103,48,71,410,5,100
1246,3/11/2018 19:50,107,80,105,35,80,407,5,100
1247,3/11/2018 19:55,110,89,98,32,74,403,5,100
1248,3/11/2018 20:00,110,78,113,49,69,419,5,100
1249,3/11/2018 20:05,103,81,107,42,58,391,5,100
1250,3/11/2018 20:10,102,94,103,52,58,409,5,100
1251,3/11/2018 20:15,97,69,88,32,53,339,5,100
1252,3/11/2018 20:20,113,85,96,45,58,397,5,100
1253,3/11/2018 20:25,107,65,90,49,55,366,5,100
1254,3/11/2018 20:30,102,85,95,46,61,389,5,100
1255,3/11/2018 20:35,115,90,101,57,78,441,5,100
1256,3/11/2018 20:40,104,88,103,39,65,399,5,100
1257,3/11/2018 20:45,105,97,86,39,57,384,5,100
1258,3/11/2018 20:50,88,77,94,48,54,361,5,100
1259,3/11/2018 20:55,110,84,103,43,60,400,5,100
1260,3/11/2018 21:00,112,90,103,38,66,409,5,100
1261,3/11/2018 21:05,111,85,103,49,76,424,5,100
1262,3/11/2018 21:10,98,78,107,33,64,380,5,100
1263,3/11/2018 21:15,106,88,94,33,63,384,5,100
1264,3/11/2018 21:20,104,81,101,33,70,389,5,100
1265,3/11/2018 21:25,102,68,105,38,68,381,5,100
1266,3/11/2018 21:30,86,64,89,49,56,344,5,100
1267,3/11/2018 21:35,82,74,84,28,56,324,5,100
1268,3/11/2018 21:40,101,73,97,43,62,376,5,100
1269,3/11/2018 21:45,87,68,89,37,62,343,5,100
1270,3/11/2018 21:50,85,69,88,23,61,326,5,100
1271,3/11/2018 21:55,88,63,89,35,62,337,5,100
1272,3/11/2018 22:00,85,69,79,23,53,309,5,100
1273,3/11/2018 22:05,87,67,87,31,67,339,5,100
1274,3/11/2018 22:10,89,76,83,38,50,336,5,100
1275,3/11/2018 22:15,85,62,69,33,50,299,5,100
1276,3/11/2018 22:20,80,69,80,37,60,326,5,100
1277,3/11/2018 22:25,77,56,68,37,47,285,5,100
1278,3/11/2018 22:30,69,68,78,38,59,312,5,100
1279,3/11/2018 22:35,81,76,73,23,53,306,5,100
1280,3/11/2018 22:40,79,74,79,32,62,326,5,100
1281,3/11/2018 22:45,66,56,57,29,44,252,5,100
1282,3/11/2018 22:50,55,52,57,25,43,232,5,100
1283,3/11/2018 22:55,47,66,74,24,56,267,5,100
1284,3/11/2018 23:00,55,51,58,22,49,235,5,100
1285,3/11/2018 23:05,38,54,53,34,52,231,5,100
1286,3/11/2018 23:10,68,54,71,27,46,266,5,100
1287,3/11/2018 23:15,52,56,55,38,36,237,5,100
1288,3/11/2018 23:20,50,53,49,24,32,208,5,100
1289,3/11/2018 23:25,45,36,58,22,44,205,5,100
1290,3/11/2018 23:30,39,38,41,27,46,191,5,100
1291,3/11/2018 23:35,40,44,42,26,39,191,5,100
1292,3/11/2018 23:40,49,51,55,20,29,204,5,100
1293,3/11/2018 23:45,54,56,50,23,41,224,5,100
1294,3/11/2018 23:50,40,39,40,21,25,165,5,100
1295,3/11/2018 23:55,32,34,39,9,30,144,5,100
1296,3/12/2018 0:00,36,43,43,23,39,184,5,100
1297,3/12/2018 0:05,36,38,33,18,42,167,5,100
1298,3/12/2018 0:10,20,36,39,25,24,144,5,100
1299,3/12/2018 0:15,31,42,36,23,27,159,5,100
1300,3/12/2018 0:20,21,28,33,14,34,130,5,100
1301,3/12/2018 0:25,26,36,31,16,37,146,5,100
1302,3/12/2018 0:30,32,30,31,23,35,151,5,100
1303,3/12/2018 0:35,23,26,31,19,27,126,5,100
1304,3/12/2018 0:40,29,31,32,9,28,129,5,100
1305,3/12/2018 0:45,23,28,29,15,27,122,5,100
1306,3/12/2018 0:50,13,26,24,17,23,103,5,100
1307,3/12/2018 0:55,24,20,35,15,31,125,5,100
1308,3/12/2018 1:00,20,26,25,14,28,113,5,100
1309,3/12/2018 1:05,16,30,23,9,24,102,5,100
1310,3/12/2018 1:10,12,23,26,8,30,99,5,100
1311,3/12/2018 1:15,20,21,19,11,23,94,5,100
1312,3/12/2018 1:20,8,19,27,15,17,86,5,100
1313,3/12/2018 1:25,13,22,13,9,19,76,5,100
1314,3/12/2018 1:30,14,22,23,14,17,90,5,100
1315,3/12/2018 1:35,10,21,27,5,18,81,5,100
1316,3/12/2018 1:40,12,24,15,7,17,75,5,100
1317,3/12/2018 1:45,10,18,17,11,22,78,5,100
1318,3/12/2018 1:50,14,15,15,9,12,65,5,100
1319,3/12/2018 1:55,9,15,15,4,14,57,5,100
1320,3/12/2018 2:00,12,20,17,6,22,77,5,100
1321,3/12/2018 2:05,9,18,20,10,13,70,5,100
1322,3/12/2018 2:10,7,14,8,7,18,54,5,100
1323,3/12/2018 2:15,11,16,14,8,11,60,5,100
1324,3/12/2018 2:20,9,12,19,5,9,54,5,100
1325,3/12/2018 2:25,5,13,15,6,17,56,5,100
1326,3/12/2018 2:30,3,20,10,9,9,51,5,100
1327,3/12/2018 2:35,6,15,14,3,9,47,5,100
1328,3/12/2018 2:40,4,12,6,6,9,37,5,100
1329,3/12/2018 2:45,8,15,10,2,11,46,5,100
1330,3/12/2018 2:50,2,10,10,4,13,39,5,100
1331,3/12/2018 2:55,7,4,9,2,9,31,5,100
1332,3/12/2018 3:00,11,11,12,8,12,54,5,100
1333,3/12/2018 3:05,7,13,7,5,12,44,5,100
1334,3/12/2018 3:10,5,14,12,8,9,48,5,100
1335,3/12/2018 3:15,10,15,10,3,9,47,5,100
1336,3/12/2018 3:20,5,8,8,5,11,37,5,100
1337,3/12/2018 3:25,5,9,16,0,10,40,5,100
1338,3/12/2018 3:30,9,14,14,2,6,45,5,100
1339,3/12/2018 3:35,11,13,12,8,16,60,5,100
1340,3/12/2018 3:40,7,15,12,3,8,45,5,100
1341,3/12/2018 3:45,9,22,10,7,12,60,5,100
1342,3/12/2018 3:50,7,17,12,8,14,58,5,100
1343,3/12/2018 3:55,8,16,14,6,14,58,5,100
1344,3/12/2018 4:00,10,15,14,7,8,54,5,100
1345,3/12/2018 4:05,12,19,17,6,10,64,5,100
1346,3/12/2018 4:10,14,18,14,11,12,69,5,100
1347,3/12/2018 4:15,17,12,22,11,12,74,5,100
1348,3/12/2018 4:20,18,17,21,10,10,76,5,100
1349,3/12/2018 4:25,21,21,17,10,23,92,5,100
1350,3/12/2018 4:30,22,22,28,12,23,107,5,100
1351,3/12/2018 4:35,7,19,20,8,19,73,5,100
1352,3/12/2018 4:40,45,39,47,18,21,170,5,100
1353,3/12/2018 4:45,29,36,39,14,22,140,5,100
1354,3/12/2018 4:50,31,25,37,20,24,137,5,100
1355,3/12/2018 4:55,28,28,35,15,24,130,5,100
1356,3/12/2018 5:00,41,42,39,9,26,157,5,100
1357,3/12/2018 5:05,36,29,50,14,34,163,5,100
1358,3/12/2018 5:10,51,45,39,16,26,177,5,100
1359,3/12/2018 5:15,60,50,68,21,35,234,5,100
1360,3/12/2018 5:20,65,49,59,17,31,221,5,100
1361,3/12/2018 5:25,66,57,70,19,41,253,5,100
1362,3/12/2018 5:30,73,60,69,21,44,267,5,100
1363,3/12/2018 5:35,89,62,73,37,56,317,5,100
1364,3/12/2018 5:40,89,69,80,39,50,327,5,100
1365,3/12/2018 5:45,84,65,79,30,60,318,5,100
1366,3/12/2018 5:50,80,62,73,40,46,301,5,100
1367,3/12/2018 5:55,87,49,90,36,46,308,5,100
1368,3/12/2018 6:00,83,63,86,44,54,330,5,100
1369,3/12/2018 6:05,78,58,75,39,45,295,5,100
1370,3/12/2018 6:10,95,66,86,39,52,338,5,100
1371,3/12/2018 6:15,77,68,85,38,53,321,5,100
1372,3/12/2018 6:20,86,67,87,30,53,323,5,100
1373,3/12/2018 6:25,99,80,89,29,63,360,5,100
1374,3/12/2018 6:30,116,71,90,51,69,397,5,100
1375,3/12/2018 6:35,94,81,99,45,79,398,5,100
1376,3/12/2018 6:40,119,77,114,56,78,444,5,100
1377,3/12/2018 6:45,100,87,91,65,74,417,5,100
1378,3/12/2018 6:50,123,90,109,59,78,459,5,100
1379,3/12/2018 6:55,84,76,91,55,66,372,5,100
1380,3/12/2018 7:00,116,79,110,54,68,427,5,100
1381,3/12/2018 7:05,124,87,118,49,66,444,5,100
1382,3/12/2018 7:10,129,89,119,65,77,479,5,100
1383,3/12/2018 7:15,125,94,126,61,90,496,5,100
1384,3/12/2018 7:20,144,98,133,69,96,540,5,100
1385,3/12/2018 7:25,141,98,122,63,89,513,5,100
1386,3/12/2018 7:30,156,116,135,73,92,572,5,100
1387,3/12/2018 7:35,174,115,156,85,111,641,5,100
1388,3/12/2018 7:40,148,127,155,85,95,610,5,100
1389,3/12/2018 7:45,136,109,120,61,83,509,5,100
1390,3/12/2018 7:50,157,108,132,69,95,561,5,100
1391,3/12/2018 7:55,156,99,131,68,103,557,5,100
1392,3/12/2018 8:00,151,94,131,100,97,573,5,100
1393,3/12/2018 8:05,128,92,122,85,87,514,5,100
1394,3/12/2018 8:10,147,89,130,80,88,534,5,100
1395,3/12/2018 8:15,140,107,118,94,88,547,5,100
1396,3/12/2018 8:20,142,104,123,76,100,545,5,100
1397,3/12/2018 8:25,138,103,131,81,95,548,5,100
1398,3/12/2018 8:30,133,100,111,65,76,485,5,100
1399,3/12/2018 8:35,131,111,132,71,97,542,5,100
1400,3/12/2018 8:40,143,107,122,81,83,536,5,100
1401,3/12/2018 8:45,152,103,122,70,82,529,5,100
1402,3/12/2018 8:50,143,109,124,80,79,535,5,100
1403,3/12/2018 8:55,144,104,120,77,80,525,5,100
1404,3/12/2018 9:00,119,79,119,69,84,470,5,100
1405,3/12/2018 9:05,134,100,122,64,83,503,5,100
1406,3/12/2018 9:10,120,90,99,57,87,453,5,100
1407,3/12/2018 9:15,128,92,107,79,90,496,5,100
1408,3/12/2018 9:20,155,100,113,60,82,510,5,100
1409,3/12/2018 9:25,123,95,115,64,93,490,5,100
1410,3/12/2018 9:30,122,87,112,67,75,463,5,100
1411,3/12/2018 9:35,130,96,114,53,70,463,5,100
1412,3/12/2018 9:40,107,80,106,66,73,432,5,100
1413,3/12/2018 9:45,114,96,102,66,71,449,5,100
1414,3/12/2018 9:50,92,73,83,47,74,369,5,100
1415,3/12/2018 9:55,92,69,92,53,57,363,5,100
1416,3/12/2018 10:00,97,86,86,39,75,383,5,100
1417,3/12/2018 10:05,100,79,106,55,74,414,5,100
1418,3/12/2018 10:10,120,95,96,51,91,453,5,100
1419,3/12/2018 10:15,97,85,98,58,75,413,5,100
1420,3/12/2018 10:20,95,87,118,57,83,440,5,100
1421,3/12/2018 10:25,112,85,114,48,66,425,5,100
1422,3/12/2018 10:30,103,87,104,56,78,428,5,100
1423,3/12/2018 10:35,97,96,112,60,72,437,5,100
1424,3/12/2018 10:40,110,78,106,50,65,409,5,100
1425,3/12/2018 10:45,112,85,112,50,88,447,5,100
1426,3/12/2018 10:50,110,78,95,51,80,414,5,100
1427,3/12/2018 10:55,116,76,110,56,90,448,5,100
1428,3/12/2018 11:00,116,89,118,51,75,449,5,100
1429,3/12/2018 11:05,110,83,107,57,69,426,5,100
1430,3/12/2018 11:10,132,100,129,65,89,515,5,100
1431,3/12/2018 11:15,112,85,107,68,83,455,5,100
1432,3/12/2018 11:20,129,96,117,64,83,489,5,100
1433,3/12/2018 11:25,123,101,113,54,78,469,5,100
1434,3/12/2018 11:30,140,104,129,64,98,535,5,100
1435,3/12/2018 11:35,103,103,117,51,82,456,5,100
1436,3/12/2018 11:40,121,85,124,66,90,486,5,100
1437,3/12/2018 11:45,135,96,114,59,82,486,5,100
1438,3/12/2018 11:50,136,122,130,61,82,531,5,100
1439,3/12/2018 11:55,126,105,119,62,94,506,5,100
1440,3/12/2018 12:00,122,98,114,56,99,489,5,100
1441,3/12/2018 12:05,130,98,129,68,87,512,5,100
1442,3/12/2018 12:10,134,96,123,64,93,510,5,100
1443,3/12/2018 12:15,131,94,117,53,96,491,5,100
1444,3/12/2018 12:20,144,104,130,53,94,525,5,100
1445,3/12/2018 12:25,137,80,119,60,81,477,5,100
1446,3/12/2018 12:30,144,96,126,61,97,524,5,100
1447,3/12/2018 12:35,126,101,120,61,86,494,5,100
1448,3/12/2018 12:40,134,115,126,74,103,552,5,100
1449,3/12/2018 12:45,112,91,112,70,83,468,5,100
1450,3/12/2018 12:50,136,111,143,63,99,552,5,100
1451,3/12/2018 12:55,120,81,106,49,72,428,5,100
1452,3/12/2018 13:00,137,91,128,69,104,529,5,100
1453,3/12/2018 13:05,130,101,109,71,92,503,5,100
1454,3/12/2018 13:10,136,97,119,72,91,515,5,100
1455,3/12/2018 13:15,142,112,128,63,91,536,5,100
1456,3/12/2018 13:20,147,112,122,74,83,538,5,100
1457,3/12/2018 13:25,147,114,122,62,100,545,5,100
1458,3/12/2018 13:30,146,108,136,62,88,540,5,100
1459,3/12/2018 13:35,136,105,119,67,89,516,5,100
1460,3/12/2018 13:40,137,108,119,68,97,529,5,100
1461,3/12/2018 13:45,134,99,147,64,108,552,5,100
1462,3/12/2018 13:50,125,104,133,70,88,520,5,100
1463,3/12/2018 13:55,138,100,123,74,88,523,5,100
1464,3/12/2018 14:00,133,101,130,65,92,521,5,100
1465,3/12/2018 14:05,138,105,124,73,106,546,5,100
1466,3/12/2018 14:10,140,108,141,67,99,555,5,100
1467,3/12/2018 14:15,134,105,131,75,96,541,5,100
1468,3/12/2018 14:20,143,96,143,98,102,582,5,100
1469,3/12/2018 14:25,144,110,147,95,92,588,5,100
1470,3/12/2018 14:30,152,117,143,85,102,599,5,100
1471,3/12/2018 14:35,147,106,128,88,116,585,5,100
1472,3/12/2018 14:40,125,103,116,97,89,530,5,100
1473,3/12/2018 14:45,137,109,123,94,100,563,5,100
1474,3/12/2018 14:50,116,116,125,103,101,561,5,100
1475,3/12/2018 14:55,108,105,101,101,91,506,5,100
1476,3/12/2018 15:00,116,97,108,114,108,543,5,100
1477,3/12/2018 15:05,137,111,127,93,88,556,5,100
1478,3/12/2018 15:10,118,105,119,90,91,523,5,100
1479,3/12/2018 15:15,124,100,115,115,93,547,5,100
1480,3/12/2018 15:20,113,96,121,90,91,511,5,100
1481,3/12/2018 15:25,114,91,116,90,103,514,5,100
1482,3/12/2018 15:30,106,90,115,89,93,493,5,100
1483,3/12/2018 15:35,116,81,112,86,71,466,5,100
1484,3/12/2018 15:40,109,100,116,87,86,498,5,100
1485,3/12/2018 15:45,119,89,95,80,83,466,5,100
1486,3/12/2018 15:50,133,98,116,80,78,505,5,100
1487,3/12/2018 15:55,125,86,120,75,86,492,5,100
1488,3/12/2018 16:00,113,106,116,81,92,508,5,100
1489,3/12/2018 16:05,60,78,76,111,82,407,5,100
1490,3/12/2018 16:10,62,51,56,88,75,332,5,100
1491,3/12/2018 16:15,65,53,61,85,75,339,5,100
1492,3/12/2018 16:20,59,52,58,87,74,330,5,100
1493,3/12/2018 16:25,59,50,48,79,64,300,5,100
1494,3/12/2018 16:30,23,19,19,45,34,140,5,100
1495,3/12/2018 16:35,56,31,43,51,58,239,5,100
1496,3/12/2018 16:40,40,26,34,63,57,220,5,100
1497,3/12/2018 16:45,44,41,43,59,53,240,5,100
1498,3/12/2018 16:50,59,43,48,62,53,265,5,100
1499,3/12/2018 16:55,61,54,49,77,64,305,5,100
1500,3/12/2018 17:00,72,45,52,61,48,278,5,100
1501,3/12/2018 17:05,55,53,51,73,57,289,5,100
1502,3/12/2018 17:10,84,79,76,101,73,413,5,100
1503,3/12/2018 17:15,85,80,80,111,93,449,5,100
1504,3/12/2018 17:20,79,69,80,110,87,425,5,100
1505,3/12/2018 17:25,81,73,72,105,83,414,5,100
1506,3/12/2018 17:30,75,64,64,96,76,375,5,100
1507,3/12/2018 17:35,80,64,70,102,76,392,5,100
1508,3/12/2018 17:40,80,75,85,92,73,405,5,100
1509,3/12/2018 17:45,80,83,91,99,89,442,5,100
1510,3/12/2018 17:50,86,89,95,94,85,449,5,100
1511,3/12/2018 17:55,84,75,100,81,82,422,5,100
1512,3/12/2018 18:00,52,44,61,61,47,265,5,100
1513,3/12/2018 18:05,94,82,101,87,69,433,5,100
1514,3/12/2018 18:10,135,108,134,106,112,595,5,100
1515,3/12/2018 18:15,117,109,118,88,89,521,5,100
1516,3/12/2018 18:20,125,87,115,92,77,496,5,100
1517,3/12/2018 18:25,93,90,95,109,75,462,5,100
1518,3/12/2018 18:30,74,65,74,97,77,387,5,100
1519,3/12/2018 18:35,69,63,68,95,80,375,5,100
1520,3/12/2018 18:40,75,65,65,84,72,361,5,100
1521,3/12/2018 18:45,64,52,62,101,65,344,5,100
1522,3/12/2018 18:50,73,56,59,79,68,335,5,100
1523,3/12/2018 18:55,63,51,58,87,57,316,5,100
1524,3/12/2018 19:00,68,56,61,96,63,344,5,100
1525,3/12/2018 19:05,71,49,54,92,63,329,5,100
1526,3/12/2018 19:10,67,46,58,79,41,291,5,100
1527,3/12/2018 19:15,69,47,58,83,60,317,5,100
1528,3/12/2018 19:20,68,50,57,79,51,305,5,100
1529,3/12/2018 19:25,62,44,66,90,51,313,5,100
1530,3/12/2018 19:30,69,49,62,74,55,309,5,100
1531,3/12/2018 19:35,74,44,67,87,51,323,5,100
1532,3/12/2018 19:40,87,63,77,89,68,384,5,100
1533,3/12/2018 19:45,101,91,94,104,92,482,5,100
1534,3/12/2018 19:50,94,80,86,105,82,447,5,100
1535,3/12/2018 19:55,98,78,113,90,76,455,5,100
1536,3/12/2018 20:00,109,71,99,72,77,428,5,100
1537,3/12/2018 20:05,120,87,113,70,74,464,5,100
1538,3/12/2018 20:10,139,103,109,62,83,496,5,100
1539,3/12/2018 20:15,115,94,120,51,74,454,5,100
1540,3/12/2018 20:20,111,84,105,53,79,432,5,100
1541,3/12/2018 20:25,128,92,123,47,70,460,5,100
1542,3/12/2018 20:30,90,72,87,42,76,367,5,100
1543,3/12/2018 20:35,109,77,95,46,59,386,5,100
1544,3/12/2018 20:40,97,78,89,30,61,355,5,100
1545,3/12/2018 20:45,91,86,91,46,61,375,5,100
1546,3/12/2018 20:50,92,76,91,45,62,366,5,100
1547,3/12/2018 20:55,100,70,83,32,65,350,5,100
1548,3/12/2018 21:00,91,70,98,34,65,358,5,100
1549,3/12/2018 21:05,83,81,80,43,56,343,5,100
1550,3/12/2018 21:10,84,79,86,34,51,334,5,100
1551,3/12/2018 21:15,91,81,81,56,74,383,5,100
1552,3/12/2018 21:20,90,75,94,43,58,360,5,100
1553,3/12/2018 21:25,93,60,81,37,55,326,5,100
1554,3/12/2018 21:30,75,66,78,38,52,309,5,100
1555,3/12/2018 21:35,76,70,75,37,54,312,5,100
1556,3/12/2018 21:40,71,62,72,31,50,286,5,100
1557,3/12/2018 21:45,73,65,75,32,51,296,5,100
1558,3/12/2018 21:50,74,75,92,40,50,331,5,100
1559,3/12/2018 21:55,79,66,81,34,52,312,5,100
1560,3/12/2018 22:00,77,52,75,37,69,310,5,100
1561,3/12/2018 22:05,75,76,74,31,72,328,5,100
1562,3/12/2018 22:10,83,70,74,31,51,309,5,100
1563,3/12/2018 22:15,71,66,77,35,60,309,5,100
1564,3/12/2018 22:20,72,70,77,35,52,306,5,100
1565,3/12/2018 22:25,69,63,70,28,54,284,5,100
1566,3/12/2018 22:30,54,54,60,29,48,245,5,100
1567,3/12/2018 22:35,55,53,68,27,53,256,5,100
1568,3/12/2018 22:40,57,58,66,34,53,268,5,100
1569,3/12/2018 22:45,56,55,59,30,51,251,5,100
1570,3/12/2018 22:50,47,43,63,30,31,214,5,100
1571,3/12/2018 22:55,53,48,59,22,39,221,5,100
1572,3/12/2018 23:00,47,53,54,24,40,218,5,100
1573,3/12/2018 23:05,62,50,61,27,53,253,5,100
1574,3/12/2018 23:10,40,47,57,21,49,214,5,100
1575,3/12/2018 23:15,36,54,49,29,36,204,5,100
1576,3/12/2018 23:20,36,45,51,21,30,183,5,100
1577,3/12/2018 23:25,33,43,41,25,31,173,5,100
1578,3/12/2018 23:30,42,41,45,23,38,189,5,100
1579,3/12/2018 23:35,29,35,40,14,43,161,5,100
1580,3/12/2018 23:40,35,36,51,30,37,189,5,100
1581,3/12/2018 23:45,29,48,45,20,40,182,5,100
1582,3/12/2018 23:50,33,32,39,17,36,157,5,100
1583,3/12/2018 23:55,34,28,32,18,46,158,5,100
1584,3/13/2018 0:00,23,35,32,25,33,148,5,100
1585,3/13/2018 0:05,27,35,42,15,27,146,5,100
1586,3/13/2018 0:10,28,34,35,27,34,158,5,100
1587,3/13/2018 0:15,26,40,31,18,30,145,5,100
1588,3/13/2018 0:20,25,37,26,14,40,142,5,100
1589,3/13/2018 0:25,20,37,37,17,32,143,5,100
1590,3/13/2018 0:30,21,29,29,12,26,117,5,100
1591,3/13/2018 0:35,18,33,23,11,34,119,5,100
1592,3/13/2018 0:40,22,33,30,14,34,133,5,100
1593,3/13/2018 0:45,27,25,25,24,25,126,5,100
1594,3/13/2018 0:50,15,32,18,10,25,100,5,100
1595,3/13/2018 0:55,14,17,30,9,23,93,5,100
1596,3/13/2018 1:00,11,19,22,15,20,87,5,100
1597,3/13/2018 1:05,13,21,28,7,25,94,5,100
1598,3/13/2018 1:10,18,30,17,20,27,112,5,100
1599,3/13/2018 1:15,9,21,22,19,22,93,5,100
1600,3/13/2018 1:20,14,23,15,11,23,86,5,100
1601,3/13/2018 1:25,13,26,27,13,19,98,5,100
1602,3/13/2018 1:30,9,17,10,5,23,64,5,100
1603,3/13/2018 1:35,11,19,14,9,13,66,5,100
1604,3/13/2018 1:40,12,20,20,8,21,81,5,100
1605,3/13/2018 1:45,6,21,17,7,26,77,5,100
1606,3/13/2018 1:50,7,15,23,7,17,69,5,100
1607,3/13/2018 1:55,7,14,19,8,10,58,5,100
1608,3/13/2018 2:00,8,12,13,11,13,57,5,100
1609,3/13/2018 2:05,9,16,10,11,18,64,5,100
1610,3/13/2018 2:10,6,20,11,8,15,60,5,100
1611,3/13/2018 2:15,13,17,17,6,17,70,5,100
1612,3/13/2018 2:20,13,13,17,6,10,59,5,100
1613,3/13/2018 2:25,6,18,20,7,12,63,5,100
1614,3/13/2018 2:30,8,12,9,6,16,51,5,100
1615,3/13/2018 2:35,4,17,10,8,13,52,5,100
1616,3/13/2018 2:40,8,22,9,5,15,59,5,100
1617,3/13/2018 2:45,8,18,19,6,11,62,5,100
1618,3/13/2018 2:50,6,14,16,8,9,53,5,100
1619,3/13/2018 2:55,6,16,7,2,9,40,5,100
1620,3/13/2018 3:00,7,14,7,8,7,43,5,100
1621,3/13/2018 3:05,6,10,5,3,8,32,5,100
1622,3/13/2018 3:10,12,17,8,3,11,51,5,100
1623,3/13/2018 3:15,3,16,10,4,13,46,5,100
1624,3/13/2018 3:20,4,19,11,5,9,48,5,100
1625,3/13/2018 3:25,8,20,15,6,18,67,5,100
1626,3/13/2018 3:30,10,13,15,5,12,55,5,100
1627,3/13/2018 3:35,12,16,16,7,10,61,5,100
1628,3/13/2018 3:40,4,15,15,8,24,66,5,100
1629,3/13/2018 3:45,9,16,10,3,18,56,5,100
1630,3/13/2018 3:50,9,14,16,9,17,65,5,100
1631,3/13/2018 3:55,5,18,17,9,8,57,5,100
1632,3/13/2018 4:00,11,14,12,9,14,60,5,100
1633,3/13/2018 4:05,12,19,14,6,9,60,5,100
1634,3/13/2018 4:10,15,23,30,10,19,97,5,100
1635,3/13/2018 4:15,12,17,22,6,13,70,5,100
1636,3/13/2018 4:20,13,23,18,11,9,74,5,100
1637,3/13/2018 4:25,16,20,24,6,8,74,5,100
1638,3/13/2018 4:30,10,24,28,16,20,98,5,100
1639,3/13/2018 4:35,29,26,35,14,20,124,5,100
1640,3/13/2018 4:40,37,21,33,18,23,132,5,100
1641,3/13/2018 4:45,40,37,39,15,25,156,5,100
1642,3/13/2018 4:50,29,31,31,16,36,143,5,100
1643,3/13/2018 4:55,37,36,36,13,25,147,5,100
1644,3/13/2018 5:00,39,36,48,19,25,167,5,100
1645,3/13/2018 5:05,41,47,43,15,31,177,5,100
1646,3/13/2018 5:10,53,46,50,18,26,193,5,100
1647,3/13/2018 5:15,51,34,53,12,27,177,5,100
1648,3/13/2018 5:20,66,49,64,23,42,244,5,100
1649,3/13/2018 5:25,63,44,61,22,36,226,5,100
1650,3/13/2018 5:30,70,49,67,25,47,258,5,100
1651,3/13/2018 5:35,81,66,87,32,53,319,5,100
1652,3/13/2018 5:40,73,67,82,37,45,304,5,100
1653,3/13/2018 5:45,72,52,80,38,58,300,5,100
1654,3/13/2018 5:50,82,65,70,30,52,299,5,100
1655,3/13/2018 5:55,73,57,75,35,47,287,5,100
1656,3/13/2018 6:00,89,71,79,35,50,324,5,100
1657,3/13/2018 6:05,85,63,85,38,52,323,5,100
1658,3/13/2018 6:10,77,75,83,43,54,332,5,100
1659,3/13/2018 6:15,83,63,89,29,51,315,5,100
1660,3/13/2018 6:20,100,76,85,46,51,358,5,100
1661,3/13/2018 6:25,96,77,85,50,62,370,5,100
1662,3/13/2018 6:30,100,78,99,42,65,384,5,100
1663,3/13/2018 6:35,94,76,83,44,82,379,5,100
1664,3/13/2018 6:40,116,90,107,63,64,440,5,100
1665,3/13/2018 6:45,106,83,112,47,68,416,5,100
1666,3/13/2018 6:50,114,100,110,63,70,457,5,100
1667,3/13/2018 6:55,123,90,111,69,79,472,5,100
1668,3/13/2018 7:00,118,77,112,58,68,433,5,100
1669,3/13/2018 7:05,119,81,114,50,82,446,5,100
1670,3/13/2018 7:10,126,98,122,68,81,495,5,100
1671,3/13/2018 7:15,139,98,121,64,87,509,5,100
1672,3/13/2018 7:20,135,101,116,55,85,492,5,100
1673,3/13/2018 7:25,146,105,141,72,91,555,5,100
1674,3/13/2018 7:30,174,123,151,81,84,613,5,100
1675,3/13/2018 7:35,141,118,136,82,94,571,5,100
1676,3/13/2018 7:40,158,124,142,83,112,619,5,100
1677,3/13/2018 7:45,173,116,164,67,98,618,5,100
1678,3/13/2018 7:50,154,104,144,72,103,577,5,100
1679,3/13/2018 7:55,135,91,119,85,89,519,5,100
1680,3/13/2018 8:00,149,110,130,81,87,557,5,100
1681,3/13/2018 8:05,151,104,135,84,95,569,5,100
1682,3/13/2018 8:10,141,95,121,70,93,520,5,100
1683,3/13/2018 8:15,142,104,126,79,90,541,5,100
1684,3/13/2018 8:20,150,114,130,72,105,571,5,100
1685,3/13/2018 8:25,151,96,127,88,95,557,5,100
1686,3/13/2018 8:30,141,113,135,87,94,570,5,100
1687,3/13/2018 8:35,128,80,125,58,79,470,5,100
1688,3/13/2018 8:40,151,107,124,88,86,556,5,100
1689,3/13/2018 8:45,134,104,117,57,79,491,5,100
1690,3/13/2018 8:50,149,100,142,85,94,570,5,100
1691,3/13/2018 8:55,141,105,124,67,102,539,5,100
1692,3/13/2018 9:00,142,102,140,80,85,549,5,100
1693,3/13/2018 9:05,131,74,115,60,83,463,5,100
1694,3/13/2018 9:10,130,87,125,68,95,505,5,100
1695,3/13/2018 9:15,127,102,127,56,91,503,5,100
1696,3/13/2018 9:20,124,94,112,66,81,477,5,100
1697,3/13/2018 9:25,129,80,108,64,91,472,5,100
1698,3/13/2018 9:30,132,100,126,79,91,528,5,100
1699,3/13/2018 9:35,129,95,131,63,89,507,5,100
1700,3/13/2018 9:40,148,106,132,64,96,546,5,100
1701,3/13/2018 9:45,110,85,121,40,81,437,5,100
1702,3/13/2018 9:50,98,95,105,42,81,421,5,100
1703,3/13/2018 9:55,118,91,97,45,91,442,5,100
1704,3/13/2018 10:00,101,90,98,52,87,428,5,100
1705,3/13/2018 10:05,121,82,99,56,77,435,5,100
1706,3/13/2018 10:10,105,82,109,57,66,419,5,100
1707,3/13/2018 10:15,120,95,119,60,84,478,5,100
1708,3/13/2018 10:20,118,97,109,52,94,470,5,100
1709,3/13/2018 10:25,109,84,116,74,80,463,5,100
1710,3/13/2018 10:30,117,86,110,58,75,446,5,100
1711,3/13/2018 10:35,123,92,107,63,80,465,5,100
1712,3/13/2018 10:40,127,103,120,59,93,502,5,100
1713,3/13/2018 10:45,109,93,109,58,92,461,5,100
1714,3/13/2018 10:50,116,83,97,56,89,441,5,100
1715,3/13/2018 10:55,105,74,107,62,90,438,5,100
1716,3/13/2018 11:00,129,90,116,51,70,456,5,100
1717,3/13/2018 11:05,119,92,104,60,87,462,5,100
1718,3/13/2018 11:10,115,77,104,58,78,432,5,100
1719,3/13/2018 11:15,119,92,111,67,78,467,5,100
1720,3/13/2018 11:20,104,96,111,54,99,464,5,100
1721,3/13/2018 11:25,128,85,115,41,83,452,5,100
1722,3/13/2018 11:30,117,89,124,53,77,460,5,100
1723,3/13/2018 11:35,108,86,95,53,78,420,5,100
1724,3/13/2018 11:40,130,90,115,69,103,507,5,100
1725,3/13/2018 11:45,121,100,124,59,99,503,5,100
1726,3/13/2018 11:50,117,101,110,54,96,478,5,100
1727,3/13/2018 11:55,127,97,109,60,87,480,5,100
0,3/13/2018 11:00,129,90,116,51,70,456,5,100
1,3/13/2018 11:05,119,92,104,60,87,462,5,100
2,3/13/2018 11:10,115,77,104,58,78,432,5,100
3,3/13/2018 11:15,119,92,111,67,78,467,5,100
4,3/13/2018 11:20,104,96,111,54,99,464,5,100
5,3/13/2018 11:25,128,85,115,41,83,452,5,100
6,3/13/2018 11:30,117,89,124,53,77,460,5,100
7,3/13/2018 11:35,108,86,95,53,78,420,5,100
8,3/13/2018 11:40,130,90,115,69,103,507,5,100
9,3/13/2018 11:45,121,100,124,59,99,503,5,100
10,3/13/2018 11:50,117,101,110,54,96,478,5,100
11,3/13/2018 11:55,127,97,109,60,87,480,5,100
12,3/13/2018 12:00,133,102,96,58,101,490,5,100
13,3/13/2018 12:05,127,96,113,52,89,477,5,100
14,3/13/2018 12:10,148,93,137,66,93,537,5,100
15,3/13/2018 12:15,150,103,128,51,98,530,5,100
16,3/13/2018 12:20,138,97,124,72,93,524,5,100
17,3/13/2018 12:25,128,105,121,71,90,515,5,100
18,3/13/2018 12:30,137,98,128,58,89,510,5,100
19,3/13/2018 12:35,129,89,114,58,82,472,5,100
20,3/13/2018 12:40,119,93,119,55,88,474,5,100
21,3/13/2018 12:45,136,105,113,64,102,520,5,100
22,3/13/2018 12:50,145,99,132,73,88,537,5,100
23,3/13/2018 12:55,127,88,125,73,82,495,5,100
24,3/13/2018 13:00,132,102,119,55,79,487,5,100
25,3/13/2018 13:05,136,102,135,70,95,538,5,100
26,3/13/2018 13:10,125,111,118,61,103,518,5,100
27,3/13/2018 13:15,130,86,121,63,100,500,5,100
28,3/13/2018 13:20,134,103,126,67,96,526,5,100
29,3/13/2018 13:25,143,91,118,61,82,495,5,100
30,3/13/2018 13:30,139,98,121,69,98,525,5,100
31,3/13/2018 13:35,121,89,97,66,97,470,5,100
32,3/13/2018 13:40,145,117,126,93,111,592,5,100
33,3/13/2018 13:45,134,101,129,70,102,536,5,100
34,3/13/2018 13:50,132,112,125,67,110,546,5,100
35,3/13/2018 13:55,120,107,116,73,94,510,5,100
36,3/13/2018 14:00,130,96,117,86,95,524,5,100
37,3/13/2018 14:05,99,78,100,93,94,464,5,100
38,3/13/2018 14:10,86,81,93,117,99,476,5,100
39,3/13/2018 14:15,71,81,77,91,70,390,5,100
40,3/13/2018 14:20,90,91,87,105,90,463,5,100
41,3/13/2018 14:25,71,74,75,101,76,397,5,100
42,3/13/2018 14:30,85,55,79,89,70,378,5,100
43,3/13/2018 14:35,78,70,68,104,80,400,5,100
44,3/13/2018 14:40,80,74,74,96,75,399,5,100
45,3/13/2018 14:45,70,61,61,89,67,348,5,100
46,3/13/2018 14:50,72,64,64,99,76,375,5,100
47,3/13/2018 14:55,70,51,64,71,62,318,5,100
48,3/13/2018 15:00,63,51,59,69,49,291,5,100
49,3/13/2018 15:05,76,63,69,89,58,355,5,100
50,3/13/2018 15:10,86,78,81,107,86,438,5,100
51,3/13/2018 15:15,87,71,84,88,74,404,5,100
52,3/13/2018 15:20,77,62,68,91,63,361,5,100
53,3/13/2018 15:25,83,58,80,81,67,369,5,100
54,3/13/2018 15:30,75,67,75,87,71,375,5,100
55,3/13/2018 15:35,70,63,65,93,71,362,5,100
56,3/13/2018 15:40,73,68,69,83,58,351,5,100
57,3/13/2018 15:45,67,56,64,85,53,325,5,100
58,3/13/2018 15:50,70,53,67,73,53,316,5,100
59,3/13/2018 15:55,83,67,74,98,77,399,5,100
60,3/13/2018 16:00,70,59,64,72,63,328,5,100
61,3/13/2018 16:05,61,59,55,83,61,319,5,100
62,3/13/2018 16:10,75,61,63,74,67,340,5,100
63,3/13/2018 16:15,75,60,64,88,83,370,5,100
64,3/13/2018 16:20,62,52,56,93,67,330,5,100
65,3/13/2018 16:25,79,60,65,111,69,384,5,100
66,3/13/2018 16:30,71,59,60,109,69,368,5,100
67,3/13/2018 16:35,65,59,49,78,56,307,5,100
68,3/13/2018 16:40,65,58,54,84,71,332,5,100
69,3/13/2018 16:45,68,55,64,96,78,361,5,100
70,3/13/2018 16:50,62,46,56,94,77,335,5,100
71,3/13/2018 16:55,56,44,46,70,49,265,5,100
72,3/13/2018 17:00,61,50,47,78,64,300,5,100
73,3/13/2018 17:05,63,57,61,86,69,336,5,100
74,3/13/2018 17:10,47,55,48,91,67,308,5,100
75,3/13/2018 17:15,56,31,46,73,53,259,5,100
76,3/13/2018 17:20,64,45,52,92,69,322,5,100
77,3/13/2018 17:25,58,50,56,87,67,318,5,100
78,3/13/2018 17:30,68,65,66,104,85,388,5,100
79,3/13/2018 17:35,67,68,71,88,75,369,5,100
80,3/13/2018 17:40,61,50,54,97,69,331,5,100
81,3/13/2018 17:45,36,29,47,74,47,233,5,100
82,3/13/2018 17:50,56,37,56,78,65,292,5,100
83,3/13/2018 17:55,76,77,82,124,93,452,5,100
84,3/13/2018 18:00,66,62,61,97,81,367,5,100
85,3/13/2018 18:05,77,65,77,125,96,440,5,100
86,3/13/2018 18:10,77,73,73,110,77,410,5,100
87,3/13/2018 18:15,60,53,60,86,65,324,5,100
88,3/13/2018 18:20,65,63,62,90,74,354,5,100
89,3/13/2018 18:25,73,72,69,99,84,397,5,100
90,3/13/2018 18:30,58,40,54,91,68,311,5,100
91,3/13/2018 18:35,76,64,75,107,83,405,5,100
92,3/13/2018 18:40,68,65,68,108,87,396,5,100
93,3/13/2018 18:45,93,91,92,108,89,473,5,100
94,3/13/2018 18:50,63,72,68,90,74,367,5,100
95,3/13/2018 18:55,73,78,63,95,76,385,5,100
96,3/13/2018 19:00,96,79,81,117,87,460,5,100
97,3/13/2018 19:05,86,78,84,111,89,448,5,100
98,3/13/2018 19:10,89,90,81,91,76,427,5,100
99,3/13/2018 19:15,99,92,103,92,83,469,5,100
100,3/13/2018 19:20,117,90,105,83,76,471,5,100
101,3/13/2018 19:25,104,86,101,62,71,424,5,100
102,3/13/2018 19:30,108,75,95,55,69,402,5,100
103,3/13/2018 19:35,103,93,118,60,80,454,5,100
104,3/13/2018 19:40,114,82,111,64,72,443,5,100
105,3/13/2018 19:45,103,80,99,51,58,391,5,100
106,3/13/2018 19:50,112,84,94,61,85,436,5,100
107,3/13/2018 19:55,83,83,87,45,78,376,5,100
108,3/13/2018 20:00,108,89,112,57,87,453,5,100
109,3/13/2018 20:05,128,102,118,48,74,470,5,100
110,3/13/2018 20:10,125,81,106,48,86,446,5,100
111,3/13/2018 20:15,123,83,108,51,75,440,5,100
112,3/13/2018 20:20,124,99,109,59,77,468,5,100
113,3/13/2018 20:25,100,93,104,47,80,424,5,100
114,3/13/2018 20:30,103,91,108,52,74,428,5,100
115,3/13/2018 20:35,116,78,118,61,70,443,5,100
116,3/13/2018 20:40,120,91,114,53,75,453,5,100
117,3/13/2018 20:45,95,72,103,39,66,375,5,100
118,3/13/2018 20:50,113,88,106,44,73,424,5,100
119,3/13/2018 20:55,100,78,101,54,57,390,5,100
120,3/13/2018 21:00,114,66,90,38,67,375,5,100
121,3/13/2018 21:05,97,84,95,53,67,396,5,100
122,3/13/2018 21:10,114,82,96,42,67,401,5,100
123,3/13/2018 21:15,99,67,100,46,65,377,5,100
124,3/13/2018 21:20,118,82,107,49,74,430,5,100
125,3/13/2018 21:25,113,86,100,37,75,411,5,100
126,3/13/2018 21:30,91,69,79,38,69,346,5,100
127,3/13/2018 21:35,91,69,83,38,56,337,5,100
128,3/13/2018 21:40,82,74,96,32,63,347,5,100
129,3/13/2018 21:45,90,71,84,40,64,349,5,100
130,3/13/2018 21:50,92,66,89,39,65,351,5,100
131,3/13/2018 21:55,92,75,82,33,52,334,5,100
132,3/13/2018 22:00,79,63,79,39,60,320,5,100
133,3/13/2018 22:05,82,69,83,40,63,337,5,100
134,3/13/2018 22:10,89,66,82,25,48,310,5,100
135,3/13/2018 22:15,91,62,89,34,56,332,5,100
136,3/13/2018 22:20,74,65,76,30,61,306,5,100
137,3/13/2018 22:25,72,61,72,41,43,289,5,100
138,3/13/2018 22:30,62,53,62,33,45,255,5,100
139,3/13/2018 22:35,65,60,66,42,50,283,5,100
140,3/13/2018 22:40,50,51,58,26,50,235,5,100
141,3/13/2018 22:45,62,52,68,39,50,271,5,100
142,3/13/2018 22:50,48,48,63,26,47,232,5,100
143,3/13/2018 22:55,50,44,63,25,46,228,5,100
144,3/13/2018 23:00,58,52,69,29,44,252,5,100
145,3/13/2018 23:05,52,61,60,32,43,248,5,100
146,3/13/2018 23:10,54,54,63,25,42,238,5,100
147,3/13/2018 23:15,50,36,51,31,43,211,5,100
148,3/13/2018 23:20,25,26,26,24,38,139,5,100
149,3/13/2018 23:25,61,51,64,32,48,256,5,100
150,3/13/2018 23:30,47,51,60,19,40,217,5,100
151,3/13/2018 23:35,42,57,47,28,37,211,5,100
152,3/13/2018 23:40,34,43,47,21,38,183,5,100
153,3/13/2018 23:45,39,36,50,18,29,172,5,100
154,3/13/2018 23:50,30,37,44,21,32,164,5,100
155,3/13/2018 23:55,44,47,42,22,30,185,5,100
156,3/14/2018 0:00,33,37,38,16,32,156,5,100
157,3/14/2018 0:05,32,37,36,19,36,160,5,100
158,3/14/2018 0:10,19,34,38,22,38,151,5,100
159,3/14/2018 0:15,6,21,17,8,24,76,5,100
160,3/14/2018 0:20,1,20,14,11,30,76,5,100
161,3/14/2018 0:25,30,32,25,13,34,134,5,100
162,3/14/2018 0:30,61,59,60,26,36,242,5,100
163,3/14/2018 0:35,18,26,23,12,25,104,5,100
164,3/14/2018 0:40,19,26,19,7,27,98,5,100
165,3/14/2018 0:45,17,26,28,21,36,128,5,100
166,3/14/2018 0:50,17,37,36,16,22,128,5,100
167,3/14/2018 0:55,21,19,30,5,26,101,5,100
168,3/14/2018 1:00,12,22,22,11,22,89,5,100
169,3/14/2018 1:05,16,22,21,6,21,86,5,100
170,3/14/2018 1:10,13,18,18,9,14,72,5,100
171,3/14/2018 1:15,10,23,17,12,23,85,5,100
172,3/14/2018 1:20,12,20,28,12,21,93,5,100
173,3/14/2018 1:25,12,20,18,7,22,79,5,100
174,3/14/2018 1:30,20,22,21,10,21,94,5,100
175,3/14/2018 1:35,11,11,11,8,17,58,5,100
176,3/14/2018 1:40,14,22,23,8,16,83,5,100
177,3/14/2018 1:45,9,18,14,6,20,67,5,100
178,3/14/2018 1:50,9,15,18,1,13,56,5,100
179,3/14/2018 1:55,19,28,18,7,21,93,5,100
180,3/14/2018 2:00,9,23,16,7,14,69,5,100
181,3/14/2018 2:05,8,12,22,9,11,62,5,100
182,3/14/2018 2:10,14,14,21,3,18,70,5,100
183,3/14/2018 2:15,7,13,14,6,16,56,5,100
184,3/14/2018 2:20,16,15,20,5,10,66,5,100
185,3/14/2018 2:25,8,17,14,7,13,59,5,100
186,3/14/2018 2:30,11,21,17,9,17,75,5,100
187,3/14/2018 2:35,10,17,11,2,14,54,5,100
188,3/14/2018 2:40,5,13,12,3,15,48,5,100
189,3/14/2018 2:45,8,14,8,4,12,46,5,100
190,3/14/2018 2:50,5,7,16,2,11,41,5,100
191,3/14/2018 2:55,6,18,16,4,6,50,5,100
192,3/14/2018 3:00,6,10,9,5,7,37,5,100
193,3/14/2018 3:05,8,9,11,4,3,35,5,100
194,3/14/2018 3:10,5,12,12,1,10,40,5,100
195,3/14/2018 3:15,4,14,15,4,12,49,5,100
196,3/14/2018 3:20,7,14,5,1,8,35,5,100
197,3/14/2018 3:25,2,9,10,1,10,32,5,100
198,3/14/2018 3:30,5,17,19,2,9,52,5,100
199,3/14/2018 3:35,16,18,21,9,14,78,5,100
200,3/14/2018 3:40,9,11,14,3,10,47,5,100
201,3/14/2018 3:45,7,20,19,8,16,70,5,100
202,3/14/2018 3:50,12,18,17,2,13,62,5,100
203,3/14/2018 3:55,4,20,17,6,13,60,5,100
204,3/14/2018 4:00,4,12,15,3,6,40,5,100
205,3/14/2018 4:05,10,12,13,4,14,53,5,100
206,3/14/2018 4:10,9,13,17,4,10,53,5,100
207,3/14/2018 4:15,10,18,22,6,10,66,5,100
208,3/14/2018 4:20,21,17,25,6,12,81,5,100
209,3/14/2018 4:25,12,26,20,9,21,88,5,100
210,3/14/2018 4:30,27,25,29,6,25,112,5,100
211,3/14/2018 4:35,18,24,27,7,20,96,5,100
212,3/14/2018 4:40,26,29,39,11,29,134,5,100
213,3/14/2018 4:45,29,35,40,17,29,150,5,100
214,3/14/2018 4:50,29,34,39,19,30,151,5,100
215,3/14/2018 4:55,27,33,31,9,21,121,5,100
216,3/14/2018 5:00,38,27,33,13,28,139,5,100
217,3/14/2018 5:05,44,41,46,17,29,177,5,100
218,3/14/2018 5:10,43,35,54,22,30,184,5,100
219,3/14/2018 5:15,51,40,54,15,35,195,5,100
220,3/14/2018 5:20,58,52,50,18,35,213,5,100
221,3/14/2018 5:25,66,56,77,24,40,263,5,100
222,3/14/2018 5:30,67,56,66,22,52,263,5,100
223,3/14/2018 5:35,78,64,75,30,49,296,5,100
224,3/14/2018 5:40,87,60,83,29,49,308,5,100
225,3/14/2018 5:45,86,67,83,34,56,326,5,100
226,3/14/2018 5:50,78,55,70,31,47,281,5,100
227,3/14/2018 5:55,72,47,64,29,42,254,5,100
228,3/14/2018 6:00,86,59,71,35,52,303,5,100
229,3/14/2018 6:05,92,74,79,34,54,333,5,100
230,3/14/2018 6:10,93,62,91,37,49,332,5,100
231,3/14/2018 6:15,84,80,82,34,56,336,5,100
232,3/14/2018 6:20,83,65,84,32,52,316,5,100
233,3/14/2018 6:25,92,81,90,46,62,371,5,100
234,3/14/2018 6:30,110,68,94,52,64,388,5,100
235,3/14/2018 6:35,108,71,83,62,62,386,5,100
236,3/14/2018 6:40,117,81,110,70,76,454,5,100
237,3/14/2018 6:45,112,91,101,71,77,452,5,100
238,3/14/2018 6:50,124,87,107,61,84,463,5,100
239,3/14/2018 6:55,112,96,111,44,83,446,5,100
240,3/14/2018 7:00,121,90,98,59,78,446,5,100
241,3/14/2018 7:05,106,88,105,52,82,433,5,100
242,3/14/2018 7:10,135,89,119,51,88,482,5,100
243,3/14/2018 7:15,143,105,133,64,86,531,5,100
244,3/14/2018 7:20,146,108,129,60,80,523,5,100
245,3/14/2018 7:25,139,121,140,68,86,554,5,100
246,3/14/2018 7:30,165,118,140,88,100,611,5,100
247,3/14/2018 7:35,175,126,149,82,105,637,5,100
248,3/14/2018 7:40,172,118,149,86,107,632,5,100
249,3/14/2018 7:45,149,117,147,84,109,606,5,100
250,3/14/2018 7:50,160,114,138,69,100,581,5,100
251,3/14/2018 7:55,141,102,122,81,85,531,5,100
252,3/14/2018 8:00,135,105,136,82,105,563,5,100
253,3/14/2018 8:05,142,100,121,67,87,517,5,100
254,3/14/2018 8:10,145,101,133,71,92,542,5,100
255,3/14/2018 8:15,145,98,124,64,85,516,5,100
256,3/14/2018 8:20,155,109,138,79,109,590,5,100
257,3/14/2018 8:25,155,116,134,84,102,591,5,100
258,3/14/2018 8:30,110,78,106,69,89,452,5,100
259,3/14/2018 8:35,168,107,131,78,86,570,5,100
260,3/14/2018 8:40,165,101,144,71,91,572,5,100
261,3/14/2018 8:45,149,109,136,56,86,536,5,100
262,3/14/2018 8:50,135,102,125,64,88,514,5,100
263,3/14/2018 8:55,137,105,127,89,78,536,5,100
264,3/14/2018 9:00,143,93,121,64,88,509,5,100
265,3/14/2018 9:05,137,90,146,48,83,504,5,100
266,3/14/2018 9:10,140,82,118,81,86,507,5,100
267,3/14/2018 9:15,122,75,111,58,72,438,5,100
268,3/14/2018 9:20,120,107,115,48,77,467,5,100
269,3/14/2018 9:25,126,87,122,55,84,474,5,100
270,3/14/2018 9:30,117,93,124,65,88,487,5,100
271,3/14/2018 9:35,119,72,112,52,82,437,5,100
272,3/14/2018 9:40,137,98,121,68,78,502,5,100
273,3/14/2018 9:45,140,105,123,62,88,518,5,100
274,3/14/2018 9:50,122,110,114,47,81,474,5,100
275,3/14/2018 9:55,122,95,113,54,91,475,5,100
276,3/14/2018 10:00,126,87,109,64,79,465,5,100
277,3/14/2018 10:05,123,104,108,43,79,457,5,100
278,3/14/2018 10:10,93,93,102,57,76,421,5,100
279,3/14/2018 10:15,113,83,112,51,74,433,5,100
280,3/14/2018 10:20,126,87,113,50,88,464,5,100
281,3/14/2018 10:25,105,104,125,55,70,459,5,100
282,3/14/2018 10:30,126,92,113,59,71,461,5,100
283,3/14/2018 10:35,135,105,120,55,80,495,5,100
284,3/14/2018 10:40,124,86,122,44,72,448,5,100
285,3/14/2018 10:45,129,101,115,65,96,506,5,100
286,3/14/2018 10:50,113,92,129,60,84,478,5,100
287,3/14/2018 10:55,119,93,123,53,81,469,5,100
288,3/14/2018 11:00,125,92,107,47,70,441,5,100
289,3/14/2018 11:05,121,94,110,52,81,458,5,100
290,3/14/2018 11:10,121,94,127,54,75,471,5,100
291,3/14/2018 11:15,120,98,104,60,90,472,5,100
292,3/14/2018 11:20,121,81,121,59,77,459,5,100
293,3/14/2018 11:25,125,92,110,55,96,478,5,100
294,3/14/2018 11:30,125,94,123,54,86,482,5,100
295,3/14/2018 11:35,109,90,115,51,70,435,5,100
296,3/14/2018 11:40,125,93,127,57,80,482,5,100
297,3/14/2018 11:45,126,93,107,50,82,458,5,100
298,3/14/2018 11:50,118,88,105,67,75,453,5,100
299,3/14/2018 11:55,117,85,120,62,93,477,5,100
300,3/14/2018 12:00,133,107,113,61,85,499,5,100
301,3/14/2018 12:05,122,81,107,59,81,450,5,100
302,3/14/2018 12:10,116,85,112,55,76,444,5,100
303,3/14/2018 12:15,117,89,120,60,94,480,5,100
304,3/14/2018 12:20,142,114,140,70,100,566,5,100
305,3/14/2018 12:25,142,93,133,61,88,517,5,100
306,3/14/2018 12:30,141,113,137,52,86,529,5,100
307,3/14/2018 12:35,149,100,137,65,94,545,5,100
308,3/14/2018 12:40,120,101,127,60,93,501,5,100
309,3/14/2018 12:45,131,97,120,69,81,498,5,100
310,3/14/2018 12:50,143,108,136,69,106,562,5,100
311,3/14/2018 12:55,116,102,111,74,83,486,5,100
312,3/14/2018 13:00,137,90,119,66,88,500,5,100
313,3/14/2018 13:05,143,97,120,76,88,524,5,100
314,3/14/2018 13:10,136,101,115,62,83,497,5,100
315,3/14/2018 13:15,136,110,137,65,101,549,5,100
316,3/14/2018 13:20,131,94,127,64,93,509,5,100
317,3/14/2018 13:25,127,95,119,77,87,505,5,100
318,3/14/2018 13:30,138,91,130,86,99,544,5,100
319,3/14/2018 13:35,130,84,113,54,92,473,5,100
320,3/14/2018 13:40,127,109,139,84,95,554,5,100
321,3/14/2018 13:45,129,112,127,68,88,524,5,100
322,3/14/2018 13:50,135,103,119,77,94,528,5,100
323,3/14/2018 13:55,128,105,135,71,99,538,5,100
324,3/14/2018 14:00,136,96,123,68,82,505,5,100
325,3/14/2018 14:05,130,99,127,88,85,529,5,100
326,3/14/2018 14:10,123,104,132,87,116,562,5,100
327,3/14/2018 14:15,138,104,127,86,87,542,5,100
328,3/14/2018 14:20,130,102,130,80,89,531,5,100
329,3/14/2018 14:25,157,111,122,82,103,575,5,100
330,3/14/2018 14:30,126,103,121,79,81,510,5,100
331,3/14/2018 14:35,149,118,136,102,118,623,5,100
332,3/14/2018 14:40,109,98,112,110,103,532,5,100
333,3/14/2018 14:45,122,111,115,128,109,585,5,100
334,3/14/2018 14:50,116,87,117,107,102,529,5,100
335,3/14/2018 14:55,121,95,122,110,100,548,5,100
336,3/14/2018 15:00,114,103,110,102,101,530,5,100
337,3/14/2018 15:05,120,103,116,79,78,496,5,100
338,3/14/2018 15:10,135,94,125,88,93,535,5,100
339,3/14/2018 15:15,102,85,108,78,79,452,5,100
340,3/14/2018 15:20,121,96,115,91,89,512,5,100
341,3/14/2018 15:25,112,88,103,99,93,495,5,100
342,3/14/2018 15:30,105,86,101,102,90,484,5,100
343,3/14/2018 15:35,101,83,102,74,79,439,5,100
344,3/14/2018 15:40,107,82,105,86,97,477,5,100
345,3/14/2018 15:45,101,77,104,94,89,465,5,100
346,3/14/2018 15:50,98,81,97,99,90,465,5,100
347,3/14/2018 15:55,77,86,82,122,79,446,5,100
348,3/14/2018 16:00,95,89,104,84,80,452,5,100
349,3/14/2018 16:05,94,77,90,108,75,444,5,100
350,3/14/2018 16:10,68,78,74,101,75,396,5,100
351,3/14/2018 16:15,86,80,79,109,77,431,5,100
352,3/14/2018 16:20,83,83,96,110,73,445,5,100
353,3/14/2018 16:25,102,92,94,110,69,467,5,100
354,3/14/2018 16:30,106,88,102,73,72,441,5,100
355,3/14/2018 16:35,104,81,93,113,79,470,5,100
356,3/14/2018 16:40,104,71,101,92,79,447,5,100
357,3/14/2018 16:45,85,79,98,86,80,428,5,100
358,3/14/2018 16:50,104,81,102,76,79,442,5,100
359,3/14/2018 16:55,91,73,83,101,70,418,5,100
360,3/14/2018 17:00,82,80,78,107,75,422,5,100
361,3/14/2018 17:05,84,76,75,98,79,412,5,100
362,3/14/2018 17:10,87,84,77,106,81,435,5,100
363,3/14/2018 17:15,73,83,82,118,90,446,5,100
364,3/14/2018 17:20,73,74,66,111,77,401,5,100
365,3/14/2018 17:25,74,77,75,111,83,420,5,100
366,3/14/2018 17:30,79,85,71,115,84,434,5,100
367,3/14/2018 17:35,76,82,64,109,82,413,5,100
368,3/14/2018 17:40,52,36,48,89,55,280,5,100
369,3/14/2018 17:45,70,58,56,91,71,346,5,100
370,3/14/2018 17:50,88,89,83,113,95,468,5,100
371,3/14/2018 17:55,76,75,77,99,83,410,5,100
372,3/14/2018 18:00,60,51,59,87,65,322,5,100
373,3/14/2018 18:05,63,66,69,86,77,361,5,100
374,3/14/2018 18:10,78,78,79,113,102,450,5,100
375,3/14/2018 18:15,84,86,79,110,82,441,5,100
376,3/14/2018 18:20,89,85,91,90,76,431,5,100
377,3/14/2018 18:25,100,85,96,78,82,441,5,100
378,3/14/2018 18:30,69,70,79,104,72,394,5,100
379,3/14/2018 18:35,76,70,81,119,85,431,5,100
380,3/14/2018 18:40,92,92,96,118,93,491,5,100
381,3/14/2018 18:45,88,79,81,96,88,432,5,100
382,3/14/2018 18:50,107,88,115,92,82,484,5,100
383,3/14/2018 18:55,106,89,100,84,92,471,5,100
384,3/14/2018 19:00,106,111,103,73,82,475,5,100
385,3/14/2018 19:05,116,92,111,82,86,487,5,100
386,3/14/2018 19:10,123,89,120,83,98,513,5,100
387,3/14/2018 19:15,118,92,112,79,96,497,5,100
388,3/14/2018 19:20,111,91,111,82,80,475,5,100
389,3/14/2018 19:25,117,87,122,68,97,491,5,100
390,3/14/2018 19:30,118,80,106,86,76,466,5,100
391,3/14/2018 19:35,128,94,109,71,82,484,5,100
392,3/14/2018 19:40,112,90,111,76,85,474,5,100
393,3/14/2018 19:45,107,79,116,69,80,451,5,100
394,3/14/2018 19:50,144,93,104,65,81,487,5,100
395,3/14/2018 19:55,113,89,97,60,85,444,5,100
396,3/14/2018 20:00,125,95,112,59,78,469,5,100
397,3/14/2018 20:05,120,90,109,67,81,467,5,100
398,3/14/2018 20:10,124,98,118,53,89,482,5,100
399,3/14/2018 20:15,126,98,122,45,86,477,5,100
400,3/14/2018 20:20,139,102,125,47,78,491,5,100
401,3/14/2018 20:25,117,93,113,51,85,459,5,100
402,3/14/2018 20:30,144,85,126,54,85,494,5,100
403,3/14/2018 20:35,126,99,122,50,81,478,5,100
404,3/14/2018 20:40,103,85,108,53,74,423,5,100
405,3/14/2018 20:45,120,92,112,50,94,468,5,100
406,3/14/2018 20:50,106,80,110,37,72,405,5,100
407,3/14/2018 20:55,128,93,115,53,83,472,5,100
408,3/14/2018 21:00,124,80,106,46,77,433,5,100
409,3/14/2018 21:05,96,81,95,38,57,367,5,100
410,3/14/2018 21:10,124,79,101,38,79,421,5,100
411,3/14/2018 21:15,103,82,101,51,75,412,5,100
412,3/14/2018 21:20,101,93,103,56,69,422,5,100
413,3/14/2018 21:25,112,94,103,40,70,419,5,100
414,3/14/2018 21:30,93,55,88,36,56,328,5,100
415,3/14/2018 21:35,87,77,93,58,57,372,5,100
416,3/14/2018 21:40,104,80,91,48,56,379,5,100
417,3/14/2018 21:45,108,95,93,39,69,404,5,100
418,3/14/2018 21:50,98,74,91,49,56,368,5,100
419,3/14/2018 21:55,81,74,81,33,47,316,5,100
420,3/14/2018 22:00,82,74,81,39,56,332,5,100
421,3/14/2018 22:05,99,73,90,46,61,369,5,100
422,3/14/2018 22:10,94,66,80,33,56,329,5,100
423,3/14/2018 22:15,90,60,90,43,51,334,5,100
424,3/14/2018 22:20,82,62,75,36,59,314,5,100
425,3/14/2018 22:25,75,72,77,44,50,318,5,100
426,3/14/2018 22:30,63,71,71,36,52,293,5,100
427,3/14/2018 22:35,92,74,82,40,56,344,5,100
428,3/14/2018 22:40,53,66,66,47,44,276,5,100
429,3/14/2018 22:45,70,73,75,35,41,294,5,100
430,3/14/2018 22:50,60,65,76,37,52,290,5,100
431,3/14/2018 22:55,50,51,52,22,52,227,5,100
432,3/14/2018 23:00,59,57,63,22,47,248,5,100
433,3/14/2018 23:05,52,61,59,28,33,233,5,100
434,3/14/2018 23:10,55,50,60,32,41,238,5,100
435,3/14/2018 23:15,55,54,61,35,44,249,5,100
436,3/14/2018 23:20,41,41,52,20,46,200,5,100
437,3/14/2018 23:25,48,52,57,21,46,224,5,100
438,3/14/2018 23:30,51,45,57,23,47,223,5,100
439,3/14/2018 23:35,38,49,52,18,36,193,5,100
440,3/14/2018 23:40,36,43,42,29,39,189,5,100
441,3/14/2018 23:45,46,50,51,22,35,204,5,100
442,3/14/2018 23:50,39,38,34,10,32,153,5,100
443,3/14/2018 23:55,48,37,56,20,36,197,5,100
444,3/15/2018 0:00,33,38,39,21,29,160,5,100
445,3/15/2018 0:05,33,35,41,12,31,152,5,100
446,3/15/2018 0:10,31,40,40,12,34,157,5,100
447,3/15/2018 0:15,26,44,36,20,32,158,5,100
448,3/15/2018 0:20,27,42,29,26,34,158,5,100
449,3/15/2018 0:25,25,48,37,17,29,156,5,100
450,3/15/2018 0:30,21,23,34,13,26,117,5,100
451,3/15/2018 0:35,20,27,29,15,31,122,5,100
452,3/15/2018 0:40,16,32,29,14,24,115,5,100
453,3/15/2018 0:45,21,28,32,9,31,121,5,100
454,3/15/2018 0:50,20,27,31,7,26,111,5,100
455,3/15/2018 0:55,15,24,26,10,22,97,5,100
456,3/15/2018 1:00,12,35,28,9,29,113,5,100
457,3/15/2018 1:05,13,17,24,10,27,91,5,100
458,3/15/2018 1:10,12,18,19,8,22,79,5,100
459,3/15/2018 1:15,21,38,20,16,22,117,5,100
460,3/15/2018 1:20,10,17,16,10,16,69,5,100
461,3/15/2018 1:25,9,16,18,6,16,65,5,100
462,3/15/2018 1:30,14,28,16,4,20,82,5,100
463,3/15/2018 1:35,9,21,16,5,12,63,5,100
464,3/15/2018 1:40,11,20,17,6,23,77,5,100
465,3/15/2018 1:45,9,19,17,14,12,71,5,100
466,3/15/2018 1:50,18,26,20,5,20,89,5,100
467,3/15/2018 1:55,10,23,22,11,16,82,5,100
468,3/15/2018 2:00,10,21,12,4,14,61,5,100
469,3/15/2018 2:05,5,18,14,7,15,59,5,100
470,3/15/2018 2:10,5,18,18,9,12,62,5,100
471,3/15/2018 2:15,2,14,23,2,8,49,5,100
472,3/15/2018 2:20,15,18,13,9,6,61,5,100
473,3/15/2018 2:25,11,23,16,7,15,72,5,100
474,3/15/2018 2:30,11,20,18,2,14,65,5,100
475,3/15/2018 2:35,10,15,7,8,9,49,5,100
476,3/15/2018 2:40,7,17,17,0,10,51,5,100
477,3/15/2018 2:45,7,20,14,4,6,51,5,100
478,3/15/2018 2:50,6,14,11,2,13,46,5,100
479,3/15/2018 2:55,5,12,9,7,12,45,5,100
480,3/15/2018 3:00,3,7,12,2,10,34,5,100
481,3/15/2018 3:05,5,13,16,3,9,46,5,100
482,3/15/2018 3:10,6,10,10,2,7,35,5,100
483,3/15/2018 3:15,10,18,14,9,13,64,5,100
484,3/15/2018 3:20,5,11,13,3,12,44,5,100
485,3/15/2018 3:25,10,20,19,9,10,68,5,100
486,3/15/2018 3:30,9,17,18,3,8,55,5,100
487,3/15/2018 3:35,10,19,16,6,11,62,5,100
488,3/15/2018 3:40,7,19,18,6,14,64,5,100
489,3/15/2018 3:45,6,18,13,10,13,60,5,100
490,3/15/2018 3:50,12,13,14,6,9,54,5,100
491,3/15/2018 3:55,7,18,14,6,11,56,5,100
492,3/15/2018 4:00,5,30,15,8,13,71,5,100
493,3/15/2018 4:05,10,13,17,6,12,58,5,0
494,3/15/2018 4:10,5,15,8,5,8,41,5,100
495,3/15/2018 4:15,10,17,28,4,22,81,5,100
496,3/15/2018 4:20,11,17,21,5,14,68,5,100
497,3/15/2018 4:25,20,23,32,6,18,99,5,100
498,3/15/2018 4:30,18,25,21,8,15,87,5,100
499,3/15/2018 4:35,17,30,31,11,24,113,5,100
500,3/15/2018 4:40,31,21,38,11,23,124,5,100
501,3/15/2018 4:45,26,31,31,16,20,124,5,100
502,3/15/2018 4:50,26,32,37,22,23,140,5,100
503,3/15/2018 4:55,32,36,37,8,25,138,5,100
504,3/15/2018 5:00,39,35,37,14,26,151,5,100
505,3/15/2018 5:05,48,32,40,12,29,161,5,100
506,3/15/2018 5:10,40,48,58,9,31,186,5,100
507,3/15/2018 5:15,45,45,48,14,29,181,5,100
508,3/15/2018 5:20,79,54,64,21,43,261,5,100
509,3/15/2018 5:25,61,52,68,27,41,249,5,100
510,3/15/2018 5:30,77,70,65,23,51,286,5,100
511,3/15/2018 5:35,76,58,85,24,61,304,5,100
512,3/15/2018 5:40,94,63,79,37,51,324,5,100
513,3/15/2018 5:45,93,76,94,43,55,361,5,100
514,3/15/2018 5:50,87,57,89,35,53,321,5,100
515,3/15/2018 5:55,82,63,76,30,58,309,5,100
516,3/15/2018 6:00,68,62,73,36,57,296,5,100
517,3/15/2018 6:05,86,58,80,34,44,302,5,100
518,3/15/2018 6:10,88,70,85,38,57,338,5,100
519,3/15/2018 6:15,90,66,80,37,58,331,5,100
520,3/15/2018 6:20,91,73,81,39,50,334,5,100
521,3/15/2018 6:25,107,81,97,40,51,376,5,100
522,3/15/2018 6:30,109,86,93,55,77,420,5,100
523,3/15/2018 6:35,99,82,99,54,62,396,5,100
524,3/15/2018 6:40,120,96,116,78,79,489,5,100
525,3/15/2018 6:45,127,99,108,49,82,465,5,100
526,3/15/2018 6:50,117,89,100,63,72,441,5,100
527,3/15/2018 6:55,106,94,106,45,76,427,5,100
528,3/15/2018 7:00,111,89,110,52,73,435,5,100
529,3/15/2018 7:05,116,90,106,54,56,422,5,100
530,3/15/2018 7:10,159,88,124,66,75,512,5,100
531,3/15/2018 7:15,145,102,134,58,105,544,5,100
532,3/15/2018 7:20,157,100,132,74,100,563,5,100
533,3/15/2018 7:25,143,110,136,61,90,540,5,100
534,3/15/2018 7:30,167,113,154,83,108,625,5,100
535,3/15/2018 7:35,168,120,153,93,107,641,5,100
536,3/15/2018 7:40,157,114,141,90,111,613,5,100
537,3/15/2018 7:45,156,110,138,68,97,569,5,100
538,3/15/2018 7:50,148,104,137,82,101,572,5,100
539,3/15/2018 7:55,149,97,128,79,95,548,5,100
540,3/15/2018 8:00,127,104,116,69,94,510,5,100
541,3/15/2018 8:05,122,97,127,59,76,481,5,100
542,3/15/2018 8:10,120,93,107,58,76,454,5,100
543,3/15/2018 8:15,131,104,124,65,89,513,5,100
544,3/15/2018 8:20,133,100,130,77,84,524,5,100
545,3/15/2018 8:25,130,109,128,70,94,531,5,100
546,3/15/2018 8:30,146,108,122,58,84,518,5,100
547,3/15/2018 8:35,137,90,134,78,93,532,5,100
548,3/15/2018 8:40,152,100,125,78,91,546,5,100
549,3/15/2018 8:45,150,91,128,71,106,546,5,100
550,3/15/2018 8:50,143,107,128,69,69,516,5,100
551,3/15/2018 8:55,144,102,142,63,99,550,5,100
552,3/15/2018 9:00,120,105,133,66,95,519,5,100
553,3/15/2018 9:05,130,98,140,67,94,529,5,100
554,3/15/2018 9:10,150,117,121,70,91,549,5,100
555,3/15/2018 9:15,144,97,129,77,90,537,5,100
556,3/15/2018 9:20,128,87,108,70,80,473,5,100
557,3/15/2018 9:25,130,108,137,59,78,512,5,100
558,3/15/2018 9:30,140,102,125,71,84,522,5,100
559,3/15/2018 9:35,114,88,102,55,71,430,5,100
560,3/15/2018 9:40,115,107,116,69,79,486,5,100
561,3/15/2018 9:45,121,87,118,63,78,467,5,100
562,3/15/2018 9:50,113,95,109,58,85,460,5,100
563,3/15/2018 9:55,126,95,107,82,90,500,5,100
564,3/15/2018 10:00,131,83,120,58,89,481,5,100
565,3/15/2018 10:05,111,97,109,52,75,444,5,100
566,3/15/2018 10:10,115,93,112,51,87,458,5,100
567,3/15/2018 10:15,118,100,104,54,83,459,5,100
568,3/15/2018 10:20,107,79,112,36,66,400,5,100
569,3/15/2018 10:25,132,102,120,66,96,516,5,100
570,3/15/2018 10:30,98,83,104,51,66,402,5,100
571,3/15/2018 10:35,116,75,102,49,89,431,5,100
572,3/15/2018 10:40,114,95,129,62,84,484,5,100
573,3/15/2018 10:45,124,103,108,70,92,497,5,100
574,3/15/2018 10:50,116,111,105,46,91,469,5,100
575,3/15/2018 10:55,111,94,105,61,91,462,5,100
576,3/15/2018 11:00,127,110,118,46,72,473,5,100
577,3/15/2018 11:05,122,89,120,59,83,473,5,100
578,3/15/2018 11:10,121,99,112,68,82,482,5,100
579,3/15/2018 11:15,108,94,108,61,88,459,5,100
580,3/15/2018 11:20,126,98,118,54,78,474,5,100
581,3/15/2018 11:25,114,88,107,49,82,440,5,100
582,3/15/2018 11:30,120,93,108,42,71,434,5,100
583,3/15/2018 11:35,142,97,128,68,86,521,5,100
584,3/15/2018 11:40,129,103,112,57,97,498,5,100
585,3/15/2018 11:45,132,97,125,62,93,509,5,100
586,3/15/2018 11:50,135,113,116,73,87,524,5,100
587,3/15/2018 11:55,123,98,119,55,84,479,5,100
588,3/15/2018 12:00,149,94,119,68,88,518,5,100
589,3/15/2018 12:05,122,87,118,59,84,470,5,100
590,3/15/2018 12:10,136,112,123,70,95,536,5,100
591,3/15/2018 12:15,141,94,133,54,97,519,5,100
592,3/15/2018 12:20,155,99,136,60,83,533,5,100
593,3/15/2018 12:25,141,109,120,69,86,525,5,100
594,3/15/2018 12:30,139,101,131,53,77,501,5,100
595,3/15/2018 12:35,144,106,134,58,81,523,5,100
596,3/15/2018 12:40,136,100,121,65,83,505,5,100
597,3/15/2018 12:45,140,100,117,54,89,500,5,100
598,3/15/2018 12:50,132,99,125,69,92,517,5,100
599,3/15/2018 12:55,124,102,120,62,94,502,5,100
600,3/15/2018 13:00,138,102,121,58,75,494,5,100
601,3/15/2018 13:05,140,105,130,58,92,525,5,100
602,3/15/2018 13:10,141,99,114,63,92,509,5,100
603,3/15/2018 13:15,148,108,123,69,91,539,5,100
604,3/15/2018 13:20,127,93,124,62,81,487,5,100
605,3/15/2018 13:25,135,113,117,81,97,543,5,100
606,3/15/2018 13:30,131,106,116,60,98,511,5,100
607,3/15/2018 13:35,117,100,110,59,88,474,5,100
608,3/15/2018 13:40,151,98,130,77,105,561,5,100
609,3/15/2018 13:45,141,105,134,79,99,558,5,100
610,3/15/2018 13:50,135,95,122,87,98,537,5,100
611,3/15/2018 13:55,137,90,123,79,89,518,5,100
612,3/15/2018 14:00,133,99,117,53,102,504,5,100
613,3/15/2018 14:05,127,99,124,74,100,524,5,100
614,3/15/2018 14:10,120,99,124,87,84,514,5,100
615,3/15/2018 14:15,135,101,121,70,84,511,5,100
616,3/15/2018 14:20,134,100,130,97,97,558,5,100
617,3/15/2018 14:25,139,107,122,99,106,573,5,100
618,3/15/2018 14:30,114,84,122,99,97,516,5,100
619,3/15/2018 14:35,111,111,115,97,86,520,5,100
620,3/15/2018 14:40,109,107,115,116,100,547,5,100
621,3/15/2018 14:45,127,98,114,91,95,525,5,100
622,3/15/2018 14:50,111,102,117,112,86,528,5,100
623,3/15/2018 14:55,96,88,113,77,84,458,5,100
624,3/15/2018 15:00,126,91,122,82,109,530,5,100
625,3/15/2018 15:05,104,82,104,61,84,435,5,100
626,3/15/2018 15:10,114,92,113,80,85,484,5,100
627,3/15/2018 15:15,108,89,122,74,86,479,5,100
628,3/15/2018 15:20,88,82,79,89,77,415,5,100
629,3/15/2018 15:25,86,82,88,100,77,433,5,100
630,3/15/2018 15:30,71,71,74,108,89,413,5,100
631,3/15/2018 15:35,76,66,67,113,80,402,5,100
632,3/15/2018 15:40,81,92,82,112,92,459,5,100
633,3/15/2018 15:45,76,70,70,104,82,402,5,100
634,3/15/2018 15:50,80,75,78,104,80,417,5,100
635,3/15/2018 15:55,72,66,78,100,69,385,5,100
636,3/15/2018 16:00,66,62,69,101,73,371,5,100
637,3/15/2018 16:05,75,57,71,85,66,354,5,100
638,3/15/2018 16:10,83,81,85,110,81,440,5,100
639,3/15/2018 16:15,87,68,82,70,74,381,5,100
640,3/15/2018 16:20,80,78,92,71,71,392,5,100
641,3/15/2018 16:25,102,80,86,95,71,434,5,100
642,3/15/2018 16:30,71,73,80,106,79,409,5,100
643,3/15/2018 16:35,102,81,110,90,82,465,5,100
644,3/15/2018 16:40,82,75,104,70,76,407,5,100
645,3/15/2018 16:45,116,85,97,86,82,466,5,100
646,3/15/2018 16:50,90,83,95,89,74,431,5,100
647,3/15/2018 16:55,63,60,78,89,52,342,5,100
648,3/15/2018 17:00,72,57,70,54,49,302,5,100
649,3/15/2018 17:05,71,70,80,64,56,341,5,100
650,3/15/2018 17:10,70,65,71,51,54,311,5,100
651,3/15/2018 17:15,80,69,88,54,57,348,5,100
652,3/15/2018 17:20,88,64,69,51,51,323,5,100
653,3/15/2018 17:25,81,64,80,59,61,345,5,100
654,3/15/2018 17:30,82,64,83,43,71,343,5,100
655,3/15/2018 17:35,73,67,71,56,58,325,5,100
656,3/15/2018 17:40,81,51,80,44,57,313,5,100
657,3/15/2018 17:45,87,78,79,57,65,366,5,100
658,3/15/2018 17:50,88,63,79,44,62,336,5,100
659,3/15/2018 17:55,93,59,86,59,63,360,5,100
660,3/15/2018 18:00,79,66,78,47,65,335,5,100
661,3/15/2018 18:05,92,62,85,70,60,369,5,100
662,3/15/2018 18:10,87,62,96,61,62,368,5,100
663,3/15/2018 18:15,79,57,86,55,60,337,5,100
664,3/15/2018 18:20,97,52,84,60,62,355,5,100
665,3/15/2018 18:25,121,111,115,114,92,553,5,100
666,3/15/2018 18:30,135,107,126,99,101,568,5,100
667,3/15/2018 18:35,101,88,97,103,66,455,5,100
668,3/15/2018 18:40,105,95,96,89,94,479,5,100
669,3/15/2018 18:45,98,98,94,112,77,479,5,100
670,3/15/2018 18:50,104,88,99,91,76,458,5,100
671,3/15/2018 18:55,107,92,103,96,73,471,5,100
672,3/15/2018 19:00,97,89,105,98,78,467,5,100
673,3/15/2018 19:05,111,93,115,92,87,498,5,100
674,3/15/2018 19:10,110,82,110,66,86,454,5,100
675,3/15/2018 19:15,114,92,118,66,83,473,5,100
676,3/15/2018 19:20,110,94,108,89,81,482,5,100
677,3/15/2018 19:25,115,87,124,61,81,468,5,100
678,3/15/2018 19:30,127,96,107,82,83,495,5,100
679,3/15/2018 19:35,115,97,117,78,81,488,5,100
680,3/15/2018 19:40,113,87,112,80,89,481,5,100
681,3/15/2018 19:45,122,95,114,82,76,489,5,100
682,3/15/2018 19:50,113,86,105,84,85,473,5,100
683,3/15/2018 19:55,108,98,106,65,86,463,5,100
684,3/15/2018 20:00,121,92,114,64,89,480,5,100
685,3/15/2018 20:05,124,90,128,85,95,522,5,100
686,3/15/2018 20:10,117,91,118,70,72,468,5,100
687,3/15/2018 20:15,133,99,127,59,92,510,5,100
688,3/15/2018 20:20,123,99,122,63,74,481,5,100
689,3/15/2018 20:25,117,94,111,56,81,459,5,100
690,3/15/2018 20:30,127,87,119,48,79,460,5,100
691,3/15/2018 20:35,135,96,123,64,94,512,5,100
692,3/15/2018 20:40,115,86,121,69,83,474,5,100
693,3/15/2018 20:45,131,103,123,53,73,483,5,100
694,3/15/2018 20:50,124,100,117,44,88,473,5,100
695,3/15/2018 20:55,126,95,113,50,78,462,5,100
696,3/15/2018 21:00,129,93,113,44,70,449,5,100
697,3/15/2018 21:05,129,98,111,62,69,469,5,100
698,3/15/2018 21:10,122,99,114,46,75,456,5,100
699,3/15/2018 21:15,118,81,102,52,71,424,5,100
700,3/15/2018 21:20,113,94,107,53,77,444,5,100
701,3/15/2018 21:25,131,90,112,43,65,441,5,100
702,3/15/2018 21:30,108,88,111,48,74,429,5,100
703,3/15/2018 21:35,122,91,107,55,74,449,5,100
704,3/15/2018 21:40,119,91,107,60,79,456,5,100
705,3/15/2018 21:45,107,75,98,40,63,383,5,100
706,3/15/2018 21:50,110,85,97,46,65,403,5,100
707,3/15/2018 21:55,108,75,112,45,68,408,5,100
708,3/15/2018 22:00,104,70,90,45,71,380,5,100
709,3/15/2018 22:05,109,72,97,50,73,401,5,100
710,3/15/2018 22:10,100,69,95,36,59,359,5,100
711,3/15/2018 22:15,97,73,99,43,66,378,5,100
712,3/15/2018 22:20,92,88,87,43,60,370,5,100
713,3/15/2018 22:25,74,69,79,33,57,312,5,100
714,3/15/2018 22:30,88,82,89,35,61,355,5,100
715,3/15/2018 22:35,83,65,70,29,51,298,5,100
716,3/15/2018 22:40,73,71,82,38,55,319,5,100
717,3/15/2018 22:45,83,62,80,31,52,308,5,100
718,3/15/2018 22:50,57,60,64,26,52,259,5,100
719,3/15/2018 22:55,67,57,77,42,56,299,5,100
720,3/15/2018 23:00,61,68,72,30,45,276,5,100
721,3/15/2018 23:05,55,51,71,33,44,254,5,100
722,3/15/2018 23:10,59,63,74,30,51,277,5,100
723,3/15/2018 23:15,62,53,80,33,47,275,5,100
724,3/15/2018 23:20,68,55,59,35,44,261,5,100
725,3/15/2018 23:25,52,54,60,21,37,224,5,100
726,3/15/2018 23:30,59,53,58,33,44,247,5,100
727,3/15/2018 23:35,60,50,62,21,50,243,5,100
728,3/15/2018 23:40,53,45,56,29,45,228,5,100
729,3/15/2018 23:45,61,56,54,16,45,232,5,100
730,3/15/2018 23:50,42,36,63,13,38,192,5,100
731,3/15/2018 23:55,36,38,42,31,37,184,5,100
732,3/16/2018 0:00,43,44,52,18,35,192,5,100
733,3/16/2018 0:05,39,37,56,30,28,190,5,100
734,3/16/2018 0:10,34,36,40,23,44,177,5,100
735,3/16/2018 0:15,35,39,46,27,35,182,5,100
736,3/16/2018 0:20,41,29,45,22,36,173,5,100
737,3/16/2018 0:25,35,29,38,15,30,147,5,100
738,3/16/2018 0:30,20,36,30,17,33,136,5,100
739,3/16/2018 0:35,32,32,42,23,32,161,5,100
740,3/16/2018 0:40,24,36,25,20,32,137,5,100
741,3/16/2018 0:45,26,30,34,21,27,138,5,100
742,3/16/2018 0:50,23,41,27,17,25,133,5,100
743,3/16/2018 0:55,22,23,33,13,24,115,5,100
744,3/16/2018 1:00,19,26,27,14,27,113,5,100
745,3/16/2018 1:05,24,29,34,9,32,128,5,100
746,3/16/2018 1:10,24,21,29,16,26,116,5,100
747,3/16/2018 1:15,20,22,31,13,20,106,5,100
748,3/16/2018 1:20,17,23,20,12,26,98,5,100
749,3/16/2018 1:25,20,22,24,8,18,92,5,100
750,3/16/2018 1:30,13,17,20,15,24,89,5,100
751,3/16/2018 1:35,17,26,29,8,31,111,5,100
752,3/16/2018 1:40,17,24,30,21,29,121,5,100
753,3/16/2018 1:45,15,20,21,13,24,93,5,100
754,3/16/2018 1:50,12,21,27,5,26,91,5,100
755,3/16/2018 1:55,13,27,21,7,18,86,5,100
756,3/16/2018 2:00,13,16,21,10,23,83,5,100
757,3/16/2018 2:05,14,23,25,11,25,98,5,100
758,3/16/2018 2:10,15,21,21,7,20,84,5,100
759,3/16/2018 2:15,14,26,19,7,14,80,5,100
760,3/16/2018 2:20,15,16,21,16,19,87,5,100
761,3/16/2018 2:25,11,11,21,8,10,61,5,100
762,3/16/2018 2:30,16,21,17,9,17,80,5,100
763,3/16/2018 2:35,8,15,19,12,17,71,5,100
764,3/16/2018 2:40,9,20,17,6,9,61,5,100
765,3/16/2018 2:45,10,20,21,6,11,68,5,100
766,3/16/2018 2:50,8,19,12,6,13,58,5,100
767,3/16/2018 2:55,9,14,5,1,17,46,5,100
768,3/16/2018 3:00,6,9,16,6,20,57,5,100
769,3/16/2018 3:05,6,14,8,5,11,44,5,100
770,3/16/2018 3:10,4,17,10,5,10,46,5,100
771,3/16/2018 3:15,10,14,16,6,16,62,5,100
772,3/16/2018 3:20,10,19,18,1,16,64,5,100
773,3/16/2018 3:25,9,18,16,4,13,60,5,100
774,3/16/2018 3:30,5,9,14,9,17,54,5,100
775,3/16/2018 3:35,10,17,18,4,18,67,5,100
776,3/16/2018 3:40,14,16,20,6,27,83,5,100
777,3/16/2018 3:45,11,15,23,6,16,71,5,100
778,3/16/2018 3:50,8,11,16,10,11,56,5,100
779,3/16/2018 3:55,8,22,18,9,20,77,5,100
780,3/16/2018 4:00,12,18,19,9,13,71,5,100
781,3/16/2018 4:05,11,12,19,9,14,65,5,100
782,3/16/2018 4:10,11,12,23,9,14,69,5,100
783,3/16/2018 4:15,19,21,23,7,21,91,5,100
784,3/16/2018 4:20,15,14,22,4,20,75,5,100
785,3/16/2018 4:25,18,25,19,9,19,90,5,100
786,3/16/2018 4:30,20,25,29,13,14,101,5,100
787,3/16/2018 4:35,25,20,25,6,21,97,5,100
788,3/16/2018 4:40,23,29,30,12,25,119,5,100
789,3/16/2018 4:45,36,35,38,8,27,144,5,100
790,3/16/2018 4:50,24,31,37,17,23,132,5,100
791,3/16/2018 4:55,28,28,45,13,28,142,5,100
792,3/16/2018 5:00,27,30,40,13,29,139,5,100
793,3/16/2018 5:05,36,28,38,18,21,141,5,100
794,3/16/2018 5:10,40,40,37,15,29,161,5,100
795,3/16/2018 5:15,54,47,52,15,42,210,5,100
796,3/16/2018 5:20,51,42,49,13,27,182,5,100
797,3/16/2018 5:25,64,42,65,21,39,231,5,100
798,3/16/2018 5:30,49,57,55,27,38,226,5,100
799,3/16/2018 5:35,79,61,77,27,50,294,5,100
800,3/16/2018 5:40,87,64,81,27,54,313,5,100
801,3/16/2018 5:45,71,68,77,35,54,305,5,100
802,3/16/2018 5:50,84,53,74,25,57,293,5,100
803,3/16/2018 5:55,72,57,75,29,33,266,5,100
804,3/16/2018 6:00,59,51,72,34,48,264,5,100
805,3/16/2018 6:05,67,55,77,33,46,278,5,100
806,3/16/2018 6:10,71,60,60,33,44,268,5,100
807,3/16/2018 6:15,88,62,79,33,62,324,5,100
808,3/16/2018 6:20,83,64,86,34,50,317,5,100
809,3/16/2018 6:25,95,71,93,42,51,352,5,100
810,3/16/2018 6:30,76,63,85,37,48,309,5,100
811,3/16/2018 6:35,92,72,97,39,64,364,5,100
812,3/16/2018 6:40,94,82,89,57,89,411,5,100
813,3/16/2018 6:45,99,70,94,59,72,394,5,100
814,3/16/2018 6:50,103,75,89,49,60,376,5,100
815,3/16/2018 6:55,114,84,108,56,73,435,5,100
816,3/16/2018 7:00,86,54,84,39,76,339,5,100
817,3/16/2018 7:05,117,90,109,61,77,454,5,100
818,3/16/2018 7:10,94,81,101,47,59,382,5,100
819,3/16/2018 7:15,137,90,122,43,87,479,5,100
820,3/16/2018 7:20,122,101,130,57,78,488,5,100
821,3/16/2018 7:25,130,96,113,78,88,505,5,100
822,3/16/2018 7:30,142,105,132,67,71,517,5,100
823,3/16/2018 7:35,151,121,154,75,95,596,5,100
824,3/16/2018 7:40,151,109,145,69,120,594,5,100
825,3/16/2018 7:45,138,97,125,68,96,524,5,100
826,3/16/2018 7:50,138,112,134,72,109,565,5,100
827,3/16/2018 7:55,151,105,130,87,99,572,5,100
828,3/16/2018 8:00,128,87,119,76,84,494,5,100
829,3/16/2018 8:05,114,81,126,63,64,448,5,100
830,3/16/2018 8:10,128,98,128,78,77,509,5,100
831,3/16/2018 8:15,151,117,137,86,112,603,5,100
832,3/16/2018 8:20,134,90,133,69,104,530,5,100
833,3/16/2018 8:25,141,98,117,62,84,502,5,100
834,3/16/2018 8:30,139,98,119,73,89,518,5,100
835,3/16/2018 8:35,141,93,119,74,98,525,5,100
836,3/16/2018 8:40,148,105,126,68,90,537,5,100
837,3/16/2018 8:45,144,90,129,66,87,516,5,100
838,3/16/2018 8:50,139,87,112,61,76,475,5,100
839,3/16/2018 8:55,128,98,129,84,96,535,5,100
840,3/16/2018 9:00,135,88,119,65,90,497,5,100
841,3/16/2018 9:05,119,97,110,67,82,475,5,100
842,3/16/2018 9:10,119,95,108,75,86,483,5,100
843,3/16/2018 9:15,120,96,119,57,94,486,5,100
844,3/16/2018 9:20,126,100,115,41,78,460,5,100
845,3/16/2018 9:25,121,99,116,63,84,483,5,100
846,3/16/2018 9:30,116,87,120,54,94,471,5,100
847,3/16/2018 9:35,122,109,120,62,96,509,5,100
848,3/16/2018 9:40,117,90,120,54,89,470,5,100
849,3/16/2018 9:45,120,92,115,69,78,474,5,100
850,3/16/2018 9:50,132,93,116,59,92,492,5,100
851,3/16/2018 9:55,119,89,102,69,83,462,5,100
852,3/16/2018 10:00,111,90,117,49,89,456,5,100
853,3/16/2018 10:05,113,104,108,68,94,487,5,100
854,3/16/2018 10:10,101,79,98,39,76,393,5,100
855,3/16/2018 10:15,133,86,114,56,86,475,5,100
856,3/16/2018 10:20,136,102,122,51,73,484,5,100
857,3/16/2018 10:25,134,105,120,54,83,496,5,100
858,3/16/2018 10:30,122,94,124,59,83,482,5,100
859,3/16/2018 10:35,100,78,116,57,81,432,5,100
860,3/16/2018 10:40,122,90,116,65,92,485,5,100
861,3/16/2018 10:45,135,92,117,59,95,498,5,100
862,3/16/2018 10:50,132,96,120,66,94,508,5,100
863,3/16/2018 10:55,146,97,128,66,93,530,5,100
864,3/16/2018 11:00,133,89,122,51,89,484,5,100
865,3/16/2018 11:05,133,100,128,49,94,504,5,100
866,3/16/2018 11:10,131,104,120,57,79,491,5,100
867,3/16/2018 11:15,142,98,132,61,82,515,5,100
868,3/16/2018 11:20,135,92,132,60,97,516,5,100
869,3/16/2018 11:25,138,94,113,65,74,484,5,100
870,3/16/2018 11:30,128,107,126,50,73,484,5,100
871,3/16/2018 11:35,125,100,121,48,87,481,5,100
872,3/16/2018 11:40,152,103,131,63,95,544,5,100
873,3/16/2018 11:45,117,100,127,62,87,493,5,100
874,3/16/2018 11:50,134,95,125,69,86,509,5,100
875,3/16/2018 11:55,130,105,128,64,77,504,5,100
876,3/16/2018 12:00,126,93,117,61,90,487,5,100
877,3/16/2018 12:05,131,102,128,61,89,511,5,100
878,3/16/2018 12:10,124,100,117,67,91,499,5,100
879,3/16/2018 12:15,137,119,122,70,91,539,5,100
880,3/16/2018 12:20,133,93,133,64,88,511,5,100
881,3/16/2018 12:25,143,105,136,62,99,545,5,100
882,3/16/2018 12:30,145,99,135,68,104,551,5,100
883,3/16/2018 12:35,112,98,121,87,97,515,5,100
884,3/16/2018 12:40,129,101,119,73,101,523,5,100
885,3/16/2018 12:45,133,109,133,62,101,538,5,100
886,3/16/2018 12:50,119,91,122,66,83,481,5,100
887,3/16/2018 12:55,132,94,124,71,91,512,5,100
888,3/16/2018 13:00,136,96,118,73,88,511,5,100
889,3/16/2018 13:05,137,100,126,64,87,514,5,100
890,3/16/2018 13:10,131,94,129,79,103,536,5,100
891,3/16/2018 13:15,111,100,111,92,95,509,5,100
892,3/16/2018 13:20,100,92,94,114,97,497,5,100
893,3/16/2018 13:25,108,96,112,115,104,535,5,100
894,3/16/2018 13:30,106,88,103,128,88,513,5,100
895,3/16/2018 13:35,90,79,87,118,93,467,5,100
896,3/16/2018 13:40,108,83,110,129,97,527,5,100
897,3/16/2018 13:45,95,93,98,118,98,502,5,100
898,3/16/2018 13:50,97,90,97,109,110,503,5,100
899,3/16/2018 13:55,87,71,82,118,95,453,5,100
900,3/16/2018 14:00,87,80,84,122,91,464,5,100
901,3/16/2018 14:05,102,93,100,110,93,498,5,100
902,3/16/2018 14:10,94,105,95,114,96,504,5,100
903,3/16/2018 14:15,103,92,96,103,103,497,5,100
904,3/16/2018 14:20,110,87,104,95,84,480,5,100
905,3/16/2018 14:25,98,74,97,78,83,430,5,100
906,3/16/2018 14:30,96,87,90,66,87,426,5,100
907,3/16/2018 14:35,91,76,101,90,78,436,5,100
908,3/16/2018 14:40,71,76,78,114,84,423,5,100
909,3/16/2018 14:45,92,84,87,107,91,461,5,100
910,3/16/2018 14:50,101,96,101,110,88,496,5,100
911,3/16/2018 14:55,74,82,77,112,89,434,5,100
912,3/16/2018 15:00,119,97,100,103,91,510,5,100
913,3/16/2018 15:05,95,91,94,77,79,436,5,100
914,3/16/2018 15:10,118,88,98,73,81,458,5,100
915,3/16/2018 15:15,79,80,73,112,90,434,5,100
916,3/16/2018 15:20,66,62,59,71,60,318,5,100
917,3/16/2018 15:25,53,46,57,74,46,276,5,100
918,3/16/2018 15:30,84,73,76,106,82,421,5,100
919,3/16/2018 15:35,70,58,60,82,68,338,5,100
920,3/16/2018 15:40,88,81,86,127,93,475,5,100
921,3/16/2018 15:45,76,71,67,101,79,394,5,100
922,3/16/2018 15:50,66,60,53,78,63,320,5,100
923,3/16/2018 15:55,59,59,58,72,65,313,5,100
924,3/16/2018 16:00,102,93,104,126,96,521,5,100
925,3/16/2018 16:05,67,58,59,93,77,354,5,100
926,3/16/2018 16:10,69,61,72,104,76,382,5,100
927,3/16/2018 16:15,62,50,55,80,67,314,5,100
928,3/16/2018 16:20,67,53,53,59,64,296,5,100
929,3/16/2018 16:25,69,57,56,82,75,339,5,100
930,3/16/2018 16:30,82,70,72,93,86,403,5,100
931,3/16/2018 16:35,104,94,98,104,84,484,5,100
932,3/16/2018 16:40,91,71,91,86,72,411,5,100
933,3/16/2018 16:45,97,77,107,78,68,427,5,100
934,3/16/2018 16:50,83,75,91,77,70,396,5,100
935,3/16/2018 16:55,78,71,91,93,77,410,5,100
936,3/16/2018 17:00,76,75,85,76,68,380,5,100
937,3/16/2018 17:05,88,81,92,100,66,427,5,100
938,3/16/2018 17:10,77,73,70,102,71,393,5,100
939,3/16/2018 17:15,80,90,84,113,95,462,5,100
940,3/16/2018 17:20,94,87,104,105,91,481,5,100
941,3/16/2018 17:25,99,94,107,107,77,484,5,100
942,3/16/2018 17:30,107,89,113,90,88,487,5,100
943,3/16/2018 17:35,97,83,118,97,84,479,5,100
944,3/16/2018 17:40,100,87,105,92,81,465,5,100
945,3/16/2018 17:45,101,91,103,92,79,466,5,100
946,3/16/2018 17:50,115,92,107,82,79,475,5,100
947,3/16/2018 17:55,116,98,107,83,88,492,5,100
948,3/16/2018 18:00,117,101,108,80,89,495,5,100
949,3/16/2018 18:05,123,92,115,86,83,499,5,100
950,3/16/2018 18:10,139,102,117,94,100,552,5,100
951,3/16/2018 18:15,122,98,113,92,84,509,5,100
952,3/16/2018 18:20,125,103,123,86,88,525,5,100
953,3/16/2018 18:25,126,96,131,91,102,546,5,100
954,3/16/2018 18:30,125,97,123,86,87,518,5,100
955,3/16/2018 18:35,122,103,119,79,99,522,5,100
956,3/16/2018 18:40,127,118,120,82,96,543,5,100
957,3/16/2018 18:45,132,115,125,84,95,551,5,100
958,3/16/2018 18:50,151,111,126,89,104,581,5,100
959,3/16/2018 18:55,133,103,122,76,95,529,5,100
960,3/16/2018 19:00,127,94,125,57,85,488,5,100
961,3/16/2018 19:05,126,98,131,67,80,502,5,100
962,3/16/2018 19:10,126,95,116,71,113,521,5,100
963,3/16/2018 19:15,117,81,120,66,84,468,5,100
964,3/16/2018 19:20,123,106,123,78,90,520,5,100
965,3/16/2018 19:25,134,114,122,76,88,534,5,100
966,3/16/2018 19:30,110,89,124,84,80,487,5,100
967,3/16/2018 19:35,118,89,110,54,77,448,5,100
968,3/16/2018 19:40,128,94,112,67,85,486,5,100
969,3/16/2018 19:45,131,107,121,52,79,490,5,100
970,3/16/2018 19:50,116,99,110,49,72,446,5,100
971,3/16/2018 19:55,115,88,103,56,73,435,5,100
972,3/16/2018 20:00,109,86,103,63,82,443,5,100
973,3/16/2018 20:05,122,91,103,74,85,475,5,100
974,3/16/2018 20:10,108,82,100,67,94,451,5,100
975,3/16/2018 20:15,111,92,108,65,78,454,5,100
976,3/16/2018 20:20,89,78,86,73,75,401,5,100
977,3/16/2018 20:25,102,89,99,69,81,440,5,100
978,3/16/2018 20:30,97,71,94,56,63,381,5,100
979,3/16/2018 20:35,108,86,113,45,75,427,5,100
980,3/16/2018 20:40,94,88,107,57,78,424,5,100
981,3/16/2018 20:45,97,74,97,41,61,370,5,100
982,3/16/2018 20:50,100,74,93,51,72,390,5,100
983,3/16/2018 20:55,77,81,90,48,65,361,5,100
984,3/16/2018 21:00,96,79,93,59,76,403,5,100
985,3/16/2018 21:05,122,89,109,67,60,447,5,100
986,3/16/2018 21:10,97,76,87,47,66,373,5,100
987,3/16/2018 21:15,119,84,114,45,63,425,5,100
988,3/16/2018 21:20,113,87,107,62,71,440,5,100
989,3/16/2018 21:25,104,86,95,47,74,406,5,100
990,3/16/2018 21:30,117,83,96,46,71,413,5,100
991,3/16/2018 21:35,96,66,95,41,73,371,5,100
992,3/16/2018 21:40,103,82,104,44,67,400,5,100
993,3/16/2018 21:45,92,70,92,41,72,367,5,100
994,3/16/2018 21:50,102,85,95,37,76,395,5,100
995,3/16/2018 21:55,106,91,107,42,67,413,5,100
996,3/16/2018 22:00,103,76,90,42,65,376,5,100
997,3/16/2018 22:05,110,81,100,48,71,410,5,100
998,3/16/2018 22:10,110,85,97,56,74,422,5,100
999,3/16/2018 22:15,109,79,87,49,60,384,5,100
1000,3/16/2018 22:20,79,63,80,32,55,309,5,100
1001,3/16/2018 22:25,85,75,85,38,50,333,5,100
1002,3/16/2018 22:30,79,70,76,40,62,327,5,100
1003,3/16/2018 22:35,110,93,108,39,61,411,5,100
1004,3/16/2018 22:40,102,85,84,37,65,373,5,100
1005,3/16/2018 22:45,83,73,87,42,66,351,5,100
1006,3/16/2018 22:50,100,69,83,30,55,337,5,100
1007,3/16/2018 22:55,75,61,75,30,53,294,5,100
1008,3/16/2018 23:00,79,59,86,25,57,306,5,100
1009,3/16/2018 23:05,71,70,83,34,39,297,5,100
1010,3/16/2018 23:10,60,72,80,44,63,319,5,100
1011,3/16/2018 23:15,68,64,88,34,52,306,5,100
1012,3/16/2018 23:20,81,66,87,30,60,324,5,100
1013,3/16/2018 23:25,79,62,82,26,46,295,5,100
1014,3/16/2018 23:30,58,53,69,26,45,251,5,100
1015,3/16/2018 23:35,57,61,68,36,49,271,5,100
1016,3/16/2018 23:40,55,50,68,25,44,242,5,100
1017,3/16/2018 23:45,62,58,73,21,51,265,5,100
1018,3/16/2018 23:50,49,62,59,23,47,240,5,100
1019,3/16/2018 23:55,48,46,46,30,43,213,5,100
1020,3/17/2018 0:00,48,49,62,34,38,231,5,100
1021,3/17/2018 0:05,48,43,51,27,40,209,5,100
1022,3/17/2018 0:10,51,50,57,26,52,236,5,100
1023,3/17/2018 0:15,46,44,54,21,48,213,5,100
1024,3/17/2018 0:20,43,54,56,20,32,205,5,100
1025,3/17/2018 0:25,47,49,54,15,39,204,5,100
1026,3/17/2018 0:30,43,39,65,24,31,202,5,100
1027,3/17/2018 0:35,34,39,46,15,27,161,5,100
1028,3/17/2018 0:40,36,44,43,13,35,171,5,100
1029,3/17/2018 0:45,39,46,42,12,30,169,5,100
1030,3/17/2018 0:50,32,39,37,12,48,168,5,100
1031,3/17/2018 0:55,39,34,43,9,21,146,5,100
1032,3/17/2018 1:00,31,38,38,10,35,152,5,100
1033,3/17/2018 1:05,24,32,37,12,31,136,5,100
1034,3/17/2018 1:10,31,35,37,15,29,147,5,100
1035,3/17/2018 1:15,32,34,39,18,41,164,5,100
1036,3/17/2018 1:20,34,29,40,20,34,157,5,100
1037,3/17/2018 1:25,18,30,33,10,25,116,5,100
1038,3/17/2018 1:30,18,25,25,9,17,94,5,100
1039,3/17/2018 1:35,20,20,36,10,21,107,5,100
1040,3/17/2018 1:40,16,26,28,14,27,111,5,100
1041,3/17/2018 1:45,25,28,30,11,23,117,5,100
1042,3/17/2018 1:50,28,40,30,12,24,134,5,100
1043,3/17/2018 1:55,21,27,27,11,24,110,5,100
1044,3/17/2018 2:00,19,28,38,15,30,130,5,100
1045,3/17/2018 2:05,19,32,32,7,17,107,5,100
1046,3/17/2018 2:10,25,31,27,13,23,119,5,100
1047,3/17/2018 2:15,22,21,27,3,22,95,5,100
1048,3/17/2018 2:20,22,23,40,7,18,110,5,100
1049,3/17/2018 2:25,11,24,23,9,24,91,5,100
1050,3/17/2018 2:30,15,19,18,9,23,84,5,100
1051,3/17/2018 2:35,17,21,24,12,17,91,5,100
1052,3/17/2018 2:40,24,23,27,5,14,93,5,100
1053,3/17/2018 2:45,11,21,16,8,13,69,5,100
1054,3/17/2018 2:50,13,19,17,6,8,63,5,100
1055,3/17/2018 2:55,9,12,19,2,10,52,5,100
1056,3/17/2018 3:00,18,19,22,5,11,75,5,100
1057,3/17/2018 3:05,13,16,20,11,13,73,5,100
1058,3/17/2018 3:10,10,15,16,9,15,65,5,100
1059,3/17/2018 3:15,8,14,16,3,14,55,5,100
1060,3/17/2018 3:20,8,21,17,9,12,67,5,100
1061,3/17/2018 3:25,8,18,19,4,14,63,5,100
1062,3/17/2018 3:30,13,18,22,8,16,77,5,100
1063,3/17/2018 3:35,8,19,9,4,9,49,5,100
1064,3/17/2018 3:40,8,16,14,11,16,65,5,100
1065,3/17/2018 3:45,14,16,17,10,19,76,5,100
1066,3/17/2018 3:50,10,19,14,6,8,57,5,100
1067,3/17/2018 3:55,8,12,15,8,13,56,5,100
1068,3/17/2018 4:00,9,15,16,6,13,59,5,100
1069,3/17/2018 4:05,10,11,12,2,14,49,5,100
1070,3/17/2018 4:10,10,18,17,3,8,56,5,100
1071,3/17/2018 4:15,6,16,10,7,11,50,5,100
1072,3/17/2018 4:20,6,13,15,8,9,51,5,100
1073,3/17/2018 4:25,11,21,16,10,17,75,5,100
1074,3/17/2018 4:30,10,20,17,8,16,71,5,100
1075,3/17/2018 4:35,15,19,22,5,16,77,5,100
1076,3/17/2018 4:40,14,19,16,8,13,70,5,100
1077,3/17/2018 4:45,15,12,15,7,16,65,5,100
1078,3/17/2018 4:50,16,23,26,7,26,98,5,100
1079,3/17/2018 4:55,18,10,18,11,23,80,5,100
1080,3/17/2018 5:00,15,17,19,8,14,73,5,100
1081,3/17/2018 5:05,14,16,19,8,21,78,5,100
1082,3/17/2018 5:10,22,20,30,5,17,94,5,100
1083,3/17/2018 5:15,19,18,20,8,17,82,5,100
1084,3/17/2018 5:20,19,28,28,9,28,112,5,100
1085,3/17/2018 5:25,15,21,25,7,19,87,5,100
1086,3/17/2018 5:30,21,28,34,7,23,113,5,100
1087,3/17/2018 5:35,31,35,33,12,22,133,5,100
1088,3/17/2018 5:40,30,34,31,8,27,130,5,100
1089,3/17/2018 5:45,27,33,32,19,22,133,5,100
1090,3/17/2018 5:50,28,31,31,5,29,124,5,100
1091,3/17/2018 5:55,26,25,29,12,21,113,5,100
1092,3/17/2018 6:00,35,32,38,12,25,142,5,100
1093,3/17/2018 6:05,32,30,27,9,26,124,5,100
1094,3/17/2018 6:10,38,33,37,17,32,157,5,100
1095,3/17/2018 6:15,38,30,48,19,37,172,5,100
1096,3/17/2018 6:20,41,41,48,21,27,178,5,100
1097,3/17/2018 6:25,46,37,56,16,36,191,5,100
1098,3/17/2018 6:30,50,44,48,11,24,177,5,100
1099,3/17/2018 6:35,60,50,66,17,41,234,5,100
1100,3/17/2018 6:40,51,39,48,15,33,186,5,100
1101,3/17/2018 6:45,54,52,59,20,39,224,5,100
1102,3/17/2018 6:50,64,44,64,33,46,251,5,100
1103,3/17/2018 6:55,62,54,64,17,37,234,5,100
1104,3/17/2018 7:00,15,19,22,19,23,98,5,100
1105,3/17/2018 7:05,64,55,67,32,61,279,5,100
1106,3/17/2018 7:10,71,61,86,30,53,301,5,100
1107,3/17/2018 7:15,50,40,57,22,39,208,5,100
1108,3/17/2018 7:20,124,76,98,30,59,387,5,100
1109,3/17/2018 7:25,91,59,79,25,46,300,5,100
1110,3/17/2018 7:30,98,67,92,31,61,349,5,100
1111,3/17/2018 7:35,77,64,80,27,51,299,5,100
1112,3/17/2018 7:40,91,80,94,31,56,352,5,100
1113,3/17/2018 7:45,94,77,91,39,73,374,5,100
1114,3/17/2018 7:50,94,75,88,32,65,354,5,100
1115,3/17/2018 7:55,83,72,79,34,72,340,5,100
1116,3/17/2018 8:00,97,90,87,35,62,371,5,100
1117,3/17/2018 8:05,72,73,100,31,65,341,5,100
1118,3/17/2018 8:10,104,86,97,41,69,397,5,100
1119,3/17/2018 8:15,123,89,100,39,80,431,5,100
1120,3/17/2018 8:20,77,74,88,25,69,333,5,100
1121,3/17/2018 8:25,107,79,112,35,64,397,5,100
1122,3/17/2018 8:30,92,84,93,37,76,382,5,100
1123,3/17/2018 8:35,104,92,108,48,73,425,5,100
1124,3/17/2018 8:40,112,92,111,45,74,434,5,100
1125,3/17/2018 8:45,119,93,121,36,83,452,5,100
1126,3/17/2018 8:50,126,101,109,44,84,464,5,100
1127,3/17/2018 8:55,115,92,100,53,75,435,5,100
1128,3/17/2018 9:00,98,78,94,35,64,369,5,100
1129,3/17/2018 9:05,99,91,95,47,81,413,5,100
1130,3/17/2018 9:10,112,84,113,44,68,421,5,100
1131,3/17/2018 9:15,117,89,126,42,86,460,5,100
1132,3/17/2018 9:20,96,75,100,36,69,376,5,100
1133,3/17/2018 9:25,126,100,134,39,87,486,5,100
1134,3/17/2018 9:30,117,91,123,45,70,446,5,100
1135,3/17/2018 9:35,122,98,111,33,72,436,5,100
1136,3/17/2018 9:40,100,87,100,46,68,401,5,100
1137,3/17/2018 9:45,130,99,111,39,76,455,5,100
1138,3/17/2018 9:50,142,106,129,56,90,523,5,100
1139,3/17/2018 9:55,134,108,124,50,84,500,5,100
1140,3/17/2018 10:00,123,108,130,43,101,505,5,100
1141,3/17/2018 10:05,127,101,139,50,82,499,5,100
1142,3/17/2018 10:10,143,113,123,53,97,529,5,100
1143,3/17/2018 10:15,155,109,132,49,95,540,5,100
1144,3/17/2018 10:20,137,122,124,61,84,528,5,100
1145,3/17/2018 10:25,137,110,128,49,87,511,5,100
1146,3/17/2018 10:30,146,115,134,57,79,531,5,100
1147,3/17/2018 10:35,159,127,146,59,105,596,5,100
1148,3/17/2018 10:40,150,115,134,52,93,544,5,100
1149,3/17/2018 10:45,149,110,132,53,104,548,5,100
1150,3/17/2018 10:50,145,116,125,61,81,528,5,100
1151,3/17/2018 10:55,158,128,135,61,88,570,5,100
1152,3/17/2018 11:00,132,110,114,47,86,489,5,100
1153,3/17/2018 11:05,145,122,127,51,82,527,5,100
1154,3/17/2018 11:10,147,110,130,53,93,533,5,100
1155,3/17/2018 11:15,131,106,135,51,94,517,5,100
1156,3/17/2018 11:20,147,114,147,48,108,564,5,100
1157,3/17/2018 11:25,146,119,148,68,105,586,5,100
1158,3/17/2018 11:30,147,126,143,50,105,571,5,100
1159,3/17/2018 11:35,146,109,124,60,111,550,5,100
1160,3/17/2018 11:40,142,113,134,46,95,530,5,100
1161,3/17/2018 11:45,136,119,125,52,85,517,5,100
1162,3/17/2018 11:50,133,105,135,55,90,518,5,100
1163,3/17/2018 11:55,143,109,132,62,94,540,5,100
1164,3/17/2018 12:00,140,114,125,78,94,551,5,100
1165,3/17/2018 12:05,120,104,122,65,92,503,5,100
1166,3/17/2018 12:10,124,88,112,64,101,489,5,100
1167,3/17/2018 12:15,140,99,137,68,90,534,5,100
1168,3/17/2018 12:20,134,102,116,57,103,512,5,100
1169,3/17/2018 12:25,127,117,119,67,98,528,5,100
1170,3/17/2018 12:30,121,107,122,55,103,508,5,100
1171,3/17/2018 12:35,145,113,133,72,96,559,5,100
1172,3/17/2018 12:40,131,98,127,54,91,501,5,100
1173,3/17/2018 12:45,133,98,113,56,86,486,5,100
1174,3/17/2018 12:50,136,111,128,67,77,519,5,100
1175,3/17/2018 12:55,126,111,125,61,85,508,5,100
1176,3/17/2018 13:00,138,96,125,49,91,499,5,100
1177,3/17/2018 13:05,136,111,134,67,91,539,5,100
1178,3/17/2018 13:10,135,109,131,66,100,541,5,100
1179,3/17/2018 13:15,133,102,129,73,86,523,5,100
1180,3/17/2018 13:20,126,112,136,54,101,529,5,100
1181,3/17/2018 13:25,131,101,126,64,89,511,5,100
1182,3/17/2018 13:30,129,108,130,53,100,520,5,100
1183,3/17/2018 13:35,137,103,121,68,97,526,5,100
1184,3/17/2018 13:40,115,112,129,76,96,528,5,100
1185,3/17/2018 13:45,119,109,117,97,109,551,5,100
1186,3/17/2018 13:50,114,97,108,104,102,525,5,100
1187,3/17/2018 13:55,110,112,108,104,86,520,5,100
1188,3/17/2018 14:00,104,93,103,112,102,514,5,100
1189,3/17/2018 14:05,104,103,109,110,97,523,5,100
1190,3/17/2018 14:10,109,98,99,108,96,510,5,100
1191,3/17/2018 14:15,105,91,98,101,92,487,5,100
1192,3/17/2018 14:20,101,91,100,113,82,487,5,100
1193,3/17/2018 14:25,102,95,100,98,92,487,5,100
1194,3/17/2018 14:30,100,89,96,107,95,487,5,100
1195,3/17/2018 14:35,106,99,109,87,116,517,5,100
1196,3/17/2018 14:40,91,96,92,92,95,466,5,100
1197,3/17/2018 14:45,107,97,109,104,100,517,5,100
1198,3/17/2018 14:50,113,102,118,67,93,493,5,100
1199,3/17/2018 14:55,114,100,118,58,84,474,5,100
1200,3/17/2018 15:00,141,119,126,71,95,552,5,100
1201,3/17/2018 15:05,130,115,128,76,75,524,5,100
1202,3/17/2018 15:10,128,111,126,64,80,509,5,100
1203,3/17/2018 15:15,132,102,113,69,91,507,5,100
1204,3/17/2018 15:20,121,109,121,74,79,504,5,100
1205,3/17/2018 15:25,141,112,124,63,93,533,5,100
1206,3/17/2018 15:30,114,114,118,78,96,520,5,100
1207,3/17/2018 15:35,119,118,139,73,109,558,5,100
1208,3/17/2018 15:40,132,105,119,65,97,518,5,100
1209,3/17/2018 15:45,122,107,128,66,91,514,5,100
1210,3/17/2018 15:50,121,92,123,60,77,473,5,100
1211,3/17/2018 15:55,137,105,134,48,88,512,5,100
1212,3/17/2018 16:00,139,113,139,79,96,566,5,100
1213,3/17/2018 16:05,128,113,145,55,92,533,5,100
1214,3/17/2018 16:10,130,101,128,78,84,521,5,100
1215,3/17/2018 16:15,134,105,123,50,91,503,5,100
1216,3/17/2018 16:20,124,99,116,43,107,489,5,100
1217,3/17/2018 16:25,130,107,135,54,84,510,5,100
1218,3/17/2018 16:30,135,103,117,64,99,518,5,100
1219,3/17/2018 16:35,130,116,125,67,97,535,5,100
1220,3/17/2018 16:40,136,114,123,67,102,542,5,100
1221,3/17/2018 16:45,127,114,115,56,88,500,5,100
1222,3/17/2018 16:50,141,110,134,67,93,545,5,100
1223,3/17/2018 16:55,132,107,126,61,83,509,5,100
1224,3/17/2018 17:00,119,112,121,66,90,508,5,100
1225,3/17/2018 17:05,143,106,121,70,89,529,5,100
1226,3/17/2018 17:10,126,102,121,59,91,499,5,100
1227,3/17/2018 17:15,124,107,114,56,79,480,5,100
1228,3/17/2018 17:20,128,105,117,44,98,492,5,100
1229,3/17/2018 17:25,135,108,148,64,105,560,5,100
1230,3/17/2018 17:30,137,115,139,60,97,548,5,100
1231,3/17/2018 17:35,139,109,129,51,80,508,5,100
1232,3/17/2018 17:40,137,102,128,47,94,508,5,100
1233,3/17/2018 17:45,137,113,131,67,87,535,5,100
1234,3/17/2018 17:50,145,119,122,64,88,538,5,100
1235,3/17/2018 17:55,119,113,136,57,74,499,5,100
1236,3/17/2018 18:00,125,99,121,38,81,464,5,100
1237,3/17/2018 18:05,128,93,114,62,88,485,5,100
1238,3/17/2018 18:10,129,114,130,60,83,516,5,100
1239,3/17/2018 18:15,132,97,122,51,85,487,5,100
1240,3/17/2018 18:20,129,110,141,65,94,539,5,100
1241,3/17/2018 18:25,136,120,128,58,89,531,5,100
1242,3/17/2018 18:30,139,106,133,63,98,539,5,100
1243,3/17/2018 18:35,131,103,118,67,90,509,5,100
1244,3/17/2018 18:40,128,99,134,63,84,508,5,100
1245,3/17/2018 18:45,123,108,129,64,94,518,5,100
1246,3/17/2018 18:50,126,109,115,62,79,491,5,100
1247,3/17/2018 18:55,132,100,122,59,86,499,5,100
1248,3/17/2018 19:00,121,105,122,54,94,496,5,100
1249,3/17/2018 19:05,110,95,122,54,98,479,5,100
1250,3/17/2018 19:10,123,104,126,47,82,482,5,100
1251,3/17/2018 19:15,126,102,113,51,79,471,5,100
1252,3/17/2018 19:20,106,78,105,38,83,410,5,100
1253,3/17/2018 19:25,120,90,109,46,77,442,5,100
1254,3/17/2018 19:30,109,81,91,44,69,394,5,100
1255,3/17/2018 19:35,111,87,113,51,74,436,5,100
1256,3/17/2018 19:40,117,100,107,46,86,456,5,100
1257,3/17/2018 19:45,122,82,104,53,65,426,5,100
1258,3/17/2018 19:50,97,82,100,43,69,391,5,100
1259,3/17/2018 19:55,111,83,108,41,68,411,5,100
1260,3/17/2018 20:00,118,84,111,57,71,441,5,100
1261,3/17/2018 20:05,103,72,97,54,69,395,5,100
1262,3/17/2018 20:10,123,77,112,40,66,418,5,100
1263,3/17/2018 20:15,101,81,101,55,73,411,5,100
1264,3/17/2018 20:20,106,89,103,44,70,412,5,100
1265,3/17/2018 20:25,103,96,103,56,70,428,5,100
1266,3/17/2018 20:30,92,85,88,55,62,382,5,100
1267,3/17/2018 20:35,116,81,102,38,64,401,5,100
1268,3/17/2018 20:40,101,75,85,45,60,366,5,100
1269,3/17/2018 20:45,81,70,86,37,59,333,5,100
1270,3/17/2018 20:50,90,73,89,36,65,353,5,100
1271,3/17/2018 20:55,93,77,93,36,62,361,5,100
1272,3/17/2018 21:00,76,75,84,32,54,321,5,100
1273,3/17/2018 21:05,78,78,83,39,55,333,5,100
1274,3/17/2018 21:10,109,72,92,35,62,370,5,100
1275,3/17/2018 21:15,99,88,93,45,68,393,5,100
1276,3/17/2018 21:20,93,80,97,42,69,381,5,100
1277,3/17/2018 21:25,92,84,86,38,58,358,5,100
1278,3/17/2018 21:30,92,79,86,34,61,352,5,100
1279,3/17/2018 21:35,84,66,97,42,58,347,5,100
1280,3/17/2018 21:40,77,73,73,24,61,308,5,100
1281,3/17/2018 21:45,84,71,103,37,66,361,5,100
1282,3/17/2018 21:50,81,64,79,17,51,292,5,100
1283,3/17/2018 21:55,81,71,81,36,59,328,5,100
1284,3/17/2018 22:00,77,77,84,37,52,327,5,100
1285,3/17/2018 22:05,79,75,83,35,56,328,5,100
1286,3/17/2018 22:10,78,83,88,48,59,356,5,100
1287,3/17/2018 22:15,80,78,79,41,61,339,5,100
1288,3/17/2018 22:20,87,75,83,33,61,339,5,100
1289,3/17/2018 22:25,90,88,92,38,63,371,5,100
1290,3/17/2018 22:30,82,60,93,33,59,327,5,100
1291,3/17/2018 22:35,76,74,80,40,63,333,5,100
1292,3/17/2018 22:40,80,78,82,40,64,344,5,100
1293,3/17/2018 22:45,70,72,75,30,54,301,5,100
1294,3/17/2018 22:50,73,71,77,50,57,328,5,100
1295,3/17/2018 22:55,66,61,70,27,57,281,5,100
1296,3/17/2018 23:00,80,63,76,34,55,308,5,100
1297,3/17/2018 23:05,64,62,78,24,57,285,5,100
1298,3/17/2018 23:10,73,67,71,38,52,301,5,100
1299,3/17/2018 23:15,71,57,81,32,58,299,5,100
1300,3/17/2018 23:20,67,69,77,46,49,308,5,100
1301,3/17/2018 23:25,58,60,63,36,31,248,5,100
1302,3/17/2018 23:30,76,65,72,39,48,300,5,100
1303,3/17/2018 23:35,71,62,60,20,44,257,5,100
1304,3/17/2018 23:40,72,66,60,30,48,276,5,100
1305,3/17/2018 23:45,48,55,62,38,46,249,5,100
1306,3/17/2018 23:50,53,54,49,24,36,216,5,100
1307,3/17/2018 23:55,56,51,55,27,41,230,5,100
1308,3/18/2018 0:00,48,61,62,30,38,239,5,100
1309,3/18/2018 0:05,48,41,43,28,28,188,5,100
1310,3/18/2018 0:10,54,54,62,23,44,237,5,100
1311,3/18/2018 0:15,44,62,68,21,47,242,5,100
1312,3/18/2018 0:20,43,47,59,14,37,200,5,100
1313,3/18/2018 0:25,43,47,50,21,30,191,5,100
1314,3/18/2018 0:30,43,44,60,23,33,203,5,100
1315,3/18/2018 0:35,42,43,43,20,33,181,5,100
1316,3/18/2018 0:40,38,46,40,22,40,186,5,100
1317,3/18/2018 0:45,35,35,46,22,34,172,5,100
1318,3/18/2018 0:50,39,36,45,12,31,163,5,100
1319,3/18/2018 0:55,28,36,39,16,27,146,5,100
1320,3/18/2018 1:00,33,44,30,17,28,152,5,100
1321,3/18/2018 1:05,28,29,31,16,29,133,5,100
1322,3/18/2018 1:10,29,29,36,9,28,131,5,100
1323,3/18/2018 1:15,35,43,34,14,35,161,5,100
1324,3/18/2018 1:20,31,45,35,15,35,161,5,100
1325,3/18/2018 1:25,22,34,32,16,27,131,5,100
1326,3/18/2018 1:30,27,36,33,10,18,124,5,100
1327,3/18/2018 1:35,26,32,32,9,17,116,5,100
1328,3/18/2018 1:40,31,36,33,13,28,141,5,100
1329,3/18/2018 1:45,25,29,25,22,26,127,5,100
1330,3/18/2018 1:50,27,36,33,15,28,139,5,100
1331,3/18/2018 1:55,22,26,28,11,26,113,5,100
1332,3/18/2018 2:00,23,24,32,7,15,101,5,100
1333,3/18/2018 2:05,25,33,33,15,19,125,5,100
1334,3/18/2018 2:10,18,32,25,15,24,114,5,100
1335,3/18/2018 2:15,19,27,33,12,21,112,5,100
1336,3/18/2018 2:20,19,22,27,12,28,108,5,100
1337,3/18/2018 2:25,14,28,25,7,24,98,5,100
1338,3/18/2018 2:30,14,24,26,4,23,91,5,100
1339,3/18/2018 2:35,14,23,18,15,19,89,5,100
1340,3/18/2018 2:40,15,18,23,13,18,87,5,100
1341,3/18/2018 2:45,13,23,21,6,20,83,5,100
1342,3/18/2018 2:50,12,24,20,4,19,79,5,100
1343,3/18/2018 2:55,10,18,22,9,8,67,5,100
1344,3/18/2018 3:00,13,18,13,9,16,69,5,100
1345,3/18/2018 3:05,12,17,22,3,7,61,5,100
1346,3/18/2018 3:10,9,16,16,8,12,61,5,100
1347,3/18/2018 3:15,10,18,16,6,14,64,5,100
1348,3/18/2018 3:20,15,17,21,10,12,75,5,100
1349,3/18/2018 3:25,6,16,14,6,15,57,5,100
1350,3/18/2018 3:30,10,17,22,5,13,67,5,100
1351,3/18/2018 3:35,17,21,17,6,11,72,5,100
1352,3/18/2018 3:40,9,17,14,7,10,57,5,100
1353,3/18/2018 3:45,8,16,12,4,10,50,5,100
1354,3/18/2018 3:50,8,9,12,6,14,49,5,100
1355,3/18/2018 3:55,9,16,20,5,10,60,5,100
1356,3/18/2018 4:00,9,18,11,9,16,63,5,100
1357,3/18/2018 4:05,5,13,10,5,15,48,5,100
1358,3/18/2018 4:10,6,14,10,3,12,45,5,100
1359,3/18/2018 4:15,9,12,7,6,12,46,5,100
1360,3/18/2018 4:20,11,13,15,9,11,59,5,100
1361,3/18/2018 4:25,8,12,14,8,16,58,5,100
1362,3/18/2018 4:30,5,10,16,5,14,50,5,100
1363,3/18/2018 4:35,8,22,18,2,16,66,5,100
1364,3/18/2018 4:40,8,19,19,5,14,65,5,100
1365,3/18/2018 4:45,10,20,13,9,12,64,5,100
1366,3/18/2018 4:50,7,20,19,15,7,68,5,100
1367,3/18/2018 4:55,5,11,13,9,16,54,5,100
1368,3/18/2018 5:00,7,10,10,3,14,44,5,100
1369,3/18/2018 5:05,7,14,18,8,14,61,5,100
1370,3/18/2018 5:10,11,15,25,11,17,79,5,100
1371,3/18/2018 5:15,13,20,29,15,11,88,5,100
1372,3/18/2018 5:20,11,16,19,11,21,78,5,100
1373,3/18/2018 5:25,19,14,17,9,14,73,5,100
1374,3/18/2018 5:30,11,24,20,5,15,75,5,100
1375,3/18/2018 5:35,13,24,24,8,26,95,5,100
1376,3/18/2018 5:40,17,20,22,12,22,93,5,100
1377,3/18/2018 5:45,13,20,18,10,25,86,5,100
1378,3/18/2018 5:50,19,27,19,10,27,102,5,100
1379,3/18/2018 5:55,17,28,28,8,13,94,5,100
1380,3/18/2018 6:00,15,23,28,11,17,94,5,100
1381,3/18/2018 6:05,16,20,28,22,20,106,5,100
1382,3/18/2018 6:10,20,26,24,12,26,108,5,100
1383,3/18/2018 6:15,28,34,37,13,32,144,5,100
1384,3/18/2018 6:20,27,29,37,11,29,133,5,100
1385,3/18/2018 6:25,33,36,34,19,21,143,5,100
1386,3/18/2018 6:30,31,32,43,12,34,152,5,100
1387,3/18/2018 6:35,30,36,41,13,31,151,5,100
1388,3/18/2018 6:40,27,36,38,21,34,156,5,100
1389,3/18/2018 6:45,34,33,48,19,36,170,5,100
1390,3/18/2018 6:50,46,40,43,16,32,177,5,100
1391,3/18/2018 6:55,45,35,45,12,33,170,5,100
1392,3/18/2018 7:00,28,36,37,22,27,150,5,100
1393,3/18/2018 7:05,30,34,44,19,38,165,5,100
1394,3/18/2018 7:10,30,45,49,13,40,177,5,100
1395,3/18/2018 7:15,50,42,51,18,35,196,5,100
1396,3/18/2018 7:20,48,43,48,15,34,188,5,100
1397,3/18/2018 7:25,45,45,46,20,28,184,5,100
1398,3/18/2018 7:30,48,49,60,24,39,220,5,100
1399,3/18/2018 7:35,47,48,56,19,39,209,5,100
1400,3/18/2018 7:40,41,39,65,35,45,225,5,100
1401,3/18/2018 7:45,56,54,66,21,57,254,5,100
1402,3/18/2018 7:50,57,49,50,20,42,218,5,100
1403,3/18/2018 7:55,49,62,64,29,48,252,5,100
1404,3/18/2018 8:00,49,56,54,28,41,228,5,100
1405,3/18/2018 8:05,55,63,58,24,44,244,5,100
1406,3/18/2018 8:10,59,60,71,17,37,244,5,100
1407,3/18/2018 8:15,52,57,61,30,51,251,5,100
1408,3/18/2018 8:20,55,58,57,17,45,232,5,100
1409,3/18/2018 8:25,67,64,62,24,38,255,5,100
1410,3/18/2018 8:30,60,50,61,25,56,252,5,100
1411,3/18/2018 8:35,70,71,106,25,46,318,5,100
1412,3/18/2018 8:40,81,58,77,32,65,313,5,100
1413,3/18/2018 8:45,76,71,80,41,75,343,5,100
1414,3/18/2018 8:50,73,80,87,36,57,333,5,100
1415,3/18/2018 8:55,71,64,77,23,54,289,5,100
1416,3/18/2018 9:00,77,80,86,33,58,334,5,100
1417,3/18/2018 9:05,79,73,86,40,62,340,5,100
1418,3/18/2018 9:10,64,71,90,36,58,319,5,100
1419,3/18/2018 9:15,93,71,98,31,66,359,5,100
1420,3/18/2018 9:20,75,73,78,36,66,328,5,100
1421,3/18/2018 9:25,89,75,90,37,61,352,5,100
1422,3/18/2018 9:30,102,77,90,43,65,377,5,100
1423,3/18/2018 9:35,79,68,89,38,67,341,5,100
1424,3/18/2018 9:40,90,76,83,38,52,339,5,100
1425,3/18/2018 9:45,106,89,92,39,71,397,5,100
1426,3/18/2018 9:50,107,85,100,49,74,415,5,100
1427,3/18/2018 9:55,93,75,101,37,71,377,5,100
1428,3/18/2018 10:00,101,82,107,37,79,406,5,100
1429,3/18/2018 10:05,96,74,90,34,69,363,5,100
1430,3/18/2018 10:10,91,72,94,30,64,351,5,100
1431,3/18/2018 10:15,112,93,106,49,78,438,5,100
1432,3/18/2018 10:20,95,95,106,39,84,419,5,100
1433,3/18/2018 10:25,102,91,114,30,67,404,5,100
1434,3/18/2018 10:30,109,92,122,33,82,438,5,100
1435,3/18/2018 10:35,87,88,95,54,86,410,5,100
1436,3/18/2018 10:40,119,101,103,43,89,455,5,100
1437,3/18/2018 10:45,109,108,110,47,75,449,5,100
1438,3/18/2018 10:50,108,101,101,49,85,444,5,100
1439,3/18/2018 10:55,112,106,113,50,91,472,5,100
1440,3/18/2018 11:00,123,98,108,43,84,456,5,100
1441,3/18/2018 11:05,125,96,115,42,86,464,5,100
1442,3/18/2018 11:10,112,103,109,47,88,459,5,100
1443,3/18/2018 11:15,121,109,110,62,83,485,5,100
1444,3/18/2018 11:20,131,111,123,64,90,519,5,100
1445,3/18/2018 11:25,119,109,126,49,97,500,5,100
1446,3/18/2018 11:30,124,101,123,54,108,510,5,100
1447,3/18/2018 11:35,125,107,131,62,105,530,5,100
1448,3/18/2018 11:40,124,107,118,46,94,489,5,100
1449,3/18/2018 11:45,131,107,126,64,96,524,5,100
1450,3/18/2018 11:50,137,99,131,60,96,523,5,100
1451,3/18/2018 11:55,116,104,117,58,97,492,5,100
1452,3/18/2018 12:00,126,99,118,39,98,480,5,100
1453,3/18/2018 12:05,121,102,125,62,103,513,5,100
1454,3/18/2018 12:10,134,103,123,58,96,514,5,100
1455,3/18/2018 12:15,127,99,120,47,91,484,5,100
1456,3/18/2018 12:20,135,101,123,43,81,483,5,100
1457,3/18/2018 12:25,118,106,112,49,78,463,5,100
1458,3/18/2018 12:30,104,101,115,44,103,467,5,100
1459,3/18/2018 12:35,134,110,128,56,111,539,5,100
1460,3/18/2018 12:40,154,111,135,62,97,559,5,100
1461,3/18/2018 12:45,143,122,143,65,105,578,5,100
1462,3/18/2018 12:50,140,113,123,50,104,530,5,100
1463,3/18/2018 12:55,129,120,139,60,96,544,5,100
1464,3/18/2018 13:00,159,114,139,63,106,581,5,100
1465,3/18/2018 13:05,118,104,125,49,84,480,5,100
1466,3/18/2018 13:10,157,112,136,63,105,573,5,100
1467,3/18/2018 13:15,136,111,137,51,96,531,5,100
1468,3/18/2018 13:20,138,115,140,63,109,565,5,100
1469,3/18/2018 13:25,145,121,138,76,109,589,5,100
1470,3/18/2018 13:30,149,123,147,53,104,576,5,100
1471,3/18/2018 13:35,144,109,127,75,91,546,5,100
1472,3/18/2018 13:40,137,114,120,58,87,516,5,100
1473,3/18/2018 13:45,137,121,140,53,110,561,5,100
1474,3/18/2018 13:50,116,95,106,53,89,459,5,100
1475,3/18/2018 13:55,141,103,121,56,80,501,5,100
1476,3/18/2018 14:00,122,96,130,55,89,492,5,100
1477,3/18/2018 14:05,127,117,120,62,93,519,5,100
1478,3/18/2018 14:10,130,111,134,71,112,558,5,100
1479,3/18/2018 14:15,122,110,128,80,106,546,5,100
1480,3/18/2018 14:20,128,118,122,74,98,540,5,100
1481,3/18/2018 14:25,129,97,125,60,94,505,5,100
1482,3/18/2018 14:30,143,112,135,70,91,551,5,100
1483,3/18/2018 14:35,139,124,134,60,102,559,5,100
1484,3/18/2018 14:40,134,105,117,59,90,505,5,100
1485,3/18/2018 14:45,115,95,118,64,95,487,5,100
1486,3/18/2018 14:50,124,109,129,58,97,517,5,100
1487,3/18/2018 14:55,124,96,125,54,84,483,5,100
1488,3/18/2018 15:00,121,91,123,63,84,482,5,100
1489,3/18/2018 15:05,143,103,125,54,90,515,5,100
1490,3/18/2018 15:10,145,116,139,60,111,571,5,100
1491,3/18/2018 15:15,126,98,112,60,99,495,5,100
1492,3/18/2018 15:20,115,104,124,78,88,509,5,100
1493,3/18/2018 15:25,137,105,127,54,86,509,5,100
1494,3/18/2018 15:30,137,97,126,45,84,489,5,100
1495,3/18/2018 15:35,140,111,134,60,97,542,5,100
1496,3/18/2018 15:40,132,103,123,54,88,500,5,100
1497,3/18/2018 15:45,126,101,132,64,89,512,5,100
1498,3/18/2018 15:50,143,121,131,64,103,562,5,100
1499,3/18/2018 15:55,127,116,128,63,98,532,5,100
1500,3/18/2018 16:00,134,109,128,58,105,534,5,100
1501,3/18/2018 16:05,128,100,134,46,96,504,5,100
1502,3/18/2018 16:10,118,107,129,47,96,497,5,100
1503,3/18/2018 16:15,134,118,130,62,96,540,5,100
1504,3/18/2018 16:20,130,102,115,61,95,503,5,100
1505,3/18/2018 16:25,133,98,129,65,94,519,5,100
1506,3/18/2018 16:30,135,102,116,54,85,492,5,100
1507,3/18/2018 16:35,131,101,127,64,92,515,5,100
1508,3/18/2018 16:40,131,102,122,49,95,499,5,100
1509,3/18/2018 16:45,148,111,132,64,93,548,5,100
1510,3/18/2018 16:50,128,106,131,54,95,514,5,100
1511,3/18/2018 16:55,144,112,134,62,101,553,5,100
1512,3/18/2018 17:00,131,105,125,62,75,498,5,100
1513,3/18/2018 17:05,132,105,122,65,95,519,5,100
1514,3/18/2018 17:10,132,115,126,70,99,542,5,100
1515,3/18/2018 17:15,128,115,117,60,100,520,5,100
1516,3/18/2018 17:20,142,120,129,58,101,550,5,100
1517,3/18/2018 17:25,128,93,129,50,89,489,5,100
1518,3/18/2018 17:30,142,104,127,56,104,533,5,100
1519,3/18/2018 17:35,141,106,136,64,89,536,5,100
1520,3/18/2018 17:40,144,117,144,51,81,537,5,100
1521,3/18/2018 17:45,146,112,135,54,94,541,5,100
1522,3/18/2018 17:50,122,115,127,40,86,490,5,100
1523,3/18/2018 17:55,138,108,111,51,77,485,5,100
1524,3/18/2018 18:00,127,98,117,63,81,486,5,100
1525,3/18/2018 18:05,118,105,129,54,81,487,5,100
1526,3/18/2018 18:10,135,117,114,45,93,504,5,100
1527,3/18/2018 18:15,144,109,128,45,90,516,5,100
1528,3/18/2018 18:20,128,86,118,55,62,449,5,100
1529,3/18/2018 18:25,142,95,134,50,96,517,5,100
1530,3/18/2018 18:30,135,95,118,50,91,489,5,100
1531,3/18/2018 18:35,129,99,120,38,72,458,5,100
1532,3/18/2018 18:40,130,111,120,48,95,504,5,100
1533,3/18/2018 18:45,128,95,126,60,71,480,5,100
1534,3/18/2018 18:50,116,86,108,54,78,442,5,100
1535,3/18/2018 18:55,113,87,106,40,69,415,5,100
1536,3/18/2018 19:00,113,93,107,46,62,421,5,100
1537,3/18/2018 19:05,105,84,111,47,61,408,5,100
1538,3/18/2018 19:10,117,97,113,37,73,437,5,100
1539,3/18/2018 19:15,109,97,104,47,74,431,5,100
1540,3/18/2018 19:20,128,88,119,46,82,463,5,100
1541,3/18/2018 19:25,110,81,99,45,62,397,5,100
1542,3/18/2018 19:30,109,86,92,38,74,399,5,100
1543,3/18/2018 19:35,107,93,101,48,78,427,5,100
1544,3/18/2018 19:40,115,97,107,53,69,441,5,100
1545,3/18/2018 19:45,111,91,112,50,67,431,5,100
1546,3/18/2018 19:50,100,80,113,52,71,416,5,100
1547,3/18/2018 19:55,104,86,98,40,70,398,5,100
1548,3/18/2018 20:00,101,71,105,50,71,398,5,100
1549,3/18/2018 20:05,113,85,102,31,72,403,5,100
1550,3/18/2018 20:10,106,80,111,47,61,405,5,100
1551,3/18/2018 20:15,94,81,100,39,72,386,5,100
1552,3/18/2018 20:20,111,92,99,41,59,402,5,100
1553,3/18/2018 20:25,108,79,94,43,63,387,5,100
1554,3/18/2018 20:30,95,73,101,32,61,362,5,100
1555,3/18/2018 20:35,102,75,102,41,52,372,5,100
1556,3/18/2018 20:40,98,74,101,37,75,385,5,100
1557,3/18/2018 20:45,94,81,91,44,64,374,5,100
1558,3/18/2018 20:50,119,75,99,46,58,397,5,100
1559,3/18/2018 20:55,107,85,98,27,56,373,5,100
1560,3/18/2018 21:00,98,76,94,34,68,370,5,100
1561,3/18/2018 21:05,100,86,96,40,64,386,5,100
1562,3/18/2018 21:10,112,85,93,31,64,385,5,100
1563,3/18/2018 21:15,88,73,81,27,53,322,5,100
1564,3/18/2018 21:20,88,67,87,31,55,328,5,100
1565,3/18/2018 21:25,84,75,85,35,63,342,5,100
1566,3/18/2018 21:30,97,78,99,39,53,366,5,100
1567,3/18/2018 21:35,91,80,91,38,54,354,5,100
1568,3/18/2018 21:40,92,84,86,41,50,353,5,100
1569,3/18/2018 21:45,96,68,88,33,55,340,5,100
1570,3/18/2018 21:50,76,76,76,30,54,312,5,100
1571,3/18/2018 21:55,68,64,77,28,57,294,5,100
1572,3/18/2018 22:00,68,52,72,22,52,266,5,100
1573,3/18/2018 22:05,81,67,77,27,57,309,5,100
1574,3/18/2018 22:10,82,72,86,31,52,323,5,100
1575,3/18/2018 22:15,84,72,79,30,47,312,5,100
1576,3/18/2018 22:20,82,67,80,32,53,314,5,100
1577,3/18/2018 22:25,67,64,72,39,65,307,5,100
1578,3/18/2018 22:30,57,58,70,30,57,272,5,100
1579,3/18/2018 22:35,63,51,72,32,49,267,5,100
1580,3/18/2018 22:40,74,66,72,26,59,297,5,100
1581,3/18/2018 22:45,50,51,61,36,42,240,5,100
1582,3/18/2018 22:50,54,59,57,39,41,250,5,100
1583,3/18/2018 22:55,66,48,69,26,44,253,5,100
1584,3/18/2018 23:00,53,42,56,29,41,221,5,100
1585,3/18/2018 23:05,46,45,55,27,50,223,5,100
1586,3/18/2018 23:10,58,57,53,29,59,256,5,100
1587,3/18/2018 23:15,60,55,62,32,41,250,5,100
1588,3/18/2018 23:20,47,59,67,30,45,248,5,100
1589,3/18/2018 23:25,53,46,43,34,51,227,5,100
1590,3/18/2018 23:30,44,48,54,21,38,205,5,100
1591,3/18/2018 23:35,35,42,55,25,60,217,5,100
1592,3/18/2018 23:40,32,44,40,22,44,182,5,100
1593,3/18/2018 23:45,43,37,51,25,44,200,5,100
1594,3/18/2018 23:50,39,44,44,16,45,188,5,100
1595,3/18/2018 23:55,37,41,46,28,45,197,5,100
1596,3/19/2018 0:00,41,35,36,25,46,183,5,100
1597,3/19/2018 0:05,37,34,34,16,40,161,5,100
1598,3/19/2018 0:10,32,41,34,17,24,148,5,100
1599,3/19/2018 0:15,24,34,39,18,37,152,5,100
1600,3/19/2018 0:20,25,37,28,21,25,136,5,100
1601,3/19/2018 0:25,31,30,37,13,31,142,5,100
1602,3/19/2018 0:30,17,24,25,13,26,105,5,100
1603,3/19/2018 0:35,22,22,30,12,26,112,5,100
1604,3/19/2018 0:40,26,23,29,13,23,114,5,100
1605,3/19/2018 0:45,16,31,21,17,22,107,5,100
1606,3/19/2018 0:50,20,28,28,11,32,119,5,100
1607,3/19/2018 0:55,18,24,25,13,37,117,5,100
1608,3/19/2018 1:00,19,33,24,17,26,119,5,100
1609,3/19/2018 1:05,21,29,22,13,21,106,5,100
1610,3/19/2018 1:10,19,20,27,17,29,112,5,100
1611,3/19/2018 1:15,12,29,22,14,26,103,5,100
1612,3/19/2018 1:20,14,27,20,12,21,94,5,100
1613,3/19/2018 1:25,12,19,19,5,26,81,5,100
1614,3/19/2018 1:30,13,20,16,10,18,77,5,100
1615,3/19/2018 1:35,13,12,18,6,19,68,5,100
1616,3/19/2018 1:40,17,12,22,8,24,83,5,100
1617,3/19/2018 1:45,14,21,16,6,11,68,5,100
1618,3/19/2018 1:50,16,18,13,10,20,77,5,100
1619,3/19/2018 1:55,8,14,16,3,12,53,5,100
1620,3/19/2018 2:00,3,16,10,9,8,46,5,100
1621,3/19/2018 2:05,5,18,12,8,13,56,5,100
1622,3/19/2018 2:10,10,19,14,13,7,63,5,100
1623,3/19/2018 2:15,5,11,10,4,11,41,5,100
1624,3/19/2018 2:20,11,13,17,4,11,56,5,100
1625,3/19/2018 2:25,8,14,12,2,11,47,5,100
1626,3/19/2018 2:30,9,16,12,5,14,56,5,100
1627,3/19/2018 2:35,5,13,14,3,9,44,5,100
1628,3/19/2018 2:40,7,8,13,4,10,42,5,100
1629,3/19/2018 2:45,7,14,16,3,6,46,5,100
1630,3/19/2018 2:50,3,11,17,2,9,42,5,100
1631,3/19/2018 2:55,9,14,15,1,14,53,5,100
1632,3/19/2018 3:00,6,18,11,7,15,57,5,100
1633,3/19/2018 3:05,5,10,14,5,7,41,5,100
1634,3/19/2018 3:10,3,13,9,5,10,40,5,100
1635,3/19/2018 3:15,6,10,10,6,12,44,5,100
1636,3/19/2018 3:20,1,11,8,6,10,36,5,100
1637,3/19/2018 3:25,11,17,16,4,8,56,5,100
1638,3/19/2018 3:30,8,13,12,3,10,46,5,100
1639,3/19/2018 3:35,5,8,11,6,13,43,5,100
1640,3/19/2018 3:40,9,21,11,3,13,57,5,100
1641,3/19/2018 3:45,9,14,22,5,17,67,5,100
1642,3/19/2018 3:50,7,19,16,7,10,59,5,100
1643,3/19/2018 3:55,10,21,17,6,12,66,5,100
1644,3/19/2018 4:00,9,20,22,9,16,76,5,100
1645,3/19/2018 4:05,11,15,18,10,18,72,5,100
1646,3/19/2018 4:10,14,14,20,6,15,69,5,100
1647,3/19/2018 4:15,18,29,28,10,19,104,5,100
1648,3/19/2018 4:20,12,24,23,5,19,83,5,100
1649,3/19/2018 4:25,24,20,24,9,18,95,5,100
1650,3/19/2018 4:30,31,32,35,9,18,125,5,100
1651,3/19/2018 4:35,32,34,32,12,18,128,5,100
1652,3/19/2018 4:40,32,35,39,13,27,146,5,100
1653,3/19/2018 4:45,32,36,42,12,32,154,5,100
1654,3/19/2018 4:50,29,36,30,21,28,144,5,100
1655,3/19/2018 4:55,40,42,43,20,37,182,5,100
1656,3/19/2018 5:00,51,39,51,15,27,183,5,100
1657,3/19/2018 5:05,43,33,47,15,35,173,5,100
1658,3/19/2018 5:10,52,45,61,21,29,208,5,100
1659,3/19/2018 5:15,77,68,67,24,38,274,5,100
1660,3/19/2018 5:20,78,52,66,21,50,267,5,100
1661,3/19/2018 5:25,74,59,71,20,46,270,5,100
1662,3/19/2018 5:30,88,61,79,30,55,313,5,100
1663,3/19/2018 5:35,81,65,75,27,44,292,5,100
1664,3/19/2018 5:40,98,59,97,41,55,350,5,100
1665,3/19/2018 5:45,92,76,81,45,59,353,5,100
1666,3/19/2018 5:50,87,57,88,51,63,346,5,100
1667,3/19/2018 5:55,90,62,83,34,55,324,5,100
1668,3/19/2018 6:00,84,63,75,34,63,319,5,100
1669,3/19/2018 6:05,84,62,79,32,59,316,5,100
1670,3/19/2018 6:10,75,70,60,35,49,289,5,100
1671,3/19/2018 6:15,95,58,91,28,49,321,5,100
1672,3/19/2018 6:20,94,68,90,49,59,360,5,100
1673,3/19/2018 6:25,106,75,93,46,55,375,5,100
1674,3/19/2018 6:30,110,76,100,46,70,402,5,100
1675,3/19/2018 6:35,95,74,85,44,51,349,5,100
1676,3/19/2018 6:40,122,88,104,56,86,456,5,100
1677,3/19/2018 6:45,114,76,113,46,93,442,5,100
1678,3/19/2018 6:50,120,86,106,59,77,448,5,100
1679,3/19/2018 6:55,104,84,104,60,73,425,5,100
1680,3/19/2018 7:00,114,87,110,55,61,427,5,100
1681,3/19/2018 7:05,121,92,114,53,78,458,5,100
1682,3/19/2018 7:10,139,98,119,65,92,513,5,100
1683,3/19/2018 7:15,134,98,125,66,86,509,5,100
1684,3/19/2018 7:20,139,93,128,74,76,510,5,100
1685,3/19/2018 7:25,146,126,130,79,100,581,5,100
1686,3/19/2018 7:30,165,112,143,79,85,584,5,100
1687,3/19/2018 7:35,156,113,142,81,104,596,5,100
1688,3/19/2018 7:40,156,114,147,94,103,614,5,100
1689,3/19/2018 7:45,158,117,142,78,102,597,5,100
1690,3/19/2018 7:50,141,104,134,97,83,559,5,100
1691,3/19/2018 7:55,126,97,116,77,95,511,5,100
1692,3/19/2018 8:00,147,111,118,67,86,529,5,100
1693,3/19/2018 8:05,140,98,118,72,81,509,5,100
1694,3/19/2018 8:10,141,92,119,101,91,544,5,100
1695,3/19/2018 8:15,163,124,143,80,105,615,5,100
1696,3/19/2018 8:20,134,110,132,80,89,545,5,100
1697,3/19/2018 8:25,137,111,124,64,98,534,5,100
1698,3/19/2018 8:30,133,88,120,77,87,505,5,100
1699,3/19/2018 8:35,142,102,106,70,79,499,5,100
1700,3/19/2018 8:40,135,97,143,61,87,523,5,100
1701,3/19/2018 8:45,140,102,135,60,86,523,5,100
1702,3/19/2018 8:50,148,105,113,64,91,521,5,100
1703,3/19/2018 8:55,131,94,107,67,101,500,5,100
1704,3/19/2018 9:00,131,86,115,57,73,462,5,100
1705,3/19/2018 9:05,126,98,124,57,80,485,5,100
1706,3/19/2018 9:10,117,81,111,58,70,437,5,100
1707,3/19/2018 9:15,116,82,104,51,81,434,5,100
1708,3/19/2018 9:20,125,97,125,51,84,482,5,100
1709,3/19/2018 9:25,131,90,121,68,70,480,5,100
1710,3/19/2018 9:30,116,105,104,63,74,462,5,100
1711,3/19/2018 9:35,118,77,105,54,72,426,5,100
1712,3/19/2018 9:40,129,94,115,54,81,473,5,100
1713,3/19/2018 9:45,114,94,105,65,92,470,5,100
1714,3/19/2018 9:50,126,102,113,47,88,476,5,100
1715,3/19/2018 9:55,112,98,114,50,78,452,5,100
1716,3/19/2018 10:00,107,100,115,51,80,453,5,100
1717,3/19/2018 10:05,105,84,101,50,81,421,5,100
1718,3/19/2018 10:10,102,72,89,50,70,383,5,100
1719,3/19/2018 10:15,102,98,94,58,81,433,5,100
1720,3/19/2018 10:20,100,85,107,67,73,432,5,100
1721,3/19/2018 10:25,107,85,104,64,73,433,5,100
1722,3/19/2018 10:30,99,78,104,53,70,404,5,100
1723,3/19/2018 10:35,100,93,106,62,81,442,5,100
1724,3/19/2018 10:40,124,82,108,51,84,449,5,100
1725,3/19/2018 10:45,117,96,115,56,89,473,5,100
1726,3/19/2018 10:50,123,96,109,51,85,464,5,100
1727,3/19/2018 10:55,118,85,125,58,89,475,5,100
1728,3/19/2018 11:00,112,91,96,51,75,425,5,100
1729,3/19/2018 11:05,127,88,122,66,76,479,5,100
1730,3/19/2018 11:10,140,100,122,62,98,522,5,100
1731,3/19/2018 11:15,116,103,114,55,85,473,5,100
1732,3/19/2018 11:20,122,99,127,70,82,500,5,100
1733,3/19/2018 11:25,132,102,127,73,88,522,5,100
1734,3/19/2018 11:30,126,95,130,61,88,500,5,100
1735,3/19/2018 11:35,126,93,106,61,93,479,5,100
1736,3/19/2018 11:40,104,89,117,65,81,456,5,100
1737,3/19/2018 11:45,133,101,123,67,80,504,5,100
1738,3/19/2018 11:50,112,90,109,69,78,458,5,100
1739,3/19/2018 11:55,125,99,119,59,82,484,5,100
0,3/19/2018 11:00,112,91,96,51,75,425,5,100
1,3/19/2018 11:05,127,88,122,66,76,479,5,100
2,3/19/2018 11:10,140,100,122,62,98,522,5,100
3,3/19/2018 11:15,116,103,114,55,85,473,5,100
4,3/19/2018 11:20,122,99,127,70,82,500,5,100
5,3/19/2018 11:25,132,102,127,73,88,522,5,100
6,3/19/2018 11:30,126,95,130,61,88,500,5,100
7,3/19/2018 11:35,126,93,106,61,93,479,5,100
8,3/19/2018 11:40,104,89,117,65,81,456,5,100
9,3/19/2018 11:45,133,101,123,67,80,504,5,100
10,3/19/2018 11:50,112,90,109,69,78,458,5,100
11,3/19/2018 11:55,125,99,119,59,82,484,5,100
12,3/19/2018 12:00,126,100,108,73,85,492,5,100
13,3/19/2018 12:05,137,107,120,74,99,537,5,100
14,3/19/2018 12:10,134,98,127,59,94,512,5,100
15,3/19/2018 12:15,140,110,125,68,75,518,5,100
16,3/19/2018 12:20,115,91,119,63,88,476,5,100
17,3/19/2018 12:25,123,98,138,63,86,508,5,100
18,3/19/2018 12:30,142,102,123,46,102,515,5,100
19,3/19/2018 12:35,118,108,139,65,91,521,5,100
20,3/19/2018 12:40,136,108,115,79,89,527,5,100
21,3/19/2018 12:45,126,102,130,60,81,499,5,100
22,3/19/2018 12:50,121,101,122,66,88,498,5,100
23,3/19/2018 12:55,150,116,128,62,99,555,5,100
24,3/19/2018 13:00,129,95,134,69,89,516,5,100
25,3/19/2018 13:05,136,108,126,67,92,529,5,100
26,3/19/2018 13:10,130,100,112,67,107,516,5,100
27,3/19/2018 13:15,133,96,132,64,102,527,5,100
28,3/19/2018 13:20,138,110,126,73,81,528,5,100
29,3/19/2018 13:25,136,102,129,70,94,531,5,100
30,3/19/2018 13:30,134,111,121,65,92,523,5,100
31,3/19/2018 13:35,138,88,129,54,89,498,5,100
32,3/19/2018 13:40,142,103,125,82,109,561,5,100
33,3/19/2018 13:45,133,112,133,62,99,539,5,100
34,3/19/2018 13:50,128,104,131,58,96,517,5,100
35,3/19/2018 13:55,132,90,131,67,104,524,5,100
36,3/19/2018 14:00,143,120,132,77,103,575,5,100
37,3/19/2018 14:05,147,118,132,66,98,561,5,100
38,3/19/2018 14:10,146,104,127,74,104,555,5,100
39,3/19/2018 14:15,157,99,142,93,109,600,5,100
40,3/19/2018 14:20,133,109,134,89,104,569,5,100
41,3/19/2018 14:25,130,113,131,90,105,569,5,100
42,3/19/2018 14:30,129,111,131,91,102,564,5,100
43,3/19/2018 14:35,143,110,141,99,105,598,5,100
44,3/19/2018 14:40,142,101,118,84,95,540,5,100
45,3/19/2018 14:45,117,94,116,90,83,500,5,100
46,3/19/2018 14:50,101,90,114,123,109,537,5,100
47,3/19/2018 14:55,101,102,111,118,96,528,5,100
48,3/19/2018 15:00,114,99,112,108,107,540,5,100
49,3/19/2018 15:05,87,94,91,106,88,466,5,100
50,3/19/2018 15:10,80,84,83,115,87,449,5,100
51,3/19/2018 15:15,116,99,113,140,95,563,5,100
52,3/19/2018 15:20,113,100,115,106,92,526,5,100
53,3/19/2018 15:25,111,92,119,77,88,487,5,100
54,3/19/2018 15:30,111,83,101,84,95,474,5,100
55,3/19/2018 15:35,105,89,108,87,84,473,5,100
56,3/19/2018 15:40,113,94,114,78,93,492,5,100
57,3/19/2018 15:45,94,84,106,92,79,455,5,100
58,3/19/2018 15:50,103,92,96,90,76,457,5,100
59,3/19/2018 15:55,100,97,95,95,85,472,5,100
60,3/19/2018 16:00,110,91,109,90,91,491,5,100
61,3/19/2018 16:05,118,100,115,92,102,527,5,100
62,3/19/2018 16:10,106,85,115,84,89,479,5,100
63,3/19/2018 16:15,118,88,120,74,89,489,5,100
64,3/19/2018 16:20,109,86,113,90,80,478,5,100
65,3/19/2018 16:25,93,83,99,66,77,418,5,100
66,3/19/2018 16:30,93,83,89,112,76,453,5,100
67,3/19/2018 16:35,108,82,104,98,76,468,5,100
68,3/19/2018 16:40,72,85,84,116,79,436,5,100
69,3/19/2018 16:45,86,86,89,138,85,484,5,100
70,3/19/2018 16:50,88,90,85,113,81,457,5,100
71,3/19/2018 16:55,99,85,105,111,71,471,5,100
72,3/19/2018 17:00,63,72,61,87,80,363,5,100
73,3/19/2018 17:05,87,73,78,114,98,450,5,100
74,3/19/2018 17:10,93,91,90,118,95,487,5,100
75,3/19/2018 17:15,54,54,51,117,82,358,5,100
76,3/19/2018 17:20,75,61,69,97,68,370,5,100
77,3/19/2018 17:25,83,77,78,121,97,456,5,100
78,3/19/2018 17:30,71,71,71,111,81,405,5,100
79,3/19/2018 17:35,67,53,62,90,59,331,5,100
80,3/19/2018 17:40,72,66,71,120,94,423,5,100
81,3/19/2018 17:45,93,88,91,119,95,486,5,100
82,3/19/2018 17:50,95,91,94,117,85,482,5,100
83,3/19/2018 17:55,60,76,67,99,82,384,5,100
84,3/19/2018 18:00,73,77,63,122,79,414,5,100
85,3/19/2018 18:05,67,65,72,109,98,411,5,100
86,3/19/2018 18:10,92,87,91,122,94,486,5,100
87,3/19/2018 18:15,74,86,85,105,86,436,5,100
88,3/19/2018 18:20,77,82,84,108,88,439,5,100
89,3/19/2018 18:25,82,79,73,116,80,430,5,100
90,3/19/2018 18:30,72,66,68,106,85,397,5,100
91,3/19/2018 18:35,70,68,77,120,89,424,5,100
92,3/19/2018 18:40,66,49,58,97,67,337,5,100
93,3/19/2018 18:45,63,59,62,104,72,360,5,100
94,3/19/2018 18:50,55,56,54,89,68,322,5,100
95,3/19/2018 18:55,67,49,57,79,64,316,5,100
96,3/19/2018 19:00,71,57,64,94,61,347,5,100
97,3/19/2018 19:05,83,73,82,99,87,424,5,100
98,3/19/2018 19:10,94,90,98,118,91,491,5,100
99,3/19/2018 19:15,85,70,77,101,83,416,5,100
100,3/19/2018 19:20,87,82,79,104,87,439,5,100
101,3/19/2018 19:25,103,87,94,99,99,482,5,100
102,3/19/2018 19:30,102,79,107,66,80,434,5,100
103,3/19/2018 19:35,104,85,117,64,75,445,5,100
104,3/19/2018 19:40,105,92,109,57,81,444,5,100
105,3/19/2018 19:45,109,94,109,60,80,452,5,100
106,3/19/2018 19:50,103,95,101,53,82,434,5,100
107,3/19/2018 19:55,112,85,118,63,78,456,5,100
108,3/19/2018 20:00,129,90,125,62,77,483,5,100
109,3/19/2018 20:05,110,94,114,55,81,454,5,100
110,3/19/2018 20:10,121,93,115,62,82,473,5,100
111,3/19/2018 20:15,124,92,112,44,86,458,5,100
112,3/19/2018 20:20,118,94,112,61,78,463,5,100
113,3/19/2018 20:25,116,95,102,57,74,444,5,100
114,3/19/2018 20:30,125,94,114,53,82,468,5,100
115,3/19/2018 20:35,107,81,113,69,71,441,5,100
116,3/19/2018 20:40,114,86,107,67,71,445,5,100
117,3/19/2018 20:45,104,78,97,48,72,399,5,100
118,3/19/2018 20:50,98,81,87,42,69,377,5,100
119,3/19/2018 20:55,100,74,81,45,66,366,5,100
120,3/19/2018 21:00,90,78,92,32,58,350,5,100
121,3/19/2018 21:05,98,83,93,47,69,390,5,100
122,3/19/2018 21:10,103,86,110,41,68,408,5,100
123,3/19/2018 21:15,94,68,85,48,53,348,5,100
124,3/19/2018 21:20,94,71,100,46,61,372,5,100
125,3/19/2018 21:25,109,70,110,48,75,412,5,100
126,3/19/2018 21:30,97,74,79,45,62,357,5,100
127,3/19/2018 21:35,90,74,94,37,64,359,5,100
128,3/19/2018 21:40,81,75,89,27,64,336,5,100
129,3/19/2018 21:45,85,64,91,33,66,339,5,100
130,3/19/2018 21:50,79,65,91,38,45,318,5,100
131,3/19/2018 21:55,73,59,69,36,53,290,5,100
132,3/19/2018 22:00,77,82,81,37,60,337,5,100
133,3/19/2018 22:05,90,62,80,27,44,303,5,100
134,3/19/2018 22:10,80,61,78,41,49,309,5,100
135,3/19/2018 22:15,88,73,80,50,49,340,5,100
136,3/19/2018 22:20,71,69,86,43,51,320,5,100
137,3/19/2018 22:25,83,62,70,29,50,294,5,100
138,3/19/2018 22:30,64,75,72,33,56,300,5,100
139,3/19/2018 22:35,47,63,57,36,45,248,5,100
140,3/19/2018 22:40,65,43,69,29,46,252,5,100
141,3/19/2018 22:45,60,48,72,29,44,253,5,100
142,3/19/2018 22:50,46,50,53,29,45,223,5,100
143,3/19/2018 22:55,54,46,67,32,52,251,5,100
144,3/19/2018 23:00,44,49,59,30,44,226,5,100
145,3/19/2018 23:05,42,41,40,26,43,192,5,100
146,3/19/2018 23:10,59,51,51,29,45,235,5,100
147,3/19/2018 23:15,45,48,59,28,52,232,5,100
148,3/19/2018 23:20,38,55,57,28,32,210,5,100
149,3/19/2018 23:25,39,33,53,19,33,177,5,100
150,3/19/2018 23:30,41,46,42,16,47,192,5,100
151,3/19/2018 23:35,33,43,55,18,44,193,5,100
152,3/19/2018 23:40,36,48,46,30,27,187,5,100
153,3/19/2018 23:45,28,38,43,26,30,165,5,100
154,3/19/2018 23:50,30,29,33,16,28,136,5,100
155,3/19/2018 23:55,36,33,40,18,35,162,5,100
156,3/20/2018 0:00,29,31,33,16,40,149,5,100
157,3/20/2018 0:05,24,31,36,24,34,149,5,100
158,3/20/2018 0:10,28,30,33,14,21,126,5,100
159,3/20/2018 0:15,25,35,36,24,27,147,5,100
160,3/20/2018 0:20,19,38,28,13,29,127,5,100
161,3/20/2018 0:25,29,36,38,22,33,158,5,100
162,3/20/2018 0:30,18,34,31,19,35,137,5,100
163,3/20/2018 0:35,22,31,36,14,36,139,5,100
164,3/20/2018 0:40,20,26,23,18,26,113,5,100
165,3/20/2018 0:45,14,23,25,11,29,102,5,100
166,3/20/2018 0:50,10,31,31,10,31,113,5,100
167,3/20/2018 0:55,8,26,18,15,15,82,5,100
168,3/20/2018 1:00,13,30,23,11,20,97,5,100
169,3/20/2018 1:05,14,20,21,12,25,92,5,100
170,3/20/2018 1:10,13,28,29,17,22,109,5,100
171,3/20/2018 1:15,13,23,20,13,22,91,5,100
172,3/20/2018 1:20,14,17,20,12,19,82,5,100
173,3/20/2018 1:25,11,14,22,4,14,65,5,100
174,3/20/2018 1:30,11,23,17,10,20,81,5,100
175,3/20/2018 1:35,7,15,16,4,18,60,5,100
176,3/20/2018 1:40,14,16,21,10,15,76,5,100
177,3/20/2018 1:45,13,17,20,6,15,71,5,100
178,3/20/2018 1:50,6,18,17,8,16,65,5,100
179,3/20/2018 1:55,9,14,12,11,25,71,5,100
180,3/20/2018 2:00,10,15,11,7,16,59,5,100
181,3/20/2018 2:05,5,18,8,6,14,51,5,100
182,3/20/2018 2:10,7,15,13,7,14,56,5,100
183,3/20/2018 2:15,11,15,14,7,16,63,5,100
184,3/20/2018 2:20,14,22,10,7,10,63,5,100
185,3/20/2018 2:25,5,8,17,8,10,48,5,100
186,3/20/2018 2:30,8,10,11,3,12,44,5,100
187,3/20/2018 2:35,10,17,9,6,15,57,5,100
188,3/20/2018 2:40,6,8,11,3,9,37,5,100
189,3/20/2018 2:45,3,12,12,4,19,50,5,100
190,3/20/2018 2:50,7,13,11,4,12,47,5,100
191,3/20/2018 2:55,5,14,11,10,8,48,5,100
192,3/20/2018 3:00,2,13,9,4,7,35,5,100
193,3/20/2018 3:05,6,9,8,5,9,37,5,100
194,3/20/2018 3:10,6,19,11,3,11,50,5,100
195,3/20/2018 3:15,8,15,14,1,13,51,5,100
196,3/20/2018 3:20,7,11,10,5,8,41,5,100
197,3/20/2018 3:25,2,19,16,2,12,51,5,100
198,3/20/2018 3:30,11,15,16,7,12,61,5,100
199,3/20/2018 3:35,10,17,19,5,15,66,5,100
200,3/20/2018 3:40,12,19,12,4,20,67,5,100
201,3/20/2018 3:45,13,20,13,5,10,61,5,100
202,3/20/2018 3:50,7,14,9,5,14,49,5,100
203,3/20/2018 3:55,13,19,15,10,17,74,5,100
204,3/20/2018 4:00,7,13,22,9,19,70,5,100
205,3/20/2018 4:05,9,21,14,3,22,69,5,100
206,3/20/2018 4:10,10,23,20,6,17,76,5,100
207,3/20/2018 4:15,19,22,24,4,12,81,5,100
208,3/20/2018 4:20,12,21,20,6,14,73,5,100
209,3/20/2018 4:25,14,17,24,15,15,85,5,100
210,3/20/2018 4:30,24,21,24,6,17,92,5,100
211,3/20/2018 4:35,18,26,28,12,22,106,5,100
212,3/20/2018 4:40,31,38,42,15,18,144,5,100
213,3/20/2018 4:45,30,36,35,12,20,133,5,100
214,3/20/2018 4:50,31,29,36,20,30,146,5,100
215,3/20/2018 4:55,28,32,39,15,33,147,5,100
216,3/20/2018 5:00,42,31,43,16,25,157,5,100
217,3/20/2018 5:05,55,36,47,12,28,178,5,100
218,3/20/2018 5:10,56,36,52,22,29,195,5,100
219,3/20/2018 5:15,71,53,75,28,41,268,5,100
220,3/20/2018 5:20,63,51,69,27,33,243,5,100
221,3/20/2018 5:25,83,70,82,21,51,307,5,100
222,3/20/2018 5:30,72,50,75,29,52,278,5,100
223,3/20/2018 5:35,85,60,81,27,64,317,5,100
224,3/20/2018 5:40,91,66,90,33,51,331,5,100
225,3/20/2018 5:45,77,70,83,41,55,326,5,100
226,3/20/2018 5:50,73,64,77,39,61,314,5,100
227,3/20/2018 5:55,71,52,77,28,45,273,5,100
228,3/20/2018 6:00,71,50,81,40,54,296,5,100
229,3/20/2018 6:05,91,66,91,29,60,337,5,100
230,3/20/2018 6:10,91,65,81,38,47,322,5,100
231,3/20/2018 6:15,78,70,85,34,70,337,5,100
232,3/20/2018 6:20,94,69,85,56,65,369,5,100
233,3/20/2018 6:25,92,61,85,40,64,342,5,100
234,3/20/2018 6:30,88,76,96,45,64,369,5,100
235,3/20/2018 6:35,106,78,114,56,78,432,5,100
236,3/20/2018 6:40,110,85,96,69,75,435,5,100
237,3/20/2018 6:45,124,95,117,56,69,461,5,100
238,3/20/2018 6:50,120,97,105,61,79,462,5,100
239,3/20/2018 6:55,129,89,112,56,84,470,5,100
240,3/20/2018 7:00,118,83,105,55,80,441,5,100
241,3/20/2018 7:05,128,89,121,65,82,485,5,100
242,3/20/2018 7:10,137,77,119,76,85,494,5,100
243,3/20/2018 7:15,140,106,112,57,85,500,5,100
244,3/20/2018 7:20,153,115,148,80,93,589,5,100
245,3/20/2018 7:25,157,109,146,79,98,589,5,100
246,3/20/2018 7:30,170,129,143,84,109,635,5,100
247,3/20/2018 7:35,166,116,159,80,105,626,5,100
248,3/20/2018 7:40,172,122,156,74,107,631,5,100
249,3/20/2018 7:45,163,103,142,89,95,592,5,100
250,3/20/2018 7:50,152,101,142,89,105,589,5,100
251,3/20/2018 7:55,140,92,127,70,111,540,5,100
252,3/20/2018 8:00,158,104,122,84,97,565,5,100
253,3/20/2018 8:05,143,92,143,85,97,560,5,100
254,3/20/2018 8:10,147,104,146,67,103,567,5,100
255,3/20/2018 8:15,136,88,123,79,88,514,5,100
256,3/20/2018 8:20,128,99,137,86,75,525,5,100
257,3/20/2018 8:25,137,99,142,73,90,541,5,100
258,3/20/2018 8:30,149,104,141,78,98,570,5,100
259,3/20/2018 8:35,141,97,120,62,90,510,5,100
260,3/20/2018 8:40,159,122,142,75,92,590,5,100
261,3/20/2018 8:45,151,95,133,77,83,539,5,100
262,3/20/2018 8:50,144,99,129,60,87,519,5,100
263,3/20/2018 8:55,125,88,108,81,100,502,5,100
264,3/20/2018 9:00,138,97,121,75,80,511,5,100
265,3/20/2018 9:05,140,107,115,71,87,520,5,100
266,3/20/2018 9:10,121,98,127,60,83,489,5,100
267,3/20/2018 9:15,119,104,109,60,92,484,5,100
268,3/20/2018 9:20,136,86,128,75,89,514,5,100
269,3/20/2018 9:25,123,76,110,54,103,466,5,100
270,3/20/2018 9:30,127,87,110,42,72,438,5,100
271,3/20/2018 9:35,118,102,121,55,84,480,5,100
272,3/20/2018 9:40,122,87,117,53,80,459,5,100
273,3/20/2018 9:45,47,44,58,29,58,236,5,100
274,3/20/2018 9:50,2,16,2,23,36,79,5,100
275,3/20/2018 9:55,57,53,56,64,74,304,5,100
276,3/20/2018 10:00,152,126,132,99,115,624,5,100
277,3/20/2018 10:05,146,128,144,104,119,641,5,100
278,3/20/2018 10:10,144,120,132,88,94,578,5,100
279,3/20/2018 10:15,140,102,135,61,103,541,5,100
280,3/20/2018 10:20,115,92,107,51,93,458,5,100
281,3/20/2018 10:25,119,95,136,65,78,493,5,100
282,3/20/2018 10:30,124,96,124,61,86,491,5,100
283,3/20/2018 10:35,142,104,122,61,100,529,5,100
284,3/20/2018 10:40,126,98,119,56,88,487,5,100
285,3/20/2018 10:45,145,117,135,73,94,564,5,100
286,3/20/2018 10:50,131,91,122,67,86,497,5,100
287,3/20/2018 10:55,126,91,126,69,84,496,5,100
288,3/20/2018 11:00,134,101,122,53,87,497,5,100
289,3/20/2018 11:05,130,97,136,57,85,505,5,100
290,3/20/2018 11:10,129,105,111,67,87,499,5,100
291,3/20/2018 11:15,122,107,131,59,84,503,5,100
292,3/20/2018 11:20,136,106,146,76,91,555,5,100
293,3/20/2018 11:25,162,121,125,71,98,577,5,100
294,3/20/2018 11:30,144,115,133,56,95,543,5,100
295,3/20/2018 11:35,157,116,126,63,102,564,5,100
296,3/20/2018 11:40,152,112,131,74,86,555,5,100
297,3/20/2018 11:45,152,119,151,65,105,592,5,100
298,3/20/2018 11:50,96,76,87,61,73,393,5,100
299,3/20/2018 11:55,0,8,0,21,17,46,5,100
300,3/20/2018 12:00,139,112,129,91,113,584,5,100
301,3/20/2018 12:05,152,106,147,79,107,591,5,100
302,3/20/2018 12:10,150,94,126,77,93,540,5,100
303,3/20/2018 12:15,116,101,127,61,87,492,5,100
304,3/20/2018 12:20,141,95,122,74,93,525,5,100
305,3/20/2018 12:25,151,104,130,72,80,537,5,100
306,3/20/2018 12:30,131,99,138,58,84,510,5,100
307,3/20/2018 12:35,131,101,122,63,92,509,5,100
308,3/20/2018 12:40,145,118,123,64,86,536,5,100
309,3/20/2018 12:45,146,109,140,76,118,589,5,100
310,3/20/2018 12:50,148,90,128,56,82,504,5,100
311,3/20/2018 12:55,140,92,123,64,73,492,5,100
312,3/20/2018 13:00,118,84,109,65,86,462,5,100
313,3/20/2018 13:05,117,113,108,75,83,496,5,100
314,3/20/2018 13:10,157,110,138,66,98,569,5,100
315,3/20/2018 13:15,139,95,118,59,88,499,5,100
316,3/20/2018 13:20,143,100,128,71,96,538,5,100
317,3/20/2018 13:25,141,90,133,78,91,533,5,100
318,3/20/2018 13:30,149,111,143,71,94,568,5,100
319,3/20/2018 13:35,147,101,134,75,111,568,5,100
320,3/20/2018 13:40,134,102,133,77,88,534,5,100
321,3/20/2018 13:45,140,117,123,67,91,538,5,100
322,3/20/2018 13:50,151,104,129,69,105,558,5,100
323,3/20/2018 13:55,131,97,128,76,81,513,5,100
324,3/20/2018 14:00,122,99,126,67,90,504,5,100
325,3/20/2018 14:05,124,100,123,83,98,528,5,100
326,3/20/2018 14:10,144,104,122,81,102,553,5,100
327,3/20/2018 14:15,149,109,136,82,99,575,5,100
328,3/20/2018 14:20,151,111,145,87,109,603,5,100
329,3/20/2018 14:25,144,101,131,75,89,540,5,100
330,3/20/2018 14:30,146,105,138,80,88,557,5,100
331,3/20/2018 14:35,130,91,131,102,110,564,5,100
332,3/20/2018 14:40,140,107,138,92,111,588,5,100
333,3/20/2018 14:45,120,101,109,90,103,523,5,100
334,3/20/2018 14:50,110,93,119,81,92,495,5,100
335,3/20/2018 14:55,125,104,127,83,105,544,5,100
336,3/20/2018 15:00,113,90,116,99,94,512,5,100
337,3/20/2018 15:05,122,93,120,74,84,493,5,100
338,3/20/2018 15:10,109,87,117,91,100,504,5,100
339,3/20/2018 15:15,110,94,100,106,80,490,5,100
340,3/20/2018 15:20,101,90,101,109,80,481,5,100
341,3/20/2018 15:25,84,89,86,104,84,447,5,100
342,3/20/2018 15:30,71,68,71,102,81,393,5,100
343,3/20/2018 15:35,100,84,97,115,86,482,5,100
344,3/20/2018 15:40,119,84,95,87,80,465,5,100
345,3/20/2018 15:45,98,83,95,95,73,444,5,100
346,3/20/2018 15:50,68,66,66,113,93,406,5,100
347,3/20/2018 15:55,72,77,72,95,78,394,5,100
348,3/20/2018 16:00,74,70,69,76,78,367,5,100
349,3/20/2018 16:05,69,76,75,91,87,398,5,100
350,3/20/2018 16:10,75,66,72,96,78,387,5,100
351,3/20/2018 16:15,85,76,78,107,87,433,5,100
352,3/20/2018 16:20,90,76,85,127,89,467,5,100
353,3/20/2018 16:25,81,81,79,119,90,450,5,100
354,3/20/2018 16:30,83,82,69,116,91,441,5,100
355,3/20/2018 16:35,77,76,77,94,84,408,5,100
356,3/20/2018 16:40,69,78,68,109,77,401,5,100
357,3/20/2018 16:45,64,65,59,83,69,340,5,100
358,3/20/2018 16:50,58,53,48,71,57,287,5,100
359,3/20/2018 16:55,64,69,73,92,75,373,5,100
360,3/20/2018 17:00,98,85,107,122,98,510,5,100
361,3/20/2018 17:05,74,62,66,107,78,387,5,100
362,3/20/2018 17:10,73,78,74,105,75,405,5,100
363,3/20/2018 17:15,74,64,68,103,79,388,5,100
364,3/20/2018 17:20,61,64,49,78,63,315,5,100
365,3/20/2018 17:25,76,64,64,98,71,373,5,100
366,3/20/2018 17:30,80,72,75,102,75,404,5,100
367,3/20/2018 17:35,70,64,64,106,74,378,5,100
368,3/20/2018 17:40,68,47,63,96,76,350,5,100
369,3/20/2018 17:45,73,61,68,88,75,365,5,100
370,3/20/2018 17:50,66,73,72,108,87,406,5,100
371,3/20/2018 17:55,77,54,64,96,62,353,5,100
372,3/20/2018 18:00,65,44,58,101,61,329,5,100
373,3/20/2018 18:05,78,76,78,120,92,444,5,100
374,3/20/2018 18:10,70,65,63,102,74,374,5,100
375,3/20/2018 18:15,55,43,49,79,59,285,5,100
376,3/20/2018 18:20,82,69,77,114,74,416,5,100
377,3/20/2018 18:25,81,92,89,128,91,481,5,100
378,3/20/2018 18:30,84,75,85,121,90,455,5,100
379,3/20/2018 18:35,87,79,72,121,88,447,5,100
380,3/20/2018 18:40,80,70,68,109,82,409,5,100
381,3/20/2018 18:45,81,85,90,112,81,449,5,100
382,3/20/2018 18:50,90,79,84,111,84,448,5,100
383,3/20/2018 18:55,83,72,79,128,100,462,5,100
384,3/20/2018 19:00,84,76,78,123,88,449,5,100
385,3/20/2018 19:05,78,63,68,104,67,380,5,100
386,3/20/2018 19:10,106,92,94,105,96,493,5,100
387,3/20/2018 19:15,105,98,97,94,106,500,5,100
388,3/20/2018 19:20,104,89,106,82,93,474,5,100
389,3/20/2018 19:25,104,80,94,74,90,442,5,100
390,3/20/2018 19:30,119,83,99,89,74,464,5,100
391,3/20/2018 19:35,117,93,108,64,79,461,5,100
392,3/20/2018 19:40,104,87,97,59,70,417,5,100
393,3/20/2018 19:45,122,93,111,57,71,454,5,100
394,3/20/2018 19:50,103,89,105,45,80,422,5,100
395,3/20/2018 19:55,124,94,117,53,80,468,5,100
396,3/20/2018 20:00,137,101,114,61,86,499,5,100
397,3/20/2018 20:05,120,96,128,54,80,478,5,100
398,3/20/2018 20:10,136,93,119,61,87,496,5,100
399,3/20/2018 20:15,120,90,115,65,83,473,5,100
400,3/20/2018 20:20,128,95,124,49,83,479,5,100
401,3/20/2018 20:25,127,87,100,61,77,452,5,100
402,3/20/2018 20:30,104,88,95,39,72,398,5,100
403,3/20/2018 20:35,125,82,114,48,70,439,5,100
404,3/20/2018 20:40,110,76,92,46,67,391,5,100
405,3/20/2018 20:45,106,78,109,47,63,403,5,100
406,3/20/2018 20:50,90,70,92,40,65,357,5,100
407,3/20/2018 20:55,106,73,99,37,61,376,5,100
408,3/20/2018 21:00,93,76,79,49,59,356,5,100
409,3/20/2018 21:05,96,75,93,38,70,372,5,100
410,3/20/2018 21:10,97,75,104,45,68,389,5,100
411,3/20/2018 21:15,88,91,90,46,56,371,5,100
412,3/20/2018 21:20,101,92,94,44,62,393,5,100
413,3/20/2018 21:25,103,76,96,38,75,388,5,100
414,3/20/2018 21:30,91,63,86,44,63,347,5,100
415,3/20/2018 21:35,104,78,90,48,68,388,5,100
416,3/20/2018 21:40,84,73,84,49,59,349,5,100
417,3/20/2018 21:45,103,68,85,37,54,347,5,100
418,3/20/2018 21:50,76,70,73,39,51,309,5,100
419,3/20/2018 21:55,93,69,96,45,61,364,5,100
420,3/20/2018 22:00,89,67,86,51,57,350,5,100
421,3/20/2018 22:05,83,61,79,40,44,307,5,100
422,3/20/2018 22:10,78,58,76,33,57,302,5,100
423,3/20/2018 22:15,72,66,87,27,58,310,5,100
424,3/20/2018 22:20,75,69,72,47,60,323,5,100
425,3/20/2018 22:25,68,58,72,36,58,292,5,100
426,3/20/2018 22:30,84,73,72,32,54,315,5,100
427,3/20/2018 22:35,68,63,71,24,63,289,5,100
428,3/20/2018 22:40,79,63,70,34,46,292,5,100
429,3/20/2018 22:45,60,43,59,34,49,245,5,100
430,3/20/2018 22:50,60,60,65,25,41,251,5,100
431,3/20/2018 22:55,56,53,68,19,41,237,5,100
432,3/20/2018 23:00,45,53,55,23,42,218,5,100
433,3/20/2018 23:05,52,47,48,31,50,228,5,100
434,3/20/2018 23:10,43,47,57,25,41,213,5,100
435,3/20/2018 23:15,55,46,72,28,46,247,5,100
436,3/20/2018 23:20,43,42,48,26,31,190,5,100
437,3/20/2018 23:25,57,44,48,34,35,218,5,100
438,3/20/2018 23:30,41,47,46,29,31,194,5,100
439,3/20/2018 23:35,32,34,44,14,30,154,5,100
440,3/20/2018 23:40,44,43,50,25,32,194,5,100
441,3/20/2018 23:45,47,48,47,21,43,206,5,100
442,3/20/2018 23:50,46,39,50,28,35,198,5,100
443,3/20/2018 23:55,26,40,42,24,31,163,5,100
444,3/21/2018 0:00,38,35,42,15,36,166,5,100
445,3/21/2018 0:05,33,33,33,18,32,149,5,100
446,3/21/2018 0:10,29,29,44,19,34,155,5,100
447,3/21/2018 0:15,27,40,40,11,24,142,5,100
448,3/21/2018 0:20,33,31,39,15,35,153,5,100
449,3/21/2018 0:25,24,30,36,18,29,137,5,100
450,3/21/2018 0:30,17,25,29,15,39,125,5,100
451,3/21/2018 0:35,16,29,29,11,31,116,5,100
452,3/21/2018 0:40,20,30,25,17,21,113,5,100
453,3/21/2018 0:45,22,29,22,11,23,107,5,100
454,3/21/2018 0:50,19,20,26,18,21,104,5,100
455,3/21/2018 0:55,19,30,26,15,30,120,5,100
456,3/21/2018 1:00,19,28,22,9,24,102,5,100
457,3/21/2018 1:05,15,25,26,10,15,91,5,100
458,3/21/2018 1:10,12,34,15,12,23,96,5,100
459,3/21/2018 1:15,15,23,19,6,15,78,5,100
460,3/21/2018 1:20,13,15,24,16,20,88,5,100
461,3/21/2018 1:25,12,20,20,8,14,74,5,100
462,3/21/2018 1:30,13,11,27,7,14,72,5,100
463,3/21/2018 1:35,10,22,20,10,30,92,5,100
464,3/21/2018 1:40,7,22,22,8,17,76,5,100
465,3/21/2018 1:45,9,11,21,10,18,69,5,100
466,3/21/2018 1:50,14,18,24,6,22,84,5,100
467,3/21/2018 1:55,5,19,14,7,18,63,5,100
468,3/21/2018 2:00,10,24,16,6,10,66,5,100
469,3/21/2018 2:05,7,18,16,8,21,70,5,100
470,3/21/2018 2:10,17,16,13,7,11,64,5,100
471,3/21/2018 2:15,11,20,18,4,19,72,5,100
472,3/21/2018 2:20,12,20,15,8,18,73,5,100
473,3/21/2018 2:25,7,15,10,9,8,49,5,100
474,3/21/2018 2:30,8,14,14,3,12,51,5,100
475,3/21/2018 2:35,12,11,8,2,12,45,5,100
476,3/21/2018 2:40,8,14,17,1,23,63,5,100
477,3/21/2018 2:45,7,14,12,3,11,47,5,100
478,3/21/2018 2:50,2,13,8,2,9,34,5,100
479,3/21/2018 2:55,2,10,10,4,5,31,5,100
480,3/21/2018 3:00,4,9,9,4,6,32,5,100
481,3/21/2018 3:05,5,7,6,1,8,27,5,100
482,3/21/2018 3:10,10,13,15,5,13,56,5,100
483,3/21/2018 3:15,5,17,10,3,9,44,5,100
484,3/21/2018 3:20,7,9,12,2,8,38,5,100
485,3/21/2018 3:25,6,13,10,2,5,36,5,100
486,3/21/2018 3:30,5,13,12,4,15,49,5,100
487,3/21/2018 3:35,10,23,18,2,11,64,5,100
488,3/21/2018 3:40,7,24,14,12,12,69,5,100
489,3/21/2018 3:45,3,13,14,9,14,53,5,100
490,3/21/2018 3:50,6,21,18,6,20,71,5,100
491,3/21/2018 3:55,10,18,11,9,15,63,5,100
492,3/21/2018 4:00,7,13,21,10,16,67,5,100
493,3/21/2018 4:05,10,14,16,6,9,55,5,100
494,3/21/2018 4:10,10,11,15,6,11,53,5,100
495,3/21/2018 4:15,16,21,23,7,15,82,5,100
496,3/21/2018 4:20,13,21,21,7,21,83,5,100
497,3/21/2018 4:25,20,21,26,15,23,105,5,100
498,3/21/2018 4:30,17,31,26,4,17,95,5,100
499,3/21/2018 4:35,32,36,27,16,19,130,5,100
500,3/21/2018 4:40,26,28,30,8,24,116,5,100
501,3/21/2018 4:45,34,32,40,17,19,142,5,100
502,3/21/2018 4:50,38,31,28,24,23,144,5,100
503,3/21/2018 4:55,39,30,40,17,29,155,5,100
504,3/21/2018 5:00,42,30,42,10,31,155,5,100
505,3/21/2018 5:05,43,29,44,11,35,162,5,100
506,3/21/2018 5:10,47,40,46,17,31,181,5,100
507,3/21/2018 5:15,51,46,56,18,38,209,5,100
508,3/21/2018 5:20,66,44,58,19,35,222,5,100
509,3/21/2018 5:25,82,51,67,26,48,274,5,100
510,3/21/2018 5:30,69,54,80,24,49,276,5,100
511,3/21/2018 5:35,67,63,80,26,47,283,5,100
512,3/21/2018 5:40,89,63,75,36,54,317,5,100
513,3/21/2018 5:45,84,67,79,42,59,331,5,100
514,3/21/2018 5:50,80,59,71,38,47,295,5,100
515,3/21/2018 5:55,75,72,76,29,59,311,5,100
516,3/21/2018 6:00,87,53,72,34,60,306,5,100
517,3/21/2018 6:05,76,65,74,35,50,300,5,100
518,3/21/2018 6:10,76,57,57,39,48,277,5,100
519,3/21/2018 6:15,81,62,75,33,52,303,5,100
520,3/21/2018 6:20,88,77,84,46,53,348,5,100
521,3/21/2018 6:25,95,70,89,48,55,357,5,100
522,3/21/2018 6:30,92,89,106,33,64,384,5,100
523,3/21/2018 6:35,98,78,90,66,72,404,5,100
524,3/21/2018 6:40,130,91,127,60,82,490,5,100
525,3/21/2018 6:45,113,86,97,57,90,443,5,100
526,3/21/2018 6:50,119,85,107,78,84,473,5,100
527,3/21/2018 6:55,117,84,116,53,68,438,5,100
528,3/21/2018 7:00,119,88,108,60,67,442,5,100
529,3/21/2018 7:05,130,88,120,57,77,472,5,100
530,3/21/2018 7:10,133,88,131,57,76,485,5,100
531,3/21/2018 7:15,142,108,134,66,101,551,5,100
532,3/21/2018 7:20,151,101,142,64,94,552,5,100
533,3/21/2018 7:25,150,128,134,80,109,601,5,100
534,3/21/2018 7:30,145,122,139,70,98,574,5,100
535,3/21/2018 7:35,173,116,153,84,112,638,5,100
536,3/21/2018 7:40,168,119,141,79,106,613,5,100
537,3/21/2018 7:45,158,115,141,87,105,606,5,100
538,3/21/2018 7:50,142,104,129,93,90,558,5,100
539,3/21/2018 7:55,131,96,115,75,83,500,5,100
540,3/21/2018 8:00,141,100,136,83,86,546,5,100
541,3/21/2018 8:05,164,111,136,83,91,585,5,100
542,3/21/2018 8:10,143,112,131,93,107,586,5,100
543,3/21/2018 8:15,153,106,131,72,88,550,5,100
544,3/21/2018 8:20,146,116,134,77,94,567,5,100
545,3/21/2018 8:25,143,102,117,64,78,504,5,100
546,3/21/2018 8:30,136,115,123,74,79,527,5,100
547,3/21/2018 8:35,133,98,129,79,72,511,5,100
548,3/21/2018 8:40,153,97,137,64,95,546,5,100
549,3/21/2018 8:45,154,102,111,68,91,526,5,100
550,3/21/2018 8:50,136,93,132,67,104,532,5,100
551,3/21/2018 8:55,154,102,137,65,95,553,5,100
552,3/21/2018 9:00,123,97,115,78,94,507,5,100
553,3/21/2018 9:05,150,99,125,72,81,527,5,100
554,3/21/2018 9:10,111,96,120,66,96,489,5,100
555,3/21/2018 9:15,140,86,127,71,78,502,5,100
556,3/21/2018 9:20,107,85,106,66,82,446,5,100
557,3/21/2018 9:25,140,99,121,63,109,532,5,100
558,3/21/2018 9:30,128,94,113,65,81,481,5,100
559,3/21/2018 9:35,123,96,114,59,76,468,5,100
560,3/21/2018 9:40,116,82,104,67,86,455,5,100
561,3/21/2018 9:45,123,83,121,70,99,496,5,100
562,3/21/2018 9:50,111,90,111,63,85,460,5,100
563,3/21/2018 9:55,117,80,105,64,82,448,5,100
564,3/21/2018 10:00,109,93,108,53,78,441,5,100
565,3/21/2018 10:05,116,92,104,51,75,438,5,100
566,3/21/2018 10:10,118,81,112,60,77,448,5,100
567,3/21/2018 10:15,108,87,102,56,82,435,5,100
568,3/21/2018 10:20,110,85,113,59,74,441,5,100
569,3/21/2018 10:25,124,90,117,60,103,494,5,100
570,3/21/2018 10:30,116,97,119,57,82,471,5,100
571,3/21/2018 10:35,91,90,92,50,79,402,5,100
572,3/21/2018 10:40,108,82,87,49,90,416,5,100
573,3/21/2018 10:45,113,89,104,61,85,452,5,100
574,3/21/2018 10:50,103,76,97,45,75,396,5,100
575,3/21/2018 10:55,112,88,94,65,81,440,5,100
576,3/21/2018 11:00,106,82,99,71,75,433,5,100
577,3/21/2018 11:05,103,93,112,46,87,441,5,100
578,3/21/2018 11:10,116,87,105,51,90,449,5,100
579,3/21/2018 11:15,118,85,105,59,73,440,5,100
580,3/21/2018 11:20,120,91,120,50,92,473,5,100
581,3/21/2018 11:25,124,95,113,48,80,460,5,100
582,3/21/2018 11:30,106,97,105,61,84,453,5,100
583,3/21/2018 11:35,127,99,118,63,82,489,5,100
584,3/21/2018 11:40,102,82,95,42,87,408,5,100
585,3/21/2018 11:45,113,98,110,45,83,449,5,100
586,3/21/2018 11:50,104,94,110,67,85,460,5,100
587,3/21/2018 11:55,123,81,100,47,74,425,5,100
588,3/21/2018 12:00,100,95,99,55,85,434,5,100
589,3/21/2018 12:05,103,91,108,55,69,426,5,100
590,3/21/2018 12:10,125,85,108,76,80,474,5,100
591,3/21/2018 12:15,116,100,102,63,85,466,5,100
592,3/21/2018 12:20,126,93,131,80,93,523,5,100
593,3/21/2018 12:25,119,101,114,67,95,496,5,100
594,3/21/2018 12:30,121,94,109,79,92,495,5,100
595,3/21/2018 12:35,126,100,118,66,107,517,5,100
596,3/21/2018 12:40,113,86,101,75,97,472,5,100
597,3/21/2018 12:45,93,79,90,99,78,439,5,100
598,3/21/2018 12:50,89,77,89,97,80,432,5,100
599,3/21/2018 12:55,97,80,100,109,99,485,5,100
600,3/21/2018 13:00,98,83,93,95,96,465,5,100
601,3/21/2018 13:05,115,97,110,101,89,512,5,100
602,3/21/2018 13:10,109,85,101,69,79,443,5,100
603,3/21/2018 13:15,128,108,124,72,84,516,5,100
604,3/21/2018 13:20,123,93,115,78,89,498,5,100
605,3/21/2018 13:25,121,97,104,77,80,479,5,100
606,3/21/2018 13:30,124,90,117,66,104,501,5,100
607,3/21/2018 13:35,106,81,112,89,89,477,5,100
608,3/21/2018 13:40,112,84,105,99,81,481,5,100
609,3/21/2018 13:45,82,97,92,112,91,474,5,100
610,3/21/2018 13:50,114,104,119,98,91,526,5,100
611,3/21/2018 13:55,101,77,106,87,91,462,5,100
612,3/21/2018 14:00,97,90,111,88,72,458,5,100
613,3/21/2018 14:05,112,89,113,84,79,477,5,100
614,3/21/2018 14:10,119,96,107,81,92,495,5,100
615,3/21/2018 14:15,107,93,101,83,86,470,5,100
616,3/21/2018 14:20,111,91,108,69,78,457,5,100
617,3/21/2018 14:25,104,97,109,85,91,486,5,100
618,3/21/2018 14:30,107,90,99,104,84,484,5,100
619,3/21/2018 14:35,92,84,91,97,82,446,5,100
620,3/21/2018 14:40,102,79,104,89,91,465,5,100
621,3/21/2018 14:45,97,83,100,69,80,429,5,100
622,3/21/2018 14:50,101,70,107,78,71,427,5,100
623,3/21/2018 14:55,100,83,88,59,68,398,5,100
624,3/21/2018 15:00,118,87,118,90,78,491,5,100
625,3/21/2018 15:05,115,98,109,80,86,488,5,100
626,3/21/2018 15:10,129,103,109,79,101,521,5,100
627,3/21/2018 15:15,101,85,104,83,76,449,5,100
628,3/21/2018 15:20,117,99,115,76,88,495,5,100
629,3/21/2018 15:25,104,87,101,75,66,433,5,100
630,3/21/2018 15:30,111,86,99,90,82,468,5,100
631,3/21/2018 15:35,116,87,112,92,86,493,5,100
632,3/21/2018 15:40,113,98,108,93,93,505,5,100
633,3/21/2018 15:45,104,93,108,109,92,506,5,100
634,3/21/2018 15:50,106,102,111,93,88,500,5,100
635,3/21/2018 15:55,128,90,119,87,91,515,5,100
636,3/21/2018 16:00,104,77,106,102,82,471,5,100
637,3/21/2018 16:05,114,87,111,91,87,490,5,100
638,3/21/2018 16:10,135,99,106,91,97,528,5,100
639,3/21/2018 16:15,118,105,111,93,101,528,5,100
640,3/21/2018 16:20,112,89,116,108,81,506,5,100
641,3/21/2018 16:25,103,89,106,91,83,472,5,100
642,3/21/2018 16:30,100,78,96,100,72,446,5,100
643,3/21/2018 16:35,106,86,108,97,76,473,5,100
644,3/21/2018 16:40,113,91,111,88,88,491,5,100
645,3/21/2018 16:45,111,90,110,103,84,498,5,100
646,3/21/2018 16:50,101,90,105,84,84,464,5,100
647,3/21/2018 16:55,101,83,111,85,88,468,5,100
648,3/21/2018 17:00,114,96,102,81,94,487,5,100
649,3/21/2018 17:05,118,92,117,89,89,505,5,100
650,3/21/2018 17:10,120,103,127,97,112,559,5,100
651,3/21/2018 17:15,107,98,106,109,98,518,5,100
652,3/21/2018 17:20,115,92,125,78,79,489,5,100
653,3/21/2018 17:25,121,88,114,79,86,488,5,100
654,3/21/2018 17:30,110,90,117,97,97,511,5,100
655,3/21/2018 17:35,96,82,106,99,86,469,5,100
656,3/21/2018 17:40,105,90,101,86,82,464,5,100
657,3/21/2018 17:45,119,101,106,87,89,502,5,100
658,3/21/2018 17:50,108,90,114,88,88,488,5,100
659,3/21/2018 17:55,102,100,118,87,89,496,5,100
660,3/21/2018 18:00,116,97,112,80,88,493,5,100
661,3/21/2018 18:05,113,83,102,73,64,435,5,100
662,3/21/2018 18:10,107,87,101,94,79,468,5,100
663,3/21/2018 18:15,123,105,105,86,78,497,5,100
664,3/21/2018 18:20,118,98,109,82,93,500,5,100
665,3/21/2018 18:25,141,103,124,93,73,534,5,100
666,3/21/2018 18:30,133,94,115,79,68,489,5,100
667,3/21/2018 18:35,131,92,108,72,99,502,5,100
668,3/21/2018 18:40,133,101,119,75,90,518,5,100
669,3/21/2018 18:45,131,94,117,94,86,522,5,100
670,3/21/2018 18:50,133,92,122,87,70,504,5,100
671,3/21/2018 18:55,107,93,115,66,76,457,5,100
672,3/21/2018 19:00,108,84,103,57,82,434,5,100
673,3/21/2018 19:05,129,85,125,76,83,498,5,100
674,3/21/2018 19:10,115,93,117,58,67,450,5,100
675,3/21/2018 19:15,130,99,121,77,80,507,5,100
676,3/21/2018 19:20,126,95,113,71,80,485,5,100
677,3/21/2018 19:25,104,79,95,67,63,408,5,100
678,3/21/2018 19:30,112,92,108,62,77,451,5,100
679,3/21/2018 19:35,125,91,115,55,84,470,5,100
680,3/21/2018 19:40,120,92,116,61,85,474,5,100
681,3/21/2018 19:45,112,92,115,46,81,446,5,100
682,3/21/2018 19:50,108,84,100,44,71,407,5,100
683,3/21/2018 19:55,106,73,92,34,77,382,5,100
684,3/21/2018 20:00,111,86,103,57,94,451,5,100
685,3/21/2018 20:05,103,84,93,54,79,413,5,100
686,3/21/2018 20:10,115,90,109,59,61,434,5,100
687,3/21/2018 20:15,110,102,99,60,76,447,5,100
688,3/21/2018 20:20,116,93,102,51,82,444,5,100
689,3/21/2018 20:25,100,89,111,53,67,420,5,100
690,3/21/2018 20:30,97,79,93,54,60,383,5,100
691,3/21/2018 20:35,116,96,112,55,76,455,5,100
692,3/21/2018 20:40,99,74,104,48,69,394,5,100
693,3/21/2018 20:45,118,95,103,44,71,431,5,100
694,3/21/2018 20:50,95,79,88,46,76,384,5,100
695,3/21/2018 20:55,97,82,87,41,77,384,5,100
696,3/21/2018 21:00,92,70,107,32,58,359,5,100
697,3/21/2018 21:05,88,79,106,29,67,369,5,100
698,3/21/2018 21:10,106,84,92,47,60,389,5,100
699,3/21/2018 21:15,115,80,105,32,56,388,5,100
700,3/21/2018 21:20,97,93,93,54,68,405,5,100
701,3/21/2018 21:25,107,86,93,46,61,393,5,100
702,3/21/2018 21:30,101,72,105,32,72,382,5,100
703,3/21/2018 21:35,84,70,83,28,62,327,5,100
704,3/21/2018 21:40,81,70,81,34,51,317,5,100
705,3/21/2018 21:45,90,68,87,29,51,325,5,100
706,3/21/2018 21:50,91,72,82,41,54,340,5,100
707,3/21/2018 21:55,82,73,76,36,63,330,5,100
708,3/21/2018 22:00,84,68,80,26,64,322,5,100
709,3/21/2018 22:05,89,70,87,39,59,344,5,100
710,3/21/2018 22:10,103,69,91,33,67,363,5,100
711,3/21/2018 22:15,98,75,82,35,65,355,5,100
712,3/21/2018 22:20,90,72,86,30,55,333,5,100
713,3/21/2018 22:25,93,70,78,26,59,326,5,100
714,3/21/2018 22:30,83,86,94,2,67,332,5,100
715,3/21/2018 22:35,62,65,71,3,57,258,5,100
716,3/21/2018 22:40,66,76,77,0,73,292,5,100
717,3/21/2018 22:45,63,65,69,3,56,256,5,100
718,3/21/2018 22:50,67,60,81,4,63,275,5,100
719,3/21/2018 22:55,65,77,61,1,59,263,5,100
720,3/21/2018 23:00,60,70,63,2,43,238,5,100
721,3/21/2018 23:05,54,68,66,6,52,246,5,100
722,3/21/2018 23:10,52,55,53,3,57,220,5,100
723,3/21/2018 23:15,42,51,50,1,43,187,5,100
724,3/21/2018 23:20,76,61,65,3,52,257,5,100
725,3/21/2018 23:25,46,53,64,2,49,214,5,100
726,3/21/2018 23:30,53,50,49,2,34,188,5,100
727,3/21/2018 23:35,41,56,58,0,48,203,5,100
728,3/21/2018 23:40,29,50,51,2,34,166,5,100
729,3/21/2018 23:45,42,41,52,2,41,178,5,100
730,3/21/2018 23:50,41,53,50,1,55,200,5,100
731,3/21/2018 23:55,27,44,47,1,39,158,5,100
732,3/22/2018 0:00,44,51,50,0,35,180,5,100
733,3/22/2018 0:05,39,54,52,0,21,166,5,100
734,3/22/2018 0:10,36,44,44,1,32,157,5,100
735,3/22/2018 0:15,32,48,43,0,29,152,5,100
736,3/22/2018 0:20,34,44,37,2,40,157,5,100
737,3/22/2018 0:25,22,39,47,1,33,142,5,100
738,3/22/2018 0:30,27,46,41,0,22,136,5,100
739,3/22/2018 0:35,21,37,41,2,26,127,5,100
740,3/22/2018 0:40,18,46,27,0,17,108,5,100
741,3/22/2018 0:45,28,35,41,0,21,125,5,100
742,3/22/2018 0:50,21,27,34,0,23,105,5,100
743,3/22/2018 0:55,22,28,22,0,24,96,5,100
744,3/22/2018 1:00,16,35,34,0,23,108,5,100
745,3/22/2018 1:05,17,35,39,0,20,111,5,100
746,3/22/2018 1:10,18,33,40,0,27,118,5,100
747,3/22/2018 1:15,5,32,28,0,15,80,5,100
748,3/22/2018 1:20,19,42,33,0,18,112,5,100
749,3/22/2018 1:25,15,28,23,1,23,90,5,100
750,3/22/2018 1:30,10,26,21,0,13,70,5,100
751,3/22/2018 1:35,9,25,23,0,12,69,5,100
752,3/22/2018 1:40,8,29,31,1,8,77,5,100
753,3/22/2018 1:45,11,24,24,0,8,67,5,100
754,3/22/2018 1:50,22,29,32,1,18,102,5,100
755,3/22/2018 1:55,13,25,25,0,18,81,5,100
756,3/22/2018 2:00,17,26,29,0,10,82,5,100
757,3/22/2018 2:05,10,23,28,0,12,73,5,100
758,3/22/2018 2:10,11,25,18,0,7,61,5,100
759,3/22/2018 2:15,15,21,13,0,13,62,5,100
760,3/22/2018 2:20,15,23,20,0,4,62,5,100
761,3/22/2018 2:25,11,27,18,0,12,68,5,100
762,3/22/2018 2:30,12,21,13,0,9,55,5,100
763,3/22/2018 2:35,10,20,12,0,10,52,5,100
764,3/22/2018 2:40,10,17,15,0,1,43,5,100
765,3/22/2018 2:45,8,17,15,0,7,47,5,100
766,3/22/2018 2:50,5,17,20,0,10,52,5,100
767,3/22/2018 2:55,8,22,13,0,6,49,5,100
768,3/22/2018 3:00,10,21,23,0,10,64,5,100
769,3/22/2018 3:05,5,19,16,0,6,46,5,100
770,3/22/2018 3:10,12,21,11,0,5,49,5,100
771,3/22/2018 3:15,3,22,11,0,2,38,5,100
772,3/22/2018 3:20,8,14,12,0,6,40,5,100
773,3/22/2018 3:25,8,20,13,0,3,44,5,100
774,3/22/2018 3:30,4,15,20,0,6,45,5,100
775,3/22/2018 3:35,9,14,14,0,9,46,5,100
776,3/22/2018 3:40,16,20,15,0,3,54,5,100
777,3/22/2018 3:45,10,20,25,0,5,60,5,100
778,3/22/2018 3:50,12,11,24,0,4,51,5,100
779,3/22/2018 3:55,4,17,12,2,13,48,5,100
780,3/22/2018 4:00,8,14,13,2,9,46,5,100
781,3/22/2018 4:05,14,31,23,7,11,86,5,100
782,3/22/2018 4:10,13,15,18,5,10,61,5,100
783,3/22/2018 4:15,13,17,23,3,13,69,5,100
784,3/22/2018 4:20,15,29,21,8,18,91,5,100
785,3/22/2018 4:25,18,19,27,8,23,95,5,100
786,3/22/2018 4:30,19,17,24,6,18,84,5,100
787,3/22/2018 4:35,23,24,21,11,26,105,5,100
788,3/22/2018 4:40,30,37,36,13,27,143,5,100
789,3/22/2018 4:45,31,34,39,12,20,136,5,100
790,3/22/2018 4:50,24,25,26,11,23,109,5,100
791,3/22/2018 4:55,29,31,35,18,27,140,5,100
792,3/22/2018 5:00,40,40,47,14,22,163,5,100
793,3/22/2018 5:05,32,34,40,20,26,152,5,100
794,3/22/2018 5:10,42,34,43,16,27,162,5,100
795,3/22/2018 5:15,46,34,45,16,35,176,5,100
796,3/22/2018 5:20,42,41,44,26,32,185,5,100
797,3/22/2018 5:25,50,45,52,20,39,206,5,100
798,3/22/2018 5:30,61,55,63,25,42,246,5,100
799,3/22/2018 5:35,64,55,63,29,36,247,5,100
800,3/22/2018 5:40,84,63,73,35,51,306,5,100
801,3/22/2018 5:45,77,57,77,30,52,293,5,100
802,3/22/2018 5:50,65,57,70,19,52,263,5,100
803,3/22/2018 5:55,90,71,69,27,42,299,5,100
804,3/22/2018 6:00,72,61,63,38,42,276,5,100
805,3/22/2018 6:05,71,59,71,27,46,274,5,100
806,3/22/2018 6:10,77,55,70,32,56,290,5,100
807,3/22/2018 6:15,90,72,90,35,57,344,5,100
808,3/22/2018 6:20,82,53,71,28,37,271,5,100
809,3/22/2018 6:25,95,64,91,53,56,359,5,100
810,3/22/2018 6:30,86,78,87,52,55,358,5,100
811,3/22/2018 6:35,94,73,90,45,66,368,5,100
812,3/22/2018 6:40,112,77,92,61,53,395,5,100
813,3/22/2018 6:45,127,88,124,58,89,486,5,100
814,3/22/2018 6:50,100,70,96,49,74,389,5,100
815,3/22/2018 6:55,106,74,92,57,75,404,5,100
816,3/22/2018 7:00,113,84,104,61,69,431,5,100
817,3/22/2018 7:05,101,68,92,55,68,384,5,100
818,3/22/2018 7:10,132,92,120,69,75,488,5,100
819,3/22/2018 7:15,142,102,121,57,90,512,5,100
820,3/22/2018 7:20,135,101,130,71,83,520,5,100
821,3/22/2018 7:25,145,96,138,48,84,511,5,100
822,3/22/2018 7:30,130,106,126,90,88,540,5,100
823,3/22/2018 7:35,134,103,144,77,106,564,5,100
824,3/22/2018 7:40,145,113,125,93,89,565,5,100
825,3/22/2018 7:45,124,97,123,63,89,496,5,100
826,3/22/2018 7:50,126,107,126,67,102,528,5,100
827,3/22/2018 7:55,125,100,115,85,99,524,5,100
828,3/22/2018 8:00,127,80,114,64,83,468,5,100
829,3/22/2018 8:05,117,101,109,67,67,461,5,100
830,3/22/2018 8:10,136,86,125,76,94,517,5,100
831,3/22/2018 8:15,121,102,127,75,99,524,5,100
832,3/22/2018 8:20,129,102,121,74,98,524,5,100
833,3/22/2018 8:25,123,97,120,67,72,479,5,100
834,3/22/2018 8:30,109,91,112,71,90,473,5,100
835,3/22/2018 8:35,139,102,131,62,92,526,5,100
836,3/22/2018 8:40,117,87,110,69,90,473,5,100
837,3/22/2018 8:45,121,92,113,65,90,481,5,100
838,3/22/2018 8:50,125,94,106,66,79,470,5,100
839,3/22/2018 8:55,114,86,95,65,81,441,5,100
840,3/22/2018 9:00,112,81,110,56,66,425,5,100
841,3/22/2018 9:05,123,91,110,68,83,475,5,100
842,3/22/2018 9:10,123,86,110,58,75,452,5,100
843,3/22/2018 9:15,123,99,109,78,75,484,5,100
844,3/22/2018 9:20,123,80,105,59,76,443,5,100
845,3/22/2018 9:25,113,80,113,58,84,448,5,100
846,3/22/2018 9:30,119,90,106,56,78,449,5,100
847,3/22/2018 9:35,119,89,104,59,81,452,5,100
848,3/22/2018 9:40,110,100,103,65,96,474,5,100
849,3/22/2018 9:45,114,86,102,61,94,457,5,100
850,3/22/2018 9:50,107,86,99,55,71,418,5,100
851,3/22/2018 9:55,104,86,80,50,74,394,5,100
852,3/22/2018 10:00,80,71,77,53,57,338,5,100
853,3/22/2018 10:05,103,75,94,48,65,385,5,100
854,3/22/2018 10:10,118,94,104,62,78,456,5,100
855,3/22/2018 10:15,100,90,91,50,77,408,5,100
856,3/22/2018 10:20,100,100,96,48,74,418,5,100
857,3/22/2018 10:25,91,75,88,44,66,364,5,100
858,3/22/2018 10:30,102,83,107,62,75,429,5,100
859,3/22/2018 10:35,97,82,102,54,74,409,5,100
860,3/22/2018 10:40,94,82,99,53,78,406,5,100
861,3/22/2018 10:45,103,94,99,48,88,432,5,100
862,3/22/2018 10:50,96,90,107,47,87,427,5,100
863,3/22/2018 10:55,101,94,108,70,92,465,5,100
864,3/22/2018 11:00,97,88,89,46,66,386,5,100
865,3/22/2018 11:05,98,82,109,48,85,422,5,100
866,3/22/2018 11:10,88,75,102,41,71,377,5,100
867,3/22/2018 11:15,98,88,102,58,70,416,5,100
868,3/22/2018 11:20,118,99,107,54,100,478,5,100
869,3/22/2018 11:25,117,86,116,66,75,460,5,100
870,3/22/2018 11:30,100,81,105,38,67,391,5,100
871,3/22/2018 11:35,109,103,102,53,91,458,5,100
872,3/22/2018 11:40,121,97,106,63,95,482,5,100
873,3/22/2018 11:45,102,98,115,52,87,454,5,100
874,3/22/2018 11:50,103,89,102,54,71,419,5,100
875,3/22/2018 11:55,115,90,115,46,80,446,5,100
876,3/22/2018 12:00,105,85,113,50,89,442,5,100
877,3/22/2018 12:05,113,87,111,71,90,472,5,100
878,3/22/2018 12:10,110,97,115,70,100,492,5,100
879,3/22/2018 12:15,126,104,105,51,77,463,5,100
880,3/22/2018 12:20,104,84,110,56,85,439,5,100
881,3/22/2018 12:25,139,98,118,62,94,511,5,100
882,3/22/2018 12:30,101,90,104,55,77,427,5,100
883,3/22/2018 12:35,126,108,114,69,95,512,5,100
884,3/22/2018 12:40,121,99,125,61,96,502,5,100
885,3/22/2018 12:45,120,103,123,59,81,486,5,100
886,3/22/2018 12:50,109,86,108,60,92,455,5,100
887,3/22/2018 12:55,128,102,115,67,77,489,5,100
888,3/22/2018 13:00,111,94,105,74,79,463,5,100
889,3/22/2018 13:05,111,87,106,69,86,459,5,100
890,3/22/2018 13:10,104,85,108,63,91,451,5,100
891,3/22/2018 13:15,118,93,102,57,86,456,5,100
892,3/22/2018 13:20,114,95,107,65,88,469,5,100
893,3/22/2018 13:25,125,98,111,67,87,488,5,100
894,3/22/2018 13:30,134,82,115,67,93,491,5,100
895,3/22/2018 13:35,105,99,113,61,93,471,5,100
896,3/22/2018 13:40,123,111,113,77,90,514,5,100
897,3/22/2018 13:45,114,78,103,61,81,437,5,100
898,3/22/2018 13:50,127,103,113,78,90,511,5,100
899,3/22/2018 13:55,121,85,120,79,86,491,5,100
900,3/22/2018 14:00,104,89,104,83,79,459,5,100
901,3/22/2018 14:05,127,89,114,77,85,492,5,100
902,3/22/2018 14:10,122,91,114,62,98,487,5,100
903,3/22/2018 14:15,135,105,128,90,76,534,5,100
904,3/22/2018 14:20,119,105,130,80,90,524,5,100
905,3/22/2018 14:25,128,104,114,84,81,511,5,100
906,3/22/2018 14:30,126,86,115,75,81,483,5,100
907,3/22/2018 14:35,129,105,127,74,112,547,5,100
908,3/22/2018 14:40,128,97,125,79,82,511,5,100
909,3/22/2018 14:45,122,100,107,104,100,533,5,100
910,3/22/2018 14:50,120,98,126,75,89,508,5,100
911,3/22/2018 14:55,130,95,127,71,84,507,5,100
912,3/22/2018 15:00,126,102,121,74,89,512,5,100
913,3/22/2018 15:05,133,103,114,87,102,539,5,100
914,3/22/2018 15:10,112,93,122,77,92,496,5,100
915,3/22/2018 15:15,125,95,127,77,90,514,5,100
916,3/22/2018 15:20,110,96,102,69,83,460,5,100
917,3/22/2018 15:25,94,99,101,70,83,447,5,100
918,3/22/2018 15:30,100,90,94,71,75,430,5,100
919,3/22/2018 15:35,108,85,101,66,75,435,5,100
920,3/22/2018 15:40,95,85,106,71,84,441,5,100
921,3/22/2018 15:45,105,77,112,90,77,461,5,100
922,3/22/2018 15:50,100,98,112,74,78,462,5,100
923,3/22/2018 15:55,110,90,115,70,70,455,5,100
924,3/22/2018 16:00,103,99,106,90,85,483,5,100
925,3/22/2018 16:05,121,94,113,80,90,498,5,100
926,3/22/2018 16:10,111,95,104,66,83,459,5,100
927,3/22/2018 16:15,108,83,106,86,77,460,5,100
928,3/22/2018 16:20,110,83,107,79,90,469,5,100
929,3/22/2018 16:25,107,97,110,78,93,485,5,100
930,3/22/2018 16:30,119,89,111,77,86,482,5,100
931,3/22/2018 16:35,127,106,105,84,108,530,5,100
932,3/22/2018 16:40,110,93,100,86,68,457,5,100
933,3/22/2018 16:45,104,89,90,67,84,434,5,100
934,3/22/2018 16:50,96,89,99,83,86,453,5,100
935,3/22/2018 16:55,93,82,98,94,72,439,5,100
936,3/22/2018 17:00,84,67,71,81,63,366,5,100
937,3/22/2018 17:05,101,94,99,90,76,460,5,100
938,3/22/2018 17:10,93,88,97,88,88,454,5,100
939,3/22/2018 17:15,100,77,98,91,76,442,5,100
940,3/22/2018 17:20,112,82,99,79,77,449,5,100
941,3/22/2018 17:25,102,92,101,76,88,459,5,100
942,3/22/2018 17:30,102,78,101,98,75,454,5,100
943,3/22/2018 17:35,90,87,91,96,77,441,5,100
944,3/22/2018 17:40,82,72,75,102,80,411,5,100
945,3/22/2018 17:45,77,69,70,102,79,397,5,100
946,3/22/2018 17:50,79,72,71,106,72,400,5,100
947,3/22/2018 17:55,81,76,79,109,84,429,5,100
948,3/22/2018 18:00,82,76,74,114,83,429,5,100
949,3/22/2018 18:05,89,90,84,101,83,447,5,100
950,3/22/2018 18:10,85,95,81,95,82,438,5,100
951,3/22/2018 18:15,87,83,89,99,88,446,5,100
952,3/22/2018 18:20,103,85,105,94,79,466,5,100
953,3/22/2018 18:25,108,80,106,110,84,488,5,100
954,3/22/2018 18:30,102,88,98,86,81,455,5,100
955,3/22/2018 18:35,108,86,110,94,82,480,5,100
956,3/22/2018 18:40,97,97,101,107,84,486,5,100
957,3/22/2018 18:45,99,100,99,101,94,493,5,100
958,3/22/2018 18:50,112,97,112,70,78,469,5,100
959,3/22/2018 18:55,116,96,109,84,84,489,5,100
960,3/22/2018 19:00,110,91,109,47,76,433,5,100
961,3/22/2018 19:05,98,79,111,55,69,412,5,100
962,3/22/2018 19:10,107,79,105,66,78,435,5,100
963,3/22/2018 19:15,124,96,115,67,89,491,5,100
964,3/22/2018 19:20,99,93,109,69,94,464,5,100
965,3/22/2018 19:25,111,98,117,66,83,475,5,100
966,3/22/2018 19:30,118,95,114,60,85,472,5,100
967,3/22/2018 19:35,113,88,92,63,89,445,5,100
968,3/22/2018 19:40,102,92,115,52,66,427,5,100
969,3/22/2018 19:45,99,88,96,51,86,420,5,100
970,3/22/2018 19:50,113,90,101,58,88,450,5,100
971,3/22/2018 19:55,104,92,104,51,87,438,5,100
972,3/22/2018 20:00,97,77,96,57,81,408,5,100
973,3/22/2018 20:05,108,100,106,61,67,442,5,100
974,3/22/2018 20:10,101,100,107,56,87,451,5,100
975,3/22/2018 20:15,117,97,105,51,73,443,5,100
976,3/22/2018 20:20,97,85,109,53,79,423,5,100
977,3/22/2018 20:25,107,88,112,61,69,437,5,100
978,3/22/2018 20:30,88,72,86,45,64,355,5,100
979,3/22/2018 20:35,120,97,106,68,78,469,5,100
980,3/22/2018 20:40,98,79,102,60,62,401,5,100
981,3/22/2018 20:45,114,85,101,55,62,417,5,100
982,3/22/2018 20:50,110,82,99,59,79,429,5,100
983,3/22/2018 20:55,99,79,85,47,74,384,5,100
984,3/22/2018 21:00,97,73,98,37,73,378,5,100
985,3/22/2018 21:05,94,76,99,46,64,379,5,100
986,3/22/2018 21:10,117,82,103,41,67,410,5,100
987,3/22/2018 21:15,90,76,91,36,63,356,5,100
988,3/22/2018 21:20,94,76,81,55,61,367,5,100
989,3/22/2018 21:25,99,79,87,45,60,370,5,100
990,3/22/2018 21:30,96,71,94,42,66,369,5,100
991,3/22/2018 21:35,70,68,76,41,56,311,5,100
992,3/22/2018 21:40,88,85,90,45,62,370,5,100
993,3/22/2018 21:45,89,80,80,38,62,349,5,100
994,3/22/2018 21:50,85,74,80,33,56,328,5,100
995,3/22/2018 21:55,79,70,79,45,64,337,5,100
996,3/22/2018 22:00,90,65,98,50,60,363,5,100
997,3/22/2018 22:05,78,81,90,50,69,368,5,100
998,3/22/2018 22:10,98,67,101,50,64,380,5,100
999,3/22/2018 22:15,87,77,80,40,68,352,5,100
1000,3/22/2018 22:20,94,81,98,49,63,385,5,100
1001,3/22/2018 22:25,82,70,92,25,68,337,5,100
1002,3/22/2018 22:30,80,66,78,30,58,312,5,100
1003,3/22/2018 22:35,76,71,98,38,69,352,5,100
1004,3/22/2018 22:40,74,50,71,33,52,280,5,100
1005,3/22/2018 22:45,72,67,72,30,51,292,5,100
1006,3/22/2018 22:50,60,66,63,28,43,260,5,100
1007,3/22/2018 22:55,76,63,77,35,53,304,5,100
1008,3/22/2018 23:00,58,50,69,25,47,249,5,100
1009,3/22/2018 23:05,54,47,66,29,49,245,5,100
1010,3/22/2018 23:10,54,63,64,18,41,240,5,100
1011,3/22/2018 23:15,57,58,63,33,48,259,5,100
1012,3/22/2018 23:20,58,53,56,39,36,242,5,100
1013,3/22/2018 23:25,42,38,49,23,40,192,5,100
1014,3/22/2018 23:30,49,49,60,28,39,225,5,100
1015,3/22/2018 23:35,54,57,61,22,39,233,5,100
1016,3/22/2018 23:40,62,45,70,29,38,244,5,100
1017,3/22/2018 23:45,48,52,49,26,54,229,5,100
1018,3/22/2018 23:50,27,36,35,19,36,153,5,100
1019,3/22/2018 23:55,38,32,49,24,43,186,5,100
1020,3/23/2018 0:00,37,42,49,28,28,184,5,100
1021,3/23/2018 0:05,40,33,43,27,43,186,5,100
1022,3/23/2018 0:10,35,47,48,25,40,195,5,100
1023,3/23/2018 0:15,37,49,40,18,38,182,5,100
1024,3/23/2018 0:20,37,43,47,20,31,178,5,100
1025,3/23/2018 0:25,30,40,48,22,40,180,5,100
1026,3/23/2018 0:30,19,42,34,21,34,150,5,100
1027,3/23/2018 0:35,20,31,24,11,29,115,5,100
1028,3/23/2018 0:40,25,25,32,12,32,126,5,100
1029,3/23/2018 0:45,18,28,30,8,25,109,5,100
1030,3/23/2018 0:50,25,28,31,14,21,119,5,100
1031,3/23/2018 0:55,16,38,27,13,28,122,5,100
1032,3/23/2018 1:00,13,20,21,12,36,102,5,100
1033,3/23/2018 1:05,17,30,26,21,27,121,5,100
1034,3/23/2018 1:10,12,25,23,15,22,97,5,100
1035,3/23/2018 1:15,23,27,24,13,18,105,5,100
1036,3/23/2018 1:20,16,31,21,9,29,106,5,100
1037,3/23/2018 1:25,17,22,23,16,31,109,5,100
1038,3/23/2018 1:30,14,26,31,8,24,103,5,100
1039,3/23/2018 1:35,23,26,19,12,21,101,5,100
1040,3/23/2018 1:40,10,24,22,14,27,97,5,100
1041,3/23/2018 1:45,14,19,23,8,18,82,5,100
1042,3/23/2018 1:50,11,18,19,8,24,80,5,100
1043,3/23/2018 1:55,12,25,20,7,24,88,5,100
1044,3/23/2018 2:00,21,24,19,13,21,98,5,100
1045,3/23/2018 2:05,9,18,21,9,24,81,5,100
1046,3/23/2018 2:10,9,16,13,6,21,65,5,100
1047,3/23/2018 2:15,9,20,15,9,20,73,5,100
1048,3/23/2018 2:20,17,17,18,7,13,72,5,100
1049,3/23/2018 2:25,15,17,15,11,13,71,5,100
1050,3/23/2018 2:30,10,15,13,7,13,58,5,100
1051,3/23/2018 2:35,7,8,14,2,9,40,5,100
1052,3/23/2018 2:40,12,14,20,6,10,62,5,100
1053,3/23/2018 2:45,12,17,21,8,15,73,5,100
1054,3/23/2018 2:50,10,15,16,6,22,69,5,100
1055,3/23/2018 2:55,9,18,18,7,13,65,5,100
1056,3/23/2018 3:00,11,11,18,4,14,58,5,100
1057,3/23/2018 3:05,10,14,12,2,11,49,5,100
1058,3/23/2018 3:10,7,18,13,2,12,52,5,100
1059,3/23/2018 3:15,8,19,15,6,11,59,5,100
1060,3/23/2018 3:20,10,19,12,4,16,61,5,100
1061,3/23/2018 3:25,3,12,11,2,8,36,5,100
1062,3/23/2018 3:30,9,20,16,7,19,71,5,100
1063,3/23/2018 3:35,12,17,16,4,14,63,5,100
1064,3/23/2018 3:40,13,18,11,2,12,56,5,100
1065,3/23/2018 3:45,13,22,22,12,16,85,5,100
1066,3/23/2018 3:50,10,17,14,4,15,60,5,100
1067,3/23/2018 3:55,12,16,15,5,17,65,5,100
1068,3/23/2018 4:00,13,15,10,10,20,68,5,100
1069,3/23/2018 4:05,13,15,19,7,14,68,5,0
1070,3/23/2018 4:10,17,18,22,8,13,78,5,0
1071,3/23/2018 4:15,12,19,19,9,17,76,5,100
1072,3/23/2018 4:20,16,19,25,3,22,85,5,100
1073,3/23/2018 4:25,16,20,25,8,15,84,5,100
1074,3/23/2018 4:30,16,41,21,13,20,111,5,100
1075,3/23/2018 4:35,21,32,38,10,26,127,5,100
1076,3/23/2018 4:40,23,18,28,13,20,102,5,100
1077,3/23/2018 4:45,25,23,25,16,23,112,5,100
1078,3/23/2018 4:50,36,29,32,11,30,138,5,100
1079,3/23/2018 4:55,23,35,33,18,29,138,5,100
1080,3/23/2018 5:00,29,34,38,15,25,141,5,100
1081,3/23/2018 5:05,37,30,37,10,26,140,5,100
1082,3/23/2018 5:10,48,46,48,13,19,174,5,100
1083,3/23/2018 5:15,44,30,43,14,25,156,5,100
1084,3/23/2018 5:20,63,50,53,19,33,218,5,100
1085,3/23/2018 5:25,60,51,77,13,44,245,5,100
1086,3/23/2018 5:30,67,49,77,23,42,258,5,100
1087,3/23/2018 5:35,62,43,69,32,39,245,5,100
1088,3/23/2018 5:40,86,55,72,30,52,295,5,100
1089,3/23/2018 5:45,70,56,72,30,50,278,5,100
1090,3/23/2018 5:50,83,64,84,36,46,313,5,100
1091,3/23/2018 5:55,56,53,56,29,32,226,5,100
1092,3/23/2018 6:00,82,66,79,24,44,295,5,100
1093,3/23/2018 6:05,61,50,64,30,32,237,5,100
1094,3/23/2018 6:10,80,55,69,32,48,284,5,100
1095,3/23/2018 6:15,76,62,78,46,50,312,5,100
1096,3/23/2018 6:20,87,67,86,29,54,323,5,100
1097,3/23/2018 6:25,81,61,77,45,60,324,5,100
1098,3/23/2018 6:30,84,65,79,44,47,319,5,100
1099,3/23/2018 6:35,92,78,94,40,73,377,5,100
1100,3/23/2018 6:40,104,90,99,59,74,426,5,100
1101,3/23/2018 6:45,103,74,96,53,71,397,5,100
1102,3/23/2018 6:50,117,83,96,45,65,406,5,100
1103,3/23/2018 6:55,99,83,103,56,61,402,5,100
1104,3/23/2018 7:00,104,76,91,58,72,401,5,100
1105,3/23/2018 7:05,117,76,103,44,70,410,5,100
1106,3/23/2018 7:10,111,95,106,49,76,437,5,100
1107,3/23/2018 7:15,142,83,114,55,69,463,5,100
1108,3/23/2018 7:20,138,109,130,55,72,504,5,100
1109,3/23/2018 7:25,144,109,132,59,84,528,5,100
1110,3/23/2018 7:30,143,100,140,74,86,543,5,100
1111,3/23/2018 7:35,162,118,133,63,101,577,5,100
1112,3/23/2018 7:40,167,126,144,76,99,612,5,100
1113,3/23/2018 7:45,144,101,140,72,102,559,5,100
1114,3/23/2018 7:50,145,107,131,78,94,555,5,100
1115,3/23/2018 7:55,142,113,127,68,103,553,5,100
1116,3/23/2018 8:00,146,95,132,64,90,527,5,100
1117,3/23/2018 8:05,154,117,130,74,92,567,5,100
1118,3/23/2018 8:10,126,95,134,76,87,518,5,100
1119,3/23/2018 8:15,143,99,119,71,90,522,5,100
1120,3/23/2018 8:20,152,109,127,82,94,564,5,100
1121,3/23/2018 8:25,137,95,133,68,94,527,5,100
1122,3/23/2018 8:30,149,101,130,55,98,533,5,100
1123,3/23/2018 8:35,138,105,124,66,87,520,5,100
1124,3/23/2018 8:40,148,99,129,64,97,537,5,100
1125,3/23/2018 8:45,126,108,121,61,72,488,5,100
1126,3/23/2018 8:50,124,90,107,64,76,461,5,100
1127,3/23/2018 8:55,118,92,111,74,91,486,5,100
1128,3/23/2018 9:00,118,89,112,59,79,457,5,100
1129,3/23/2018 9:05,102,85,117,51,67,422,5,100
1130,3/23/2018 9:10,128,104,107,55,77,471,5,100
1131,3/23/2018 9:15,124,83,105,56,85,453,5,100
1132,3/23/2018 9:20,140,103,118,64,88,513,5,100
1133,3/23/2018 9:25,120,106,104,55,87,472,5,100
1134,3/23/2018 9:30,113,85,113,58,80,449,5,100
1135,3/23/2018 9:35,98,93,111,48,73,423,5,100
1136,3/23/2018 9:40,141,106,120,64,83,514,5,100
1137,3/23/2018 9:45,123,82,110,63,84,462,5,100
1138,3/23/2018 9:50,115,93,108,46,81,443,5,100
1139,3/23/2018 9:55,101,77,97,64,78,417,5,100
1140,3/23/2018 10:00,118,78,117,47,97,457,5,100
1141,3/23/2018 10:05,120,83,108,44,85,440,5,100
1142,3/23/2018 10:10,111,98,118,61,86,474,5,100
1143,3/23/2018 10:15,129,93,115,59,83,479,5,100
1144,3/23/2018 10:20,124,90,119,62,87,482,5,100
1145,3/23/2018 10:25,130,102,123,50,89,494,5,100
1146,3/23/2018 10:30,152,106,124,49,86,517,5,100
1147,3/23/2018 10:35,111,98,123,56,84,472,5,100
1148,3/23/2018 10:40,116,100,125,52,85,478,5,100
1149,3/23/2018 10:45,138,100,121,66,90,515,5,100
1150,3/23/2018 10:50,150,92,122,46,90,500,5,100
1151,3/23/2018 10:55,114,88,110,47,80,439,5,100
1152,3/23/2018 11:00,128,104,129,54,85,500,5,100
1153,3/23/2018 11:05,127,102,105,51,90,475,5,100
1154,3/23/2018 11:10,129,95,124,53,90,491,5,100
1155,3/23/2018 11:15,132,93,126,48,94,493,5,100
1156,3/23/2018 11:20,132,85,123,50,97,487,5,100
1157,3/23/2018 11:25,141,97,129,51,109,527,5,100
1158,3/23/2018 11:30,130,104,132,58,99,523,5,100
1159,3/23/2018 11:35,121,96,127,51,95,490,5,100
1160,3/23/2018 11:40,138,107,111,58,99,513,5,100
1161,3/23/2018 11:45,143,104,122,61,82,512,5,100
1162,3/23/2018 11:50,136,111,136,64,115,562,5,100
1163,3/23/2018 11:55,137,107,132,61,93,530,5,100
1164,3/23/2018 12:00,149,99,129,65,98,540,5,100
1165,3/23/2018 12:05,136,103,131,60,101,531,5,100
1166,3/23/2018 12:10,127,90,125,53,81,476,5,100
1167,3/23/2018 12:15,136,102,118,54,76,486,5,100
1168,3/23/2018 12:20,141,108,122,52,91,514,5,100
1169,3/23/2018 12:25,117,95,121,52,97,482,5,100
1170,3/23/2018 12:30,135,114,123,58,87,517,5,100
1171,3/23/2018 12:35,137,104,129,71,97,538,5,100
1172,3/23/2018 12:40,122,110,113,72,89,506,5,100
1173,3/23/2018 12:45,134,92,127,72,96,521,5,100
1174,3/23/2018 12:50,114,101,123,79,100,517,5,100
1175,3/23/2018 12:55,103,99,107,91,103,503,5,100
1176,3/23/2018 13:00,108,93,75,74,92,442,5,100
1177,3/23/2018 13:05,108,100,52,75,104,439,5,100
1178,3/23/2018 13:10,123,97,41,108,117,486,5,100
1179,3/23/2018 13:15,115,108,35,112,102,472,5,100
1180,3/23/2018 13:20,118,99,38,102,92,449,5,100
1181,3/23/2018 13:25,107,95,32,98,99,431,5,100
1182,3/23/2018 13:30,124,109,64,99,105,501,5,100
1183,3/23/2018 13:35,141,111,139,99,107,597,5,100
1184,3/23/2018 13:40,99,101,107,95,94,496,5,100
1185,3/23/2018 13:45,106,69,80,90,80,425,5,100
1186,3/23/2018 13:50,124,99,121,111,110,565,5,100
1187,3/23/2018 13:55,100,95,104,97,94,490,5,100
1188,3/23/2018 14:00,106,96,101,106,85,494,5,100
1189,3/23/2018 14:05,102,105,107,105,96,515,5,100
1190,3/23/2018 14:10,100,85,105,94,98,482,5,100
1191,3/23/2018 14:15,103,101,111,96,102,513,5,100
1192,3/23/2018 14:20,103,94,114,103,81,495,5,100
1193,3/23/2018 14:25,83,82,85,101,84,435,5,100
1194,3/23/2018 14:30,76,71,78,102,79,406,5,100
1195,3/23/2018 14:35,91,83,78,113,88,453,5,100
1196,3/23/2018 14:40,91,81,84,115,87,458,5,100
1197,3/23/2018 14:45,88,74,87,120,93,462,5,100
1198,3/23/2018 14:50,77,83,84,124,87,455,5,100
1199,3/23/2018 14:55,91,78,85,105,91,450,5,100
1200,3/23/2018 15:00,68,62,66,98,76,370,5,100
1201,3/23/2018 15:05,84,76,83,115,85,443,5,100
1202,3/23/2018 15:10,90,87,93,114,103,487,5,100
1203,3/23/2018 15:15,66,62,70,93,84,375,5,100
1204,3/23/2018 15:20,71,51,62,88,68,340,5,100
1205,3/23/2018 15:25,61,57,57,84,70,329,5,100
1206,3/23/2018 15:30,86,77,81,100,82,426,5,100
1207,3/23/2018 15:35,88,78,85,105,92,448,5,100
1208,3/23/2018 15:40,65,73,67,99,74,378,5,100
1209,3/23/2018 15:45,65,67,61,97,78,368,5,100
1210,3/23/2018 15:50,59,51,58,79,73,320,5,100
1211,3/23/2018 15:55,72,69,74,100,81,396,5,100
1212,3/23/2018 16:00,77,64,68,77,73,359,5,100
1213,3/23/2018 16:05,64,51,53,86,60,314,5,100
1214,3/23/2018 16:10,62,66,63,84,70,345,5,100
1215,3/23/2018 16:15,89,83,88,111,94,465,5,100
1216,3/23/2018 16:20,85,74,77,119,88,443,5,100
1217,3/23/2018 16:25,69,70,64,108,84,395,5,100
1218,3/23/2018 16:30,67,63,68,91,77,366,5,100
1219,3/23/2018 16:35,88,84,79,115,99,465,5,100
1220,3/23/2018 16:40,66,74,76,91,82,389,5,100
1221,3/23/2018 16:45,61,74,65,91,71,362,5,100
1222,3/23/2018 16:50,67,67,53,80,64,331,5,100
1223,3/23/2018 16:55,63,75,61,78,83,360,5,100
1224,3/23/2018 17:00,71,64,63,81,76,355,5,100
1225,3/23/2018 17:05,64,63,59,67,66,319,5,100
1226,3/23/2018 17:10,80,68,85,81,77,391,5,100
1227,3/23/2018 17:15,90,92,103,101,94,480,5,100
1228,3/23/2018 17:20,92,98,89,144,104,527,5,100
1229,3/23/2018 17:25,74,63,63,111,82,393,5,100
1230,3/23/2018 17:30,68,55,67,104,75,369,5,100
1231,3/23/2018 17:35,82,55,73,101,66,377,5,100
1232,3/23/2018 17:40,81,81,80,123,89,454,5,100
1233,3/23/2018 17:45,69,51,59,81,74,334,5,100
1234,3/23/2018 17:50,71,52,67,92,68,350,5,100
1235,3/23/2018 17:55,74,62,76,105,80,397,5,100
1236,3/23/2018 18:00,64,55,69,93,74,355,5,100
1237,3/23/2018 18:05,72,74,70,111,75,402,5,100
1238,3/23/2018 18:10,92,95,92,122,104,505,5,100
1239,3/23/2018 18:15,84,82,84,105,89,444,5,100
1240,3/23/2018 18:20,80,95,88,107,99,469,5,100
1241,3/23/2018 18:25,87,96,90,92,84,449,5,100
1242,3/23/2018 18:30,92,97,89,119,97,494,5,100
1243,3/23/2018 18:35,99,103,97,129,102,530,5,100
1244,3/23/2018 18:40,109,104,118,101,87,519,5,100
1245,3/23/2018 18:45,88,104,101,119,98,510,5,100
1246,3/23/2018 18:50,102,85,96,127,97,507,5,100
1247,3/23/2018 18:55,100,98,89,111,99,497,5,100
1248,3/23/2018 19:00,118,107,115,87,99,526,5,100
1249,3/23/2018 19:05,94,107,115,105,87,508,5,100
1250,3/23/2018 19:10,99,100,102,87,94,482,5,100
1251,3/23/2018 19:15,120,93,116,90,70,489,5,100
1252,3/23/2018 19:20,119,102,110,77,85,493,5,100
1253,3/23/2018 19:25,131,109,123,82,95,540,5,100
1254,3/23/2018 19:30,126,101,115,84,84,510,5,100
1255,3/23/2018 19:35,131,93,133,62,111,530,5,100
1256,3/23/2018 19:40,114,102,116,71,75,478,5,100
1257,3/23/2018 19:45,119,100,123,59,95,496,5,100
1258,3/23/2018 19:50,130,101,121,60,68,480,5,100
1259,3/23/2018 19:55,104,72,98,55,69,398,5,100
1260,3/23/2018 20:00,123,107,116,61,93,500,5,100
1261,3/23/2018 20:05,146,97,116,63,96,518,5,100
1262,3/23/2018 20:10,128,108,122,55,91,504,5,100
1263,3/23/2018 20:15,126,108,113,60,90,497,5,100
1264,3/23/2018 20:20,101,87,100,43,80,411,5,100
1265,3/23/2018 20:25,129,98,120,50,85,482,5,100
1266,3/23/2018 20:30,146,112,129,74,94,555,5,100
1267,3/23/2018 20:35,136,99,126,63,87,511,5,100
1268,3/23/2018 20:40,126,97,115,61,84,483,5,100
1269,3/23/2018 20:45,105,73,95,37,62,372,5,100
1270,3/23/2018 20:50,95,85,91,48,79,398,5,100
1271,3/23/2018 20:55,100,86,107,55,63,411,5,100
1272,3/23/2018 21:00,107,74,98,53,65,397,5,100
1273,3/23/2018 21:05,97,70,89,47,73,376,5,100
1274,3/23/2018 21:10,88,74,96,53,54,365,5,100
