,5 Minutes,Lane 1 Flow (Veh/5 Minutes),Lane 2 Flow (Veh/5 Minutes),Lane 3 Flow (Veh/5 Minutes),Lane 4 Flow (Veh/5 Minutes),Flow (Veh/5 Minutes),# Lane Points,% Observed
1275,3/23/2018 21:15,97,99,87,78,361,4,0
1276,3/23/2018 21:20,83,86,75,68,312,4,0
1277,3/23/2018 21:25,85,88,78,69,320,4,0
1278,3/23/2018 21:30,98,99,87,79,363,4,0
1279,3/23/2018 21:35,84,87,76,69,316,4,0
1280,3/23/2018 21:40,78,81,72,64,295,4,0
1281,3/23/2018 21:45,85,88,77,70,320,4,0
1282,3/23/2018 21:50,81,84,74,67,306,4,0
1283,3/23/2018 21:55,85,88,78,70,321,4,0
1284,3/23/2018 22:00,81,85,75,68,309,4,0
1285,3/23/2018 22:05,84,87,76,69,316,4,0
1286,3/23/2018 22:10,73,77,68,61,279,4,0
1287,3/23/2018 22:15,79,83,73,66,301,4,0
1288,3/23/2018 22:20,70,74,65,59,268,4,0
1289,3/23/2018 22:25,69,73,64,58,264,4,0
1290,3/23/2018 22:30,74,78,69,62,283,4,0
1291,3/23/2018 22:35,77,81,71,65,294,4,0
1292,3/23/2018 22:40,75,79,70,63,287,4,0
1293,3/23/2018 22:45,77,81,71,64,293,4,0
1294,3/23/2018 22:50,74,78,69,62,283,4,0
1295,3/23/2018 22:55,68,73,65,59,265,4,0
1296,3/23/2018 23:00,67,72,63,57,259,4,0
1297,3/23/2018 23:05,68,73,65,58,264,4,0
1298,3/23/2018 23:10,61,66,58,52,237,4,0
1299,3/23/2018 23:15,64,69,61,56,250,4,0
1300,3/23/2018 23:20,63,68,60,54,245,4,0
1301,3/23/2018 23:25,58,65,57,51,231,4,0
1302,3/23/2018 23:30,55,62,55,50,222,4,0
1303,3/23/2018 23:35,52,59,52,46,209,4,0
1304,3/23/2018 23:40,49,56,50,44,199,4,0
1305,3/23/2018 23:45,51,58,52,47,208,4,0
1306,3/23/2018 23:50,55,62,55,49,221,4,0
1307,3/23/2018 23:55,47,55,50,44,196,4,0
1308,3/24/2018 0:00,54,61,54,48,217,4,0
1309,3/24/2018 0:05,47,55,49,43,194,4,0
1310,3/24/2018 0:10,50,56,50,45,201,4,0
1311,3/24/2018 0:15,49,57,50,43,199,4,0
1312,3/24/2018 0:20,46,54,48,43,191,4,0
1313,3/24/2018 0:25,48,55,49,44,196,4,0
1314,3/24/2018 0:30,38,46,40,33,157,4,0
1315,3/24/2018 0:35,46,54,48,43,191,4,0
1316,3/24/2018 0:40,44,53,47,40,184,4,0
1317,3/24/2018 0:45,49,56,49,44,198,4,0
1318,3/24/2018 0:50,46,54,48,42,190,4,0
1319,3/24/2018 0:55,38,47,42,37,164,4,0
1320,3/24/2018 1:00,37,46,42,37,162,4,0
1321,3/24/2018 1:05,40,49,42,36,167,4,0
1322,3/24/2018 1:10,35,44,39,35,153,4,0
1323,3/24/2018 1:15,32,42,36,31,141,4,0
1324,3/24/2018 1:20,36,44,39,34,153,4,0
1325,3/24/2018 1:25,39,47,41,36,163,4,0
1326,3/24/2018 1:30,31,41,38,33,143,4,0
1327,3/24/2018 1:35,32,41,37,31,141,4,0
1328,3/24/2018 1:40,30,40,37,31,138,4,0
1329,3/24/2018 1:45,34,43,38,34,149,4,0
1330,3/24/2018 1:50,33,42,36,31,142,4,0
1331,3/24/2018 1:55,32,42,38,34,146,4,0
1332,3/24/2018 2:00,30,39,33,27,129,4,0
1333,3/24/2018 2:05,27,38,32,26,123,4,0
1334,3/24/2018 2:10,31,40,35,30,136,4,0
1335,3/24/2018 2:15,39,47,41,37,164,4,0
1336,3/24/2018 2:20,35,43,37,30,145,4,0
1337,3/24/2018 2:25,32,41,35,30,138,4,0
1338,3/24/2018 2:30,33,42,37,33,145,4,0
1339,3/24/2018 2:35,29,38,32,28,127,4,0
1340,3/24/2018 2:40,30,39,34,30,133,4,0
1341,3/24/2018 2:45,30,40,35,31,136,4,0
1342,3/24/2018 2:50,32,41,36,32,141,4,0
1343,3/24/2018 2:55,30,40,37,31,138,4,0
1344,3/24/2018 3:00,32,41,36,30,139,4,0
1345,3/24/2018 3:05,27,36,32,28,123,4,0
1346,3/24/2018 3:10,29,39,33,27,128,4,0
1347,3/24/2018 3:15,29,39,35,29,132,4,0
1348,3/24/2018 3:20,22,33,29,24,108,4,0
1349,3/24/2018 3:25,30,39,33,29,131,4,0
1350,3/24/2018 3:30,30,40,35,30,135,4,0
1351,3/24/2018 3:35,31,40,37,33,141,4,0
1352,3/24/2018 3:40,33,42,38,33,146,4,0
1353,3/24/2018 3:45,33,42,37,33,145,4,0
1354,3/24/2018 3:50,29,39,34,30,132,4,0
1355,3/24/2018 3:55,30,40,36,32,138,4,0
1356,3/24/2018 4:00,31,41,36,31,139,4,0
1357,3/24/2018 4:05,32,41,36,31,140,4,0
1358,3/24/2018 4:10,28,37,33,28,126,4,0
1359,3/24/2018 4:15,27,37,34,28,126,4,0
1360,3/24/2018 4:20,31,41,36,32,140,4,0
1361,3/24/2018 4:25,38,46,41,36,161,4,0
1362,3/24/2018 4:30,32,41,36,32,141,4,0
1363,3/24/2018 4:35,36,46,40,35,157,4,0
1364,3/24/2018 4:40,43,51,44,37,175,4,0
1365,3/24/2018 4:45,41,49,43,38,171,4,0
1366,3/24/2018 4:50,41,50,44,39,174,4,0
1367,3/24/2018 4:55,43,50,44,39,176,4,0
1368,3/24/2018 5:00,37,47,40,35,159,4,0
1369,3/24/2018 5:05,41,49,44,39,173,4,0
1370,3/24/2018 5:10,38,46,41,36,161,4,0
1371,3/24/2018 5:15,45,53,46,42,186,4,0
1372,3/24/2018 5:20,49,57,50,44,200,4,0
1373,3/24/2018 5:25,52,59,53,48,212,4,0
1374,3/24/2018 5:30,49,56,49,44,198,4,0
1375,3/24/2018 5:35,51,58,51,44,204,4,0
1376,3/24/2018 5:40,68,72,64,57,261,4,0
1377,3/24/2018 5:45,64,69,61,54,248,4,0
1378,3/24/2018 5:50,61,67,59,53,240,4,0
1379,3/24/2018 5:55,55,62,55,48,220,4,0
1380,3/24/2018 6:00,52,59,53,47,211,4,0
1381,3/24/2018 6:05,50,58,51,44,203,4,0
1382,3/24/2018 6:10,50,57,50,45,202,4,0
1383,3/24/2018 6:15,57,62,55,49,223,4,0
1384,3/24/2018 6:20,53,60,53,47,213,4,0
1385,3/24/2018 6:25,45,52,46,40,183,4,0
1386,3/24/2018 6:30,64,69,61,55,249,4,0
1387,3/24/2018 6:35,58,64,56,50,228,4,0
1388,3/24/2018 6:40,73,77,68,61,279,4,0
1389,3/24/2018 6:45,73,78,68,61,280,4,0
1390,3/24/2018 6:50,80,83,73,66,302,4,0
1391,3/24/2018 6:55,71,76,67,60,274,4,0
1392,3/24/2018 7:00,70,75,66,59,270,4,0
1393,3/24/2018 7:05,63,68,60,54,245,4,0
1394,3/24/2018 7:10,67,72,63,56,258,4,0
1395,3/24/2018 7:15,73,77,68,61,279,4,0
1396,3/24/2018 7:20,71,75,66,59,271,4,0
1397,3/24/2018 7:25,79,82,72,65,298,4,0
1398,3/24/2018 7:30,76,81,71,63,291,4,0
1399,3/24/2018 7:35,80,84,74,66,304,4,0
1400,3/24/2018 7:40,86,89,78,70,323,4,0
1401,3/24/2018 7:45,88,90,79,72,329,4,0
1402,3/24/2018 7:50,93,95,83,76,347,4,0
1403,3/24/2018 7:55,90,92,81,74,337,4,0
1404,3/24/2018 8:00,76,80,71,64,291,4,0
1405,3/24/2018 8:05,80,84,73,66,303,4,0
1406,3/24/2018 8:10,86,89,78,71,324,4,0
1407,3/24/2018 8:15,85,88,78,70,321,4,0
1408,3/24/2018 8:20,89,91,80,72,332,4,0
1409,3/24/2018 8:25,67,72,63,57,259,4,0
1410,3/24/2018 8:30,79,83,73,66,301,4,0
1411,3/24/2018 8:35,96,97,85,77,355,4,0
1412,3/24/2018 8:40,91,93,81,74,339,4,0
1413,3/24/2018 8:45,84,87,77,69,317,4,0
1414,3/24/2018 8:50,96,98,86,78,358,4,0
1415,3/24/2018 8:55,84,87,77,69,317,4,0
1416,3/24/2018 9:00,99,100,88,79,366,4,0
1417,3/24/2018 9:05,92,93,82,74,341,4,0
1418,3/24/2018 9:10,83,86,75,68,312,4,0
1419,3/24/2018 9:15,98,99,87,78,362,4,0
1420,3/24/2018 9:20,97,98,86,78,359,4,0
1421,3/24/2018 9:25,103,103,90,82,378,4,0
1422,3/24/2018 9:30,97,98,85,78,358,4,0
1423,3/24/2018 9:35,85,88,77,70,320,4,0
1424,3/24/2018 9:40,100,101,89,80,370,4,0
1425,3/24/2018 9:45,105,106,93,84,388,4,0
1426,3/24/2018 9:50,101,102,90,81,374,4,0
1427,3/24/2018 9:55,111,111,97,88,407,4,0
1428,3/24/2018 10:00,99,100,88,79,366,4,0
1429,3/24/2018 10:05,99,100,88,79,366,4,0
1430,3/24/2018 10:10,95,96,85,76,352,4,0
1431,3/24/2018 10:15,109,109,95,86,399,4,0
1432,3/24/2018 10:20,101,102,90,81,374,4,0
1433,3/24/2018 10:25,103,104,91,82,380,4,0
1434,3/24/2018 10:30,103,104,91,83,381,4,0
1435,3/24/2018 10:35,104,104,92,83,383,4,0
1436,3/24/2018 10:40,102,102,89,81,374,4,0
1437,3/24/2018 10:45,106,107,94,84,391,4,0
1438,3/24/2018 10:50,109,109,95,86,399,4,0
1439,3/24/2018 10:55,109,109,95,87,400,4,0
1440,3/24/2018 11:00,93,95,83,75,346,4,0
1441,3/24/2018 11:05,87,90,79,71,327,4,0
1442,3/24/2018 11:10,89,91,80,73,333,4,0
1443,3/24/2018 11:15,106,106,93,85,390,4,0
1444,3/24/2018 11:20,102,102,89,81,374,4,0
1445,3/24/2018 11:25,100,101,89,80,370,4,0
1446,3/24/2018 11:30,109,109,96,86,400,4,0
1447,3/24/2018 11:35,102,103,90,81,376,4,0
1448,3/24/2018 11:40,104,105,92,83,384,4,0
1449,3/24/2018 11:45,121,119,104,94,438,4,0
1450,3/24/2018 11:50,104,105,92,83,384,4,0
1451,3/24/2018 11:55,112,112,98,89,411,4,0
1452,3/24/2018 12:00,102,103,90,82,377,4,0
1453,3/24/2018 12:05,96,98,86,77,357,4,0
1454,3/24/2018 12:10,100,101,89,81,371,4,0
1455,3/24/2018 12:15,82,86,75,68,311,4,0
1456,3/24/2018 12:20,110,110,96,87,403,4,0
1457,3/24/2018 12:25,125,123,108,98,454,4,0
1458,3/24/2018 12:30,115,114,100,91,420,4,0
1459,3/24/2018 12:35,110,110,96,88,404,4,0
1460,3/24/2018 12:40,111,110,96,87,404,4,0
1461,3/24/2018 12:45,109,108,95,86,398,4,0
1462,3/24/2018 12:50,103,103,90,82,378,4,0
1463,3/24/2018 12:55,121,119,104,95,439,4,0
1464,3/24/2018 13:00,112,112,98,89,411,4,0
1465,3/24/2018 13:05,107,107,94,85,393,4,0
1466,3/24/2018 13:10,107,107,94,85,393,4,0
1467,3/24/2018 13:15,102,103,90,82,377,4,0
1468,3/24/2018 13:20,113,113,100,91,417,4,0
1469,3/24/2018 13:25,121,119,103,94,437,4,0
1470,3/24/2018 13:30,122,120,105,95,442,4,0
1471,3/24/2018 13:35,117,116,101,92,426,4,0
1472,3/24/2018 13:40,128,126,109,100,463,4,0
1473,3/24/2018 13:45,122,121,106,96,445,4,0
1474,3/24/2018 13:50,123,122,106,97,448,4,0
1475,3/24/2018 13:55,112,112,98,89,411,4,0
1476,3/24/2018 14:00,113,113,99,89,414,4,0
1477,3/24/2018 14:05,107,108,94,85,394,4,0
1478,3/24/2018 14:10,131,128,112,102,473,4,0
1479,3/24/2018 14:15,115,114,99,90,418,4,0
1480,3/24/2018 14:20,122,121,106,96,445,4,0
1481,3/24/2018 14:25,126,125,109,99,459,4,0
1482,3/24/2018 14:30,113,112,98,89,412,4,0
1483,3/24/2018 14:35,111,110,96,88,405,4,0
1484,3/24/2018 14:40,115,114,100,91,420,4,0
1485,3/24/2018 14:45,120,118,103,94,435,4,0
1486,3/24/2018 14:50,121,120,106,96,443,4,0
1487,3/24/2018 14:55,115,114,100,91,420,4,0
1488,3/24/2018 15:00,107,108,95,86,396,4,0
1489,3/24/2018 15:05,113,112,97,89,411,4,0
1490,3/24/2018 15:10,106,106,94,85,391,4,0
1491,3/24/2018 15:15,121,119,104,94,438,4,0
1492,3/24/2018 15:20,105,106,93,84,388,4,0
1493,3/24/2018 15:25,121,119,105,95,440,4,0
1494,3/24/2018 15:30,121,119,104,94,438,4,0
1495,3/24/2018 15:35,119,118,103,94,434,4,0
1496,3/24/2018 15:40,121,119,105,95,440,4,0
1497,3/24/2018 15:45,119,118,103,94,434,4,0
1498,3/24/2018 15:50,124,122,107,97,450,4,0
1499,3/24/2018 15:55,123,121,106,96,446,4,0
1500,3/24/2018 16:00,126,124,109,98,457,4,0
1501,3/24/2018 16:05,123,121,105,96,445,4,0
1502,3/24/2018 16:10,123,121,106,96,446,4,0
1503,3/24/2018 16:15,110,109,96,87,402,4,0
1504,3/24/2018 16:20,120,119,104,94,437,4,0
1505,3/24/2018 16:25,109,109,95,87,400,4,0
1506,3/24/2018 16:30,117,116,102,92,427,4,0
1507,3/24/2018 16:35,110,110,96,87,403,4,0
1508,3/24/2018 16:40,124,122,107,97,450,4,0
1509,3/24/2018 16:45,120,119,104,95,438,4,0
1510,3/24/2018 16:50,119,117,102,93,431,4,0
1511,3/24/2018 16:55,117,115,100,91,423,4,0
1512,3/24/2018 17:00,107,107,94,85,393,4,0
1513,3/24/2018 17:05,109,109,95,86,399,4,0
1514,3/24/2018 17:10,111,111,97,88,407,4,0
1515,3/24/2018 17:15,105,106,93,84,388,4,0
1516,3/24/2018 17:20,119,117,102,93,431,4,0
1517,3/24/2018 17:25,121,119,104,95,439,4,0
1518,3/24/2018 17:30,118,117,103,93,431,4,0
1519,3/24/2018 17:35,118,116,102,93,429,4,0
1520,3/24/2018 17:40,114,113,99,90,416,4,0
1521,3/24/2018 17:45,106,106,93,84,389,4,0
1522,3/24/2018 17:50,115,114,100,91,420,4,0
1523,3/24/2018 17:55,114,114,100,90,418,4,0
1524,3/24/2018 18:00,109,109,96,87,401,4,0
1525,3/24/2018 18:05,102,103,90,82,377,4,0
1526,3/24/2018 18:10,84,87,76,69,316,4,0
1527,3/24/2018 18:15,110,110,96,87,403,4,0
1528,3/24/2018 18:20,104,105,92,83,384,4,0
1529,3/24/2018 18:25,96,98,86,78,358,4,0
1530,3/24/2018 18:30,97,98,86,78,359,4,0
1531,3/24/2018 18:35,120,118,103,94,435,4,0
1532,3/24/2018 18:40,109,109,95,86,399,4,0
1533,3/24/2018 18:45,95,96,85,77,353,4,0
1534,3/24/2018 18:50,100,101,89,81,371,4,0
1535,3/24/2018 18:55,96,97,85,77,355,4,0
1536,3/24/2018 19:00,95,96,85,77,353,4,0
1537,3/24/2018 19:05,97,99,86,78,360,4,0
1538,3/24/2018 19:10,106,105,92,84,387,4,0
1539,3/24/2018 19:15,92,94,83,75,344,4,0
1540,3/24/2018 19:20,94,96,85,76,351,4,0
1541,3/24/2018 19:25,91,93,82,74,340,4,0
1542,3/24/2018 19:30,94,96,84,76,350,4,0
1543,3/24/2018 19:35,96,97,85,77,355,4,0
1544,3/24/2018 19:40,105,105,92,83,385,4,0
1545,3/24/2018 19:45,108,108,94,85,395,4,0
1546,3/24/2018 19:50,109,109,95,86,399,4,0
1547,3/24/2018 19:55,104,105,93,84,386,4,0
1548,3/24/2018 20:00,99,100,88,80,367,4,0
1549,3/24/2018 20:05,95,97,85,77,354,4,0
1550,3/24/2018 20:10,91,94,82,74,341,4,0
1551,3/24/2018 20:15,87,89,78,71,325,4,0
1552,3/24/2018 20:20,88,90,79,72,329,4,0
1553,3/24/2018 20:25,88,90,79,72,329,4,0
1554,3/24/2018 20:30,89,91,80,73,333,4,0
1555,3/24/2018 20:35,81,85,74,67,307,4,0
1556,3/24/2018 20:40,85,88,77,70,320,4,0
1557,3/24/2018 20:45,80,84,73,66,303,4,0
1558,3/24/2018 20:50,78,82,72,65,297,4,0
1559,3/24/2018 20:55,82,85,75,68,310,4,0
1560,3/24/2018 21:00,88,91,80,72,331,4,0
1561,3/24/2018 21:05,88,91,80,72,331,4,0
1562,3/24/2018 21:10,90,92,81,73,336,4,0
1563,3/24/2018 21:15,97,99,86,78,360,4,0
1564,3/24/2018 21:20,75,79,69,62,285,4,0
1565,3/24/2018 21:25,84,87,76,69,316,4,0
1566,3/24/2018 21:30,83,86,76,68,313,4,0
1567,3/24/2018 21:35,81,84,74,67,306,4,0
1568,3/24/2018 21:40,79,83,73,65,300,4,0
1569,3/24/2018 21:45,88,90,79,71,328,4,0
1570,3/24/2018 21:50,84,87,77,69,317,4,0
1571,3/24/2018 21:55,78,82,72,65,297,4,0
1572,3/24/2018 22:00,90,93,81,73,337,4,0
1573,3/24/2018 22:05,76,80,70,63,289,4,0
1574,3/24/2018 22:10,71,76,67,60,274,4,0
1575,3/24/2018 22:15,81,85,74,67,307,4,0
1576,3/24/2018 22:20,79,82,72,65,298,4,0
1577,3/24/2018 22:25,83,86,75,68,312,4,0
1578,3/24/2018 22:30,85,88,77,70,320,4,0
1579,3/24/2018 22:35,78,82,72,65,297,4,0
1580,3/24/2018 22:40,79,83,73,66,301,4,0
1581,3/24/2018 22:45,72,76,67,60,275,4,0
1582,3/24/2018 22:50,73,77,68,61,279,4,0
1583,3/24/2018 22:55,71,76,67,60,274,4,0
1584,3/24/2018 23:00,75,80,70,63,288,4,0
1585,3/24/2018 23:05,64,70,61,55,250,4,0
1586,3/24/2018 23:10,64,69,61,55,249,4,0
1587,3/24/2018 23:15,64,69,61,54,248,4,0
1588,3/24/2018 23:20,73,77,68,61,279,4,0
1589,3/24/2018 23:25,61,67,59,53,240,4,0
1590,3/24/2018 23:30,67,71,63,56,257,4,0
1591,3/24/2018 23:35,61,67,58,52,238,4,0
1592,3/24/2018 23:40,59,65,57,51,232,4,0
1593,3/24/2018 23:45,57,64,57,51,229,4,0
1594,3/24/2018 23:50,56,62,55,49,222,4,0
1595,3/24/2018 23:55,48,55,49,44,196,4,0
1596,3/25/2018 0:00,24,39,32,36,131,4,0
1597,3/25/2018 0:05,27,43,35,39,144,4,0
1598,3/25/2018 0:10,27,43,35,39,144,4,0
1599,3/25/2018 0:15,32,47,38,44,161,4,0
1600,3/25/2018 0:20,31,46,38,43,158,4,0
1601,3/25/2018 0:25,30,45,36,42,153,4,0
1602,3/25/2018 0:30,26,41,34,38,139,4,0
1603,3/25/2018 0:35,20,36,30,33,119,4,0
1604,3/25/2018 0:40,22,37,31,35,125,4,0
1605,3/25/2018 0:45,19,34,29,32,114,4,0
1606,3/25/2018 0:50,19,36,30,33,118,4,0
1607,3/25/2018 0:55,17,33,28,31,109,4,0
1608,3/25/2018 1:00,18,34,28,31,111,4,0
1609,3/25/2018 1:05,20,35,29,33,117,4,0
1610,3/25/2018 1:10,10,27,23,25,85,4,0
1611,3/25/2018 1:15,11,27,24,25,87,4,0
1612,3/25/2018 1:20,19,35,29,32,115,4,0
1613,3/25/2018 1:25,18,33,28,31,110,4,0
1614,3/25/2018 1:30,18,34,29,32,113,4,0
1615,3/25/2018 1:35,10,26,22,24,82,4,0
1616,3/25/2018 1:40,11,27,24,25,87,4,0
1617,3/25/2018 1:45,17,33,27,30,107,4,0
1618,3/25/2018 1:50,11,28,24,25,88,4,0
1619,3/25/2018 1:55,7,23,20,21,71,4,0
1620,3/25/2018 2:00,9,26,22,24,81,4,0
1621,3/25/2018 2:05,11,28,24,25,88,4,0
1622,3/25/2018 2:10,14,30,26,28,98,4,0
1623,3/25/2018 2:15,19,30,25,28,102,4,0
1624,3/25/2018 2:20,15,32,27,29,103,4,0
1625,3/25/2018 2:25,17,33,28,30,108,4,0
1626,3/25/2018 2:30,15,31,26,29,101,4,0
1627,3/25/2018 2:35,15,31,26,28,100,4,0
1628,3/25/2018 2:40,1,18,16,16,51,4,0
1629,3/25/2018 2:45,11,24,22,22,79,4,0
1630,3/25/2018 2:50,10,19,17,17,63,4,0
1631,3/25/2018 2:55,3,19,17,17,56,4,0
1632,3/25/2018 3:00,6,22,19,20,67,4,0
1633,3/25/2018 3:05,14,20,18,18,70,4,0
1634,3/25/2018 3:10,6,21,19,19,65,4,0
1635,3/25/2018 3:15,6,23,20,21,70,4,0
1636,3/25/2018 3:20,6,21,18,19,64,4,0
1637,3/25/2018 3:25,7,18,16,16,57,4,0
1638,3/25/2018 3:30,13,24,21,22,80,4,0
1639,3/25/2018 3:35,11,19,17,17,64,4,0
1640,3/25/2018 3:40,11,28,25,26,90,4,0
1641,3/25/2018 3:45,7,16,15,15,53,4,0
1642,3/25/2018 3:50,13,20,18,19,70,4,0
1643,3/25/2018 3:55,6,17,15,15,53,4,0
1644,3/25/2018 4:00,9,17,15,15,56,4,0
1645,3/25/2018 4:05,9,18,16,16,59,4,0
1646,3/25/2018 4:10,3,19,17,17,56,4,0
1647,3/25/2018 4:15,8,13,12,11,44,4,0
1648,3/25/2018 4:20,8,19,17,17,61,4,0
1649,3/25/2018 4:25,9,21,18,19,67,4,0
1650,3/25/2018 4:30,8,17,16,15,56,4,0
1651,3/25/2018 4:35,13,21,19,19,72,4,0
1652,3/25/2018 4:40,6,21,18,19,64,4,0
1653,3/25/2018 4:45,6,22,19,20,67,4,0
1654,3/25/2018 4:50,14,17,16,15,62,4,0
1655,3/25/2018 4:55,10,23,20,20,73,4,0
1656,3/25/2018 5:00,5,21,18,19,63,4,0
1657,3/25/2018 5:05,9,20,18,18,65,4,0
1658,3/25/2018 5:10,8,24,21,22,75,4,0
1659,3/25/2018 5:15,10,23,20,20,73,4,0
1660,3/25/2018 5:20,16,22,19,20,77,4,0
1661,3/25/2018 5:25,10,23,20,21,74,4,0
1662,3/25/2018 5:30,10,24,21,22,77,4,0
1663,3/25/2018 5:35,5,20,18,19,62,4,0
1664,3/25/2018 5:40,13,29,24,26,92,4,0
1665,3/25/2018 5:45,18,34,28,31,111,4,0
1666,3/25/2018 5:50,11,27,23,25,86,4,0
1667,3/25/2018 5:55,13,25,22,23,83,4,0
1668,3/25/2018 6:00,10,27,23,24,84,4,0
1669,3/25/2018 6:05,6,22,20,20,68,4,0
1670,3/25/2018 6:10,12,28,24,26,90,4,0
1671,3/25/2018 6:15,11,28,23,25,87,4,0
1672,3/25/2018 6:20,16,32,27,29,104,4,0
1673,3/25/2018 6:25,14,30,25,28,97,4,0
1674,3/25/2018 6:30,20,35,29,33,117,4,0
1675,3/25/2018 6:35,16,32,27,29,104,4,0
1676,3/25/2018 6:40,19,35,29,32,115,4,0
1677,3/25/2018 6:45,24,39,32,36,131,4,0
1678,3/25/2018 6:50,24,40,33,37,134,4,0
1679,3/25/2018 6:55,20,35,29,32,116,4,0
1680,3/25/2018 7:00,11,28,23,25,87,4,0
1681,3/25/2018 7:05,17,33,28,31,109,4,0
1682,3/25/2018 7:10,17,33,28,31,109,4,0
1683,3/25/2018 7:15,23,38,31,35,127,4,0
1684,3/25/2018 7:20,22,38,31,35,126,4,0
1685,3/25/2018 7:25,33,47,39,44,163,4,0
1686,3/25/2018 7:30,26,41,34,38,139,4,0
1687,3/25/2018 7:35,31,46,38,43,158,4,0
1688,3/25/2018 7:40,19,36,30,33,118,4,0
1689,3/25/2018 7:45,44,57,46,53,200,4,0
1690,3/25/2018 7:50,38,52,42,48,180,4,0
1691,3/25/2018 7:55,30,45,37,41,153,4,0
1692,3/25/2018 8:00,40,53,43,50,186,4,0
1693,3/25/2018 8:05,23,39,33,36,131,4,0
1694,3/25/2018 8:10,33,47,39,44,163,4,0
1695,3/25/2018 8:15,36,50,40,46,172,4,0
1696,3/25/2018 8:20,36,50,41,46,173,4,0
1697,3/25/2018 8:25,39,53,43,49,184,4,0
1698,3/25/2018 8:30,42,55,44,51,192,4,0
1699,3/25/2018 8:35,42,55,44,51,192,4,0
1700,3/25/2018 8:40,42,55,44,51,192,4,0
1701,3/25/2018 8:45,40,53,43,50,186,4,0
1702,3/25/2018 8:50,49,62,49,58,218,4,0
1703,3/25/2018 8:55,48,61,48,56,213,4,0
1704,3/25/2018 9:00,41,54,43,50,188,4,0
1705,3/25/2018 9:05,36,50,41,46,173,4,0
1706,3/25/2018 9:10,46,59,47,54,206,4,0
1707,3/25/2018 9:15,57,69,54,64,244,4,0
1708,3/25/2018 9:20,54,66,52,61,233,4,0
1709,3/25/2018 9:25,55,67,53,62,237,4,0
1710,3/25/2018 9:30,55,67,53,62,237,4,0
1711,3/25/2018 9:35,69,79,63,74,285,4,0
1712,3/25/2018 9:40,62,72,57,68,259,4,0
1713,3/25/2018 9:45,59,71,56,66,252,4,0
1714,3/25/2018 9:50,67,77,61,72,277,4,0
1715,3/25/2018 9:55,63,74,58,69,264,4,0
1716,3/25/2018 10:00,59,70,55,65,249,4,0
1717,3/25/2018 10:05,58,69,55,65,247,4,0
1718,3/25/2018 10:10,62,73,57,68,260,4,0
1719,3/25/2018 10:15,59,70,56,66,251,4,0
1720,3/25/2018 10:20,62,73,57,68,260,4,0
1721,3/25/2018 10:25,65,75,59,70,269,4,0
1722,3/25/2018 10:30,71,81,63,75,290,4,0
1723,3/25/2018 10:35,72,81,63,76,292,4,0
1724,3/25/2018 10:40,81,89,69,84,323,4,0
1725,3/25/2018 10:45,69,79,62,74,284,4,0
1726,3/25/2018 10:50,68,78,61,73,280,4,0
1727,3/25/2018 10:55,71,81,63,76,291,4,0
1728,3/25/2018 11:00,70,80,63,74,287,4,0
1729,3/25/2018 11:05,73,82,64,77,296,4,0
1730,3/25/2018 11:10,71,81,64,76,292,4,0
1731,3/25/2018 11:15,80,89,69,83,321,4,0
1732,3/25/2018 11:20,73,83,65,77,298,4,0
1733,3/25/2018 11:25,80,89,69,83,321,4,0
1734,3/25/2018 11:30,85,92,72,87,336,4,0
1735,3/25/2018 11:35,83,91,72,86,332,4,0
1736,3/25/2018 11:40,90,97,76,91,354,4,0
1737,3/25/2018 11:45,77,86,68,81,312,4,0
1738,3/25/2018 11:50,78,87,68,81,314,4,0
1739,3/25/2018 11:55,88,96,75,90,349,4,0
0,3/25/2018 11:00,70,80,63,74,287,4,0
1,3/25/2018 11:05,73,82,64,77,296,4,0
2,3/25/2018 11:10,71,81,64,76,292,4,0
3,3/25/2018 11:15,80,89,69,83,321,4,0
4,3/25/2018 11:20,73,83,65,77,298,4,0
5,3/25/2018 11:25,80,89,69,83,321,4,0
6,3/25/2018 11:30,85,92,72,87,336,4,0
7,3/25/2018 11:35,83,91,72,86,332,4,0
8,3/25/2018 11:40,90,97,76,91,354,4,0
9,3/25/2018 11:45,77,86,68,81,312,4,0
10,3/25/2018 11:50,78,87,68,81,314,4,0
11,3/25/2018 11:55,88,96,75,90,349,4,0
12,3/25/2018 12:00,76,85,66,79,306,4,0
13,3/25/2018 12:05,80,89,70,83,322,4,0
14,3/25/2018 12:10,87,94,73,88,342,4,0
15,3/25/2018 12:15,87,95,74,89,345,4,0
16,3/25/2018 12:20,81,89,70,84,324,4,0
17,3/25/2018 12:25,94,101,79,95,369,4,0
18,3/25/2018 12:30,96,103,80,96,375,4,0
19,3/25/2018 12:35,103,108,84,102,397,4,0
20,3/25/2018 12:40,107,113,88,106,414,4,0
21,3/25/2018 12:45,105,111,86,104,406,4,0
22,3/25/2018 12:50,98,104,81,98,381,4,0
23,3/25/2018 12:55,100,107,83,100,390,4,0
24,3/25/2018 13:00,89,96,75,90,350,4,0
25,3/25/2018 13:05,88,95,74,89,346,4,0
26,3/25/2018 13:10,96,101,78,95,370,4,0
27,3/25/2018 13:15,97,104,81,97,379,4,0
28,3/25/2018 13:20,104,110,86,103,403,4,0
29,3/25/2018 13:25,87,95,74,89,345,4,0
30,3/25/2018 13:30,107,113,88,106,414,4,0
31,3/25/2018 13:35,113,118,92,111,434,4,0
32,3/25/2018 13:40,91,99,77,93,360,4,0
33,3/25/2018 13:45,98,105,82,98,383,4,0
34,3/25/2018 13:50,99,105,82,99,385,4,0
35,3/25/2018 13:55,89,97,76,90,352,4,0
36,3/25/2018 14:00,111,115,89,109,424,4,0
37,3/25/2018 14:05,108,112,87,106,413,4,0
38,3/25/2018 14:10,100,107,83,100,390,4,0
39,3/25/2018 14:15,107,113,88,106,414,4,0
40,3/25/2018 14:20,93,100,77,94,364,4,0
41,3/25/2018 14:25,94,102,79,95,370,4,0
42,3/25/2018 14:30,93,101,79,94,367,4,0
43,3/25/2018 14:35,88,96,75,89,348,4,0
44,3/25/2018 14:40,100,107,83,100,390,4,0
45,3/25/2018 14:45,94,100,78,94,366,4,0
46,3/25/2018 14:50,97,102,79,96,374,4,0
47,3/25/2018 14:55,107,113,88,106,414,4,0
48,3/25/2018 15:00,85,93,73,87,338,4,0
49,3/25/2018 15:05,96,104,81,97,378,4,0
50,3/25/2018 15:10,97,104,81,97,379,4,0
51,3/25/2018 15:15,85,93,73,87,338,4,0
52,3/25/2018 15:20,85,94,73,88,340,4,0
53,3/25/2018 15:25,94,101,79,95,369,4,0
54,3/25/2018 15:30,89,97,76,90,352,4,0
55,3/25/2018 15:35,90,96,75,91,352,4,0
56,3/25/2018 15:40,99,106,82,99,386,4,0
57,3/25/2018 15:45,103,110,85,103,401,4,0
58,3/25/2018 15:50,99,105,82,99,385,4,0
59,3/25/2018 15:55,104,109,84,103,400,4,0
60,3/25/2018 16:00,98,105,82,99,384,4,0
61,3/25/2018 16:05,99,105,81,98,383,4,0
62,3/25/2018 16:10,108,114,88,107,417,4,0
63,3/25/2018 16:15,106,112,86,105,409,4,0
64,3/25/2018 16:20,96,102,78,96,372,4,0
65,3/25/2018 16:25,87,95,74,89,345,4,0
66,3/25/2018 16:30,85,94,73,88,340,4,0
67,3/25/2018 16:35,77,86,67,80,310,4,0
68,3/25/2018 16:40,94,102,79,95,370,4,0
69,3/25/2018 16:45,95,102,80,95,372,4,0
70,3/25/2018 16:50,108,114,88,107,417,4,0
71,3/25/2018 16:55,104,110,86,103,403,4,0
72,3/25/2018 17:00,94,100,78,94,366,4,0
73,3/25/2018 17:05,95,102,80,95,372,4,0
74,3/25/2018 17:10,92,100,78,93,363,4,0
75,3/25/2018 17:15,98,105,82,98,383,4,0
76,3/25/2018 17:20,91,99,77,93,360,4,0
77,3/25/2018 17:25,88,95,74,90,347,4,0
78,3/25/2018 17:30,76,85,66,79,306,4,0
79,3/25/2018 17:35,93,100,77,93,363,4,0
80,3/25/2018 17:40,84,93,73,87,337,4,0
81,3/25/2018 17:45,77,86,67,80,310,4,0
82,3/25/2018 17:50,93,101,79,94,367,4,0
83,3/25/2018 17:55,77,86,68,80,311,4,0
84,3/25/2018 18:00,69,79,62,74,284,4,0
85,3/25/2018 18:05,82,91,71,85,329,4,0
86,3/25/2018 18:10,88,96,75,90,349,4,0
87,3/25/2018 18:15,71,81,63,76,291,4,0
88,3/25/2018 18:20,75,85,66,79,305,4,0
89,3/25/2018 18:25,79,88,69,82,318,4,0
90,3/25/2018 18:30,79,87,68,82,316,4,0
91,3/25/2018 18:35,78,86,67,81,312,4,0
92,3/25/2018 18:40,67,77,60,72,276,4,0
93,3/25/2018 18:45,71,81,64,76,292,4,0
94,3/25/2018 18:50,70,80,63,75,288,4,0
95,3/25/2018 18:55,78,87,69,82,316,4,0
96,3/25/2018 19:00,63,74,58,69,264,4,0
97,3/25/2018 19:05,74,83,66,78,301,4,0
98,3/25/2018 19:10,63,73,58,69,263,4,0
99,3/25/2018 19:15,73,82,65,77,297,4,0
100,3/25/2018 19:20,77,85,67,80,309,4,0
101,3/25/2018 19:25,61,72,57,67,257,4,0
102,3/25/2018 19:30,55,66,53,62,236,4,0
103,3/25/2018 19:35,68,78,61,73,280,4,0
104,3/25/2018 19:40,54,66,52,62,234,4,0
105,3/25/2018 19:45,68,78,61,73,280,4,0
106,3/25/2018 19:50,58,69,55,65,247,4,0
107,3/25/2018 19:55,57,69,54,64,244,4,0
108,3/25/2018 20:00,60,71,56,66,253,4,0
109,3/25/2018 20:05,47,60,48,56,211,4,0
110,3/25/2018 20:10,60,71,56,66,253,4,0
111,3/25/2018 20:15,62,72,57,68,259,4,0
112,3/25/2018 20:20,56,67,53,63,239,4,0
113,3/25/2018 20:25,60,71,56,66,253,4,0
114,3/25/2018 20:30,75,84,66,79,304,4,0
115,3/25/2018 20:35,72,81,64,76,293,4,0
116,3/25/2018 20:40,56,68,54,63,241,4,0
117,3/25/2018 20:45,70,80,63,75,288,4,0
118,3/25/2018 20:50,49,62,49,58,218,4,0
119,3/25/2018 20:55,66,77,61,72,276,4,0
120,3/25/2018 21:00,53,65,51,60,229,4,0
121,3/25/2018 21:05,56,67,53,63,239,4,0
122,3/25/2018 21:10,60,71,56,66,253,4,0
123,3/25/2018 21:15,58,69,55,65,247,4,0
124,3/25/2018 21:20,70,80,63,75,288,4,0
125,3/25/2018 21:25,68,78,62,73,281,4,0
126,3/25/2018 21:30,56,67,53,63,239,4,0
127,3/25/2018 21:35,65,75,59,70,269,4,0
128,3/25/2018 21:40,63,73,58,69,263,4,0
129,3/25/2018 21:45,46,59,47,55,207,4,0
130,3/25/2018 21:50,53,64,51,60,228,4,0
131,3/25/2018 21:55,48,60,48,56,212,4,0
132,3/25/2018 22:00,27,40,35,29,131,4,0
133,3/25/2018 22:05,27,39,35,29,130,4,0
134,3/25/2018 22:10,46,58,47,55,206,4,0
135,3/25/2018 22:15,45,58,46,54,203,4,0
136,3/25/2018 22:20,56,67,53,63,239,4,0
137,3/25/2018 22:25,48,60,48,56,212,4,0
138,3/25/2018 22:30,36,50,41,47,174,4,0
139,3/25/2018 22:35,38,52,42,48,180,4,0
140,3/25/2018 22:40,34,49,40,45,168,4,0
141,3/25/2018 22:45,35,49,40,45,169,4,0
142,3/25/2018 22:50,29,44,35,40,148,4,0
143,3/25/2018 22:55,31,46,38,43,158,4,0
144,3/25/2018 23:00,23,39,32,36,130,4,0
145,3/25/2018 23:05,35,49,40,45,169,4,0
146,3/25/2018 23:10,30,45,37,41,153,4,0
147,3/25/2018 23:15,23,39,33,36,131,4,0
148,3/25/2018 23:20,28,42,35,40,145,4,0
149,3/25/2018 23:25,22,38,32,35,127,4,0
150,3/25/2018 23:30,22,38,31,35,126,4,0
151,3/25/2018 23:35,17,33,28,30,108,4,0
152,3/25/2018 23:40,26,42,34,39,141,4,0
153,3/25/2018 23:45,19,35,30,32,116,4,0
154,3/25/2018 23:50,17,32,27,30,106,4,0
155,3/25/2018 23:55,16,33,28,30,107,4,0
156,3/26/2018 0:00,18,33,28,31,110,4,0
157,3/26/2018 0:05,15,32,27,29,103,4,0
158,3/26/2018 0:10,8,24,21,22,75,4,0
159,3/26/2018 0:15,13,29,25,27,94,4,0
160,3/26/2018 0:20,7,24,21,22,74,4,0
161,3/26/2018 0:25,9,27,24,25,85,4,0
162,3/26/2018 0:30,10,22,19,20,71,4,0
163,3/26/2018 0:35,13,28,24,26,91,4,0
164,3/26/2018 0:40,6,23,20,21,70,4,0
165,3/26/2018 0:45,7,24,21,22,74,4,0
166,3/26/2018 0:50,8,22,19,20,69,4,0
167,3/26/2018 0:55,12,20,18,18,68,4,0
168,3/26/2018 1:00,8,19,17,17,61,4,0
169,3/26/2018 1:05,9,15,14,14,52,4,0
170,3/26/2018 1:10,4,20,18,18,60,4,0
171,3/26/2018 1:15,5,19,17,17,58,4,0
172,3/26/2018 1:20,7,15,14,14,50,4,0
173,3/26/2018 1:25,10,16,15,15,56,4,0
174,3/26/2018 1:30,6,16,15,14,51,4,0
175,3/26/2018 1:35,6,21,19,19,65,4,0
176,3/26/2018 1:40,4,20,18,18,60,4,0
177,3/26/2018 1:45,9,15,14,13,51,4,0
178,3/26/2018 1:50,8,14,13,13,48,4,0
179,3/26/2018 1:55,10,13,12,11,46,4,0
180,3/26/2018 2:00,7,11,11,10,39,4,0
181,3/26/2018 2:05,8,19,17,17,61,4,0
182,3/26/2018 2:10,6,17,15,15,53,4,0
183,3/26/2018 2:15,11,14,13,12,50,4,0
184,3/26/2018 2:20,8,16,14,14,52,4,0
185,3/26/2018 2:25,11,15,15,14,55,4,0
186,3/26/2018 2:30,8,13,12,11,44,4,0
187,3/26/2018 2:35,8,12,11,10,41,4,0
188,3/26/2018 2:40,9,18,16,16,59,4,0
189,3/26/2018 2:45,3,19,17,17,56,4,0
190,3/26/2018 2:50,2,19,17,17,55,4,0
191,3/26/2018 2:55,5,15,15,14,49,4,0
192,3/26/2018 3:00,6,18,16,16,56,4,0
193,3/26/2018 3:05,5,17,15,15,52,4,0
194,3/26/2018 3:10,16,16,15,14,61,4,0
195,3/26/2018 3:15,6,18,16,16,56,4,0
196,3/26/2018 3:20,3,20,18,18,59,4,0
197,3/26/2018 3:25,8,22,20,21,71,4,0
198,3/26/2018 3:30,8,25,22,23,78,4,0
199,3/26/2018 3:35,14,29,25,26,94,4,0
200,3/26/2018 3:40,6,23,20,21,70,4,0
201,3/26/2018 3:45,12,28,24,25,89,4,0
202,3/26/2018 3:50,18,26,22,24,90,4,0
203,3/26/2018 3:55,8,24,21,22,75,4,0
204,3/26/2018 4:00,12,26,22,23,83,4,0
205,3/26/2018 4:05,8,24,20,21,73,4,0
206,3/26/2018 4:10,5,22,19,20,66,4,0
207,3/26/2018 4:15,21,36,30,33,120,4,0
208,3/26/2018 4:20,29,44,36,40,149,4,0
209,3/26/2018 4:25,36,50,41,47,174,4,0
210,3/26/2018 4:30,34,49,39,45,167,4,0
211,3/26/2018 4:35,47,60,48,56,211,4,0
212,3/26/2018 4:40,59,70,55,65,249,4,0
213,3/26/2018 4:45,55,66,53,62,236,4,0
214,3/26/2018 4:50,59,70,55,65,249,4,0
215,3/26/2018 4:55,34,48,39,45,166,4,0
216,3/26/2018 5:00,52,64,51,59,226,4,0
217,3/26/2018 5:05,46,59,47,55,207,4,0
218,3/26/2018 5:10,68,78,61,73,280,4,0
219,3/26/2018 5:15,78,87,68,81,314,4,0
220,3/26/2018 5:20,89,96,75,91,351,4,0
221,3/26/2018 5:25,83,90,70,85,328,4,0
222,3/26/2018 5:30,112,117,91,110,430,4,0
223,3/26/2018 5:35,111,115,89,108,423,4,0
224,3/26/2018 5:40,129,131,100,124,484,4,0
225,3/26/2018 5:45,121,126,98,118,463,4,0
226,3/26/2018 5:50,111,116,90,109,426,4,0
227,3/26/2018 5:55,107,113,87,106,413,4,0
228,3/26/2018 6:00,103,108,83,102,396,4,0
229,3/26/2018 6:05,101,106,82,100,389,4,0
230,3/26/2018 6:10,120,123,94,116,453,4,0
231,3/26/2018 6:15,112,117,90,110,429,4,0
232,3/26/2018 6:20,120,125,97,117,459,4,0
233,3/26/2018 6:25,111,117,91,110,429,4,0
234,3/26/2018 6:30,117,122,95,115,449,4,0
235,3/26/2018 6:35,110,116,90,109,425,4,0
236,3/26/2018 6:40,123,127,99,120,469,4,0
237,3/26/2018 6:45,127,131,102,123,483,4,0
238,3/26/2018 6:50,113,119,92,111,435,4,0
239,3/26/2018 6:55,113,119,92,111,435,4,0
240,3/26/2018 7:00,119,124,96,116,455,4,0
241,3/26/2018 7:05,102,109,85,102,398,4,0
242,3/26/2018 7:10,112,117,91,110,430,4,0
243,3/26/2018 7:15,108,114,89,107,418,4,0
244,3/26/2018 7:20,115,120,93,112,440,4,0
245,3/26/2018 7:25,113,118,92,111,434,4,0
246,3/26/2018 7:30,111,117,91,110,429,4,0
247,3/26/2018 7:35,110,115,90,108,423,4,0
248,3/26/2018 7:40,114,119,93,112,438,4,0
249,3/26/2018 7:45,107,113,88,106,414,4,0
250,3/26/2018 7:50,115,120,93,113,441,4,0
251,3/26/2018 7:55,107,113,88,106,414,4,0
252,3/26/2018 8:00,105,112,87,105,409,4,0
253,3/26/2018 8:05,100,107,83,100,390,4,0
254,3/26/2018 8:10,97,104,81,98,380,4,0
255,3/26/2018 8:15,69,79,62,74,284,4,0
256,3/26/2018 8:20,79,88,69,83,319,4,0
257,3/26/2018 8:25,74,83,65,78,300,4,0
258,3/26/2018 8:30,60,71,56,66,253,4,0
259,3/26/2018 8:35,70,80,63,75,288,4,0
260,3/26/2018 8:40,88,96,75,90,349,4,0
261,3/26/2018 8:45,90,98,77,92,357,4,0
262,3/26/2018 8:50,101,108,84,101,394,4,0
263,3/26/2018 8:55,94,101,79,95,369,4,0
264,3/26/2018 9:00,68,78,62,73,281,4,0
265,3/26/2018 9:05,88,96,75,90,349,4,0
266,3/26/2018 9:10,92,99,78,93,362,4,0
267,3/26/2018 9:15,82,91,71,85,329,4,0
268,3/26/2018 9:20,95,102,79,96,372,4,0
269,3/26/2018 9:25,94,100,77,94,365,4,0
270,3/26/2018 9:30,92,99,78,93,362,4,0
271,3/26/2018 9:35,83,90,70,85,328,4,0
272,3/26/2018 9:40,89,96,74,90,349,4,0
273,3/26/2018 9:45,95,101,78,95,369,4,0
274,3/26/2018 9:50,92,99,76,93,360,4,0
275,3/26/2018 9:55,85,92,72,87,336,4,0
276,3/26/2018 10:00,92,99,77,93,361,4,0
277,3/26/2018 10:05,82,90,70,85,327,4,0
278,3/26/2018 10:10,89,97,76,90,352,4,0
279,3/26/2018 10:15,83,91,71,85,330,4,0
280,3/26/2018 10:20,88,95,74,90,347,4,0
281,3/26/2018 10:25,82,90,70,84,326,4,0
282,3/26/2018 10:30,67,77,61,72,277,4,0
283,3/26/2018 10:35,85,93,72,87,337,4,0
284,3/26/2018 10:40,115,118,91,112,436,4,0
285,3/26/2018 10:45,102,108,84,101,395,4,0
286,3/26/2018 10:50,101,106,82,100,389,4,0
287,3/26/2018 10:55,97,103,81,97,378,4,0
288,3/26/2018 11:00,101,108,84,101,394,4,0
289,3/26/2018 11:05,100,106,83,99,388,4,0
290,3/26/2018 11:10,100,105,82,99,386,4,0
291,3/26/2018 11:15,85,93,73,87,338,4,0
292,3/26/2018 11:20,92,99,76,93,360,4,0
293,3/26/2018 11:25,85,92,72,87,336,4,0
294,3/26/2018 11:30,100,105,81,99,385,4,0
295,3/26/2018 11:35,84,92,72,86,334,4,0
296,3/26/2018 11:40,90,98,76,91,355,4,0
297,3/26/2018 11:45,97,104,81,97,379,4,0
298,3/26/2018 11:50,99,105,82,99,385,4,0
299,3/26/2018 11:55,99,106,82,99,386,4,0
300,3/26/2018 12:00,105,109,84,103,401,4,0
301,3/26/2018 12:05,94,100,77,94,365,4,0
302,3/26/2018 12:10,95,102,79,95,371,4,0
303,3/26/2018 12:15,83,91,71,85,330,4,0
304,3/26/2018 12:20,97,104,81,98,380,4,0
305,3/26/2018 12:25,94,101,79,94,368,4,0
306,3/26/2018 12:30,95,102,80,95,372,4,0
307,3/26/2018 12:35,97,104,81,97,379,4,0
308,3/26/2018 12:40,104,110,86,104,404,4,0
309,3/26/2018 12:45,94,101,78,94,367,4,0
310,3/26/2018 12:50,98,104,81,98,381,4,0
311,3/26/2018 12:55,93,101,79,95,368,4,0
312,3/26/2018 13:00,102,109,85,102,398,4,0
313,3/26/2018 13:05,91,98,77,92,358,4,0
314,3/26/2018 13:10,93,101,79,94,367,4,0
315,3/26/2018 13:15,97,103,80,97,377,4,0
316,3/26/2018 13:20,100,107,83,100,390,4,0
317,3/26/2018 13:25,88,96,75,90,349,4,0
318,3/26/2018 13:30,112,116,89,110,427,4,0
319,3/26/2018 13:35,110,114,88,108,420,4,0
320,3/26/2018 13:40,98,105,82,99,384,4,0
321,3/26/2018 13:45,95,102,80,96,373,4,0
322,3/26/2018 13:50,102,108,83,101,394,4,0
323,3/26/2018 13:55,97,104,81,98,380,4,0
324,3/26/2018 14:00,91,99,77,92,359,4,0
325,3/26/2018 14:05,91,98,76,92,357,4,0
326,3/26/2018 14:10,96,102,79,96,373,4,0
327,3/26/2018 14:15,95,101,78,95,369,4,0
328,3/26/2018 14:20,101,106,82,100,389,4,0
329,3/26/2018 14:25,98,104,80,98,380,4,0
330,3/26/2018 14:30,103,108,84,102,397,4,0
331,3/26/2018 14:35,101,107,82,100,390,4,0
332,3/26/2018 14:40,95,101,78,95,369,4,0
333,3/26/2018 14:45,95,101,78,95,369,4,0
334,3/26/2018 14:50,96,102,79,96,373,4,0
335,3/26/2018 14:55,87,94,73,89,343,4,0
336,3/26/2018 15:00,85,92,72,87,336,4,0
337,3/26/2018 15:05,84,92,72,86,334,4,0
338,3/26/2018 15:10,101,106,82,100,389,4,0
339,3/26/2018 15:15,103,108,83,101,395,4,0
340,3/26/2018 15:20,105,111,86,104,406,4,0
341,3/26/2018 15:25,98,104,80,97,379,4,0
342,3/26/2018 15:30,97,103,80,97,377,4,0
343,3/26/2018 15:35,99,104,80,98,381,4,0
344,3/26/2018 15:40,102,108,83,101,394,4,0
345,3/26/2018 15:45,99,105,81,99,384,4,0
346,3/26/2018 15:50,97,103,79,97,376,4,0
347,3/26/2018 15:55,94,101,78,95,368,4,0
348,3/26/2018 16:00,90,98,77,92,357,4,0
349,3/26/2018 16:05,102,107,83,101,393,4,0
350,3/26/2018 16:10,93,99,76,93,361,4,0
351,3/26/2018 16:15,95,101,78,95,369,4,0
352,3/26/2018 16:20,94,100,78,94,366,4,0
353,3/26/2018 16:25,105,110,85,104,404,4,0
354,3/26/2018 16:30,98,103,80,97,378,4,0
355,3/26/2018 16:35,99,104,81,98,382,4,0
356,3/26/2018 16:40,108,114,88,107,417,4,0
357,3/26/2018 16:45,100,107,83,100,390,4,0
358,3/26/2018 16:50,97,102,79,96,374,4,0
359,3/26/2018 16:55,94,101,79,95,369,4,0
360,3/26/2018 17:00,91,99,77,92,359,4,0
361,3/26/2018 17:05,94,101,79,95,369,4,0
362,3/26/2018 17:10,101,106,82,100,389,4,0
363,3/26/2018 17:15,89,97,76,91,353,4,0
364,3/26/2018 17:20,104,109,84,103,400,4,0
365,3/26/2018 17:25,96,103,80,97,376,4,0
366,3/26/2018 17:30,86,93,73,88,340,4,0
367,3/26/2018 17:35,87,94,73,89,343,4,0
368,3/26/2018 17:40,81,89,70,84,324,4,0
369,3/26/2018 17:45,98,105,82,99,384,4,0
370,3/26/2018 17:50,100,106,81,100,387,4,0
371,3/26/2018 17:55,96,102,79,96,373,4,0
372,3/26/2018 18:00,92,99,76,93,360,4,0
373,3/26/2018 18:05,95,102,79,96,372,4,0
374,3/26/2018 18:10,88,95,74,89,346,4,0
375,3/26/2018 18:15,87,94,73,89,343,4,0
376,3/26/2018 18:20,85,92,72,87,336,4,0
377,3/26/2018 18:25,78,86,68,81,313,4,0
378,3/26/2018 18:30,93,99,77,93,362,4,0
379,3/26/2018 18:35,81,89,69,84,323,4,0
380,3/26/2018 18:40,85,92,71,86,334,4,0
381,3/26/2018 18:45,80,88,68,83,319,4,0
382,3/26/2018 18:50,83,91,70,85,329,4,0
383,3/26/2018 18:55,83,91,71,85,330,4,0
384,3/26/2018 19:00,82,90,71,85,328,4,0
385,3/26/2018 19:05,85,93,72,87,337,4,0
386,3/26/2018 19:10,94,100,78,94,366,4,0
387,3/26/2018 19:15,84,92,72,86,334,4,0
388,3/26/2018 19:20,92,98,76,92,358,4,0
389,3/26/2018 19:25,70,80,63,75,288,4,0
390,3/26/2018 19:30,61,72,57,67,257,4,0
391,3/26/2018 19:35,71,80,63,75,289,4,0
392,3/26/2018 19:40,69,78,62,74,283,4,0
393,3/26/2018 19:45,53,65,52,61,231,4,0
394,3/26/2018 19:50,68,78,61,73,280,4,0
395,3/26/2018 19:55,67,77,61,72,277,4,0
396,3/26/2018 20:00,60,71,56,66,253,4,0
397,3/26/2018 20:05,42,55,44,51,192,4,0
398,3/26/2018 20:10,58,69,55,65,247,4,0
399,3/26/2018 20:15,60,71,56,67,254,4,0
400,3/26/2018 20:20,56,68,54,63,241,4,0
401,3/26/2018 20:25,65,75,59,71,270,4,0
402,3/26/2018 20:30,49,62,49,58,218,4,0
403,3/26/2018 20:35,53,65,52,61,231,4,0
404,3/26/2018 20:40,60,71,56,66,253,4,0
405,3/26/2018 20:45,52,64,51,59,226,4,0
406,3/26/2018 20:50,53,65,52,60,230,4,0
407,3/26/2018 20:55,52,64,51,59,226,4,0
408,3/26/2018 21:00,50,63,50,58,221,4,0
409,3/26/2018 21:05,43,56,45,52,196,4,0
410,3/26/2018 21:10,48,61,48,56,213,4,0
411,3/26/2018 21:15,52,64,51,60,227,4,0
412,3/26/2018 21:20,47,59,47,55,208,4,0
413,3/26/2018 21:25,60,71,56,66,253,4,0
414,3/26/2018 21:30,51,63,50,59,223,4,0
415,3/26/2018 21:35,46,58,47,54,205,4,0
416,3/26/2018 21:40,42,55,45,51,193,4,0
417,3/26/2018 21:45,39,52,42,49,182,4,0
418,3/26/2018 21:50,50,62,49,58,219,4,0
419,3/26/2018 21:55,36,50,40,46,172,4,0
420,3/26/2018 22:00,38,51,42,48,179,4,0
421,3/26/2018 22:05,37,51,41,47,176,4,0
422,3/26/2018 22:10,42,56,45,52,195,4,0
423,3/26/2018 22:15,41,54,44,51,190,4,0
424,3/26/2018 22:20,41,54,44,50,189,4,0
425,3/26/2018 22:25,34,48,39,45,166,4,0
426,3/26/2018 22:30,35,49,40,46,170,4,0
427,3/26/2018 22:35,31,46,37,42,156,4,0
428,3/26/2018 22:40,41,55,44,51,191,4,0
429,3/26/2018 22:45,38,52,42,48,180,4,0
430,3/26/2018 22:50,33,47,38,44,162,4,0
431,3/26/2018 22:55,29,44,36,40,149,4,0
432,3/26/2018 23:00,23,39,33,36,131,4,0
433,3/26/2018 23:05,31,45,37,42,155,4,0
434,3/26/2018 23:10,30,45,37,42,154,4,0
435,3/26/2018 23:15,23,38,32,35,128,4,0
436,3/26/2018 23:20,25,40,33,37,135,4,0
437,3/26/2018 23:25,17,34,28,31,110,4,0
438,3/26/2018 23:30,16,31,26,29,102,4,0
439,3/26/2018 23:35,24,39,32,36,131,4,0
440,3/26/2018 23:40,25,40,33,37,135,4,0
441,3/26/2018 23:45,21,36,30,34,121,4,0
442,3/26/2018 23:50,17,34,29,31,111,4,0
443,3/26/2018 23:55,17,34,29,31,111,4,0
444,3/27/2018 0:00,9,25,22,23,79,4,0
445,3/27/2018 0:05,14,30,26,28,98,4,0
446,3/27/2018 0:10,19,35,29,32,115,4,0
447,3/27/2018 0:15,10,28,24,25,87,4,0
448,3/27/2018 0:20,15,32,27,30,104,4,0
449,3/27/2018 0:25,8,25,22,23,78,4,0
450,3/27/2018 0:30,15,28,24,26,93,4,0
451,3/27/2018 0:35,12,28,24,26,90,4,0
452,3/27/2018 0:40,8,25,22,23,78,4,0
453,3/27/2018 0:45,12,25,21,23,81,4,0
454,3/27/2018 0:50,2,19,17,17,55,4,0
455,3/27/2018 0:55,6,22,19,20,67,4,0
456,3/27/2018 1:00,14,14,13,12,53,4,0
457,3/27/2018 1:05,6,17,16,16,55,4,0
458,3/27/2018 1:10,7,20,17,18,62,4,0
459,3/27/2018 1:15,4,21,18,19,62,4,0
460,3/27/2018 1:20,11,19,17,17,64,4,0
461,3/27/2018 1:25,7,18,17,17,59,4,0
462,3/27/2018 1:30,17,24,21,22,84,4,0
463,3/27/2018 1:35,8,16,15,14,53,4,0
464,3/27/2018 1:40,7,18,16,16,57,4,0
465,3/27/2018 1:45,6,17,16,15,54,4,0
466,3/27/2018 1:50,10,20,18,19,67,4,0
467,3/27/2018 1:55,7,21,19,19,66,4,0
468,3/27/2018 2:00,10,26,23,24,83,4,0
469,3/27/2018 2:05,8,16,14,14,52,4,0
470,3/27/2018 2:10,7,17,16,16,56,4,0
471,3/27/2018 2:15,4,17,15,15,51,4,0
472,3/27/2018 2:20,8,16,15,14,53,4,0
473,3/27/2018 2:25,8,23,20,21,72,4,0
474,3/27/2018 2:30,10,14,13,13,50,4,0
475,3/27/2018 2:35,1,18,16,16,51,4,0
476,3/27/2018 2:40,11,22,19,20,72,4,0
477,3/27/2018 2:45,4,21,18,19,62,4,0
478,3/27/2018 2:50,9,18,16,16,59,4,0
479,3/27/2018 2:55,9,15,14,13,51,4,0
480,3/27/2018 3:00,6,18,16,16,56,4,0
481,3/27/2018 3:05,6,23,20,21,70,4,0
482,3/27/2018 3:10,3,19,17,17,56,4,0
483,3/27/2018 3:15,8,23,20,20,71,4,0
484,3/27/2018 3:20,6,22,19,20,67,4,0
485,3/27/2018 3:25,13,26,22,23,84,4,0
486,3/27/2018 3:30,10,26,23,24,83,4,0
487,3/27/2018 3:35,15,31,26,29,101,4,0
488,3/27/2018 3:40,13,29,24,26,92,4,0
489,3/27/2018 3:45,18,35,29,32,114,4,0
490,3/27/2018 3:50,18,33,28,31,110,4,0
491,3/27/2018 3:55,8,25,21,23,77,4,0
492,3/27/2018 4:00,9,26,22,23,80,4,0
493,3/27/2018 4:05,14,30,25,27,96,4,0
494,3/27/2018 4:10,17,33,27,30,107,4,0
495,3/27/2018 4:15,18,33,28,31,110,4,0
496,3/27/2018 4:20,23,38,32,35,128,4,0
497,3/27/2018 4:25,34,49,40,45,168,4,0
498,3/27/2018 4:30,42,55,44,51,192,4,0
499,3/27/2018 4:35,52,64,51,59,226,4,0
500,3/27/2018 4:40,59,70,55,66,250,4,0
501,3/27/2018 4:45,73,82,64,77,296,4,0
502,3/27/2018 4:50,70,79,62,74,285,4,0
503,3/27/2018 4:55,58,69,55,65,247,4,0
504,3/27/2018 5:00,47,60,48,56,211,4,0
505,3/27/2018 5:05,56,67,53,63,239,4,0
506,3/27/2018 5:10,70,80,63,75,288,4,0
507,3/27/2018 5:15,80,88,69,83,320,4,0
508,3/27/2018 5:20,90,98,76,92,356,4,0
509,3/27/2018 5:25,103,109,85,103,400,4,0
510,3/27/2018 5:30,109,114,89,108,420,4,0
511,3/27/2018 5:35,115,120,92,113,440,4,0
512,3/27/2018 5:40,133,136,103,128,500,4,0
513,3/27/2018 5:45,134,137,106,129,506,4,0
514,3/27/2018 5:50,130,133,103,125,491,4,0
515,3/27/2018 5:55,112,116,89,109,426,4,0
516,3/27/2018 6:00,98,105,82,98,383,4,0
517,3/27/2018 6:05,113,116,89,109,427,4,0
518,3/27/2018 6:10,119,124,96,117,456,4,0
519,3/27/2018 6:15,119,124,96,116,455,4,0
520,3/27/2018 6:20,119,124,96,117,456,4,0
521,3/27/2018 6:25,124,128,99,120,471,4,0
522,3/27/2018 6:30,122,126,98,119,465,4,0
523,3/27/2018 6:35,114,119,93,112,438,4,0
524,3/27/2018 6:40,115,120,93,113,441,4,0
525,3/27/2018 6:45,112,118,91,111,432,4,0
526,3/27/2018 6:50,119,123,96,116,454,4,0
527,3/27/2018 6:55,125,128,98,121,472,4,0
528,3/27/2018 7:00,111,117,91,109,428,4,0
529,3/27/2018 7:05,122,124,95,117,458,4,0
530,3/27/2018 7:10,117,122,95,115,449,4,0
531,3/27/2018 7:15,119,124,96,116,455,4,0
532,3/27/2018 7:20,121,125,97,118,461,4,0
533,3/27/2018 7:25,126,130,101,122,479,4,0
534,3/27/2018 7:30,117,122,95,115,449,4,0
535,3/27/2018 7:35,118,123,95,115,451,4,0
536,3/27/2018 7:40,116,121,94,114,445,4,0
537,3/27/2018 7:45,105,111,87,105,408,4,0
538,3/27/2018 7:50,124,128,99,120,471,4,0
539,3/27/2018 7:55,91,98,77,92,358,4,0
540,3/27/2018 8:00,106,112,87,105,410,4,0
541,3/27/2018 8:05,114,119,93,112,438,4,0
542,3/27/2018 8:10,122,126,98,119,465,4,0
543,3/27/2018 8:15,118,122,94,116,450,4,0
544,3/27/2018 8:20,98,105,82,98,383,4,0
545,3/27/2018 8:25,94,101,79,95,369,4,0
546,3/27/2018 8:30,114,119,93,112,438,4,0
547,3/27/2018 8:35,104,109,84,103,400,4,0
548,3/27/2018 8:40,121,124,95,117,457,4,0
549,3/27/2018 8:45,102,107,82,101,392,4,0
550,3/27/2018 8:50,97,103,80,97,377,4,0
551,3/27/2018 8:55,102,108,84,101,395,4,0
552,3/27/2018 9:00,90,97,76,91,354,4,0
553,3/27/2018 9:05,86,94,74,88,342,4,0
554,3/27/2018 9:10,102,107,82,100,391,4,0
555,3/27/2018 9:15,93,100,77,94,364,4,0
556,3/27/2018 9:20,105,111,86,104,406,4,0
557,3/27/2018 9:25,97,104,81,97,379,4,0
558,3/27/2018 9:30,86,94,73,88,341,4,0
559,3/27/2018 9:35,100,105,82,99,386,4,0
560,3/27/2018 9:40,106,111,85,104,406,4,0
561,3/27/2018 9:45,105,110,85,103,403,4,0
562,3/27/2018 9:50,99,105,82,98,384,4,0
563,3/27/2018 9:55,99,104,81,98,382,4,0
564,3/27/2018 10:00,98,105,82,99,384,4,0
565,3/27/2018 10:05,101,106,82,100,389,4,0
566,3/27/2018 10:10,111,115,89,109,424,4,0
567,3/27/2018 10:15,100,105,81,99,385,4,0
568,3/27/2018 10:20,102,109,85,102,398,4,0
569,3/27/2018 10:25,102,107,83,101,393,4,0
570,3/27/2018 10:30,101,107,84,101,393,4,0
571,3/27/2018 10:35,96,103,80,96,375,4,0
572,3/27/2018 10:40,107,113,88,106,414,4,0
573,3/27/2018 10:45,102,108,84,102,396,4,0
574,3/27/2018 10:50,96,102,79,96,373,4,0
575,3/27/2018 10:55,108,114,89,107,418,4,0
576,3/27/2018 11:00,101,107,82,101,391,4,0
577,3/27/2018 11:05,103,109,85,103,400,4,0
578,3/27/2018 11:10,110,115,90,108,423,4,0
579,3/27/2018 11:15,102,108,84,101,395,4,0
580,3/27/2018 11:20,103,110,85,103,401,4,0
581,3/27/2018 11:25,110,115,89,108,422,4,0
582,3/27/2018 11:30,105,110,85,103,403,4,0
583,3/27/2018 11:35,100,105,81,99,385,4,0
584,3/27/2018 11:40,94,102,79,95,370,4,0
585,3/27/2018 11:45,95,101,78,95,369,4,0
586,3/27/2018 11:50,95,102,80,96,373,4,0
587,3/27/2018 11:55,93,100,77,94,364,4,0
588,3/27/2018 12:00,94,101,79,95,369,4,0
589,3/27/2018 12:05,114,118,91,111,434,4,0
590,3/27/2018 12:10,103,109,85,102,399,4,0
591,3/27/2018 12:15,102,109,85,102,398,4,0
592,3/27/2018 12:20,110,115,89,108,422,4,0
593,3/27/2018 12:25,97,102,79,96,374,4,0
594,3/27/2018 12:30,103,108,84,101,396,4,0
595,3/27/2018 12:35,96,102,79,96,373,4,0
596,3/27/2018 12:40,83,91,71,85,330,4,0
597,3/27/2018 12:45,97,104,81,97,379,4,0
598,3/27/2018 12:50,95,102,80,96,373,4,0
599,3/27/2018 12:55,93,99,77,93,362,4,0
600,3/27/2018 13:00,90,96,75,91,352,4,0
601,3/27/2018 13:05,89,96,75,90,350,4,0
602,3/27/2018 13:10,92,98,76,92,358,4,0
603,3/27/2018 13:15,103,108,83,102,396,4,0
604,3/27/2018 13:20,91,97,75,91,354,4,0
605,3/27/2018 13:25,90,96,75,91,352,4,0
606,3/27/2018 13:30,94,100,78,94,366,4,0
607,3/27/2018 13:35,94,102,79,95,370,4,0
608,3/27/2018 13:40,90,98,76,92,356,4,0
609,3/27/2018 13:45,92,100,78,93,363,4,0
610,3/27/2018 13:50,99,105,82,98,384,4,0
611,3/27/2018 13:55,91,98,76,92,357,4,0
612,3/27/2018 14:00,95,101,78,95,369,4,0
613,3/27/2018 14:05,90,96,75,91,352,4,0
614,3/27/2018 14:10,103,108,83,102,396,4,0
615,3/27/2018 14:15,97,104,81,97,379,4,0
616,3/27/2018 14:20,92,99,77,92,360,4,0
617,3/27/2018 14:25,95,101,79,95,370,4,0
618,3/27/2018 14:30,99,105,82,98,384,4,0
619,3/27/2018 14:35,95,101,78,95,369,4,0
620,3/27/2018 14:40,104,109,84,102,399,4,0
621,3/27/2018 14:45,99,106,82,100,387,4,0
622,3/27/2018 14:50,96,102,79,96,373,4,0
623,3/27/2018 14:55,97,103,80,97,377,4,0
624,3/27/2018 15:00,91,99,77,93,360,4,0
625,3/27/2018 15:05,81,89,70,84,324,4,0
626,3/27/2018 15:10,101,106,82,100,389,4,0
627,3/27/2018 15:15,98,104,80,97,379,4,0
628,3/27/2018 15:20,106,110,85,104,405,4,0
629,3/27/2018 15:25,107,111,85,105,408,4,0
630,3/27/2018 15:30,91,99,77,93,360,4,0
631,3/27/2018 15:35,104,109,84,103,400,4,0
632,3/27/2018 15:40,113,116,89,109,427,4,0
633,3/27/2018 15:45,113,117,89,110,429,4,0
634,3/27/2018 15:50,118,121,93,114,446,4,0
635,3/27/2018 15:55,105,111,86,104,406,4,0
636,3/27/2018 16:00,111,117,91,110,429,4,0
637,3/27/2018 16:05,96,103,80,97,376,4,0
638,3/27/2018 16:10,107,113,88,106,414,4,0
639,3/27/2018 16:15,104,110,85,103,402,4,0
640,3/27/2018 16:20,100,105,81,99,385,4,0
641,3/27/2018 16:25,100,105,81,99,385,4,0
642,3/27/2018 16:30,94,101,78,94,367,4,0
643,3/27/2018 16:35,104,109,84,103,400,4,0
644,3/27/2018 16:40,93,99,77,94,363,4,0
645,3/27/2018 16:45,95,103,80,96,374,4,0
646,3/27/2018 16:50,93,99,76,93,361,4,0
647,3/27/2018 16:55,95,102,80,96,373,4,0
648,3/27/2018 17:00,89,96,74,90,349,4,0
649,3/27/2018 17:05,90,97,76,91,354,4,0
650,3/27/2018 17:10,103,109,85,102,399,4,0
651,3/27/2018 17:15,95,102,80,96,373,4,0
652,3/27/2018 17:20,120,124,96,117,457,4,0
653,3/27/2018 17:25,114,119,92,112,437,4,0
654,3/27/2018 17:30,113,118,92,111,434,4,0
655,3/27/2018 17:35,105,112,86,105,408,4,0
656,3/27/2018 17:40,107,112,86,105,410,4,0
657,3/27/2018 17:45,117,122,94,114,447,4,0
658,3/27/2018 17:50,106,112,87,105,410,4,0
659,3/27/2018 17:55,97,102,79,96,374,4,0
660,3/27/2018 18:00,96,102,79,96,373,4,0
661,3/27/2018 18:05,95,102,80,96,373,4,0
662,3/27/2018 18:10,84,93,73,87,337,4,0
663,3/27/2018 18:15,91,99,77,92,359,4,0
664,3/27/2018 18:20,107,111,86,105,409,4,0
665,3/27/2018 18:25,89,97,76,91,353,4,0
666,3/27/2018 18:30,80,89,70,84,323,4,0
667,3/27/2018 18:35,81,90,70,84,325,4,0
668,3/27/2018 18:40,96,102,78,95,371,4,0
669,3/27/2018 18:45,99,106,83,99,387,4,0
670,3/27/2018 18:50,103,108,83,102,396,4,0
671,3/27/2018 18:55,94,100,78,94,366,4,0
672,3/27/2018 19:00,102,108,83,102,395,4,0
673,3/27/2018 19:05,94,100,77,94,365,4,0
674,3/27/2018 19:10,82,91,71,85,329,4,0
675,3/27/2018 19:15,90,97,75,91,353,4,0
676,3/27/2018 19:20,93,99,76,93,361,4,0
677,3/27/2018 19:25,77,86,67,81,311,4,0
678,3/27/2018 19:30,88,95,73,89,345,4,0
679,3/27/2018 19:35,91,99,77,93,360,4,0
680,3/27/2018 19:40,92,98,76,92,358,4,0
681,3/27/2018 19:45,68,78,61,73,280,4,0
682,3/27/2018 19:50,78,86,67,81,312,4,0
683,3/27/2018 19:55,79,88,68,82,317,4,0
684,3/27/2018 20:00,76,84,66,79,305,4,0
685,3/27/2018 20:05,75,85,67,79,306,4,0
686,3/27/2018 20:10,69,79,63,74,285,4,0
687,3/27/2018 20:15,82,90,70,84,326,4,0
688,3/27/2018 20:20,60,71,56,66,253,4,0
689,3/27/2018 20:25,65,75,59,70,269,4,0
690,3/27/2018 20:30,65,76,60,71,272,4,0
691,3/27/2018 20:35,64,75,59,70,268,4,0
692,3/27/2018 20:40,58,69,55,65,247,4,0
693,3/27/2018 20:45,56,68,54,63,241,4,0
694,3/27/2018 20:50,60,71,56,67,254,4,0
695,3/27/2018 20:55,50,62,50,58,220,4,0
696,3/27/2018 21:00,52,64,51,60,227,4,0
697,3/27/2018 21:05,58,70,55,65,248,4,0
698,3/27/2018 21:10,48,60,48,56,212,4,0
699,3/27/2018 21:15,58,69,55,65,247,4,0
700,3/27/2018 21:20,57,68,54,64,243,4,0
701,3/27/2018 21:25,53,64,51,60,228,4,0
702,3/27/2018 21:30,57,69,54,64,244,4,0
703,3/27/2018 21:35,48,61,49,57,215,4,0
704,3/27/2018 21:40,50,62,50,58,220,4,0
705,3/27/2018 21:45,53,65,52,61,231,4,0
706,3/27/2018 21:50,55,66,53,62,236,4,0
707,3/27/2018 21:55,45,58,47,54,204,4,0
708,3/27/2018 22:00,51,64,51,59,225,4,0
709,3/27/2018 22:05,51,63,50,58,222,4,0
710,3/27/2018 22:10,49,62,50,58,219,4,0
711,3/27/2018 22:15,49,62,49,58,218,4,0
712,3/27/2018 22:20,46,59,47,55,207,4,0
713,3/27/2018 22:25,43,56,45,52,196,4,0
714,3/27/2018 22:30,31,46,37,43,157,4,0
715,3/27/2018 22:35,37,51,41,47,176,4,0
716,3/27/2018 22:40,38,52,42,48,180,4,0
717,3/27/2018 22:45,31,46,37,42,156,4,0
718,3/27/2018 22:50,24,39,32,36,131,4,0
719,3/27/2018 22:55,35,49,40,45,169,4,0
720,3/27/2018 23:00,31,45,37,42,155,4,0
721,3/27/2018 23:05,27,42,35,39,143,4,0
722,3/27/2018 23:10,29,44,36,41,150,4,0
723,3/27/2018 23:15,28,43,35,40,146,4,0
724,3/27/2018 23:20,27,41,34,38,140,4,0
725,3/27/2018 23:25,30,45,36,41,152,4,0
726,3/27/2018 23:30,17,33,27,30,107,4,0
727,3/27/2018 23:35,22,37,31,34,124,4,0
728,3/27/2018 23:40,21,36,30,34,121,4,0
729,3/27/2018 23:45,22,37,30,34,123,4,0
730,3/27/2018 23:50,21,36,30,34,121,4,0
731,3/27/2018 23:55,21,36,30,33,120,4,0
732,3/28/2018 0:00,11,28,24,25,88,4,0
733,3/28/2018 0:05,13,30,26,28,97,4,0
734,3/28/2018 0:10,13,29,25,27,94,4,0
735,3/28/2018 0:15,10,27,23,25,85,4,0
736,3/28/2018 0:20,16,32,27,29,104,4,0
737,3/28/2018 0:25,12,27,23,25,87,4,0
738,3/28/2018 0:30,20,37,31,34,122,4,0
739,3/28/2018 0:35,15,32,27,29,103,4,0
740,3/28/2018 0:40,10,19,17,17,63,4,0
741,3/28/2018 0:45,11,29,25,26,91,4,0
742,3/28/2018 0:50,9,25,22,22,78,4,0
743,3/28/2018 0:55,10,20,18,18,66,4,0
744,3/28/2018 1:00,6,22,20,20,68,4,0
745,3/28/2018 1:05,6,18,16,16,56,4,0
746,3/28/2018 1:10,10,16,15,14,55,4,0
747,3/28/2018 1:15,5,21,19,19,64,4,0
748,3/28/2018 1:20,7,24,20,21,72,4,0
749,3/28/2018 1:25,4,20,17,18,59,4,0
750,3/28/2018 1:30,8,15,14,13,50,4,0
751,3/28/2018 1:35,10,23,20,21,74,4,0
752,3/28/2018 1:40,6,21,19,19,65,4,0
753,3/28/2018 1:45,9,19,17,17,62,4,0
754,3/28/2018 1:50,11,16,15,15,57,4,0
755,3/28/2018 1:55,4,20,18,18,60,4,0
756,3/28/2018 2:00,11,26,22,23,82,4,0
757,3/28/2018 2:05,9,18,17,16,60,4,0
758,3/28/2018 2:10,10,19,17,17,63,4,0
759,3/28/2018 2:15,5,20,18,18,61,4,0
760,3/28/2018 2:20,5,18,16,16,55,4,0
761,3/28/2018 2:25,8,23,20,20,71,4,0
762,3/28/2018 2:30,6,18,16,16,56,4,0
763,3/28/2018 2:35,11,16,15,15,57,4,0
764,3/28/2018 2:40,12,20,18,18,68,4,0
765,3/28/2018 2:45,9,16,15,14,54,4,0
766,3/28/2018 2:50,6,18,16,16,56,4,0
767,3/28/2018 2:55,14,13,13,12,52,4,0
768,3/28/2018 3:00,5,17,16,16,54,4,0
769,3/28/2018 3:05,7,20,18,18,63,4,0
770,3/28/2018 3:10,5,19,18,18,60,4,0
771,3/28/2018 3:15,8,23,20,20,71,4,0
772,3/28/2018 3:20,14,25,22,23,84,4,0
773,3/28/2018 3:25,6,24,22,22,74,4,0
774,3/28/2018 3:30,15,32,27,29,103,4,0
775,3/28/2018 3:35,9,25,22,23,79,4,0
776,3/28/2018 3:40,12,28,24,26,90,4,0
777,3/28/2018 3:45,18,34,28,31,111,4,0
778,3/28/2018 3:50,12,28,24,26,90,4,0
779,3/28/2018 3:55,14,30,25,28,97,4,0
780,3/28/2018 4:00,20,29,25,27,101,4,0
781,3/28/2018 4:05,20,35,29,33,117,4,0
782,3/28/2018 4:10,11,27,23,25,86,4,0
783,3/28/2018 4:15,22,37,31,34,124,4,0
784,3/28/2018 4:20,25,40,33,37,135,4,0
785,3/28/2018 4:25,25,40,33,37,135,4,0
786,3/28/2018 4:30,38,52,42,48,180,4,0
787,3/28/2018 4:35,41,54,44,50,189,4,0
788,3/28/2018 4:40,54,65,52,61,232,4,0
789,3/28/2018 4:45,59,70,56,66,251,4,0
790,3/28/2018 4:50,67,77,61,72,277,4,0
791,3/28/2018 4:55,54,66,52,61,233,4,0
792,3/28/2018 5:00,46,59,47,55,207,4,0
793,3/28/2018 5:05,57,69,54,64,244,4,0
794,3/28/2018 5:10,73,82,64,77,296,4,0
795,3/28/2018 5:15,73,83,65,78,299,4,0
796,3/28/2018 5:20,83,91,72,86,332,4,0
797,3/28/2018 5:25,102,108,84,102,396,4,0
798,3/28/2018 5:30,106,112,87,105,410,4,0
799,3/28/2018 5:35,116,121,94,114,445,4,0
800,3/28/2018 5:40,132,135,103,127,497,4,0
801,3/28/2018 5:45,121,125,97,118,461,4,0
802,3/28/2018 5:50,119,123,96,116,454,4,0
803,3/28/2018 5:55,97,104,81,98,380,4,0
804,3/28/2018 6:00,88,96,75,90,349,4,0
805,3/28/2018 6:05,98,104,80,98,380,4,0
806,3/28/2018 6:10,103,109,85,102,399,4,0
807,3/28/2018 6:15,121,125,96,118,460,4,0
808,3/28/2018 6:20,118,122,94,115,449,4,0
809,3/28/2018 6:25,122,126,98,119,465,4,0
810,3/28/2018 6:30,122,126,98,119,465,4,0
811,3/28/2018 6:35,119,124,96,116,455,4,0
812,3/28/2018 6:40,128,132,102,124,486,4,0
813,3/28/2018 6:45,111,117,91,110,429,4,0
814,3/28/2018 6:50,118,123,95,115,451,4,0
815,3/28/2018 6:55,124,128,99,120,471,4,0
816,3/28/2018 7:00,121,125,96,118,460,4,0
817,3/28/2018 7:05,125,127,98,120,470,4,0
818,3/28/2018 7:10,113,118,92,111,434,4,0
819,3/28/2018 7:15,116,119,91,112,438,4,0
820,3/28/2018 7:20,120,125,97,117,459,4,0
821,3/28/2018 7:25,103,109,85,102,399,4,0
822,3/28/2018 7:30,101,108,84,101,394,4,0
823,3/28/2018 7:35,105,111,87,104,407,4,0
824,3/28/2018 7:40,120,125,97,117,459,4,0
825,3/28/2018 7:45,111,116,91,109,427,4,0
826,3/28/2018 7:50,113,118,92,111,434,4,0
827,3/28/2018 7:55,113,118,92,111,434,4,0
828,3/28/2018 8:00,118,123,94,115,450,4,0
829,3/28/2018 8:05,117,121,93,114,445,4,0
830,3/28/2018 8:10,103,109,85,102,399,4,0
831,3/28/2018 8:15,94,101,79,95,369,4,0
832,3/28/2018 8:20,81,90,70,84,325,4,0
833,3/28/2018 8:25,82,90,71,85,328,4,0
834,3/28/2018 8:30,99,106,83,100,388,4,0
835,3/28/2018 8:35,96,103,79,96,374,4,0
836,3/28/2018 8:40,92,99,78,93,362,4,0
837,3/28/2018 8:45,102,109,85,102,398,4,0
838,3/28/2018 8:50,119,124,96,116,455,4,0
839,3/28/2018 8:55,109,114,89,106,418,4,0
840,3/28/2018 9:00,86,94,73,88,341,4,0
841,3/28/2018 9:05,93,99,77,93,362,4,0
842,3/28/2018 9:10,104,108,84,102,398,4,0
843,3/28/2018 9:15,85,92,72,87,336,4,0
844,3/28/2018 9:20,84,92,71,86,333,4,0
845,3/28/2018 9:25,112,117,90,110,429,4,0
846,3/28/2018 9:30,97,103,80,97,377,4,0
847,3/28/2018 9:35,105,110,86,104,405,4,0
848,3/28/2018 9:40,107,113,87,106,413,4,0
849,3/28/2018 9:45,104,110,85,104,403,4,0
850,3/28/2018 9:50,106,112,87,105,410,4,0
851,3/28/2018 9:55,110,114,88,108,420,4,0
852,3/28/2018 10:00,104,111,86,104,405,4,0
853,3/28/2018 10:05,100,106,81,99,386,4,0
854,3/28/2018 10:10,94,101,79,95,369,4,0
855,3/28/2018 10:15,89,97,76,91,353,4,0
856,3/28/2018 10:20,88,95,74,89,346,4,0
857,3/28/2018 10:25,88,96,75,90,349,4,0
858,3/28/2018 10:30,107,111,85,104,407,4,0
859,3/28/2018 10:35,100,105,81,99,385,4,0
860,3/28/2018 10:40,87,94,73,89,343,4,0
861,3/28/2018 10:45,88,95,74,90,347,4,0
862,3/28/2018 10:50,88,95,73,89,345,4,0
863,3/28/2018 10:55,85,93,73,87,338,4,0
864,3/28/2018 11:00,98,104,82,98,382,4,0
865,3/28/2018 11:05,94,100,77,94,365,4,0
866,3/28/2018 11:10,99,104,81,98,382,4,0
867,3/28/2018 11:15,90,97,75,91,353,4,0
868,3/28/2018 11:20,99,104,81,98,382,4,0
869,3/28/2018 11:25,99,104,81,98,382,4,0
870,3/28/2018 11:30,103,108,84,102,397,4,0
871,3/28/2018 11:35,108,113,87,106,414,4,0
872,3/28/2018 11:40,92,99,77,93,361,4,0
873,3/28/2018 11:45,92,98,77,93,360,4,0
874,3/28/2018 11:50,85,92,72,86,335,4,0
875,3/28/2018 11:55,88,95,74,89,346,4,0
876,3/28/2018 12:00,83,91,71,85,330,4,0
877,3/28/2018 12:05,80,88,69,83,320,4,0
878,3/28/2018 12:10,91,99,77,92,359,4,0
879,3/28/2018 12:15,102,107,83,101,393,4,0
880,3/28/2018 12:20,108,114,89,107,418,4,0
881,3/28/2018 12:25,107,113,88,106,414,4,0
882,3/28/2018 12:30,102,109,85,102,398,4,0
883,3/28/2018 12:35,115,120,93,113,441,4,0
884,3/28/2018 12:40,116,120,93,113,442,4,0
885,3/28/2018 12:45,100,106,83,100,389,4,0
886,3/28/2018 12:50,102,108,84,101,395,4,0
887,3/28/2018 12:55,97,103,80,97,377,4,0
888,3/28/2018 13:00,94,101,79,95,369,4,0
889,3/28/2018 13:05,91,99,77,92,359,4,0
890,3/28/2018 13:10,96,103,80,96,375,4,0
891,3/28/2018 13:15,102,108,84,101,395,4,0
892,3/28/2018 13:20,100,107,83,100,390,4,0
893,3/28/2018 13:25,95,101,79,95,370,4,0
894,3/28/2018 13:30,92,99,78,93,362,4,0
895,3/28/2018 13:35,112,116,89,109,426,4,0
896,3/28/2018 13:40,103,108,83,102,396,4,0
897,3/28/2018 13:45,104,109,84,102,399,4,0
898,3/28/2018 13:50,105,110,85,103,403,4,0
899,3/28/2018 13:55,94,101,79,94,368,4,0
900,3/28/2018 14:00,96,102,79,96,373,4,0
901,3/28/2018 14:05,102,107,83,101,393,4,0
902,3/28/2018 14:10,90,97,75,91,353,4,0
903,3/28/2018 14:15,111,116,90,109,426,4,0
904,3/28/2018 14:20,104,109,84,103,400,4,0
905,3/28/2018 14:25,88,96,75,90,349,4,0
906,3/28/2018 14:30,102,107,83,101,393,4,0
907,3/28/2018 14:35,104,108,84,102,398,4,0
908,3/28/2018 14:40,106,110,85,104,405,4,0
909,3/28/2018 14:45,96,102,79,96,373,4,0
910,3/28/2018 14:50,111,115,88,108,422,4,0
911,3/28/2018 14:55,94,100,77,94,365,4,0
912,3/28/2018 15:00,96,102,79,96,373,4,0
913,3/28/2018 15:05,98,105,82,99,384,4,0
914,3/28/2018 15:10,90,97,75,91,353,4,0
915,3/28/2018 15:15,81,90,71,84,326,4,0
916,3/28/2018 15:20,92,99,77,93,361,4,0
917,3/28/2018 15:25,97,104,80,98,379,4,0
918,3/28/2018 15:30,95,101,78,95,369,4,0
919,3/28/2018 15:35,100,105,81,99,385,4,0
920,3/28/2018 15:40,103,110,85,103,401,4,0
921,3/28/2018 15:45,98,104,81,98,381,4,0
922,3/28/2018 15:50,95,102,79,96,372,4,0
923,3/28/2018 15:55,102,109,85,102,398,4,0
924,3/28/2018 16:00,99,106,81,99,385,4,0
925,3/28/2018 16:05,82,90,70,85,327,4,0
926,3/28/2018 16:10,101,106,82,100,389,4,0
927,3/28/2018 16:15,90,98,77,92,357,4,0
928,3/28/2018 16:20,75,84,66,78,303,4,0
929,3/28/2018 16:25,79,88,69,82,318,4,0
930,3/28/2018 16:30,104,110,85,103,402,4,0
931,3/28/2018 16:35,106,110,85,104,405,4,0
932,3/28/2018 16:40,113,117,90,110,430,4,0
933,3/28/2018 16:45,97,104,80,98,379,4,0
934,3/28/2018 16:50,112,117,90,110,429,4,0
935,3/28/2018 16:55,96,102,79,96,373,4,0
936,3/28/2018 17:00,111,115,89,108,423,4,0
937,3/28/2018 17:05,108,114,88,107,417,4,0
938,3/28/2018 17:10,110,116,89,109,424,4,0
939,3/28/2018 17:15,106,112,87,105,410,4,0
940,3/28/2018 17:20,102,108,83,101,394,4,0
941,3/28/2018 17:25,101,106,82,100,389,4,0
942,3/28/2018 17:30,92,99,76,93,360,4,0
943,3/28/2018 17:35,92,98,76,92,358,4,0
944,3/28/2018 17:40,95,102,79,96,372,4,0
945,3/28/2018 17:45,94,102,79,95,370,4,0
946,3/28/2018 17:50,91,99,77,93,360,4,0
947,3/28/2018 17:55,91,98,77,92,358,4,0
948,3/28/2018 18:00,97,103,79,97,376,4,0
949,3/28/2018 18:05,97,102,79,96,374,4,0
950,3/28/2018 18:10,95,102,80,96,373,4,0
951,3/28/2018 18:15,106,111,86,104,407,4,0
952,3/28/2018 18:20,107,111,86,105,409,4,0
953,3/28/2018 18:25,103,109,85,102,399,4,0
954,3/28/2018 18:30,95,101,78,95,369,4,0
955,3/28/2018 18:35,107,113,87,106,413,4,0
956,3/28/2018 18:40,107,113,87,106,413,4,0
957,3/28/2018 18:45,86,93,72,88,339,4,0
958,3/28/2018 18:50,90,97,75,91,353,4,0
959,3/28/2018 18:55,83,90,70,85,328,4,0
960,3/28/2018 19:00,82,90,71,85,328,4,0
961,3/28/2018 19:05,82,91,71,85,329,4,0
962,3/28/2018 19:10,83,91,71,85,330,4,0
963,3/28/2018 19:15,84,92,71,86,333,4,0
964,3/28/2018 19:20,82,90,70,84,326,4,0
965,3/28/2018 19:25,82,90,70,84,326,4,0
966,3/28/2018 19:30,84,91,71,86,332,4,0
967,3/28/2018 19:35,89,96,75,90,350,4,0
968,3/28/2018 19:40,92,98,76,93,359,4,0
969,3/28/2018 19:45,72,81,64,76,293,4,0
970,3/28/2018 19:50,94,100,78,94,366,4,0
971,3/28/2018 19:55,89,96,75,90,350,4,0
972,3/28/2018 20:00,80,89,70,83,322,4,0
973,3/28/2018 20:05,92,99,78,93,362,4,0
974,3/28/2018 20:10,76,85,67,80,308,4,0
975,3/28/2018 20:15,86,93,73,88,340,4,0
976,3/28/2018 20:20,89,96,75,90,350,4,0
977,3/28/2018 20:25,90,96,75,91,352,4,0
978,3/28/2018 20:30,82,90,70,84,326,4,0
979,3/28/2018 20:35,71,81,63,76,291,4,0
980,3/28/2018 20:40,64,74,59,70,267,4,0
981,3/28/2018 20:45,70,80,63,75,288,4,0
982,3/28/2018 20:50,59,71,56,66,252,4,0
983,3/28/2018 20:55,66,76,60,71,273,4,0
984,3/28/2018 21:00,47,59,47,55,208,4,0
985,3/28/2018 21:05,53,65,51,60,229,4,0
986,3/28/2018 21:10,51,63,50,59,223,4,0
987,3/28/2018 21:15,52,64,51,60,227,4,0
988,3/28/2018 21:20,66,76,60,71,273,4,0
989,3/28/2018 21:25,50,62,49,58,219,4,0
990,3/28/2018 21:30,53,65,52,61,231,4,0
991,3/28/2018 21:35,49,62,49,57,217,4,0
992,3/28/2018 21:40,58,69,55,64,246,4,0
993,3/28/2018 21:45,50,62,49,58,219,4,0
994,3/28/2018 21:50,44,57,45,53,199,4,0
995,3/28/2018 21:55,44,57,45,53,199,4,0
996,3/28/2018 22:00,43,56,45,53,197,4,0
997,3/28/2018 22:05,43,56,45,52,196,4,0
998,3/28/2018 22:10,30,45,37,41,153,4,0
999,3/28/2018 22:15,54,66,52,61,233,4,0
1000,3/28/2018 22:20,45,58,46,54,203,4,0
1001,3/28/2018 22:25,45,57,46,54,202,4,0
1002,3/28/2018 22:30,35,49,39,45,168,4,0
1003,3/28/2018 22:35,36,50,41,46,173,4,0
1004,3/28/2018 22:40,44,57,45,53,199,4,0
1005,3/28/2018 22:45,42,55,45,51,193,4,0
1006,3/28/2018 22:50,38,52,42,48,180,4,0
1007,3/28/2018 22:55,29,44,36,41,150,4,0
1008,3/28/2018 23:00,35,50,40,46,171,4,0
1009,3/28/2018 23:05,23,38,31,35,127,4,0
1010,3/28/2018 23:10,25,40,33,37,135,4,0
1011,3/28/2018 23:15,29,44,36,40,149,4,0
1012,3/28/2018 23:20,25,40,33,37,135,4,0
1013,3/28/2018 23:25,23,38,31,35,127,4,0
1014,3/28/2018 23:30,24,40,33,36,133,4,0
1015,3/28/2018 23:35,30,45,37,42,154,4,0
1016,3/28/2018 23:40,22,38,31,35,126,4,0
1017,3/28/2018 23:45,28,43,35,40,146,4,0
1018,3/28/2018 23:50,22,38,32,35,127,4,0
1019,3/28/2018 23:55,22,38,32,35,127,4,0
1020,3/29/2018 0:00,16,32,27,29,104,4,0
1021,3/29/2018 0:05,16,33,28,30,107,4,0
1022,3/29/2018 0:10,13,29,24,27,93,4,0
1023,3/29/2018 0:15,15,32,27,29,103,4,0
1024,3/29/2018 0:20,14,28,24,26,92,4,0
1025,3/29/2018 0:25,17,33,27,30,107,4,0
1026,3/29/2018 0:30,10,27,23,24,84,4,0
1027,3/29/2018 0:35,10,27,23,25,85,4,0
1028,3/29/2018 0:40,9,25,22,23,79,4,0
1029,3/29/2018 0:45,9,27,23,25,84,4,0
1030,3/29/2018 0:50,4,21,19,19,63,4,0
1031,3/29/2018 0:55,6,21,19,19,65,4,0
1032,3/29/2018 1:00,7,24,21,22,74,4,0
1033,3/29/2018 1:05,6,23,20,21,70,4,0
1034,3/29/2018 1:10,11,20,17,18,66,4,0
1035,3/29/2018 1:15,3,20,18,19,60,4,0
1036,3/29/2018 1:20,11,29,25,26,91,4,0
1037,3/29/2018 1:25,8,16,15,14,53,4,0
1038,3/29/2018 1:30,6,21,18,19,64,4,0
1039,3/29/2018 1:35,10,24,21,22,77,4,0
1040,3/29/2018 1:40,9,20,18,18,65,4,0
1041,3/29/2018 1:45,11,22,20,21,74,4,0
1042,3/29/2018 1:50,14,14,14,13,55,4,0
1043,3/29/2018 1:55,4,18,16,16,54,4,0
1044,3/29/2018 2:00,9,24,22,22,77,4,0
1045,3/29/2018 2:05,7,24,21,22,74,4,0
1046,3/29/2018 2:10,6,20,18,18,62,4,0
1047,3/29/2018 2:15,7,18,17,17,59,4,0
1048,3/29/2018 2:20,6,16,15,15,52,4,0
1049,3/29/2018 2:25,7,20,18,18,63,4,0
1050,3/29/2018 2:30,3,19,17,18,57,4,0
1051,3/29/2018 2:35,4,18,16,16,54,4,0
1052,3/29/2018 2:40,13,21,19,19,72,4,0
1053,3/29/2018 2:45,8,18,16,16,58,4,0
1054,3/29/2018 2:50,7,22,19,20,68,4,0
1055,3/29/2018 2:55,7,19,17,17,60,4,0
1056,3/29/2018 3:00,6,21,19,19,65,4,0
1057,3/29/2018 3:05,7,22,19,20,68,4,0
1058,3/29/2018 3:10,5,22,19,20,66,4,0
1059,3/29/2018 3:15,4,21,19,19,63,4,0
1060,3/29/2018 3:20,5,21,19,19,64,4,0
1061,3/29/2018 3:25,6,22,20,20,68,4,0
1062,3/29/2018 3:30,11,28,24,26,89,4,0
1063,3/29/2018 3:35,14,30,25,27,96,4,0
1064,3/29/2018 3:40,14,30,25,28,97,4,0
1065,3/29/2018 3:45,19,36,30,33,118,4,0
1066,3/29/2018 3:50,20,36,30,33,119,4,0
1067,3/29/2018 3:55,12,29,24,26,91,4,0
1068,3/29/2018 4:00,11,27,23,25,86,4,0
1069,3/29/2018 4:05,16,28,24,26,94,4,0
1070,3/29/2018 4:10,12,28,24,26,90,4,0
1071,3/29/2018 4:15,23,38,31,35,127,4,0
1072,3/29/2018 4:20,20,35,29,32,116,4,0
1073,3/29/2018 4:25,36,50,40,46,172,4,0
1074,3/29/2018 4:30,31,45,37,42,155,4,0
1075,3/29/2018 4:35,45,57,46,53,201,4,0
1076,3/29/2018 4:40,49,61,49,57,216,4,0
1077,3/29/2018 4:45,63,73,58,68,262,4,0
1078,3/29/2018 4:50,69,79,62,74,284,4,0
1079,3/29/2018 4:55,56,67,53,63,239,4,0
1080,3/29/2018 5:00,53,64,51,60,228,4,0
1081,3/29/2018 5:05,60,71,56,66,253,4,0
1082,3/29/2018 5:10,55,66,53,62,236,4,0
1083,3/29/2018 5:15,68,78,61,73,280,4,0
1084,3/29/2018 5:20,83,92,72,86,333,4,0
1085,3/29/2018 5:25,93,99,77,94,363,4,0
1086,3/29/2018 5:30,105,110,84,103,402,4,0
1087,3/29/2018 5:35,115,120,92,113,440,4,0
1088,3/29/2018 5:40,139,140,106,132,517,4,0
1089,3/29/2018 5:45,131,132,100,125,488,4,0
1090,3/29/2018 5:50,108,114,88,107,417,4,0
1091,3/29/2018 5:55,107,113,88,106,414,4,0
1092,3/29/2018 6:00,96,103,81,97,377,4,0
1093,3/29/2018 6:05,98,105,82,99,384,4,0
1094,3/29/2018 6:10,111,115,88,108,422,4,0
1095,3/29/2018 6:15,108,113,88,106,415,4,0
1096,3/29/2018 6:20,120,124,96,117,457,4,0
1097,3/29/2018 6:25,117,121,94,114,446,4,0
1098,3/29/2018 6:30,119,124,96,116,455,4,0
1099,3/29/2018 6:35,119,124,96,116,455,4,0
1100,3/29/2018 6:40,111,117,91,110,429,4,0
1101,3/29/2018 6:45,113,118,92,111,434,4,0
1102,3/29/2018 6:50,115,120,93,113,441,4,0
1103,3/29/2018 6:55,110,115,90,108,423,4,0
1104,3/29/2018 7:00,105,111,87,105,408,4,0
1105,3/29/2018 7:05,112,117,91,110,430,4,0
1106,3/29/2018 7:10,105,111,86,104,406,4,0
1107,3/29/2018 7:15,110,116,90,109,425,4,0
1108,3/29/2018 7:20,113,118,92,111,434,4,0
1109,3/29/2018 7:25,107,113,88,106,414,4,0
1110,3/29/2018 7:30,109,115,89,108,421,4,0
1111,3/29/2018 7:35,116,121,94,113,444,4,0
1112,3/29/2018 7:40,113,118,92,111,434,4,0
1113,3/29/2018 7:45,114,119,92,112,437,4,0
1114,3/29/2018 7:50,114,119,93,112,438,4,0
1115,3/29/2018 7:55,113,118,90,111,432,4,0
1116,3/29/2018 8:00,105,111,87,105,408,4,0
1117,3/29/2018 8:05,99,106,82,99,386,4,0
1118,3/29/2018 8:10,107,113,88,106,414,4,0
1119,3/29/2018 8:15,110,115,90,108,423,4,0
1120,3/29/2018 8:20,107,113,88,106,414,4,0
1121,3/29/2018 8:25,115,119,92,112,438,4,0
1122,3/29/2018 8:30,107,111,86,105,409,4,0
1123,3/29/2018 8:35,110,115,89,109,423,4,0
1124,3/29/2018 8:40,107,113,88,106,414,4,0
1125,3/29/2018 8:45,104,108,84,102,398,4,0
1126,3/29/2018 8:50,95,101,78,95,369,4,0
1127,3/29/2018 8:55,103,109,85,102,399,4,0
1128,3/29/2018 9:00,103,107,83,101,394,4,0
1129,3/29/2018 9:05,105,109,84,103,401,4,0
1130,3/29/2018 9:10,94,101,79,95,369,4,0
1131,3/29/2018 9:15,115,118,91,111,435,4,0
1132,3/29/2018 9:20,99,105,81,99,384,4,0
1133,3/29/2018 9:25,103,108,83,102,396,4,0
1134,3/29/2018 9:30,84,92,72,86,334,4,0
1135,3/29/2018 9:35,87,94,73,88,342,4,0
1136,3/29/2018 9:40,93,99,77,93,362,4,0
1137,3/29/2018 9:45,102,109,85,102,398,4,0
1138,3/29/2018 9:50,99,104,81,98,382,4,0
1139,3/29/2018 9:55,100,106,82,99,387,4,0
1140,3/29/2018 10:00,90,97,76,91,354,4,0
1141,3/29/2018 10:05,107,112,86,105,410,4,0
1142,3/29/2018 10:10,94,100,77,94,365,4,0
1143,3/29/2018 10:15,85,93,73,87,338,4,0
1144,3/29/2018 10:20,92,99,77,93,361,4,0
1145,3/29/2018 10:25,84,91,71,86,332,4,0
1146,3/29/2018 10:30,95,101,79,95,370,4,0
1147,3/29/2018 10:35,97,102,79,96,374,4,0
1148,3/29/2018 10:40,96,102,79,96,373,4,0
1149,3/29/2018 10:45,91,97,76,92,356,4,0
1150,3/29/2018 10:50,95,101,78,95,369,4,0
1151,3/29/2018 10:55,84,91,71,86,332,4,0
1152,3/29/2018 11:00,107,111,86,105,409,4,0
1153,3/29/2018 11:05,102,107,83,101,393,4,0
1154,3/29/2018 11:10,98,105,82,99,384,4,0
1155,3/29/2018 11:15,95,101,79,95,370,4,0
1156,3/29/2018 11:20,95,101,78,95,369,4,0
1157,3/29/2018 11:25,97,104,81,97,379,4,0
1158,3/29/2018 11:30,88,96,75,90,349,4,0
1159,3/29/2018 11:35,80,88,69,83,320,4,0
1160,3/29/2018 11:40,95,101,78,95,369,4,0
1161,3/29/2018 11:45,105,111,86,104,406,4,0
1162,3/29/2018 11:50,110,115,89,108,422,4,0
1163,3/29/2018 11:55,90,98,76,91,355,4,0
1164,3/29/2018 12:00,100,106,83,100,389,4,0
1165,3/29/2018 12:05,109,115,89,108,421,4,0
1166,3/29/2018 12:10,103,108,84,102,397,4,0
1167,3/29/2018 12:15,95,101,78,95,369,4,0
1168,3/29/2018 12:20,115,119,91,112,437,4,0
1169,3/29/2018 12:25,98,105,82,98,383,4,0
1170,3/29/2018 12:30,102,108,84,102,396,4,0
1171,3/29/2018 12:35,110,116,90,109,425,4,0
1172,3/29/2018 12:40,108,113,88,106,415,4,0
1173,3/29/2018 12:45,102,107,83,101,393,4,0
1174,3/29/2018 12:50,101,107,82,101,391,4,0
1175,3/29/2018 12:55,97,104,81,97,379,4,0
1176,3/29/2018 13:00,98,104,81,98,381,4,0
1177,3/29/2018 13:05,106,112,87,105,410,4,0
1178,3/29/2018 13:10,101,107,82,100,390,4,0
1179,3/29/2018 13:15,102,107,82,100,391,4,0
1180,3/29/2018 13:20,95,102,79,96,372,4,0
1181,3/29/2018 13:25,95,101,78,95,369,4,0
1182,3/29/2018 13:30,49,61,49,57,216,4,0
1183,3/29/2018 13:35,14,11,11,9,45,4,0
1184,3/29/2018 13:40,94,100,78,94,366,4,0
1185,3/29/2018 13:45,93,99,77,93,362,4,0
1186,3/29/2018 13:50,89,96,74,90,349,4,0
1187,3/29/2018 13:55,97,103,79,97,376,4,0
1188,3/29/2018 14:00,106,112,87,105,410,4,0
1189,3/29/2018 14:05,108,112,87,106,413,4,0
1190,3/29/2018 14:10,100,105,81,99,385,4,0
1191,3/29/2018 14:15,94,100,77,94,365,4,0
1192,3/29/2018 14:20,94,100,78,94,366,4,0
1193,3/29/2018 14:25,96,103,80,96,375,4,0
1194,3/29/2018 14:30,97,103,80,97,377,4,0
1195,3/29/2018 14:35,107,111,86,105,409,4,0
1196,3/29/2018 14:40,94,101,79,95,369,4,0
1197,3/29/2018 14:45,97,104,81,97,379,4,0
1198,3/29/2018 14:50,88,96,75,90,349,4,0
1199,3/29/2018 14:55,92,99,78,93,362,4,0
1200,3/29/2018 15:00,97,104,81,97,379,4,0
1201,3/29/2018 15:05,92,99,76,93,360,4,0
1202,3/29/2018 15:10,90,97,75,91,353,4,0
1203,3/29/2018 15:15,98,105,81,98,382,4,0
1204,3/29/2018 15:20,92,98,76,92,358,4,0
1205,3/29/2018 15:25,100,105,81,99,385,4,0
1206,3/29/2018 15:30,92,100,78,94,364,4,0
1207,3/29/2018 15:35,107,112,86,105,410,4,0
1208,3/29/2018 15:40,114,119,92,112,437,4,0
1209,3/29/2018 15:45,99,105,81,98,383,4,0
1210,3/29/2018 15:50,112,115,89,109,425,4,0
1211,3/29/2018 15:55,95,101,78,95,369,4,0
1212,3/29/2018 16:00,91,99,77,92,359,4,0
1213,3/29/2018 16:05,92,98,76,92,358,4,0
1214,3/29/2018 16:10,102,106,82,100,390,4,0
1215,3/29/2018 16:15,113,118,92,111,434,4,0
1216,3/29/2018 16:20,97,104,81,97,379,4,0
1217,3/29/2018 16:25,91,99,77,93,360,4,0
1218,3/29/2018 16:30,108,112,86,105,411,4,0
1219,3/29/2018 16:35,103,108,83,101,395,4,0
1220,3/29/2018 16:40,109,115,89,108,421,4,0
1221,3/29/2018 16:45,104,109,84,103,400,4,0
1222,3/29/2018 16:50,110,114,88,108,420,4,0
1223,3/29/2018 16:55,98,104,82,98,382,4,0
1224,3/29/2018 17:00,98,105,82,99,384,4,0
1225,3/29/2018 17:05,101,108,84,101,394,4,0
1226,3/29/2018 17:10,104,109,83,102,398,4,0
1227,3/29/2018 17:15,101,106,81,100,388,4,0
1228,3/29/2018 17:20,105,111,86,104,406,4,0
1229,3/29/2018 17:25,96,103,81,97,377,4,0
1230,3/29/2018 17:30,89,97,76,91,353,4,0
1231,3/29/2018 17:35,101,108,83,101,393,4,0
1232,3/29/2018 17:40,85,94,73,88,340,4,0
1233,3/29/2018 17:45,89,97,76,91,353,4,0
1234,3/29/2018 17:50,71,103,91,75,340,4,0
1235,3/29/2018 17:55,69,100,88,72,329,4,0
1236,3/29/2018 18:00,67,97,86,70,320,4,0
1237,3/29/2018 18:05,67,97,86,70,320,4,0
1238,3/29/2018 18:10,67,97,86,70,320,4,0
1239,3/29/2018 18:15,66,96,85,70,317,4,0
1240,3/29/2018 18:20,67,97,86,70,320,4,0
1241,3/29/2018 18:25,64,93,83,68,308,4,0
1242,3/29/2018 18:30,63,92,81,66,302,4,0
1243,3/29/2018 18:35,62,90,79,65,296,4,0
1244,3/29/2018 18:40,60,87,77,63,287,4,0
1245,3/29/2018 18:45,59,86,76,62,283,4,0
1246,3/29/2018 18:50,57,83,73,60,273,4,0
1247,3/29/2018 18:55,55,80,71,58,264,4,0
1248,3/29/2018 19:00,55,79,70,57,261,4,0
1249,3/29/2018 19:05,54,78,69,56,257,4,0
1250,3/29/2018 19:10,54,79,70,57,260,4,0
1251,3/29/2018 19:15,51,75,66,54,246,4,0
1252,3/29/2018 19:20,50,73,64,52,239,4,0
1253,3/29/2018 19:25,48,70,62,51,231,4,0
1254,3/29/2018 19:30,47,68,60,49,224,4,0
1255,3/29/2018 19:35,46,67,59,48,220,4,0
1256,3/29/2018 19:40,45,66,58,48,217,4,0
1257,3/29/2018 19:45,43,63,55,45,206,4,0
1258,3/29/2018 19:50,42,61,54,44,201,4,0
1259,3/29/2018 19:55,40,58,51,42,191,4,0
1260,3/29/2018 20:00,40,57,51,41,189,4,0
1261,3/29/2018 20:05,38,56,49,40,183,4,0
1262,3/29/2018 20:10,38,55,49,40,182,4,0
1263,3/29/2018 20:15,38,55,48,40,181,4,0
1264,3/29/2018 20:20,38,55,49,40,182,4,0
1265,3/29/2018 20:25,37,53,47,39,176,4,0
1266,3/29/2018 20:30,35,51,45,37,168,4,0
1267,3/29/2018 20:35,61,72,56,67,256,4,0
1268,3/29/2018 20:40,65,75,59,70,269,4,0
1269,3/29/2018 20:45,57,69,54,64,244,4,0
1270,3/29/2018 20:50,56,67,53,63,239,4,0
1271,3/29/2018 20:55,64,74,58,69,265,4,0
1272,3/29/2018 21:00,71,80,63,75,289,4,0
1273,3/29/2018 21:05,67,77,60,72,276,4,0
1274,3/29/2018 21:10,75,83,65,78,301,4,0
1275,3/29/2018 21:15,73,82,64,77,296,4,0
1276,3/29/2018 21:20,65,75,59,70,269,4,0
1277,3/29/2018 21:25,68,78,61,73,280,4,0
1278,3/29/2018 21:30,63,74,58,69,264,4,0
1279,3/29/2018 21:35,54,66,52,62,234,4,0
1280,3/29/2018 21:40,70,79,62,74,285,4,0
1281,3/29/2018 21:45,61,72,57,67,257,4,0
1282,3/29/2018 21:50,50,62,49,58,219,4,0
1283,3/29/2018 21:55,57,68,54,64,243,4,0
1284,3/29/2018 22:00,50,62,50,58,220,4,0
1285,3/29/2018 22:05,59,70,55,66,250,4,0
1286,3/29/2018 22:10,56,67,53,63,239,4,0
1287,3/29/2018 22:15,65,75,59,70,269,4,0
1288,3/29/2018 22:20,45,58,46,54,203,4,0
1289,3/29/2018 22:25,54,66,52,62,234,4,0
1290,3/29/2018 22:30,41,54,44,50,189,4,0
1291,3/29/2018 22:35,50,62,50,58,220,4,0
1292,3/29/2018 22:40,48,61,48,56,213,4,0
1293,3/29/2018 22:45,50,62,49,58,219,4,0
1294,3/29/2018 22:50,41,54,43,50,188,4,0
1295,3/29/2018 22:55,28,43,35,40,146,4,0
1296,3/29/2018 23:00,38,52,42,48,180,4,0
1297,3/29/2018 23:05,53,65,52,61,231,4,0
1298,3/29/2018 23:10,36,49,40,46,171,4,0
1299,3/29/2018 23:15,38,52,42,48,180,4,0
1300,3/29/2018 23:20,38,52,42,48,180,4,0
1301,3/29/2018 23:25,36,50,40,46,172,4,0
1302,3/29/2018 23:30,28,43,35,40,146,4,0
1303,3/29/2018 23:35,40,54,43,50,187,4,0
1304,3/29/2018 23:40,33,48,39,44,164,4,0
1305,3/29/2018 23:45,42,55,45,52,194,4,0
1306,3/29/2018 23:50,33,48,39,44,164,4,0
1307,3/29/2018 23:55,33,48,39,44,164,4,0
1308,3/30/2018 0:00,34,49,40,45,168,4,0
1309,3/30/2018 0:05,27,42,35,39,143,4,0
1310,3/30/2018 0:10,22,37,31,35,125,4,0
1311,3/30/2018 0:15,30,45,37,41,153,4,0
1312,3/30/2018 0:20,19,34,28,31,112,4,0
1313,3/30/2018 0:25,21,37,31,34,123,4,0
1314,3/30/2018 0:30,19,35,29,32,115,4,0
1315,3/30/2018 0:35,18,34,29,31,112,4,0
1316,3/30/2018 0:40,16,33,28,30,107,4,0
1317,3/30/2018 0:45,10,26,23,24,83,4,0
1318,3/30/2018 0:50,14,31,26,28,99,4,0
1319,3/30/2018 0:55,15,29,25,27,96,4,0
1320,3/30/2018 1:00,10,26,23,24,83,4,0
1321,3/30/2018 1:05,14,25,21,22,82,4,0
1322,3/30/2018 1:10,11,29,25,26,91,4,0
1323,3/30/2018 1:15,10,23,20,21,74,4,0
1324,3/30/2018 1:20,22,31,26,28,107,4,0
1325,3/30/2018 1:25,10,23,20,21,74,4,0
1326,3/30/2018 1:30,8,24,21,22,75,4,0
1327,3/30/2018 1:35,11,27,23,25,86,4,0
1328,3/30/2018 1:40,4,19,18,18,59,4,0
1329,3/30/2018 1:45,9,26,22,23,80,4,0
1330,3/30/2018 1:50,16,33,28,30,107,4,0
1331,3/30/2018 1:55,6,23,20,21,70,4,0
1332,3/30/2018 2:00,13,25,22,23,83,4,0
1333,3/30/2018 2:05,7,25,22,23,77,4,0
1334,3/30/2018 2:10,7,18,16,16,57,4,0
1335,3/30/2018 2:15,10,24,20,21,75,4,0
1336,3/30/2018 2:20,7,24,21,22,74,4,0
1337,3/30/2018 2:25,3,20,18,18,59,4,0
1338,3/30/2018 2:30,10,24,21,22,77,4,0
1339,3/30/2018 2:35,2,20,17,18,57,4,0
1340,3/30/2018 2:40,9,18,16,17,60,4,0
1341,3/30/2018 2:45,14,28,24,26,92,4,0
1342,3/30/2018 2:50,6,21,19,19,65,4,0
1343,3/30/2018 2:55,6,23,20,21,70,4,0
1344,3/30/2018 3:00,7,24,20,21,72,4,0
1345,3/30/2018 3:05,9,25,22,23,79,4,0
1346,3/30/2018 3:10,1,18,16,16,51,4,0
1347,3/30/2018 3:15,4,21,19,19,63,4,0
1348,3/30/2018 3:20,11,28,24,26,89,4,0
1349,3/30/2018 3:25,5,22,19,20,66,4,0
1350,3/30/2018 3:30,13,29,25,27,94,4,0
1351,3/30/2018 3:35,12,28,24,26,90,4,0
1352,3/30/2018 3:40,17,33,28,30,108,4,0
1353,3/30/2018 3:45,19,35,29,32,115,4,0
1354,3/30/2018 3:50,23,39,32,36,130,4,0
1355,3/30/2018 3:55,9,26,22,23,80,4,0
1356,3/30/2018 4:00,11,27,23,25,86,4,0
1357,3/30/2018 4:05,8,25,22,23,78,4,0
1358,3/30/2018 4:10,8,24,21,23,76,4,0
1359,3/30/2018 4:15,13,29,25,26,93,4,0
1360,3/30/2018 4:20,25,40,33,37,135,4,0
1361,3/30/2018 4:25,27,42,34,39,142,4,0
1362,3/30/2018 4:30,42,55,44,51,192,4,0
1363,3/30/2018 4:35,45,58,47,54,204,4,0
1364,3/30/2018 4:40,48,60,48,56,212,4,0
1365,3/30/2018 4:45,53,65,52,61,231,4,0
1366,3/30/2018 4:50,55,66,52,62,235,4,0
1367,3/30/2018 4:55,48,60,48,56,212,4,0
1368,3/30/2018 5:00,48,61,48,57,214,4,0
1369,3/30/2018 5:05,49,61,49,57,216,4,0
1370,3/30/2018 5:10,58,69,55,65,247,4,0
1371,3/30/2018 5:15,68,78,61,73,280,4,0
1372,3/30/2018 5:20,67,77,60,72,276,4,0
1373,3/30/2018 5:25,86,94,73,88,341,4,0
1374,3/30/2018 5:30,86,93,73,88,340,4,0
1375,3/30/2018 5:35,95,102,80,96,373,4,0
1376,3/30/2018 5:40,89,95,74,90,348,4,0
1377,3/30/2018 5:45,108,114,89,107,418,4,0
1378,3/30/2018 5:50,111,117,91,110,429,4,0
1379,3/30/2018 5:55,87,95,74,89,345,4,0
1380,3/30/2018 6:00,87,94,73,89,343,4,0
1381,3/30/2018 6:05,79,88,69,83,319,4,0
1382,3/30/2018 6:10,94,102,79,95,370,4,0
1383,3/30/2018 6:15,102,107,83,101,393,4,0
1384,3/30/2018 6:20,89,97,76,91,353,4,0
1385,3/30/2018 6:25,113,117,90,111,431,4,0
1386,3/30/2018 6:30,110,115,90,108,423,4,0
1387,3/30/2018 6:35,109,115,89,108,421,4,0
1388,3/30/2018 6:40,104,110,86,104,404,4,0
1389,3/30/2018 6:45,99,104,81,98,382,4,0
1390,3/30/2018 6:50,91,99,77,93,360,4,0
1391,3/30/2018 6:55,110,114,87,108,419,4,0
1392,3/30/2018 7:00,94,102,79,95,370,4,0
1393,3/30/2018 7:05,97,103,79,96,375,4,0
1394,3/30/2018 7:10,100,107,83,101,391,4,0
1395,3/30/2018 7:15,102,107,83,101,393,4,0
1396,3/30/2018 7:20,109,113,87,107,416,4,0
1397,3/30/2018 7:25,109,115,88,108,420,4,0
1398,3/30/2018 7:30,116,121,93,114,444,4,0
1399,3/30/2018 7:35,111,115,88,108,422,4,0
1400,3/30/2018 7:40,113,118,92,111,434,4,0
1401,3/30/2018 7:45,111,116,90,109,426,4,0
1402,3/30/2018 7:50,105,111,86,105,407,4,0
1403,3/30/2018 7:55,102,107,83,101,393,4,0
1404,3/30/2018 8:00,102,107,83,101,393,4,0
1405,3/30/2018 8:05,99,104,81,98,382,4,0
1406,3/30/2018 8:10,95,102,79,96,372,4,0
1407,3/30/2018 8:15,100,106,82,100,388,4,0
1408,3/30/2018 8:20,97,103,80,97,377,4,0
1409,3/30/2018 8:25,108,112,87,106,413,4,0
1410,3/30/2018 8:30,100,106,82,99,387,4,0
1411,3/30/2018 8:35,89,96,75,90,350,4,0
1412,3/30/2018 8:40,107,111,86,105,409,4,0
1413,3/30/2018 8:45,98,103,80,97,378,4,0
1414,3/30/2018 8:50,92,98,76,92,358,4,0
1415,3/30/2018 8:55,91,97,75,92,355,4,0
1416,3/30/2018 9:00,91,97,75,91,354,4,0
1417,3/30/2018 9:05,93,99,77,93,362,4,0
1418,3/30/2018 9:10,90,96,75,90,351,4,0
1419,3/30/2018 9:15,84,91,71,86,332,4,0
1420,3/30/2018 9:20,108,112,86,105,411,4,0
1421,3/30/2018 9:25,98,103,80,97,378,4,0
1422,3/30/2018 9:30,88,96,75,89,348,4,0
1423,3/30/2018 9:35,88,96,75,89,348,4,0
1424,3/30/2018 9:40,87,94,74,88,343,4,0
1425,3/30/2018 9:45,95,102,79,95,371,4,0
1426,3/30/2018 9:50,97,102,79,96,374,4,0
1427,3/30/2018 9:55,84,92,71,86,333,4,0
1428,3/30/2018 10:00,89,96,74,90,349,4,0
1429,3/30/2018 10:05,96,102,79,96,373,4,0
1430,3/30/2018 10:10,84,91,71,86,332,4,0
1431,3/30/2018 10:15,79,87,68,81,315,4,0
1432,3/30/2018 10:20,87,95,74,89,345,4,0
1433,3/30/2018 10:25,97,104,81,97,379,4,0
1434,3/30/2018 10:30,78,87,69,82,316,4,0
1435,3/30/2018 10:35,95,103,80,96,374,4,0
1436,3/30/2018 10:40,113,117,90,110,430,4,0
1437,3/30/2018 10:45,95,102,79,95,371,4,0
1438,3/30/2018 10:50,94,101,79,95,369,4,0
1439,3/30/2018 10:55,96,102,79,96,373,4,0
1440,3/30/2018 11:00,107,111,86,105,409,4,0
1441,3/30/2018 11:05,106,112,88,105,411,4,0
1442,3/30/2018 11:10,105,110,85,104,404,4,0
1443,3/30/2018 11:15,102,109,85,102,398,4,0
1444,3/30/2018 11:20,100,105,81,99,385,4,0
1445,3/30/2018 11:25,96,103,81,97,377,4,0
1446,3/30/2018 11:30,109,114,89,107,419,4,0
1447,3/30/2018 11:35,99,105,81,99,384,4,0
1448,3/30/2018 11:40,86,93,72,88,339,4,0
1449,3/30/2018 11:45,87,94,73,88,342,4,0
1450,3/30/2018 11:50,87,95,74,89,345,4,0
1451,3/30/2018 11:55,86,94,74,88,342,4,0
1452,3/30/2018 12:00,92,98,76,92,358,4,0
1453,3/30/2018 12:05,91,98,76,92,357,4,0
1454,3/30/2018 12:10,107,111,85,105,408,4,0
1455,3/30/2018 12:15,110,115,90,108,423,4,0
1456,3/30/2018 12:20,102,108,84,101,395,4,0
1457,3/30/2018 12:25,103,110,85,103,401,4,0
1458,3/30/2018 12:30,106,112,87,106,411,4,0
1459,3/30/2018 12:35,97,104,81,98,380,4,0
1460,3/30/2018 12:40,101,106,82,100,389,4,0
1461,3/30/2018 12:45,102,107,83,101,393,4,0
1462,3/30/2018 12:50,99,104,81,98,382,4,0
1463,3/30/2018 12:55,90,97,75,91,353,4,0
1464,3/30/2018 13:00,79,87,68,82,316,4,0
1465,3/30/2018 13:05,101,106,82,100,389,4,0
1466,3/30/2018 13:10,87,95,74,89,345,4,0
1467,3/30/2018 13:15,86,93,72,88,339,4,0
1468,3/30/2018 13:20,96,102,79,96,373,4,0
1469,3/30/2018 13:25,96,102,79,96,373,4,0
1470,3/30/2018 13:30,94,100,78,94,366,4,0
1471,3/30/2018 13:35,95,101,79,95,370,4,0
1472,3/30/2018 13:40,93,101,79,94,367,4,0
1473,3/30/2018 13:45,108,112,86,106,412,4,0
1474,3/30/2018 13:50,96,102,79,96,373,4,0
1475,3/30/2018 13:55,103,107,83,101,394,4,0
1476,3/30/2018 14:00,97,102,79,96,374,4,0
1477,3/30/2018 14:05,114,118,90,111,433,4,0
1478,3/30/2018 14:10,103,108,84,102,397,4,0
1479,3/30/2018 14:15,91,97,76,92,356,4,0
1480,3/30/2018 14:20,96,102,78,95,371,4,0
1481,3/30/2018 14:25,94,100,78,94,366,4,0
1482,3/30/2018 14:30,96,102,79,96,373,4,0
1483,3/30/2018 14:35,101,106,82,100,389,4,0
1484,3/30/2018 14:40,92,98,76,92,358,4,0
1485,3/30/2018 14:45,102,108,83,101,394,4,0
1486,3/30/2018 14:50,86,93,72,87,338,4,0
1487,3/30/2018 14:55,86,93,72,88,339,4,0
1488,3/30/2018 15:00,77,86,67,80,310,4,0
1489,3/30/2018 15:05,89,96,74,90,349,4,0
1490,3/30/2018 15:10,94,100,78,94,366,4,0
1491,3/30/2018 15:15,90,98,77,92,357,4,0
1492,3/30/2018 15:20,81,89,69,83,322,4,0
1493,3/30/2018 15:25,91,97,75,91,354,4,0
1494,3/30/2018 15:30,89,96,74,90,349,4,0
1495,3/30/2018 15:35,92,98,76,92,358,4,0
1496,3/30/2018 15:40,100,105,81,99,385,4,0
1497,3/30/2018 15:45,96,103,80,97,376,4,0
1498,3/30/2018 15:50,99,104,81,98,382,4,0
1499,3/30/2018 15:55,103,109,85,103,400,4,0
1500,3/30/2018 16:00,97,103,80,97,377,4,0
1501,3/30/2018 16:05,110,114,88,107,419,4,0
1502,3/30/2018 16:10,100,106,82,100,388,4,0
1503,3/30/2018 16:15,100,106,82,100,388,4,0
1504,3/30/2018 16:20,103,109,85,103,400,4,0
1505,3/30/2018 16:25,98,103,80,97,378,4,0
1506,3/30/2018 16:30,97,104,80,97,378,4,0
1507,3/30/2018 16:35,86,94,74,88,342,4,0
1508,3/30/2018 16:40,102,107,83,101,393,4,0
1509,3/30/2018 16:45,86,93,73,88,340,4,0
1510,3/30/2018 16:50,72,81,64,76,293,4,0
1511,3/30/2018 16:55,121,124,95,117,457,4,0
1512,3/30/2018 17:00,91,97,76,92,356,4,0
1513,3/30/2018 17:05,95,101,78,95,369,4,0
1514,3/30/2018 17:10,90,98,77,92,357,4,0
1515,3/30/2018 17:15,97,103,80,97,377,4,0
1516,3/30/2018 17:20,91,99,77,93,360,4,0
1517,3/30/2018 17:25,97,104,81,97,379,4,0
1518,3/30/2018 17:30,95,103,80,96,374,4,0
1519,3/30/2018 17:35,93,99,77,93,362,4,0
1520,3/30/2018 17:40,90,96,75,90,351,4,0
1521,3/30/2018 17:45,70,79,62,74,285,4,0
1522,3/30/2018 17:50,99,106,81,99,385,4,0
1523,3/30/2018 17:55,103,108,83,101,395,4,0
1524,3/30/2018 18:00,86,93,72,87,338,4,0
1525,3/30/2018 18:05,99,104,81,98,382,4,0
1526,3/30/2018 18:10,93,99,77,94,363,4,0
1527,3/30/2018 18:15,104,109,84,103,400,4,0
1528,3/30/2018 18:20,80,88,69,83,320,4,0
1529,3/30/2018 18:25,98,105,82,98,383,4,0
1530,3/30/2018 18:30,87,94,73,89,343,4,0
1531,3/30/2018 18:35,91,98,76,92,357,4,0
1532,3/30/2018 18:40,95,102,80,95,372,4,0
1533,3/30/2018 18:45,87,95,75,89,346,4,0
1534,3/30/2018 18:50,103,108,84,102,397,4,0
1535,3/30/2018 18:55,99,105,81,99,384,4,0
1536,3/30/2018 19:00,96,103,81,97,377,4,0
1537,3/30/2018 19:05,95,101,79,95,370,4,0
1538,3/30/2018 19:10,78,87,69,82,316,4,0
1539,3/30/2018 19:15,79,88,69,82,318,4,0
1540,3/30/2018 19:20,89,96,75,90,350,4,0
1541,3/30/2018 19:25,88,95,74,90,347,4,0
1542,3/30/2018 19:30,84,92,71,87,334,4,0
1543,3/30/2018 19:35,72,81,63,76,292,4,0
1544,3/30/2018 19:40,77,86,67,80,310,4,0
1545,3/30/2018 19:45,74,83,65,78,300,4,0
1546,3/30/2018 19:50,66,77,61,72,276,4,0
1547,3/30/2018 19:55,79,88,69,83,319,4,0
1548,3/30/2018 20:00,67,77,61,72,277,4,0
1549,3/30/2018 20:05,60,71,56,66,253,4,0
1550,3/30/2018 20:10,64,74,59,69,266,4,0
1551,3/30/2018 20:15,57,68,54,64,243,4,0
1552,3/30/2018 20:20,61,72,56,67,256,4,0
1553,3/30/2018 20:25,53,65,51,60,229,4,0
1554,3/30/2018 20:30,62,73,58,68,261,4,0
1555,3/30/2018 20:35,66,77,60,72,275,4,0
1556,3/30/2018 20:40,60,71,56,66,253,4,0
1557,3/30/2018 20:45,67,77,60,72,276,4,0
1558,3/30/2018 20:50,54,66,52,61,233,4,0
1559,3/30/2018 20:55,63,73,58,68,262,4,0
1560,3/30/2018 21:00,58,69,55,65,247,4,0
1561,3/30/2018 21:05,56,67,53,63,239,4,0
1562,3/30/2018 21:10,58,69,55,65,247,4,0
1563,3/30/2018 21:15,56,67,53,63,239,4,0
1564,3/30/2018 21:20,72,82,64,77,295,4,0
1565,3/30/2018 21:25,67,78,61,72,278,4,0
1566,3/30/2018 21:30,68,78,61,73,280,4,0
1567,3/30/2018 21:35,57,69,54,64,244,4,0
1568,3/30/2018 21:40,57,69,54,64,244,4,0
1569,3/30/2018 21:45,61,72,57,67,257,4,0
1570,3/30/2018 21:50,71,81,63,76,291,4,0
1571,3/30/2018 21:55,59,70,56,66,251,4,0
1572,3/30/2018 22:00,69,79,62,74,284,4,0
1573,3/30/2018 22:05,58,69,55,65,247,4,0
1574,3/30/2018 22:10,69,79,62,74,284,4,0
1575,3/30/2018 22:15,52,64,51,60,227,4,0
1576,3/30/2018 22:20,51,63,50,59,223,4,0
1577,3/30/2018 22:25,56,67,53,63,239,4,0
1578,3/30/2018 22:30,52,64,51,60,227,4,0
1579,3/30/2018 22:35,48,61,49,57,215,4,0
1580,3/30/2018 22:40,50,62,50,58,220,4,0
1581,3/30/2018 22:45,51,63,50,59,223,4,0
1582,3/30/2018 22:50,46,59,47,55,207,4,0
1583,3/30/2018 22:55,41,54,44,51,190,4,0
1584,3/30/2018 23:00,43,56,45,52,196,4,0
1585,3/30/2018 23:05,40,54,43,50,187,4,0
1586,3/30/2018 23:10,36,50,40,46,172,4,0
1587,3/30/2018 23:15,41,54,44,51,190,4,0
1588,3/30/2018 23:20,53,65,52,61,231,4,0
1589,3/30/2018 23:25,40,54,43,50,187,4,0
1590,3/30/2018 23:30,36,50,41,46,173,4,0
1591,3/30/2018 23:35,45,58,47,54,204,4,0
1592,3/30/2018 23:40,42,55,44,51,192,4,0
1593,3/30/2018 23:45,44,56,45,53,198,4,0
1594,3/30/2018 23:50,34,49,40,45,168,4,0
1595,3/30/2018 23:55,29,44,36,41,150,4,0
1596,3/31/2018 0:00,27,42,35,39,143,4,0
1597,3/31/2018 0:05,20,36,30,33,119,4,0
1598,3/31/2018 0:10,24,40,33,37,134,4,0
1599,3/31/2018 0:15,27,42,35,39,143,4,0
1600,3/31/2018 0:20,25,40,33,37,135,4,0
1601,3/31/2018 0:25,19,35,29,32,115,4,0
1602,3/31/2018 0:30,11,28,24,26,89,4,0
1603,3/31/2018 0:35,19,36,30,33,118,4,0
1604,3/31/2018 0:40,15,32,27,29,103,4,0
1605,3/31/2018 0:45,20,35,29,33,117,4,0
1606,3/31/2018 0:50,12,28,24,26,90,4,0
1607,3/31/2018 0:55,20,36,30,33,119,4,0
1608,3/31/2018 1:00,16,32,27,30,105,4,0
1609,3/31/2018 1:05,17,33,28,31,109,4,0
1610,3/31/2018 1:10,13,29,25,27,94,4,0
1611,3/31/2018 1:15,13,29,25,27,94,4,0
1612,3/31/2018 1:20,14,27,23,25,89,4,0
1613,3/31/2018 1:25,11,28,24,26,89,4,0
1614,3/31/2018 1:30,20,33,28,30,111,4,0
1615,3/31/2018 1:35,15,32,28,30,105,4,0
1616,3/31/2018 1:40,15,31,26,28,100,4,0
1617,3/31/2018 1:45,14,31,27,29,101,4,0
1618,3/31/2018 1:50,12,28,24,26,90,4,0
1619,3/31/2018 1:55,12,28,24,26,90,4,0
1620,3/31/2018 2:00,1,18,17,17,53,4,0
1621,3/31/2018 2:05,19,34,28,31,112,4,0
1622,3/31/2018 2:10,12,28,24,26,90,4,0
1623,3/31/2018 2:15,11,27,23,25,86,4,0
1624,3/31/2018 2:20,10,26,22,24,82,4,0
1625,3/31/2018 2:25,14,25,22,23,84,4,0
1626,3/31/2018 2:30,16,31,26,29,102,4,0
1627,3/31/2018 2:35,5,21,18,19,63,4,0
1628,3/31/2018 2:40,15,24,21,22,82,4,0
1629,3/31/2018 2:45,7,25,23,23,78,4,0
1630,3/31/2018 2:50,9,22,20,20,71,4,0
1631,3/31/2018 2:55,5,22,20,20,67,4,0
1632,3/31/2018 3:00,14,21,19,19,73,4,0
1633,3/31/2018 3:05,7,18,16,16,57,4,0
1634,3/31/2018 3:10,9,19,17,17,62,4,0
1635,3/31/2018 3:15,9,25,22,23,79,4,0
1636,3/31/2018 3:20,7,24,20,21,72,4,0
1637,3/31/2018 3:25,5,21,19,19,64,4,0
1638,3/31/2018 3:30,9,25,22,23,79,4,0
1639,3/31/2018 3:35,12,24,21,22,79,4,0
1640,3/31/2018 3:40,8,24,20,21,73,4,0
1641,3/31/2018 3:45,9,23,21,22,75,4,0
1642,3/31/2018 3:50,6,22,19,20,67,4,0
1643,3/31/2018 3:55,17,15,14,13,59,4,0
1644,3/31/2018 4:00,6,17,16,16,55,4,0
1645,3/31/2018 4:05,11,23,20,20,74,4,0
1646,3/31/2018 4:10,9,18,17,17,61,4,0
1647,3/31/2018 4:15,11,20,18,18,67,4,0
1648,3/31/2018 4:20,10,26,23,24,83,4,0
1649,3/31/2018 4:25,11,28,25,26,90,4,0
1650,3/31/2018 4:30,9,26,22,23,80,4,0
1651,3/31/2018 4:35,19,34,28,31,112,4,0
1652,3/31/2018 4:40,17,33,28,30,108,4,0
1653,3/31/2018 4:45,19,35,29,32,115,4,0
1654,3/31/2018 4:50,19,34,29,32,114,4,0
1655,3/31/2018 4:55,18,34,28,31,111,4,0
1656,3/31/2018 5:00,16,32,27,30,105,4,0
1657,3/31/2018 5:05,15,26,23,24,88,4,0
1658,3/31/2018 5:10,17,33,27,30,107,4,0
1659,3/31/2018 5:15,23,39,32,36,130,4,0
1660,3/31/2018 5:20,19,35,29,32,115,4,0
1661,3/31/2018 5:25,25,41,34,38,138,4,0
1662,3/31/2018 5:30,27,41,34,38,140,4,0
1663,3/31/2018 5:35,32,46,38,43,159,4,0
1664,3/31/2018 5:40,33,47,38,43,161,4,0
1665,3/31/2018 5:45,35,49,40,45,169,4,0
1666,3/31/2018 5:50,39,52,42,49,182,4,0
1667,3/31/2018 5:55,32,47,38,44,161,4,0
1668,3/31/2018 6:00,25,39,32,36,132,4,0
1669,3/31/2018 6:05,26,41,33,38,138,4,0
1670,3/31/2018 6:10,24,39,32,36,131,4,0
1671,3/31/2018 6:15,38,52,42,48,180,4,0
1672,3/31/2018 6:20,38,52,42,48,180,4,0
1673,3/31/2018 6:25,36,49,40,46,171,4,0
1674,3/31/2018 6:30,43,56,45,52,196,4,0
1675,3/31/2018 6:35,47,60,48,56,211,4,0
1676,3/31/2018 6:40,45,58,47,54,204,4,0
1677,3/31/2018 6:45,61,72,57,67,257,4,0
1678,3/31/2018 6:50,50,62,50,58,220,4,0
1679,3/31/2018 6:55,46,59,47,55,207,4,0
1680,3/31/2018 7:00,41,54,43,50,188,4,0
1681,3/31/2018 7:05,51,63,50,59,223,4,0
1682,3/31/2018 7:10,41,55,44,51,191,4,0
1683,3/31/2018 7:15,47,59,48,55,209,4,0
1684,3/31/2018 7:20,64,74,59,70,267,4,0
1685,3/31/2018 7:25,55,66,53,62,236,4,0
1686,3/31/2018 7:30,59,70,55,65,249,4,0
1687,3/31/2018 7:35,58,69,55,65,247,4,0
1688,3/31/2018 7:40,67,77,61,72,277,4,0
1689,3/31/2018 7:45,66,76,60,71,273,4,0
1690,3/31/2018 7:50,72,81,64,76,293,4,0
1691,3/31/2018 7:55,60,71,56,66,253,4,0
1692,3/31/2018 8:00,62,73,57,68,260,4,0
1693,3/31/2018 8:05,63,73,58,69,263,4,0
1694,3/31/2018 8:10,58,69,55,65,247,4,0
1695,3/31/2018 8:15,53,65,52,61,231,4,0
1696,3/31/2018 8:20,56,68,54,63,241,4,0
1697,3/31/2018 8:25,68,78,61,73,280,4,0
1698,3/31/2018 8:30,68,78,61,73,280,4,0
1699,3/31/2018 8:35,75,84,65,79,303,4,0
1700,3/31/2018 8:40,78,86,67,81,312,4,0
1701,3/31/2018 8:45,77,86,68,81,312,4,0
1702,3/31/2018 8:50,82,90,71,85,328,4,0
1703,3/31/2018 8:55,75,84,66,79,304,4,0
1704,3/31/2018 9:00,75,84,65,78,302,4,0
1705,3/31/2018 9:05,60,71,56,66,253,4,0
1706,3/31/2018 9:10,73,83,65,77,298,4,0
1707,3/31/2018 9:15,76,85,67,80,308,4,0
1708,3/31/2018 9:20,77,86,68,81,312,4,0
1709,3/31/2018 9:25,72,81,64,76,293,4,0
1710,3/31/2018 9:30,78,87,68,81,314,4,0
1711,3/31/2018 9:35,84,93,73,87,337,4,0
1712,3/31/2018 9:40,89,97,76,90,352,4,0
1713,3/31/2018 9:45,87,95,75,89,346,4,0
1714,3/31/2018 9:50,85,93,72,87,337,4,0
1715,3/31/2018 9:55,82,91,71,85,329,4,0
1716,3/31/2018 10:00,84,92,72,86,334,4,0
1717,3/31/2018 10:05,85,93,73,87,338,4,0
1718,3/31/2018 10:10,86,94,73,88,341,4,0
1719,3/31/2018 10:15,94,101,79,95,369,4,0
1720,3/31/2018 10:20,94,101,79,95,369,4,0
1721,3/31/2018 10:25,88,96,74,90,348,4,0
1722,3/31/2018 10:30,88,96,75,89,348,4,0
1723,3/31/2018 10:35,87,95,75,89,346,4,0
1724,3/31/2018 10:40,86,94,74,88,342,4,0
1725,3/31/2018 10:45,86,94,74,88,342,4,0
1726,3/31/2018 10:50,84,92,71,86,333,4,0
1727,3/31/2018 10:55,98,104,81,98,381,4,0
1728,3/31/2018 11:00,91,98,77,92,358,4,0
1729,3/31/2018 11:05,91,99,77,92,359,4,0
1730,3/31/2018 11:10,86,94,73,88,341,4,0
1731,3/31/2018 11:15,87,95,74,89,345,4,0
1732,3/31/2018 11:20,90,98,77,92,357,4,0
1733,3/31/2018 11:25,81,89,69,84,323,4,0
1734,3/31/2018 11:30,95,103,80,96,374,4,0
1735,3/31/2018 11:35,77,86,67,80,310,4,0
1736,3/31/2018 11:40,101,107,84,100,392,4,0
1737,3/31/2018 11:45,96,104,81,97,378,4,0
1738,3/31/2018 11:50,104,111,86,103,404,4,0
1739,3/31/2018 11:55,95,102,80,96,373,4,0
