,5 Minutes,Lane 1 Flow (Veh/5 Minutes),Lane 2 Flow (Veh/5 Minutes),Lane 3 Flow (Veh/5 Minutes),Lane 4 Flow (Veh/5 Minutes),Flow (Veh/5 Minutes),# Lane Points,% Observed
0,3/01/2018 0:00,12,18,16,13,59,4,0
1,3/01/2018 0:05,13,18,16,13,60,4,0
2,3/01/2018 0:10,12,18,16,13,59,4,0
3,3/01/2018 0:15,12,17,15,13,57,4,0
4,3/01/2018 0:20,11,16,14,12,53,4,0
5,3/01/2018 0:25,10,15,13,11,49,4,0
6,3/01/2018 0:30,10,14,12,10,46,4,0
7,3/01/2018 0:35,10,14,13,10,47,4,0
8,3/01/2018 0:40,10,14,12,10,46,4,0
9,3/01/2018 0:45,9,13,12,10,44,4,0
10,3/01/2018 0:50,9,12,11,9,41,4,0
11,3/01/2018 0:55,8,11,10,8,37,4,0
12,3/01/2018 1:00,7,11,9,8,35,4,0
13,3/01/2018 1:05,7,11,9,8,35,4,0
14,3/01/2018 1:10,8,11,10,8,37,4,0
15,3/01/2018 1:15,7,11,9,8,35,4,0
16,3/01/2018 1:20,7,10,9,7,33,4,0
17,3/01/2018 1:25,7,10,9,7,33,4,0
18,3/01/2018 1:30,6,9,8,7,30,4,0
19,3/01/2018 1:35,6,9,8,7,30,4,0
20,3/01/2018 1:40,7,10,9,7,33,4,0
21,3/01/2018 1:45,6,9,8,7,30,4,0
22,3/01/2018 1:50,6,9,8,7,30,4,0
23,3/01/2018 1:55,6,8,7,6,27,4,0
24,3/01/2018 2:00,6,8,7,6,27,4,0
25,3/01/2018 2:05,6,8,8,6,28,4,0
26,3/01/2018 2:10,6,9,8,6,29,4,0
27,3/01/2018 2:15,6,8,8,6,28,4,0
28,3/01/2018 2:20,6,9,8,6,29,4,0
29,3/01/2018 2:25,6,8,7,6,27,4,0
30,3/01/2018 2:30,6,8,7,6,27,4,0
31,3/01/2018 2:35,6,8,7,6,27,4,0
32,3/01/2018 2:40,6,8,8,6,28,4,0
33,3/01/2018 2:45,5,8,7,6,26,4,0
34,3/01/2018 2:50,5,8,7,5,25,4,0
35,3/01/2018 2:55,5,7,6,5,23,4,0
36,3/01/2018 3:00,5,7,6,5,23,4,0
37,3/01/2018 3:05,5,8,7,5,25,4,0
38,3/01/2018 3:10,6,8,7,6,27,4,0
39,3/01/2018 3:15,5,8,7,6,26,4,0
40,3/01/2018 3:20,6,8,8,6,28,4,0
41,3/01/2018 3:25,6,9,8,6,29,4,0
42,3/01/2018 3:30,6,9,8,7,30,4,0
43,3/01/2018 3:35,7,10,9,7,33,4,0
44,3/01/2018 3:40,7,10,9,7,33,4,0
45,3/01/2018 3:45,7,11,9,8,35,4,0
46,3/01/2018 3:50,7,10,9,7,33,4,0
47,3/01/2018 3:55,7,10,9,7,33,4,0
48,3/01/2018 4:00,7,10,9,7,33,4,0
49,3/01/2018 4:05,7,11,9,8,35,4,0
50,3/01/2018 4:10,8,12,11,9,40,4,0
51,3/01/2018 4:15,9,14,12,10,45,4,0
52,3/01/2018 4:20,10,15,13,11,49,4,0
53,3/01/2018 4:25,11,16,14,12,53,4,0
54,3/01/2018 4:30,13,19,16,13,61,4,0
55,3/01/2018 4:35,14,21,18,15,68,4,0
56,3/01/2018 4:40,16,23,21,17,77,4,0
57,3/01/2018 4:45,17,24,21,17,79,4,0
58,3/01/2018 4:50,17,25,22,18,82,4,0
59,3/01/2018 4:55,17,25,22,18,82,4,0
60,3/01/2018 5:00,19,27,24,20,90,4,0
61,3/01/2018 5:05,22,32,29,23,106,4,0
62,3/01/2018 5:10,26,38,33,27,124,4,0
63,3/01/2018 5:15,29,42,37,31,139,4,0
64,3/01/2018 5:20,33,48,42,35,158,4,0
65,3/01/2018 5:25,36,52,46,38,172,4,0
66,3/01/2018 5:30,41,59,52,43,195,4,0
67,3/01/2018 5:35,44,64,56,46,210,4,0
68,3/01/2018 5:40,47,69,61,50,227,4,0
69,3/01/2018 5:45,48,70,62,51,231,4,0
70,3/01/2018 5:50,46,67,59,49,221,4,0
71,3/01/2018 5:55,45,65,57,47,214,4,0
72,3/01/2018 6:00,45,65,58,47,215,4,0
73,3/01/2018 6:05,48,69,61,50,228,4,0
74,3/01/2018 6:10,53,76,68,55,252,4,0
75,3/01/2018 6:15,56,81,72,59,268,4,0
76,3/01/2018 6:20,59,85,75,61,280,4,0
77,3/01/2018 6:25,60,87,77,63,287,4,0
78,3/01/2018 6:30,62,90,79,65,296,4,0
79,3/01/2018 6:35,64,93,82,67,306,4,0
80,3/01/2018 6:40,67,97,86,70,320,4,0
81,3/01/2018 6:45,67,97,86,70,320,4,0
82,3/01/2018 6:50,67,97,86,70,320,4,0
83,3/01/2018 6:55,65,95,84,69,313,4,0
84,3/01/2018 7:00,65,94,83,68,310,4,0
85,3/01/2018 7:05,66,96,84,69,315,4,0
86,3/01/2018 7:10,68,99,87,72,326,4,0
87,3/01/2018 7:15,70,102,90,74,336,4,0
88,3/01/2018 7:20,72,104,92,75,343,4,0
89,3/01/2018 7:25,71,103,91,75,340,4,0
90,3/01/2018 7:30,71,103,91,75,340,4,0
91,3/01/2018 7:35,73,105,93,76,347,4,0
92,3/01/2018 7:40,73,106,94,77,350,4,0
93,3/01/2018 7:45,73,106,94,77,350,4,0
94,3/01/2018 7:50,74,107,95,78,354,4,0
95,3/01/2018 7:55,71,103,91,75,340,4,0
96,3/01/2018 8:00,69,101,89,73,332,4,0
97,3/01/2018 8:05,68,98,87,71,324,4,0
98,3/01/2018 8:10,67,98,86,71,322,4,0
99,3/01/2018 8:15,66,96,85,70,317,4,0
100,3/01/2018 8:20,67,97,85,70,319,4,0
101,3/01/2018 8:25,65,94,83,68,310,4,0
102,3/01/2018 8:30,63,92,81,67,303,4,0
103,3/01/2018 8:35,63,91,81,66,301,4,0
104,3/01/2018 8:40,63,91,80,66,300,4,0
105,3/01/2018 8:45,63,91,80,66,300,4,0
106,3/01/2018 8:50,61,89,79,65,294,4,0
107,3/01/2018 8:55,58,85,75,61,279,4,0
108,3/01/2018 9:00,56,82,72,59,269,4,0
109,3/01/2018 9:05,56,81,71,58,266,4,0
110,3/01/2018 9:10,55,80,71,58,264,4,0
111,3/01/2018 9:15,56,81,71,58,266,4,0
112,3/01/2018 9:20,55,80,71,58,264,4,0
113,3/01/2018 9:25,55,80,70,58,263,4,0
114,3/01/2018 9:30,55,79,70,58,262,4,0
115,3/01/2018 9:35,55,80,71,58,264,4,0
116,3/01/2018 9:40,55,80,71,58,264,4,0
117,3/01/2018 9:45,55,79,70,58,262,4,0
118,3/01/2018 9:50,55,80,70,58,263,4,0
119,3/01/2018 9:55,54,78,69,56,257,4,0
120,3/01/2018 10:00,51,74,66,54,245,4,0
121,3/01/2018 10:05,52,76,67,55,250,4,0
122,3/01/2018 10:10,52,75,66,54,247,4,0
123,3/01/2018 10:15,53,76,68,55,252,4,0
124,3/01/2018 10:20,52,76,67,55,250,4,0
125,3/01/2018 10:25,52,76,67,55,250,4,0
126,3/01/2018 10:30,52,75,66,54,247,4,0
127,3/01/2018 10:35,51,74,65,54,244,4,0
128,3/01/2018 10:40,52,76,67,55,250,4,0
129,3/01/2018 10:45,53,77,68,56,254,4,0
130,3/01/2018 10:50,53,77,68,56,254,4,0
131,3/01/2018 10:55,52,76,67,55,250,4,0
132,3/01/2018 11:00,51,74,66,54,245,4,0
133,3/01/2018 11:05,52,76,67,55,250,4,0
134,3/01/2018 11:10,52,75,66,54,247,4,0
135,3/01/2018 11:15,51,75,66,54,246,4,0
136,3/01/2018 11:20,52,76,67,55,250,4,0
137,3/01/2018 11:25,52,76,67,55,250,4,0
138,3/01/2018 11:30,53,77,68,56,254,4,0
139,3/01/2018 11:35,54,78,69,57,258,4,0
140,3/01/2018 11:40,54,78,69,56,257,4,0
141,3/01/2018 11:45,53,77,68,56,254,4,0
142,3/01/2018 11:50,54,78,69,56,257,4,0
143,3/01/2018 11:55,53,76,68,55,252,4,0
144,3/01/2018 12:00,53,77,68,56,254,4,0
145,3/01/2018 12:05,54,78,69,56,257,4,0
146,3/01/2018 12:10,54,78,69,56,257,4,0
147,3/01/2018 12:15,54,78,69,57,258,4,0
148,3/01/2018 12:20,55,79,70,57,261,4,0
149,3/01/2018 12:25,54,79,70,57,260,4,0
150,3/01/2018 12:30,54,78,69,56,257,4,0
151,3/01/2018 12:35,54,78,69,56,257,4,0
152,3/01/2018 12:40,54,78,69,56,257,4,0
153,3/01/2018 12:45,55,80,70,58,263,4,0
154,3/01/2018 12:50,55,79,70,58,262,4,0
155,3/01/2018 12:55,54,79,70,57,260,4,0
156,3/01/2018 13:00,54,78,69,56,257,4,0
157,3/01/2018 13:05,54,78,69,57,258,4,0
158,3/01/2018 13:10,55,80,70,58,263,4,0
159,3/01/2018 13:15,55,80,70,58,263,4,0
160,3/01/2018 13:20,55,80,71,58,264,4,0
161,3/01/2018 13:25,55,80,70,58,263,4,0
162,3/01/2018 13:30,55,80,71,58,264,4,0
163,3/01/2018 13:35,56,81,72,59,268,4,0
164,3/01/2018 13:40,56,81,71,58,266,4,0
165,3/01/2018 13:45,56,82,72,59,269,4,0
166,3/01/2018 13:50,56,82,72,59,269,4,0
167,3/01/2018 13:55,56,82,72,59,269,4,0
168,3/01/2018 14:00,56,82,72,59,269,4,0
169,3/01/2018 14:05,57,83,73,60,273,4,0
170,3/01/2018 14:10,59,85,75,61,280,4,0
171,3/01/2018 14:15,60,86,76,63,285,4,0
172,3/01/2018 14:20,60,87,77,63,287,4,0
173,3/01/2018 14:25,60,86,76,63,285,4,0
174,3/01/2018 14:30,60,87,77,63,287,4,0
175,3/01/2018 14:35,63,91,80,66,300,4,0
176,3/01/2018 14:40,65,95,84,69,313,4,0
177,3/01/2018 14:45,66,96,85,69,316,4,0
178,3/01/2018 14:50,65,94,83,68,310,4,0
179,3/01/2018 14:55,64,93,82,67,306,4,0
180,3/01/2018 15:00,64,93,82,67,306,4,0
181,3/01/2018 15:05,65,94,83,68,310,4,0
182,3/01/2018 15:10,66,96,85,69,316,4,0
183,3/01/2018 15:15,66,96,85,69,316,4,0
184,3/01/2018 15:20,66,96,85,70,317,4,0
185,3/01/2018 15:25,66,96,85,70,317,4,0
186,3/01/2018 15:30,66,96,85,70,317,4,0
187,3/01/2018 15:35,70,102,90,74,336,4,0
188,3/01/2018 15:40,73,106,93,76,348,4,0
189,3/01/2018 15:45,73,105,93,76,347,4,0
190,3/01/2018 15:50,72,104,92,76,344,4,0
191,3/01/2018 15:55,69,100,88,72,329,4,0
192,3/01/2018 16:00,68,99,88,72,327,4,0
193,3/01/2018 16:05,69,100,89,73,331,4,0
194,3/01/2018 16:10,71,103,91,75,340,4,0
195,3/01/2018 16:15,71,103,91,74,339,4,0
196,3/01/2018 16:20,72,104,92,76,344,4,0
197,3/01/2018 16:25,69,100,89,73,331,4,0
198,3/01/2018 16:30,71,103,91,74,339,4,0
199,3/01/2018 16:35,72,104,92,75,343,4,0
200,3/01/2018 16:40,74,107,95,77,353,4,0
201,3/01/2018 16:45,74,107,95,77,353,4,0
202,3/01/2018 16:50,75,109,96,79,359,4,0
203,3/01/2018 16:55,72,105,93,76,346,4,0
204,3/01/2018 17:00,72,104,92,76,344,4,0
205,3/01/2018 17:05,74,107,95,77,353,4,0
206,3/01/2018 17:10,76,110,98,80,364,4,0
207,3/01/2018 17:15,76,110,97,80,363,4,0
208,3/01/2018 17:20,77,112,99,81,369,4,0
209,3/01/2018 17:25,73,105,93,76,347,4,0
210,3/01/2018 17:30,72,104,92,76,344,4,0
211,3/01/2018 17:35,72,104,92,75,343,4,0
212,3/01/2018 17:40,72,104,92,75,343,4,0
213,3/01/2018 17:45,71,103,91,75,340,4,0
214,3/01/2018 17:50,71,103,91,75,340,4,0
215,3/01/2018 17:55,69,100,88,72,329,4,0
216,3/01/2018 18:00,67,97,86,70,320,4,0
217,3/01/2018 18:05,67,97,86,70,320,4,0
218,3/01/2018 18:10,67,97,86,70,320,4,0
219,3/01/2018 18:15,66,96,85,70,317,4,0
220,3/01/2018 18:20,67,97,86,70,320,4,0
221,3/01/2018 18:25,64,93,83,68,308,4,0
222,3/01/2018 18:30,63,92,81,66,302,4,0
223,3/01/2018 18:35,62,90,79,65,296,4,0
224,3/01/2018 18:40,60,87,77,63,287,4,0
225,3/01/2018 18:45,59,86,76,62,283,4,0
226,3/01/2018 18:50,57,83,73,60,273,4,0
227,3/01/2018 18:55,55,80,71,58,264,4,0
228,3/01/2018 19:00,55,79,70,57,261,4,0
229,3/01/2018 19:05,54,78,69,56,257,4,0
230,3/01/2018 19:10,54,79,70,57,260,4,0
231,3/01/2018 19:15,51,75,66,54,246,4,0
232,3/01/2018 19:20,50,73,64,52,239,4,0
233,3/01/2018 19:25,48,70,62,51,231,4,0
234,3/01/2018 19:30,47,68,60,49,224,4,0
235,3/01/2018 19:35,46,67,59,48,220,4,0
236,3/01/2018 19:40,45,66,58,48,217,4,0
237,3/01/2018 19:45,43,63,55,45,206,4,0
238,3/01/2018 19:50,42,61,54,44,201,4,0
239,3/01/2018 19:55,40,58,51,42,191,4,0
240,3/01/2018 20:00,40,57,51,41,189,4,0
241,3/01/2018 20:05,38,56,49,40,183,4,0
242,3/01/2018 20:10,38,55,49,40,182,4,0
243,3/01/2018 20:15,38,55,48,40,181,4,0
244,3/01/2018 20:20,38,55,49,40,182,4,0
245,3/01/2018 20:25,37,53,47,39,176,4,0
246,3/01/2018 20:30,35,51,45,37,168,4,0
247,3/01/2018 20:35,35,51,45,37,168,4,0
248,3/01/2018 20:40,35,51,45,37,168,4,0
249,3/01/2018 20:45,35,50,44,36,165,4,0
250,3/01/2018 20:50,34,50,44,36,164,4,0
251,3/01/2018 20:55,33,48,43,35,159,4,0
252,3/01/2018 21:00,33,48,42,34,157,4,0
253,3/01/2018 21:05,34,49,44,36,163,4,0
254,3/01/2018 21:10,35,51,45,37,168,4,0
255,3/01/2018 21:15,36,52,46,38,172,4,0
256,3/01/2018 21:20,36,52,46,37,171,4,0
257,3/01/2018 21:25,35,50,44,36,165,4,0
258,3/01/2018 21:30,33,48,43,35,159,4,0
259,3/01/2018 21:35,33,49,43,35,160,4,0
260,3/01/2018 21:40,33,48,43,35,159,4,0
261,3/01/2018 21:45,32,46,41,34,153,4,0
262,3/01/2018 21:50,31,46,40,33,150,4,0
263,3/01/2018 21:55,30,44,39,32,145,4,0
264,3/01/2018 22:00,30,43,38,31,142,4,0
265,3/01/2018 22:05,29,42,37,31,139,4,0
266,3/01/2018 22:10,30,43,38,31,142,4,0
267,3/01/2018 22:15,29,42,38,31,140,4,0
268,3/01/2018 22:20,29,43,38,31,141,4,0
269,3/01/2018 22:25,27,40,35,29,131,4,0
270,3/01/2018 22:30,27,39,35,29,130,4,0
271,3/01/2018 22:35,26,37,33,27,123,4,0
272,3/01/2018 22:40,25,36,32,26,119,4,0
273,3/01/2018 22:45,25,36,32,26,119,4,0
274,3/01/2018 22:50,23,33,29,24,109,4,0
275,3/01/2018 22:55,22,31,28,23,104,4,0
276,3/01/2018 23:00,20,29,26,21,96,4,0
277,3/01/2018 23:05,21,30,27,22,100,4,0
278,3/01/2018 23:10,21,30,27,22,100,4,0
279,3/01/2018 23:15,19,28,25,20,92,4,0
280,3/01/2018 23:20,19,27,24,20,90,4,0
281,3/01/2018 23:25,18,26,23,19,86,4,0
282,3/01/2018 23:30,17,25,22,18,82,4,0
283,3/01/2018 23:35,17,24,21,18,80,4,0
284,3/01/2018 23:40,16,23,21,17,77,4,0
285,3/01/2018 23:45,16,23,20,16,75,4,0
286,3/01/2018 23:50,15,22,19,16,72,4,0
287,3/01/2018 23:55,14,20,18,15,67,4,0
288,3/02/2018 0:00,13,19,16,13,61,4,0
289,3/02/2018 0:05,13,19,16,13,61,4,0
290,3/02/2018 0:10,13,19,17,14,63,4,0
291,3/02/2018 0:15,12,18,16,13,59,4,0
292,3/02/2018 0:20,12,17,15,12,56,4,0
293,3/02/2018 0:25,10,15,13,11,49,4,0
294,3/02/2018 0:30,11,15,14,11,51,4,0
295,3/02/2018 0:35,11,15,14,11,51,4,0
296,3/02/2018 0:40,10,15,13,11,49,4,0
297,3/02/2018 0:45,10,14,13,10,47,4,0
298,3/02/2018 0:50,9,13,12,10,44,4,0
299,3/02/2018 0:55,9,13,11,9,42,4,0
300,3/02/2018 1:00,8,12,10,8,38,4,0
301,3/02/2018 1:05,8,12,10,9,39,4,0
302,3/02/2018 1:10,8,12,10,8,38,4,0
303,3/02/2018 1:15,8,12,10,9,39,4,0
304,3/02/2018 1:20,8,12,10,8,38,4,0
305,3/02/2018 1:25,7,11,9,8,35,4,0
306,3/02/2018 1:30,7,11,9,8,35,4,0
307,3/02/2018 1:35,7,11,9,8,35,4,0
308,3/02/2018 1:40,8,11,10,8,37,4,0
309,3/02/2018 1:45,7,11,9,8,35,4,0
310,3/02/2018 1:50,7,10,9,7,33,4,0
311,3/02/2018 1:55,7,10,9,7,33,4,0
312,3/02/2018 2:00,7,10,9,7,33,4,0
313,3/02/2018 2:05,7,10,9,7,33,4,0
314,3/02/2018 2:10,7,10,9,7,33,4,0
315,3/02/2018 2:15,7,10,9,7,33,4,0
316,3/02/2018 2:20,6,9,8,7,30,4,0
317,3/02/2018 2:25,6,9,8,7,30,4,0
318,3/02/2018 2:30,6,9,8,7,30,4,0
319,3/02/2018 2:35,6,9,8,7,30,4,0
320,3/02/2018 2:40,7,10,9,7,33,4,0
321,3/02/2018 2:45,6,9,8,7,30,4,0
322,3/02/2018 2:50,6,9,8,6,29,4,0
323,3/02/2018 2:55,6,8,7,6,27,4,0
324,3/02/2018 3:00,6,8,7,6,27,4,0
325,3/02/2018 3:05,6,8,7,6,27,4,0
326,3/02/2018 3:10,6,8,8,6,28,4,0
327,3/02/2018 3:15,6,9,8,7,30,4,0
328,3/02/2018 3:20,6,9,8,7,30,4,0
329,3/02/2018 3:25,7,10,9,7,33,4,0
330,3/02/2018 3:30,7,10,9,7,33,4,0
331,3/02/2018 3:35,7,11,9,8,35,4,0
332,3/02/2018 3:40,8,11,10,8,37,4,0
333,3/02/2018 3:45,8,11,10,8,37,4,0
334,3/02/2018 3:50,7,10,9,7,33,4,0
335,3/02/2018 3:55,7,10,9,7,33,4,0
336,3/02/2018 4:00,7,11,9,8,35,4,0
337,3/02/2018 4:05,8,12,10,9,39,4,0
338,3/02/2018 4:10,9,13,11,9,42,4,0
339,3/02/2018 4:15,10,14,13,10,47,4,0
340,3/02/2018 4:20,11,16,14,12,53,4,0
341,3/02/2018 4:25,11,16,14,12,53,4,0
342,3/02/2018 4:30,13,19,16,13,61,4,0
343,3/02/2018 4:35,15,21,19,15,70,4,0
344,3/02/2018 4:40,16,23,20,17,76,4,0
345,3/02/2018 4:45,17,24,21,18,80,4,0
346,3/02/2018 4:50,17,25,22,18,82,4,0
347,3/02/2018 4:55,17,25,22,18,82,4,0
348,3/02/2018 5:00,19,28,24,20,91,4,0
349,3/02/2018 5:05,21,31,27,22,101,4,0
350,3/02/2018 5:10,25,36,32,26,119,4,0
351,3/02/2018 5:15,28,41,36,30,135,4,0
352,3/02/2018 5:20,32,46,41,34,153,4,0
353,3/02/2018 5:25,35,50,44,36,165,4,0
354,3/02/2018 5:30,38,55,49,40,182,4,0
355,3/02/2018 5:35,42,61,54,44,201,4,0
356,3/02/2018 5:40,44,64,57,47,212,4,0
357,3/02/2018 5:45,45,65,57,47,214,4,0
358,3/02/2018 5:50,46,66,58,48,218,4,0
359,3/02/2018 5:55,44,64,57,47,212,4,0
360,3/02/2018 6:00,44,64,56,46,210,4,0
361,3/02/2018 6:05,47,68,60,49,224,4,0
362,3/02/2018 6:10,51,74,65,53,243,4,0
363,3/02/2018 6:15,55,80,70,58,263,4,0
364,3/02/2018 6:20,57,83,73,60,273,4,0
365,3/02/2018 6:25,59,85,75,62,281,4,0
366,3/02/2018 6:30,61,89,78,64,292,4,0
367,3/02/2018 6:35,63,91,81,66,301,4,0
368,3/02/2018 6:40,66,95,84,69,314,4,0
369,3/02/2018 6:45,66,96,85,70,317,4,0
370,3/02/2018 6:50,67,97,85,70,319,4,0
371,3/02/2018 6:55,64,93,82,67,306,4,0
372,3/02/2018 7:00,64,93,83,68,308,4,0
373,3/02/2018 7:05,66,96,85,69,316,4,0
374,3/02/2018 7:10,68,99,88,72,327,4,0
375,3/02/2018 7:15,70,102,90,74,336,4,0
376,3/02/2018 7:20,73,105,93,76,347,4,0
377,3/02/2018 7:25,73,105,93,76,347,4,0
378,3/02/2018 7:30,72,105,93,76,346,4,0
379,3/02/2018 7:35,73,106,93,76,348,4,0
380,3/02/2018 7:40,73,106,94,77,350,4,0
381,3/02/2018 7:45,75,109,96,79,359,4,0
382,3/02/2018 7:50,74,107,95,78,354,4,0
383,3/02/2018 7:55,72,104,92,75,343,4,0
384,3/02/2018 8:00,69,100,89,73,331,4,0
385,3/02/2018 8:05,69,100,88,72,329,4,0
386,3/02/2018 8:10,69,100,88,72,329,4,0
387,3/02/2018 8:15,68,99,88,72,327,4,0
388,3/02/2018 8:20,68,99,88,72,327,4,0
389,3/02/2018 8:25,66,96,85,70,317,4,0
390,3/02/2018 8:30,64,93,83,68,308,4,0
391,3/02/2018 8:35,64,93,82,67,306,4,0
392,3/02/2018 8:40,64,93,83,68,308,4,0
393,3/02/2018 8:45,62,90,80,65,297,4,0
394,3/02/2018 8:50,61,89,79,65,294,4,0
395,3/02/2018 8:55,59,86,76,62,283,4,0
396,3/02/2018 9:00,58,83,74,60,275,4,0
397,3/02/2018 9:05,56,82,72,59,269,4,0
398,3/02/2018 9:10,57,82,73,59,271,4,0
399,3/02/2018 9:15,55,80,71,58,264,4,0
400,3/02/2018 9:20,56,82,72,59,269,4,0
401,3/02/2018 9:25,56,81,72,59,268,4,0
402,3/02/2018 9:30,56,81,72,59,268,4,0
403,3/02/2018 9:35,56,81,72,59,268,4,0
404,3/02/2018 9:40,57,82,73,59,271,4,0
405,3/02/2018 9:45,56,82,72,59,269,4,0
406,3/02/2018 9:50,56,81,71,58,266,4,0
407,3/02/2018 9:55,54,79,70,57,260,4,0
408,3/02/2018 10:00,53,77,68,56,254,4,0
409,3/02/2018 10:05,54,79,70,57,260,4,0
410,3/02/2018 10:10,54,79,70,57,260,4,0
411,3/02/2018 10:15,55,79,70,58,262,4,0
412,3/02/2018 10:20,56,81,71,58,266,4,0
413,3/02/2018 10:25,55,80,70,58,263,4,0
414,3/02/2018 10:30,55,80,70,58,263,4,0
415,3/02/2018 10:35,55,80,70,58,263,4,0
416,3/02/2018 10:40,56,81,71,58,266,4,0
417,3/02/2018 10:45,56,81,71,58,266,4,0
418,3/02/2018 10:50,55,79,70,58,262,4,0
419,3/02/2018 10:55,54,78,69,57,258,4,0
420,3/02/2018 11:00,54,79,69,57,259,4,0
421,3/02/2018 11:05,54,78,69,56,257,4,0
422,3/02/2018 11:10,54,79,70,57,260,4,0
423,3/02/2018 11:15,54,79,70,57,260,4,0
424,3/02/2018 11:20,55,80,71,58,264,4,0
425,3/02/2018 11:25,55,80,71,58,264,4,0
426,3/02/2018 11:30,57,82,73,59,271,4,0
427,3/02/2018 11:35,56,81,72,59,268,4,0
428,3/02/2018 11:40,58,83,74,60,275,4,0
429,3/02/2018 11:45,57,83,73,60,273,4,0
430,3/02/2018 11:50,58,84,74,61,277,4,0
431,3/02/2018 11:55,56,81,72,59,268,4,0
432,3/02/2018 12:00,56,81,72,59,268,4,0
433,3/02/2018 12:05,58,83,74,60,275,4,0
434,3/02/2018 12:10,57,83,73,60,273,4,0
435,3/02/2018 12:15,58,84,75,61,278,4,0
436,3/02/2018 12:20,58,85,75,61,279,4,0
437,3/02/2018 12:25,58,84,75,61,278,4,0
438,3/02/2018 12:30,58,84,75,61,278,4,0
439,3/02/2018 12:35,58,84,74,61,277,4,0
440,3/02/2018 12:40,59,85,75,61,280,4,0
441,3/02/2018 12:45,59,85,75,62,281,4,0
442,3/02/2018 12:50,58,85,75,61,279,4,0
443,3/02/2018 12:55,59,85,75,61,280,4,0
444,3/02/2018 13:00,58,84,75,61,278,4,0
445,3/02/2018 13:05,59,85,75,61,280,4,0
446,3/02/2018 13:10,58,85,75,61,279,4,0
447,3/02/2018 13:15,59,86,76,62,283,4,0
448,3/02/2018 13:20,60,87,77,63,287,4,0
449,3/02/2018 13:25,60,87,77,63,287,4,0
450,3/02/2018 13:30,59,85,75,62,281,4,0
451,3/02/2018 13:35,60,87,77,63,287,4,0
452,3/02/2018 13:40,61,88,78,64,291,4,0
453,3/02/2018 13:45,60,88,77,63,288,4,0
454,3/02/2018 13:50,61,88,78,64,291,4,0
455,3/02/2018 13:55,61,89,78,64,292,4,0
456,3/02/2018 14:00,61,88,78,64,291,4,0
457,3/02/2018 14:05,61,89,78,64,292,4,0
458,3/02/2018 14:10,63,91,80,66,300,4,0
459,3/02/2018 14:15,63,92,81,66,302,4,0
460,3/02/2018 14:20,64,93,82,67,306,4,0
461,3/02/2018 14:25,64,93,82,67,306,4,0
462,3/02/2018 14:30,65,94,83,68,310,4,0
463,3/02/2018 14:35,65,94,83,68,310,4,0
464,3/02/2018 14:40,68,98,87,71,324,4,0
465,3/02/2018 14:45,70,101,89,73,333,4,0
466,3/02/2018 14:50,67,97,85,70,319,4,0
467,3/02/2018 14:55,66,96,85,70,317,4,0
468,3/02/2018 15:00,67,97,86,70,320,4,0
469,3/02/2018 15:05,69,100,88,72,329,4,0
470,3/02/2018 15:10,70,101,89,73,333,4,0
471,3/02/2018 15:15,69,101,89,73,332,4,0
472,3/02/2018 15:20,70,102,90,74,336,4,0
473,3/02/2018 15:25,69,100,88,72,329,4,0
474,3/02/2018 15:30,68,99,87,71,325,4,0
475,3/02/2018 15:35,70,102,90,74,336,4,0
476,3/02/2018 15:40,72,104,92,76,344,4,0
477,3/02/2018 15:45,73,105,93,76,347,4,0
478,3/02/2018 15:50,72,104,92,76,344,4,0
479,3/02/2018 15:55,70,102,90,74,336,4,0
480,3/02/2018 16:00,70,102,90,74,336,4,0
481,3/02/2018 16:05,71,103,91,75,340,4,0
482,3/02/2018 16:10,72,105,93,76,346,4,0
483,3/02/2018 16:15,73,106,93,76,348,4,0
484,3/02/2018 16:20,73,106,93,76,348,4,0
485,3/02/2018 16:25,72,104,92,75,343,4,0
486,3/02/2018 16:30,71,103,91,75,340,4,0
487,3/02/2018 16:35,72,104,92,76,344,4,0
488,3/02/2018 16:40,74,107,95,78,354,4,0
489,3/02/2018 16:45,74,107,94,77,352,4,0
490,3/02/2018 16:50,74,108,95,78,355,4,0
491,3/02/2018 16:55,72,105,92,76,345,4,0
492,3/02/2018 17:00,72,105,93,76,346,4,0
493,3/02/2018 17:05,74,107,95,78,354,4,0
494,3/02/2018 17:10,75,110,97,79,361,4,0
495,3/02/2018 17:15,75,110,97,79,361,4,0
496,3/02/2018 17:20,76,110,97,80,363,4,0
497,3/02/2018 17:25,74,108,95,78,355,4,0
498,3/02/2018 17:30,73,105,93,76,347,4,0
499,3/02/2018 17:35,72,105,92,76,345,4,0
500,3/02/2018 17:40,73,106,93,76,348,4,0
501,3/02/2018 17:45,72,104,92,75,343,4,0
502,3/02/2018 17:50,70,102,90,74,336,4,0
503,3/02/2018 17:55,70,102,90,74,336,4,0
504,3/02/2018 18:00,69,100,88,72,329,4,0
505,3/02/2018 18:05,69,100,88,72,329,4,0
506,3/02/2018 18:10,69,100,88,72,329,4,0
507,3/02/2018 18:15,68,99,87,72,326,4,0
508,3/02/2018 18:20,68,98,87,71,324,4,0
509,3/02/2018 18:25,66,96,85,69,316,4,0
510,3/02/2018 18:30,64,93,83,68,308,4,0
511,3/02/2018 18:35,64,93,83,68,308,4,0
512,3/02/2018 18:40,63,91,80,66,300,4,0
513,3/02/2018 18:45,61,89,79,65,294,4,0
514,3/02/2018 18:50,61,89,78,64,292,4,0
515,3/02/2018 18:55,59,86,76,62,283,4,0
516,3/02/2018 19:00,58,83,74,60,275,4,0
517,3/02/2018 19:05,57,83,73,60,273,4,0
518,3/02/2018 19:10,57,83,73,60,273,4,0
519,3/02/2018 19:15,56,82,72,59,269,4,0
520,3/02/2018 19:20,55,80,70,58,263,4,0
521,3/02/2018 19:25,54,78,69,56,257,4,0
522,3/02/2018 19:30,52,76,67,55,250,4,0
523,3/02/2018 19:35,51,74,66,54,245,4,0
524,3/02/2018 19:40,51,74,65,53,243,4,0
525,3/02/2018 19:45,49,71,62,51,233,4,0
526,3/02/2018 19:50,49,71,63,51,234,4,0
527,3/02/2018 19:55,47,68,60,49,224,4,0
528,3/02/2018 20:00,48,69,61,50,228,4,0
529,3/02/2018 20:05,46,66,59,48,219,4,0
530,3/02/2018 20:10,46,66,58,48,218,4,0
531,3/02/2018 20:15,45,65,58,47,215,4,0
532,3/02/2018 20:20,44,63,56,46,209,4,0
533,3/02/2018 20:25,43,63,56,46,208,4,0
534,3/02/2018 20:30,43,62,55,45,205,4,0
535,3/02/2018 20:35,41,59,53,43,196,4,0
536,3/02/2018 20:40,41,59,52,43,195,4,0
537,3/02/2018 20:45,40,58,51,42,191,4,0
538,3/02/2018 20:50,38,56,49,40,183,4,0
539,3/02/2018 20:55,39,56,50,41,186,4,0
540,3/02/2018 21:00,38,56,49,40,183,4,0
541,3/02/2018 21:05,39,57,50,41,187,4,0
542,3/02/2018 21:10,40,57,51,41,189,4,0
543,3/02/2018 21:15,40,58,51,42,191,4,0
544,3/02/2018 21:20,39,56,50,41,186,4,0
545,3/02/2018 21:25,39,56,50,41,186,4,0
546,3/02/2018 21:30,37,54,48,39,178,4,0
547,3/02/2018 21:35,37,54,47,39,177,4,0
548,3/02/2018 21:40,36,52,46,38,172,4,0
549,3/02/2018 21:45,37,53,47,39,176,4,0
550,3/02/2018 21:50,36,52,46,38,172,4,0
551,3/02/2018 21:55,35,51,45,37,168,4,0
552,3/02/2018 22:00,35,51,45,37,168,4,0
553,3/02/2018 22:05,36,52,46,37,171,4,0
554,3/02/2018 22:10,36,52,46,38,172,4,0
555,3/02/2018 22:15,35,51,45,37,168,4,0
556,3/02/2018 22:20,35,51,45,37,168,4,0
557,3/02/2018 22:25,33,48,43,35,159,4,0
558,3/02/2018 22:30,33,47,42,34,156,4,0
559,3/02/2018 22:35,32,46,40,33,151,4,0
560,3/02/2018 22:40,31,46,40,33,150,4,0
561,3/02/2018 22:45,31,45,40,33,149,4,0
562,3/02/2018 22:50,29,43,38,31,141,4,0
563,3/02/2018 22:55,29,42,37,30,138,4,0
564,3/02/2018 23:00,27,39,35,29,130,4,0
565,3/02/2018 23:05,27,39,34,28,128,4,0
566,3/02/2018 23:10,27,39,34,28,128,4,0
567,3/02/2018 23:15,27,39,35,29,130,4,0
568,3/02/2018 23:20,25,36,32,26,119,4,0
569,3/02/2018 23:25,24,35,31,25,115,4,0
570,3/02/2018 23:30,24,34,30,25,113,4,0
571,3/02/2018 23:35,23,34,30,25,112,4,0
572,3/02/2018 23:40,23,33,29,24,109,4,0
573,3/02/2018 23:45,22,32,28,23,105,4,0
574,3/02/2018 23:50,21,30,27,22,100,4,0
575,3/02/2018 23:55,20,29,26,21,96,4,0
576,3/03/2018 0:00,19,27,24,20,90,4,0
577,3/03/2018 0:05,19,28,24,20,91,4,0
578,3/03/2018 0:10,19,27,24,20,90,4,0
579,3/03/2018 0:15,18,26,23,19,86,4,0
580,3/03/2018 0:20,18,26,23,19,86,4,0
581,3/03/2018 0:25,17,24,21,17,79,4,0
582,3/03/2018 0:30,16,23,20,16,75,4,0
583,3/03/2018 0:35,15,22,20,16,73,4,0
584,3/03/2018 0:40,15,22,20,16,73,4,0
585,3/03/2018 0:45,15,21,19,15,70,4,0
586,3/03/2018 0:50,14,21,18,15,68,4,0
587,3/03/2018 0:55,14,20,18,15,67,4,0
588,3/03/2018 1:00,13,19,17,14,63,4,0
589,3/03/2018 1:05,13,19,17,14,63,4,0
590,3/03/2018 1:10,13,19,17,14,63,4,0
591,3/03/2018 1:15,13,18,16,13,60,4,0
592,3/03/2018 1:20,13,18,16,13,60,4,0
593,3/03/2018 1:25,12,17,15,12,56,4,0
594,3/03/2018 1:30,2,3,3,2,10,4,0
595,3/03/2018 1:35,12,17,15,12,56,4,0
596,3/03/2018 1:40,12,17,15,12,56,4,0
597,3/03/2018 1:45,11,16,14,11,52,4,0
598,3/03/2018 1:50,11,16,14,12,53,4,0
599,3/03/2018 1:55,11,15,14,11,51,4,0
600,3/03/2018 2:00,11,16,14,11,52,4,0
601,3/03/2018 2:05,11,15,14,11,51,4,0
602,3/03/2018 2:10,11,16,14,11,52,4,0
603,3/03/2018 2:15,10,15,13,11,49,4,0
604,3/03/2018 2:20,10,15,13,11,49,4,0
605,3/03/2018 2:25,10,14,12,10,46,4,0
606,3/03/2018 2:30,9,13,12,10,44,4,0
607,3/03/2018 2:35,9,13,11,9,42,4,0
608,3/03/2018 2:40,9,13,11,9,42,4,0
609,3/03/2018 2:45,8,12,11,9,40,4,0
610,3/03/2018 2:50,8,12,11,9,40,4,0
611,3/03/2018 2:55,8,11,10,8,37,4,0
612,3/03/2018 3:00,7,11,9,8,35,4,0
613,3/03/2018 3:05,7,10,9,7,33,4,0
614,3/03/2018 3:10,7,11,9,8,35,4,0
615,3/03/2018 3:15,7,11,9,8,35,4,0
616,3/03/2018 3:20,7,10,9,7,33,4,0
617,3/03/2018 3:25,7,10,9,7,33,4,0
618,3/03/2018 3:30,7,10,9,7,33,4,0
619,3/03/2018 3:35,7,11,9,8,35,4,0
620,3/03/2018 3:40,8,11,10,8,37,4,0
621,3/03/2018 3:45,7,11,9,8,35,4,0
622,3/03/2018 3:50,7,10,9,7,33,4,0
623,3/03/2018 3:55,6,9,8,7,30,4,0
624,3/03/2018 4:00,6,9,8,7,30,4,0
625,3/03/2018 4:05,6,9,8,7,30,4,0
626,3/03/2018 4:10,7,11,9,8,35,4,0
627,3/03/2018 4:15,8,11,10,8,37,4,0
628,3/03/2018 4:20,8,12,11,9,40,4,0
629,3/03/2018 4:25,8,12,11,9,40,4,0
630,3/03/2018 4:30,9,13,11,9,42,4,0
631,3/03/2018 4:35,9,14,12,10,45,4,0
632,3/03/2018 4:40,10,15,13,11,49,4,0
633,3/03/2018 4:45,10,15,13,11,49,4,0
634,3/03/2018 4:50,10,14,13,10,47,4,0
635,3/03/2018 4:55,9,14,12,10,45,4,0
636,3/03/2018 5:00,10,14,13,10,47,4,0
637,3/03/2018 5:05,11,16,14,11,52,4,0
638,3/03/2018 5:10,12,18,16,13,59,4,0
639,3/03/2018 5:15,13,19,17,14,63,4,0
640,3/03/2018 5:20,14,21,18,15,68,4,0
641,3/03/2018 5:25,15,22,20,16,73,4,0
642,3/03/2018 5:30,16,24,21,17,78,4,0
643,3/03/2018 5:35,18,26,23,19,86,4,0
644,3/03/2018 5:40,19,28,25,20,92,4,0
645,3/03/2018 5:45,20,29,25,21,95,4,0
646,3/03/2018 5:50,19,28,24,20,91,4,0
647,3/03/2018 5:55,18,26,23,19,86,4,0
648,3/03/2018 6:00,18,26,23,19,86,4,0
649,3/03/2018 6:05,19,27,24,20,90,4,0
650,3/03/2018 6:10,20,29,26,21,96,4,0
651,3/03/2018 6:15,21,31,27,22,101,4,0
652,3/03/2018 6:20,22,32,29,23,106,4,0
653,3/03/2018 6:25,23,34,30,24,111,4,0
654,3/03/2018 6:30,25,36,32,26,119,4,0
655,3/03/2018 6:35,26,38,34,28,126,4,0
656,3/03/2018 6:40,28,41,36,30,135,4,0
657,3/03/2018 6:45,29,42,37,30,138,4,0
658,3/03/2018 6:50,29,42,37,30,138,4,0
659,3/03/2018 6:55,27,39,35,29,130,4,0
660,3/03/2018 7:00,27,39,35,28,129,4,0
661,3/03/2018 7:05,28,40,35,29,132,4,0
662,3/03/2018 7:10,29,42,37,30,138,4,0
663,3/03/2018 7:15,31,45,39,32,147,4,0
664,3/03/2018 7:20,32,46,41,33,152,4,0
665,3/03/2018 7:25,34,49,43,35,161,4,0
666,3/03/2018 7:30,34,49,44,36,163,4,0
667,3/03/2018 7:35,37,53,47,38,175,4,0
668,3/03/2018 7:40,40,58,51,42,191,4,0
669,3/03/2018 7:45,41,59,52,43,195,4,0
670,3/03/2018 7:50,41,59,52,43,195,4,0
671,3/03/2018 7:55,40,58,51,42,191,4,0
672,3/03/2018 8:00,38,56,49,40,183,4,0
673,3/03/2018 8:05,38,56,49,40,183,4,0
674,3/03/2018 8:10,39,57,50,41,187,4,0
675,3/03/2018 8:15,40,59,52,42,193,4,0
676,3/03/2018 8:20,41,59,52,43,195,4,0
677,3/03/2018 8:25,42,61,54,44,201,4,0
678,3/03/2018 8:30,43,63,55,45,206,4,0
679,3/03/2018 8:35,46,66,59,48,219,4,0
680,3/03/2018 8:40,47,69,61,50,227,4,0
681,3/03/2018 8:45,49,71,63,52,235,4,0
682,3/03/2018 8:50,49,71,62,51,233,4,0
683,3/03/2018 8:55,47,68,60,49,224,4,0
684,3/03/2018 9:00,46,67,59,49,221,4,0
685,3/03/2018 9:05,44,64,57,47,212,4,0
686,3/03/2018 9:10,45,66,58,47,216,4,0
687,3/03/2018 9:15,47,68,60,49,224,4,0
688,3/03/2018 9:20,49,71,62,51,233,4,0
689,3/03/2018 9:25,49,71,63,51,234,4,0
690,3/03/2018 9:30,51,74,65,53,243,4,0
691,3/03/2018 9:35,51,74,65,54,244,4,0
692,3/03/2018 9:40,53,76,68,55,252,4,0
693,3/03/2018 9:45,54,78,69,56,257,4,0
694,3/03/2018 9:50,52,76,67,55,250,4,0
695,3/03/2018 9:55,51,73,65,53,242,4,0
696,3/03/2018 10:00,51,74,65,54,244,4,0
697,3/03/2018 10:05,51,75,66,54,246,4,0
698,3/03/2018 10:10,52,75,66,54,247,4,0
699,3/03/2018 10:15,52,76,67,55,250,4,0
700,3/03/2018 10:20,52,75,66,54,247,4,0
701,3/03/2018 10:25,52,76,67,55,250,4,0
702,3/03/2018 10:30,54,78,69,56,257,4,0
703,3/03/2018 10:35,55,79,70,58,262,4,0
704,3/03/2018 10:40,55,80,70,58,263,4,0
705,3/03/2018 10:45,55,80,71,58,264,4,0
706,3/03/2018 10:50,56,81,71,58,266,4,0
707,3/03/2018 10:55,55,79,70,57,261,4,0
708,3/03/2018 11:00,55,79,70,57,261,4,0
709,3/03/2018 11:05,55,80,71,58,264,4,0
710,3/03/2018 11:10,56,82,72,59,269,4,0
711,3/03/2018 11:15,57,82,73,59,271,4,0
712,3/03/2018 11:20,57,83,73,60,273,4,0
713,3/03/2018 11:25,57,83,73,60,273,4,0
714,3/03/2018 11:30,57,83,73,60,273,4,0
715,3/03/2018 11:35,58,85,75,61,279,4,0
716,3/03/2018 11:40,58,84,74,61,277,4,0
717,3/03/2018 11:45,58,84,75,61,278,4,0
718,3/03/2018 11:50,58,85,75,61,279,4,0
719,3/03/2018 11:55,57,83,73,60,273,4,0
720,3/03/2018 12:00,58,83,74,60,275,4,0
721,3/03/2018 12:05,59,86,76,62,283,4,0
722,3/03/2018 12:10,60,86,76,63,285,4,0
723,3/03/2018 12:15,60,87,77,63,287,4,0
724,3/03/2018 12:20,60,87,77,63,287,4,0
725,3/03/2018 12:25,59,86,76,62,283,4,0
726,3/03/2018 12:30,59,85,75,62,281,4,0
727,3/03/2018 12:35,58,85,75,61,279,4,0
728,3/03/2018 12:40,59,85,75,61,280,4,0
729,3/03/2018 12:45,59,86,76,62,283,4,0
730,3/03/2018 12:50,59,86,76,62,283,4,0
731,3/03/2018 12:55,58,85,75,61,279,4,0
732,3/03/2018 13:00,58,83,74,60,275,4,0
733,3/03/2018 13:05,58,85,75,61,279,4,0
734,3/03/2018 13:10,58,85,75,61,279,4,0
735,3/03/2018 13:15,59,86,76,62,283,4,0
736,3/03/2018 13:20,59,85,75,62,281,4,0
737,3/03/2018 13:25,59,86,76,62,283,4,0
738,3/03/2018 13:30,59,86,76,62,283,4,0
739,3/03/2018 13:35,58,85,75,61,279,4,0
740,3/03/2018 13:40,59,86,76,62,283,4,0
741,3/03/2018 13:45,59,85,75,61,280,4,0
742,3/03/2018 13:50,59,86,76,62,283,4,0
743,3/03/2018 13:55,57,83,73,60,273,4,0
744,3/03/2018 14:00,58,83,74,60,275,4,0
745,3/03/2018 14:05,58,84,74,61,277,4,0
746,3/03/2018 14:10,59,85,75,61,280,4,0
747,3/03/2018 14:15,59,86,76,62,283,4,0
748,3/03/2018 14:20,58,85,75,61,279,4,0
749,3/03/2018 14:25,59,86,76,62,283,4,0
750,3/03/2018 14:30,58,84,74,61,277,4,0
751,3/03/2018 14:35,60,86,76,63,285,4,0
752,3/03/2018 14:40,59,86,76,62,283,4,0
753,3/03/2018 14:45,60,87,77,63,287,4,0
754,3/03/2018 14:50,60,87,77,63,287,4,0
755,3/03/2018 14:55,59,85,75,61,280,4,0
756,3/03/2018 15:00,59,85,75,61,280,4,0
757,3/03/2018 15:05,59,85,75,62,281,4,0
758,3/03/2018 15:10,60,87,77,63,287,4,0
759,3/03/2018 15:15,60,87,77,63,287,4,0
760,3/03/2018 15:20,61,89,79,65,294,4,0
761,3/03/2018 15:25,60,87,77,63,287,4,0
762,3/03/2018 15:30,60,87,77,63,287,4,0
763,3/03/2018 15:35,61,88,78,64,291,4,0
764,3/03/2018 15:40,60,87,77,63,287,4,0
765,3/03/2018 15:45,60,87,77,63,287,4,0
766,3/03/2018 15:50,60,88,77,63,288,4,0
767,3/03/2018 15:55,60,86,76,63,285,4,0
768,3/03/2018 16:00,60,86,76,63,285,4,0
769,3/03/2018 16:05,60,86,76,63,285,4,0
770,3/03/2018 16:10,60,87,77,63,287,4,0
771,3/03/2018 16:15,60,88,77,63,288,4,0
772,3/03/2018 16:20,61,89,78,64,292,4,0
773,3/03/2018 16:25,60,87,77,63,287,4,0
774,3/03/2018 16:30,60,87,77,63,287,4,0
775,3/03/2018 16:35,60,87,77,63,287,4,0
776,3/03/2018 16:40,60,87,77,63,287,4,0
777,3/03/2018 16:45,60,87,77,63,287,4,0
778,3/03/2018 16:50,61,88,78,64,291,4,0
779,3/03/2018 16:55,58,85,75,61,279,4,0
780,3/03/2018 17:00,59,85,75,61,280,4,0
781,3/03/2018 17:05,59,85,75,62,281,4,0
782,3/03/2018 17:10,60,87,77,63,287,4,0
783,3/03/2018 17:15,60,87,77,63,287,4,0
784,3/03/2018 17:20,62,90,80,65,297,4,0
785,3/03/2018 17:25,59,86,76,62,283,4,0
786,3/03/2018 17:30,58,85,75,61,279,4,0
787,3/03/2018 17:35,58,84,75,61,278,4,0
788,3/03/2018 17:40,58,84,74,61,277,4,0
789,3/03/2018 17:45,57,82,73,59,271,4,0
790,3/03/2018 17:50,57,83,73,60,273,4,0
791,3/03/2018 17:55,56,81,72,59,268,4,0
792,3/03/2018 18:00,55,80,70,58,263,4,0
793,3/03/2018 18:05,56,81,72,59,268,4,0
794,3/03/2018 18:10,56,81,71,58,266,4,0
795,3/03/2018 18:15,55,80,70,58,263,4,0
796,3/03/2018 18:20,55,80,70,58,263,4,0
797,3/03/2018 18:25,53,77,68,56,254,4,0
798,3/03/2018 18:30,53,77,68,56,254,4,0
799,3/03/2018 18:35,52,75,66,54,247,4,0
800,3/03/2018 18:40,51,74,65,53,243,4,0
801,3/03/2018 18:45,50,73,65,53,241,4,0
802,3/03/2018 18:50,49,72,63,52,236,4,0
803,3/03/2018 18:55,49,71,63,52,235,4,0
804,3/03/2018 19:00,48,69,61,50,228,4,0
805,3/03/2018 19:05,48,70,62,50,230,4,0
806,3/03/2018 19:10,47,68,60,49,224,4,0
807,3/03/2018 19:15,48,69,61,50,228,4,0
808,3/03/2018 19:20,46,67,59,49,221,4,0
809,3/03/2018 19:25,45,65,57,47,214,4,0
810,3/03/2018 19:30,44,64,56,46,210,4,0
811,3/03/2018 19:35,43,62,55,45,205,4,0
812,3/03/2018 19:40,43,63,55,45,206,4,0
813,3/03/2018 19:45,42,61,54,44,201,4,0
814,3/03/2018 19:50,41,60,53,43,197,4,0
815,3/03/2018 19:55,40,58,51,42,191,4,0
816,3/03/2018 20:00,41,59,52,43,195,4,0
817,3/03/2018 20:05,40,57,51,41,189,4,0
818,3/03/2018 20:10,39,57,50,41,187,4,0
819,3/03/2018 20:15,39,57,50,41,187,4,0
820,3/03/2018 20:20,38,56,49,40,183,4,0
821,3/03/2018 20:25,38,55,49,40,182,4,0
822,3/03/2018 20:30,37,54,48,39,178,4,0
823,3/03/2018 20:35,37,54,48,39,178,4,0
824,3/03/2018 20:40,38,55,48,40,181,4,0
825,3/03/2018 20:45,37,54,47,39,177,4,0
826,3/03/2018 20:50,36,52,46,38,172,4,0
827,3/03/2018 20:55,36,53,47,38,174,4,0
828,3/03/2018 21:00,36,52,46,37,171,4,0
829,3/03/2018 21:05,36,52,46,38,172,4,0
830,3/03/2018 21:10,35,51,45,37,168,4,0
831,3/03/2018 21:15,36,52,46,38,172,4,0
832,3/03/2018 21:20,36,52,46,37,171,4,0
833,3/03/2018 21:25,35,51,45,37,168,4,0
834,3/03/2018 21:30,35,51,45,37,168,4,0
835,3/03/2018 21:35,35,51,45,37,168,4,0
836,3/03/2018 21:40,36,52,46,37,171,4,0
837,3/03/2018 21:45,36,52,46,37,171,4,0
838,3/03/2018 21:50,34,50,44,36,164,4,0
839,3/03/2018 21:55,34,49,44,36,163,4,0
840,3/03/2018 22:00,34,49,44,36,163,4,0
841,3/03/2018 22:05,35,50,44,36,165,4,0
842,3/03/2018 22:10,36,52,46,37,171,4,0
843,3/03/2018 22:15,35,50,44,36,165,4,0
844,3/03/2018 22:20,35,50,44,36,165,4,0
845,3/03/2018 22:25,34,49,43,36,162,4,0
846,3/03/2018 22:30,34,49,43,35,161,4,0
847,3/03/2018 22:35,33,48,43,35,159,4,0
848,3/03/2018 22:40,33,48,42,34,157,4,0
849,3/03/2018 22:45,32,46,41,33,152,4,0
850,3/03/2018 22:50,31,45,40,33,149,4,0
851,3/03/2018 22:55,29,42,37,31,139,4,0
852,3/03/2018 23:00,28,41,36,30,135,4,0
853,3/03/2018 23:05,29,42,37,31,139,4,0
854,3/03/2018 23:10,29,42,37,31,139,4,0
855,3/03/2018 23:15,28,41,36,30,135,4,0
856,3/03/2018 23:20,29,42,37,31,139,4,0
857,3/03/2018 23:25,27,39,35,29,130,4,0
858,3/03/2018 23:30,27,39,35,29,130,4,0
859,3/03/2018 23:35,26,37,33,27,123,4,0
860,3/03/2018 23:40,25,37,32,27,121,4,0
861,3/03/2018 23:45,25,36,32,26,119,4,0
862,3/03/2018 23:50,24,34,30,25,113,4,0
863,3/03/2018 23:55,23,33,29,24,109,4,0
864,3/04/2018 0:00,22,31,28,23,104,4,0
865,3/04/2018 0:05,21,31,27,22,101,4,0
866,3/04/2018 0:10,21,30,27,22,100,4,0
867,3/04/2018 0:15,20,29,26,21,96,4,0
868,3/04/2018 0:20,19,28,25,20,92,4,0
869,3/04/2018 0:25,19,27,24,20,90,4,0
870,3/04/2018 0:30,17,25,22,18,82,4,0
871,3/04/2018 0:35,17,25,22,18,82,4,0
872,3/04/2018 0:40,17,24,21,17,79,4,0
873,3/04/2018 0:45,16,23,20,17,76,4,0
874,3/04/2018 0:50,16,23,20,16,75,4,0
875,3/04/2018 0:55,14,21,18,15,68,4,0
876,3/04/2018 1:00,14,21,18,15,68,4,0
877,3/04/2018 1:05,14,20,17,14,65,4,0
878,3/04/2018 1:10,14,20,17,14,65,4,0
879,3/04/2018 1:15,13,19,17,14,63,4,0
880,3/04/2018 1:20,14,20,17,14,65,4,0
881,3/04/2018 1:25,12,18,16,13,59,4,0
882,3/04/2018 1:30,12,18,16,13,59,4,0
883,3/04/2018 1:35,12,18,16,13,59,4,0
884,3/04/2018 1:40,12,18,16,13,59,4,0
885,3/04/2018 1:45,12,17,15,13,57,4,0
886,3/04/2018 1:50,12,17,15,12,56,4,0
887,3/04/2018 1:55,11,16,14,12,53,4,0
888,3/04/2018 2:00,12,17,15,12,56,4,0
889,3/04/2018 2:05,12,17,15,12,56,4,0
890,3/04/2018 2:10,11,16,14,12,53,4,0
891,3/04/2018 2:15,11,15,14,11,51,4,0
892,3/04/2018 2:20,11,15,14,11,51,4,0
893,3/04/2018 2:25,10,14,12,10,46,4,0
894,3/04/2018 2:30,9,13,12,9,43,4,0
895,3/04/2018 2:35,9,13,11,9,42,4,0
896,3/04/2018 2:40,8,12,10,8,38,4,0
897,3/04/2018 2:45,8,11,10,8,37,4,0
898,3/04/2018 2:50,8,11,10,8,37,4,0
899,3/04/2018 2:55,7,10,9,7,33,4,0
900,3/04/2018 3:00,7,10,9,7,33,4,0
901,3/04/2018 3:05,7,10,9,7,33,4,0
902,3/04/2018 3:10,6,9,8,7,30,4,0
903,3/04/2018 3:15,6,9,8,7,30,4,0
904,3/04/2018 3:20,6,9,8,7,30,4,0
905,3/04/2018 3:25,6,8,8,6,28,4,0
906,3/04/2018 3:30,6,8,8,6,28,4,0
907,3/04/2018 3:35,6,8,8,6,28,4,0
908,3/04/2018 3:40,5,8,7,5,25,4,0
909,3/04/2018 3:45,5,8,7,6,26,4,0
910,3/04/2018 3:50,5,8,7,5,25,4,0
911,3/04/2018 3:55,5,7,6,5,23,4,0
912,3/04/2018 4:00,5,7,6,5,23,4,0
913,3/04/2018 4:05,5,7,6,5,23,4,0
914,3/04/2018 4:10,5,7,6,5,23,4,0
915,3/04/2018 4:15,5,7,6,5,23,4,0
916,3/04/2018 4:20,5,7,6,5,23,4,0
917,3/04/2018 4:25,5,7,6,5,23,4,0
918,3/04/2018 4:30,5,7,6,5,23,4,0
919,3/04/2018 4:35,5,8,7,6,26,4,0
920,3/04/2018 4:40,5,8,7,6,26,4,0
921,3/04/2018 4:45,6,8,7,6,27,4,0
922,3/04/2018 4:50,6,8,8,6,28,4,0
923,3/04/2018 4:55,6,8,7,6,27,4,0
924,3/04/2018 5:00,6,8,7,6,27,4,0
925,3/04/2018 5:05,6,9,8,7,30,4,0
926,3/04/2018 5:10,6,9,8,7,30,4,0
927,3/04/2018 5:15,7,10,9,7,33,4,0
928,3/04/2018 5:20,7,11,9,8,35,4,0
929,3/04/2018 5:25,8,11,10,8,37,4,0
930,3/04/2018 5:30,9,12,11,9,41,4,0
931,3/04/2018 5:35,9,13,12,9,43,4,0
932,3/04/2018 5:40,10,14,12,10,46,4,0
933,3/04/2018 5:45,10,14,13,10,47,4,0
934,3/04/2018 5:50,10,14,12,10,46,4,0
935,3/04/2018 5:55,9,13,12,10,44,4,0
936,3/04/2018 6:00,9,14,12,10,45,4,0
937,3/04/2018 6:05,10,15,13,11,49,4,0
938,3/04/2018 6:10,11,15,14,11,51,4,0
939,3/04/2018 6:15,12,17,15,12,56,4,0
940,3/04/2018 6:20,12,18,16,13,59,4,0
941,3/04/2018 6:25,13,18,16,13,60,4,0
942,3/04/2018 6:30,13,19,17,14,63,4,0
943,3/04/2018 6:35,14,20,18,14,66,4,0
944,3/04/2018 6:40,15,21,19,15,70,4,0
945,3/04/2018 6:45,15,21,19,15,70,4,0
946,3/04/2018 6:50,15,22,20,16,73,4,0
947,3/04/2018 6:55,14,21,18,15,68,4,0
948,3/04/2018 7:00,14,20,18,14,66,4,0
949,3/04/2018 7:05,14,21,18,15,68,4,0
950,3/04/2018 7:10,15,22,20,16,73,4,0
951,3/04/2018 7:15,16,23,20,17,76,4,0
952,3/04/2018 7:20,17,25,22,18,82,4,0
953,3/04/2018 7:25,18,25,23,18,84,4,0
954,3/04/2018 7:30,18,26,23,19,86,4,0
955,3/04/2018 7:35,19,28,25,20,92,4,0
956,3/04/2018 7:40,21,30,27,22,100,4,0
957,3/04/2018 7:45,21,31,27,22,101,4,0
958,3/04/2018 7:50,22,32,28,23,105,4,0
959,3/04/2018 7:55,22,31,28,23,104,4,0
960,3/04/2018 8:00,21,30,27,22,100,4,0
961,3/04/2018 8:05,22,31,28,23,104,4,0
962,3/04/2018 8:10,22,32,29,23,106,4,0
963,3/04/2018 8:15,24,34,30,25,113,4,0
964,3/04/2018 8:20,26,37,33,27,123,4,0
965,3/04/2018 8:25,26,37,33,27,123,4,0
966,3/04/2018 8:30,26,38,34,27,125,4,0
967,3/04/2018 8:35,28,40,36,29,133,4,0
968,3/04/2018 8:40,29,42,38,31,140,4,0
969,3/04/2018 8:45,31,44,39,32,146,4,0
970,3/04/2018 8:50,31,45,40,33,149,4,0
971,3/04/2018 8:55,31,45,40,33,149,4,0
972,3/04/2018 9:00,30,44,39,32,145,4,0
973,3/04/2018 9:05,30,44,39,32,145,4,0
974,3/04/2018 9:10,31,46,40,33,150,4,0
975,3/04/2018 9:15,33,48,42,35,158,4,0
976,3/04/2018 9:20,35,50,44,36,165,4,0
977,3/04/2018 9:25,35,51,45,37,168,4,0
978,3/04/2018 9:30,37,53,47,39,176,4,0
979,3/04/2018 9:35,39,56,50,41,186,4,0
980,3/04/2018 9:40,40,58,51,42,191,4,0
981,3/04/2018 9:45,41,60,53,43,197,4,0
982,3/04/2018 9:50,41,60,53,43,197,4,0
983,3/04/2018 9:55,41,59,53,43,196,4,0
984,3/04/2018 10:00,41,59,52,43,195,4,0
985,3/04/2018 10:05,40,58,51,42,191,4,0
986,3/04/2018 10:10,41,59,53,43,196,4,0
987,3/04/2018 10:15,43,62,55,45,205,4,0
988,3/04/2018 10:20,43,62,55,45,205,4,0
989,3/04/2018 10:25,44,64,56,46,210,4,0
990,3/04/2018 10:30,45,65,57,47,214,4,0
991,3/04/2018 10:35,45,65,57,47,214,4,0
992,3/04/2018 10:40,47,68,60,49,224,4,0
993,3/04/2018 10:45,47,68,60,49,224,4,0
994,3/04/2018 10:50,47,68,60,49,224,4,0
995,3/04/2018 10:55,47,68,60,49,224,4,0
996,3/04/2018 11:00,46,66,58,48,218,4,0
997,3/04/2018 11:05,46,66,58,48,218,4,0
998,3/04/2018 11:10,46,66,59,48,219,4,0
999,3/04/2018 11:15,46,67,59,49,221,4,0
1000,3/04/2018 11:20,48,69,61,50,228,4,0
1001,3/04/2018 11:25,48,69,61,50,228,4,0
1002,3/04/2018 11:30,48,70,62,51,231,4,0
1003,3/04/2018 11:35,48,70,62,51,231,4,0
1004,3/04/2018 11:40,50,72,64,52,238,4,0
1005,3/04/2018 11:45,50,72,64,52,238,4,0
1006,3/04/2018 11:50,50,72,64,52,238,4,0
1007,3/04/2018 11:55,49,72,63,52,236,4,0
1008,3/04/2018 12:00,49,70,62,51,232,4,0
1009,3/04/2018 12:05,49,70,62,51,232,4,0
1010,3/04/2018 12:10,50,72,64,52,238,4,0
1011,3/04/2018 12:15,51,73,65,53,242,4,0
1012,3/04/2018 12:20,50,73,65,53,241,4,0
1013,3/04/2018 12:25,50,73,64,52,239,4,0
1014,3/04/2018 12:30,51,74,66,54,245,4,0
1015,3/04/2018 12:35,51,74,66,54,245,4,0
1016,3/04/2018 12:40,52,76,67,55,250,4,0
1017,3/04/2018 12:45,54,79,70,57,260,4,0
1018,3/04/2018 12:50,53,77,68,56,254,4,0
1019,3/04/2018 12:55,54,79,70,57,260,4,0
1020,3/04/2018 13:00,52,76,67,55,250,4,0
1021,3/04/2018 13:05,53,76,68,55,252,4,0
1022,3/04/2018 13:10,53,77,68,56,254,4,0
1023,3/04/2018 13:15,53,77,68,56,254,4,0
1024,3/04/2018 13:20,53,77,68,56,254,4,0
1025,3/04/2018 13:25,53,77,68,56,254,4,0
1026,3/04/2018 13:30,53,77,68,56,254,4,0
1027,3/04/2018 13:35,53,77,68,56,254,4,0
1028,3/04/2018 13:40,52,75,66,54,247,4,0
1029,3/04/2018 13:45,52,75,66,54,247,4,0
1030,3/04/2018 13:50,52,76,67,55,250,4,0
1031,3/04/2018 13:55,53,76,68,55,252,4,0
1032,3/04/2018 14:00,52,76,67,55,250,4,0
1033,3/04/2018 14:05,52,76,67,55,250,4,0
1034,3/04/2018 14:10,52,76,67,55,250,4,0
1035,3/04/2018 14:15,53,76,68,55,252,4,0
1036,3/04/2018 14:20,53,77,68,56,254,4,0
1037,3/04/2018 14:25,53,77,68,56,254,4,0
1038,3/04/2018 14:30,52,76,67,55,250,4,0
1039,3/04/2018 14:35,53,77,68,56,254,4,0
1040,3/04/2018 14:40,52,76,67,55,250,4,0
1041,3/04/2018 14:45,53,76,68,55,252,4,0
1042,3/04/2018 14:50,52,76,67,55,250,4,0
1043,3/04/2018 14:55,53,77,68,56,254,4,0
1044,3/04/2018 15:00,52,76,67,55,250,4,0
1045,3/04/2018 15:05,52,76,67,55,250,4,0
1046,3/04/2018 15:10,53,77,68,56,254,4,0
1047,3/04/2018 15:15,54,78,69,57,258,4,0
1048,3/04/2018 15:20,53,77,68,56,254,4,0
1049,3/04/2018 15:25,53,77,68,56,254,4,0
1050,3/04/2018 15:30,52,76,67,55,250,4,0
1051,3/04/2018 15:35,52,76,67,55,250,4,0
1052,3/04/2018 15:40,52,75,66,54,247,4,0
1053,3/04/2018 15:45,51,75,66,54,246,4,0
1054,3/04/2018 15:50,50,72,64,52,238,4,0
1055,3/04/2018 15:55,51,73,65,53,242,4,0
1056,3/04/2018 16:00,50,73,65,53,241,4,0
1057,3/04/2018 16:05,52,75,66,54,247,4,0
1058,3/04/2018 16:10,54,79,70,57,260,4,0
1059,3/04/2018 16:15,54,79,70,57,260,4,0
1060,3/04/2018 16:20,52,76,67,55,250,4,0
1061,3/04/2018 16:25,52,76,67,55,250,4,0
1062,3/04/2018 16:30,52,76,67,55,250,4,0
1063,3/04/2018 16:35,52,76,67,55,250,4,0
1064,3/04/2018 16:40,53,76,68,55,252,4,0
1065,3/04/2018 16:45,52,76,67,55,250,4,0
1066,3/04/2018 16:50,53,77,68,56,254,4,0
1067,3/04/2018 16:55,53,77,68,56,254,4,0
1068,3/04/2018 17:00,51,74,66,54,245,4,0
1069,3/04/2018 17:05,52,76,67,55,250,4,0
1070,3/04/2018 17:10,53,77,68,56,254,4,0
1071,3/04/2018 17:15,53,76,68,55,252,4,0
1072,3/04/2018 17:20,54,78,69,56,257,4,0
1073,3/04/2018 17:25,52,76,67,55,250,4,0
1074,3/04/2018 17:30,52,76,67,55,250,4,0
1075,3/04/2018 17:35,52,75,66,54,247,4,0
1076,3/04/2018 17:40,52,76,67,55,250,4,0
1077,3/04/2018 17:45,51,74,65,53,243,4,0
1078,3/04/2018 17:50,51,74,65,54,244,4,0
1079,3/04/2018 17:55,50,73,64,52,239,4,0
1080,3/04/2018 18:00,49,70,62,51,232,4,0
1081,3/04/2018 18:05,48,70,62,50,230,4,0
1082,3/04/2018 18:10,48,70,62,50,230,4,0
1083,3/04/2018 18:15,51,73,65,53,242,4,0
1084,3/04/2018 18:20,50,73,65,53,241,4,0
1085,3/04/2018 18:25,47,69,61,50,227,4,0
1086,3/04/2018 18:30,47,68,60,49,224,4,0
1087,3/04/2018 18:35,46,66,59,48,219,4,0
1088,3/04/2018 18:40,45,66,58,48,217,4,0
1089,3/04/2018 18:45,45,66,58,47,216,4,0
1090,3/04/2018 18:50,45,65,57,47,214,4,0
1091,3/04/2018 18:55,44,64,56,46,210,4,0
1092,3/04/2018 19:00,43,62,55,45,205,4,0
1093,3/04/2018 19:05,43,62,55,45,205,4,0
1094,3/04/2018 19:10,42,62,54,45,203,4,0
1095,3/04/2018 19:15,42,62,54,45,203,4,0
1096,3/04/2018 19:20,43,62,55,45,205,4,0
1097,3/04/2018 19:25,42,61,54,44,201,4,0
1098,3/04/2018 19:30,41,60,53,43,197,4,0
1099,3/04/2018 19:35,40,59,52,42,193,4,0
1100,3/04/2018 19:40,40,58,51,42,191,4,0
1101,3/04/2018 19:45,40,58,51,42,191,4,0
1102,3/04/2018 19:50,38,56,49,40,183,4,0
1103,3/04/2018 19:55,38,56,49,40,183,4,0
1104,3/04/2018 20:00,38,55,48,40,181,4,0
1105,3/04/2018 20:05,39,56,50,41,186,4,0
1106,3/04/2018 20:10,38,55,49,40,182,4,0
1107,3/04/2018 20:15,38,55,48,40,181,4,0
1108,3/04/2018 20:20,38,56,49,40,183,4,0
1109,3/04/2018 20:25,38,55,49,40,182,4,0
1110,3/04/2018 20:30,37,54,47,39,177,4,0
1111,3/04/2018 20:35,35,51,45,37,168,4,0
1112,3/04/2018 20:40,35,51,45,37,168,4,0
1113,3/04/2018 20:45,34,49,44,36,163,4,0
1114,3/04/2018 20:50,34,50,44,36,164,4,0
1115,3/04/2018 20:55,33,48,42,35,158,4,0
1116,3/04/2018 21:00,32,46,41,33,152,4,0
1117,3/04/2018 21:05,32,46,41,34,153,4,0
1118,3/04/2018 21:10,32,46,41,34,153,4,0
1119,3/04/2018 21:15,32,46,41,34,153,4,0
1120,3/04/2018 21:20,32,47,42,34,155,4,0
1121,3/04/2018 21:25,31,45,40,33,149,4,0
1122,3/04/2018 21:30,31,45,40,32,148,4,0
1123,3/04/2018 21:35,30,44,39,32,145,4,0
1124,3/04/2018 21:40,31,44,39,32,146,4,0
1125,3/04/2018 21:45,30,43,38,31,142,4,0
1126,3/04/2018 21:50,29,42,38,31,140,4,0
1127,3/04/2018 21:55,28,40,35,29,132,4,0
1128,3/04/2018 22:00,27,40,35,29,131,4,0
1129,3/04/2018 22:05,27,39,35,29,130,4,0
1130,3/04/2018 22:10,27,39,34,28,128,4,0
1131,3/04/2018 22:15,27,39,34,28,128,4,0
1132,3/04/2018 22:20,26,37,33,27,123,4,0
1133,3/04/2018 22:25,25,36,32,26,119,4,0
1134,3/04/2018 22:30,23,33,29,24,109,4,0
1135,3/04/2018 22:35,23,33,29,24,109,4,0
1136,3/04/2018 22:40,23,33,29,24,109,4,0
1137,3/04/2018 22:45,22,32,29,23,106,4,0
1138,3/04/2018 22:50,20,29,26,21,96,4,0
1139,3/04/2018 22:55,19,27,24,20,90,4,0
1140,3/04/2018 23:00,18,26,23,19,86,4,0
1141,3/04/2018 23:05,18,26,23,19,86,4,0
1142,3/04/2018 23:10,18,26,23,19,86,4,0
1143,3/04/2018 23:15,17,25,22,18,82,4,0
1144,3/04/2018 23:20,17,25,22,18,82,4,0
1145,3/04/2018 23:25,16,23,20,17,76,4,0
1146,3/04/2018 23:30,15,22,20,16,73,4,0
1147,3/04/2018 23:35,15,21,19,15,70,4,0
1148,3/04/2018 23:40,14,21,18,15,68,4,0
1149,3/04/2018 23:45,13,19,17,14,63,4,0
1150,3/04/2018 23:50,13,19,16,13,61,4,0
1151,3/04/2018 23:55,12,17,15,13,57,4,0
1152,3/05/2018 0:00,11,16,14,12,53,4,0
1153,3/05/2018 0:05,11,16,14,11,52,4,0
1154,3/05/2018 0:10,11,15,14,11,51,4,0
1155,3/05/2018 0:15,10,15,13,11,49,4,0
1156,3/05/2018 0:20,10,15,13,11,49,4,0
1157,3/05/2018 0:25,9,14,12,10,45,4,0
1158,3/05/2018 0:30,9,13,12,9,43,4,0
1159,3/05/2018 0:35,8,12,11,9,40,4,0
1160,3/05/2018 0:40,8,12,10,9,39,4,0
1161,3/05/2018 0:45,8,12,10,8,38,4,0
1162,3/05/2018 0:50,8,11,10,8,37,4,0
1163,3/05/2018 0:55,7,11,9,8,35,4,0
1164,3/05/2018 1:00,6,9,8,7,30,4,0
1165,3/05/2018 1:05,6,9,8,7,30,4,0
1166,3/05/2018 1:10,6,9,8,6,29,4,0
1167,3/05/2018 1:15,6,9,8,7,30,4,0
1168,3/05/2018 1:20,6,9,8,6,29,4,0
1169,3/05/2018 1:25,6,8,8,6,28,4,0
1170,3/05/2018 1:30,6,8,8,6,28,4,0
1171,3/05/2018 1:35,6,8,7,6,27,4,0
1172,3/05/2018 1:40,6,8,7,6,27,4,0
1173,3/05/2018 1:45,6,8,7,6,27,4,0
1174,3/05/2018 1:50,5,8,7,6,26,4,0
1175,3/05/2018 1:55,5,8,7,6,26,4,0
1176,3/05/2018 2:00,5,8,7,5,25,4,0
1177,3/05/2018 2:05,5,8,7,5,25,4,0
1178,3/05/2018 2:10,5,8,7,6,26,4,0
1179,3/05/2018 2:15,5,8,7,5,25,4,0
1180,3/05/2018 2:20,5,8,7,5,25,4,0
1181,3/05/2018 2:25,5,7,6,5,23,4,0
1182,3/05/2018 2:30,5,7,6,5,23,4,0
1183,3/05/2018 2:35,5,7,6,5,23,4,0
1184,3/05/2018 2:40,5,7,6,5,23,4,0
1185,3/05/2018 2:45,5,7,6,5,23,4,0
1186,3/05/2018 2:50,5,7,6,5,23,4,0
1187,3/05/2018 2:55,5,7,6,5,23,4,0
1188,3/05/2018 3:00,5,7,6,5,23,4,0
1189,3/05/2018 3:05,5,7,6,5,23,4,0
1190,3/05/2018 3:10,5,7,6,5,23,4,0
1191,3/05/2018 3:15,5,7,6,5,23,4,0
1192,3/05/2018 3:20,5,8,7,6,26,4,0
1193,3/05/2018 3:25,5,8,7,6,26,4,0
1194,3/05/2018 3:30,6,8,8,6,28,4,0
1195,3/05/2018 3:35,6,9,8,7,30,4,0
1196,3/05/2018 3:40,7,10,9,7,33,4,0
1197,3/05/2018 3:45,7,10,9,7,33,4,0
1198,3/05/2018 3:50,6,9,8,7,30,4,0
1199,3/05/2018 3:55,6,9,8,7,30,4,0
1200,3/05/2018 4:00,7,10,9,7,33,4,0
1201,3/05/2018 4:05,7,11,9,8,35,4,0
1202,3/05/2018 4:10,8,12,10,8,38,4,0
1203,3/05/2018 4:15,9,13,12,9,43,4,0
1204,3/05/2018 4:20,10,15,13,11,49,4,0
1205,3/05/2018 4:25,11,16,14,12,53,4,0
1206,3/05/2018 4:30,12,18,16,13,59,4,0
1207,3/05/2018 4:35,15,21,19,15,70,4,0
1208,3/05/2018 4:40,15,22,20,16,73,4,0
1209,3/05/2018 4:45,16,23,20,17,76,4,0
1210,3/05/2018 4:50,17,24,21,18,80,4,0
1211,3/05/2018 4:55,17,25,22,18,82,4,0
1212,3/05/2018 5:00,18,26,23,19,86,4,0
1213,3/05/2018 5:05,21,31,27,22,101,4,0
1214,3/05/2018 5:10,25,36,32,26,119,4,0
1215,3/05/2018 5:15,28,41,36,29,134,4,0
1216,3/05/2018 5:20,32,46,40,33,151,4,0
1217,3/05/2018 5:25,33,49,43,35,160,4,0
1218,3/05/2018 5:30,38,56,49,40,183,4,0
1219,3/05/2018 5:35,42,61,54,44,201,4,0
1220,3/05/2018 5:40,44,64,57,47,212,4,0
1221,3/05/2018 5:45,46,66,59,48,219,4,0
1222,3/05/2018 5:50,47,68,60,49,224,4,0
1223,3/05/2018 5:55,46,67,59,49,221,4,0
1224,3/05/2018 6:00,43,63,55,45,206,4,0
1225,3/05/2018 6:05,46,67,59,48,220,4,0
1226,3/05/2018 6:10,50,72,64,52,238,4,0
1227,3/05/2018 6:15,53,77,68,56,254,4,0
1228,3/05/2018 6:20,56,81,72,59,268,4,0
1229,3/05/2018 6:25,57,83,73,60,273,4,0
1230,3/05/2018 6:30,59,86,76,62,283,4,0
1231,3/05/2018 6:35,62,90,80,65,297,4,0
1232,3/05/2018 6:40,68,98,87,71,324,4,0
1233,3/05/2018 6:45,69,100,88,72,329,4,0
1234,3/05/2018 6:50,69,100,88,72,329,4,0
1235,3/05/2018 6:55,63,92,81,67,303,4,0
1236,3/05/2018 7:00,62,90,79,65,296,4,0
1237,3/05/2018 7:05,63,91,80,66,300,4,0
1238,3/05/2018 7:10,66,96,84,69,315,4,0
1239,3/05/2018 7:15,67,98,86,71,322,4,0
1240,3/05/2018 7:20,69,101,89,73,332,4,0
1241,3/05/2018 7:25,69,100,88,72,329,4,0
1242,3/05/2018 7:30,73,106,94,77,350,4,0
1243,3/05/2018 7:35,73,106,94,77,350,4,0
1244,3/05/2018 7:40,70,102,90,74,336,4,0
1245,3/05/2018 7:45,69,100,88,72,329,4,0
1246,3/05/2018 7:50,68,99,87,71,325,4,0
1247,3/05/2018 7:55,67,97,86,70,320,4,0
1248,3/05/2018 8:00,64,93,83,68,308,4,0
1249,3/05/2018 8:05,65,94,83,68,310,4,0
1250,3/05/2018 8:10,65,95,84,68,312,4,0
1251,3/05/2018 8:15,69,100,89,73,331,4,0
1252,3/05/2018 8:20,70,101,89,73,333,4,0
1253,3/05/2018 8:25,66,96,85,70,317,4,0
1254,3/05/2018 8:30,62,90,79,65,296,4,0
1255,3/05/2018 8:35,61,88,78,64,291,4,0
1256,3/05/2018 8:40,61,88,78,64,291,4,0
1257,3/05/2018 8:45,60,87,77,63,287,4,0
1258,3/05/2018 8:50,58,85,75,61,279,4,0
1259,3/05/2018 8:55,56,81,72,59,268,4,0
1260,3/05/2018 9:00,54,79,70,57,260,4,0
1261,3/05/2018 9:05,53,77,68,56,254,4,0
1262,3/05/2018 9:10,53,77,68,56,254,4,0
1263,3/05/2018 9:15,53,76,68,55,252,4,0
1264,3/05/2018 9:20,54,78,69,56,257,4,0
1265,3/05/2018 9:25,54,79,69,57,259,4,0
1266,3/05/2018 9:30,54,79,69,57,259,4,0
1267,3/05/2018 9:35,53,77,68,56,254,4,0
1268,3/05/2018 9:40,54,78,69,56,257,4,0
1269,3/05/2018 9:45,53,77,68,56,254,4,0
1270,3/05/2018 9:50,53,76,68,55,252,4,0
1271,3/05/2018 9:55,52,75,66,54,247,4,0
1272,3/05/2018 10:00,51,74,65,54,244,4,0
1273,3/05/2018 10:05,51,74,65,54,244,4,0
1274,3/05/2018 10:10,51,74,65,54,244,4,0
1275,3/05/2018 10:15,51,74,65,53,243,4,0
1276,3/05/2018 10:20,51,73,65,53,242,4,0
1277,3/05/2018 10:25,52,75,66,54,247,4,0
1278,3/05/2018 10:30,51,73,65,53,242,4,0
1279,3/05/2018 10:35,51,74,65,53,243,4,0
1280,3/05/2018 10:40,51,75,66,54,246,4,0
1281,3/05/2018 10:45,51,74,66,54,245,4,0
1282,3/05/2018 10:50,51,74,65,54,244,4,0
1283,3/05/2018 10:55,51,74,66,54,245,4,0
1284,3/05/2018 11:00,50,73,65,53,241,4,0
1285,3/05/2018 11:05,51,74,65,53,243,4,0
1286,3/05/2018 11:10,50,73,65,53,241,4,0
1287,3/05/2018 11:15,50,73,64,53,240,4,0
1288,3/05/2018 11:20,51,73,65,53,242,4,0
1289,3/05/2018 11:25,51,74,65,54,244,4,0
1290,3/05/2018 11:30,52,75,66,54,247,4,0
1291,3/05/2018 11:35,52,76,67,55,250,4,0
1292,3/05/2018 11:40,53,77,68,56,254,4,0
1293,3/05/2018 11:45,52,76,67,55,250,4,0
1294,3/05/2018 11:50,52,76,67,55,250,4,0
1295,3/05/2018 11:55,52,75,66,54,247,4,0
1296,3/05/2018 12:00,51,75,66,54,246,4,0
1297,3/05/2018 12:05,52,76,67,55,250,4,0
1298,3/05/2018 12:10,52,76,67,55,250,4,0
1299,3/05/2018 12:15,54,78,69,56,257,4,0
1300,3/05/2018 12:20,53,77,68,56,254,4,0
1301,3/05/2018 12:25,53,76,68,55,252,4,0
1302,3/05/2018 12:30,52,76,67,55,250,4,0
1303,3/05/2018 12:35,53,77,68,56,254,4,0
1304,3/05/2018 12:40,54,78,69,56,257,4,0
1305,3/05/2018 12:45,54,78,69,57,258,4,0
1306,3/05/2018 12:50,53,77,68,56,254,4,0
1307,3/05/2018 12:55,53,77,68,56,254,4,0
1308,3/05/2018 13:00,52,76,67,55,250,4,0
1309,3/05/2018 13:05,52,76,67,55,250,4,0
1310,3/05/2018 13:10,54,78,69,56,257,4,0
1311,3/05/2018 13:15,52,76,67,55,250,4,0
1312,3/05/2018 13:20,54,78,69,56,257,4,0
1313,3/05/2018 13:25,53,77,68,56,254,4,0
1314,3/05/2018 13:30,54,78,69,56,257,4,0
1315,3/05/2018 13:35,55,79,70,58,262,4,0
1316,3/05/2018 13:40,55,80,70,58,263,4,0
1317,3/05/2018 13:45,56,82,72,59,269,4,0
1318,3/05/2018 13:50,55,80,71,58,264,4,0
1319,3/05/2018 13:55,55,80,71,58,264,4,0
1320,3/05/2018 14:00,55,80,71,58,264,4,0
1321,3/05/2018 14:05,56,82,72,59,269,4,0
1322,3/05/2018 14:10,58,84,74,61,277,4,0
1323,3/05/2018 14:15,58,84,75,61,278,4,0
1324,3/05/2018 14:20,58,84,74,61,277,4,0
1325,3/05/2018 14:25,57,83,73,60,273,4,0
1326,3/05/2018 14:30,60,86,76,63,285,4,0
1327,3/05/2018 14:35,61,88,78,64,291,4,0
1328,3/05/2018 14:40,64,93,82,67,306,4,0
1329,3/05/2018 14:45,64,93,82,67,306,4,0
1330,3/05/2018 14:50,64,93,82,67,306,4,0
1331,3/05/2018 14:55,63,92,81,67,303,4,0
1332,3/05/2018 15:00,63,92,81,66,302,4,0
1333,3/05/2018 15:05,64,93,83,68,308,4,0
1334,3/05/2018 15:10,65,94,83,68,310,4,0
1335,3/05/2018 15:15,66,96,85,70,317,4,0
1336,3/05/2018 15:20,65,95,84,68,312,4,0
1337,3/05/2018 15:25,65,95,84,69,313,4,0
1338,3/05/2018 15:30,66,95,84,69,314,4,0
1339,3/05/2018 15:35,68,99,87,71,325,4,0
1340,3/05/2018 15:40,73,105,93,76,347,4,0
1341,3/05/2018 15:45,73,105,93,76,347,4,0
1342,3/05/2018 15:50,71,103,91,75,340,4,0
1343,3/05/2018 15:55,69,101,89,73,332,4,0
1344,3/05/2018 16:00,67,97,86,70,320,4,0
1345,3/05/2018 16:05,69,100,88,72,329,4,0
1346,3/05/2018 16:10,71,103,91,74,339,4,0
1347,3/05/2018 16:15,72,104,92,76,344,4,0
1348,3/05/2018 16:20,71,103,91,75,340,4,0
1349,3/05/2018 16:25,70,101,89,73,333,4,0
1350,3/05/2018 16:30,68,99,88,72,327,4,0
1351,3/05/2018 16:35,71,103,91,75,340,4,0
1352,3/05/2018 16:40,73,106,94,77,350,4,0
1353,3/05/2018 16:45,73,105,93,76,347,4,0
1354,3/05/2018 16:50,72,104,92,75,343,4,0
1355,3/05/2018 16:55,69,101,89,73,332,4,0
1356,3/05/2018 17:00,69,100,88,72,329,4,0
1357,3/05/2018 17:05,72,104,92,75,343,4,0
1358,3/05/2018 17:10,75,109,96,79,359,4,0
1359,3/05/2018 17:15,75,109,96,79,359,4,0
1360,3/05/2018 17:20,74,107,95,77,353,4,0
1361,3/05/2018 17:25,72,104,92,75,343,4,0
1362,3/05/2018 17:30,69,100,89,73,331,4,0
1363,3/05/2018 17:35,70,102,90,74,336,4,0
1364,3/05/2018 17:40,70,102,90,74,336,4,0
1365,3/05/2018 17:45,69,101,89,73,332,4,0
1366,3/05/2018 17:50,68,98,87,71,324,4,0
1367,3/05/2018 17:55,66,96,85,70,317,4,0
1368,3/05/2018 18:00,65,94,83,68,310,4,0
1369,3/05/2018 18:05,64,93,82,67,306,4,0
1370,3/05/2018 18:10,65,94,83,68,310,4,0
1371,3/05/2018 18:15,64,93,82,67,306,4,0
1372,3/05/2018 18:20,63,91,80,66,300,4,0
1373,3/05/2018 18:25,61,89,79,64,293,4,0
1374,3/05/2018 18:30,60,88,77,63,288,4,0
1375,3/05/2018 18:35,58,85,75,61,279,4,0
1376,3/05/2018 18:40,58,83,74,60,275,4,0
1377,3/05/2018 18:45,56,81,72,59,268,4,0
1378,3/05/2018 18:50,54,78,69,57,258,4,0
1379,3/05/2018 18:55,51,74,66,54,245,4,0
1380,3/05/2018 19:00,49,71,63,52,235,4,0
1381,3/05/2018 19:05,50,73,64,52,239,4,0
1382,3/05/2018 19:10,50,72,64,52,238,4,0
1383,3/05/2018 19:15,49,71,63,51,234,4,0
1384,3/05/2018 19:20,47,68,60,49,224,4,0
1385,3/05/2018 19:25,47,68,60,49,224,4,0
1386,3/05/2018 19:30,46,67,59,49,221,4,0
1387,3/05/2018 19:35,45,65,57,47,214,4,0
1388,3/05/2018 19:40,41,59,53,43,196,4,0
1389,3/05/2018 19:45,40,58,51,42,191,4,0
1390,3/05/2018 19:50,38,56,49,40,183,4,0
1391,3/05/2018 19:55,36,52,46,38,172,4,0
1392,3/05/2018 20:00,35,50,44,36,165,4,0
1393,3/05/2018 20:05,36,53,47,38,174,4,0
1394,3/05/2018 20:10,36,52,46,38,172,4,0
1395,3/05/2018 20:15,36,52,46,38,172,4,0
1396,3/05/2018 20:20,35,50,44,36,165,4,0
1397,3/05/2018 20:25,33,48,43,35,159,4,0
1398,3/05/2018 20:30,33,47,42,34,156,4,0
1399,3/05/2018 20:35,32,47,41,34,154,4,0
1400,3/05/2018 20:40,32,47,41,34,154,4,0
1401,3/05/2018 20:45,33,47,42,34,156,4,0
1402,3/05/2018 20:50,28,41,36,30,135,4,0
1403,3/05/2018 20:55,28,41,36,29,134,4,0
1404,3/05/2018 21:00,29,42,38,31,140,4,0
1405,3/05/2018 21:05,31,45,39,32,147,4,0
1406,3/05/2018 21:10,31,46,40,33,150,4,0
1407,3/05/2018 21:15,32,46,40,33,151,4,0
1408,3/05/2018 21:20,31,45,39,32,147,4,0
1409,3/05/2018 21:25,30,44,39,32,145,4,0
1410,3/05/2018 21:30,29,42,38,31,140,4,0
1411,3/05/2018 21:35,29,42,37,31,139,4,0
1412,3/05/2018 21:40,29,42,37,30,138,4,0
1413,3/05/2018 21:45,28,41,36,29,134,4,0
1414,3/05/2018 21:50,27,40,35,29,131,4,0
1415,3/05/2018 21:55,27,40,35,29,131,4,0
1416,3/05/2018 22:00,26,38,34,28,126,4,0
1417,3/05/2018 22:05,26,38,34,28,126,4,0
1418,3/05/2018 22:10,27,39,34,28,128,4,0
1419,3/05/2018 22:15,26,37,33,27,123,4,0
1420,3/05/2018 22:20,24,35,31,25,115,4,0
1421,3/05/2018 22:25,23,33,29,24,109,4,0
1422,3/05/2018 22:30,22,32,28,23,105,4,0
1423,3/05/2018 22:35,22,32,28,23,105,4,0
1424,3/05/2018 22:40,21,31,27,22,101,4,0
1425,3/05/2018 22:45,20,29,25,21,95,4,0
1426,3/05/2018 22:50,19,27,24,20,90,4,0
1427,3/05/2018 22:55,18,25,23,18,84,4,0
1428,3/05/2018 23:00,17,24,21,17,79,4,0
1429,3/05/2018 23:05,17,24,21,18,80,4,0
1430,3/05/2018 23:10,17,25,22,18,82,4,0
1431,3/05/2018 23:15,17,24,21,18,80,4,0
1432,3/05/2018 23:20,15,22,19,16,72,4,0
1433,3/05/2018 23:25,14,20,18,15,67,4,0
1434,3/05/2018 23:30,14,20,18,14,66,4,0
1435,3/05/2018 23:35,14,20,18,14,66,4,0
1436,3/05/2018 23:40,14,20,17,14,65,4,0
1437,3/05/2018 23:45,13,19,17,14,63,4,0
1438,3/05/2018 23:50,12,18,16,13,59,4,0
1439,3/05/2018 23:55,11,16,14,12,53,4,0
1440,3/06/2018 0:00,10,15,13,11,49,4,0
1441,3/06/2018 0:05,10,14,12,10,46,4,0
1442,3/06/2018 0:10,10,15,13,11,49,4,0
1443,3/06/2018 0:15,11,16,14,12,53,4,0
1444,3/06/2018 0:20,12,17,15,12,56,4,0
1445,3/06/2018 0:25,11,16,14,12,53,4,0
1446,3/06/2018 0:30,10,15,13,11,49,4,0
1447,3/06/2018 0:35,10,15,13,11,49,4,0
1448,3/06/2018 0:40,10,15,13,11,49,4,0
1449,3/06/2018 0:45,10,14,12,10,46,4,0
1450,3/06/2018 0:50,9,13,12,9,43,4,0
1451,3/06/2018 0:55,9,13,11,9,42,4,0
1452,3/06/2018 1:00,8,12,10,9,39,4,0
1453,3/06/2018 1:05,8,12,10,9,39,4,0
1454,3/06/2018 1:10,8,12,10,9,39,4,0
1455,3/06/2018 1:15,8,11,10,8,37,4,0
1456,3/06/2018 1:20,8,12,10,8,38,4,0
1457,3/06/2018 1:25,7,11,9,8,35,4,0
1458,3/06/2018 1:30,8,11,10,8,37,4,0
1459,3/06/2018 1:35,8,12,10,9,39,4,0
1460,3/06/2018 1:40,8,12,11,9,40,4,0
1461,3/06/2018 1:45,8,12,10,8,38,4,0
1462,3/06/2018 1:50,8,11,10,8,37,4,0
1463,3/06/2018 1:55,7,11,9,8,35,4,0
1464,3/06/2018 2:00,7,11,9,8,35,4,0
1465,3/06/2018 2:05,10,14,13,10,47,4,0
1466,3/06/2018 2:10,11,16,14,11,52,4,0
1467,3/06/2018 2:15,8,11,10,8,37,4,0
1468,3/06/2018 2:20,7,11,9,8,35,4,0
1469,3/06/2018 2:25,7,10,9,7,33,4,0
1470,3/06/2018 2:30,7,10,9,7,33,4,0
1471,3/06/2018 2:35,7,10,9,7,33,4,0
1472,3/06/2018 2:40,7,10,9,7,33,4,0
1473,3/06/2018 2:45,7,10,9,7,33,4,0
1474,3/06/2018 2:50,6,9,8,7,30,4,0
1475,3/06/2018 2:55,6,9,8,7,30,4,0
1476,3/06/2018 3:00,6,9,8,6,29,4,0
1477,3/06/2018 3:05,6,9,8,6,29,4,0
1478,3/06/2018 3:10,6,9,8,7,30,4,0
1479,3/06/2018 3:15,7,10,9,7,33,4,0
1480,3/06/2018 3:20,7,11,9,8,35,4,0
1481,3/06/2018 3:25,7,11,9,8,35,4,0
1482,3/06/2018 3:30,8,12,10,8,38,4,0
1483,3/06/2018 3:35,8,11,10,8,37,4,0
1484,3/06/2018 3:40,8,12,10,8,38,4,0
1485,3/06/2018 3:45,8,11,10,8,37,4,0
1486,3/06/2018 3:50,8,11,10,8,37,4,0
1487,3/06/2018 3:55,8,11,10,8,37,4,0
1488,3/06/2018 4:00,8,11,10,8,37,4,0
1489,3/06/2018 4:05,8,12,10,9,39,4,0
1490,3/06/2018 4:10,9,12,11,9,41,4,0
1491,3/06/2018 4:15,9,14,12,10,45,4,0
1492,3/06/2018 4:20,10,14,13,10,47,4,0
1493,3/06/2018 4:25,10,15,13,11,49,4,0
1494,3/06/2018 4:30,11,16,14,11,52,4,0
1495,3/06/2018 4:35,12,17,15,12,56,4,0
1496,3/06/2018 4:40,11,16,14,11,52,4,0
1497,3/06/2018 4:45,12,17,15,13,57,4,0
1498,3/06/2018 4:50,12,17,15,12,56,4,0
1499,3/06/2018 4:55,13,19,17,14,63,4,0
1500,3/06/2018 5:00,14,20,17,14,65,4,0
1501,3/06/2018 5:05,15,22,19,16,72,4,0
1502,3/06/2018 5:10,17,24,21,18,80,4,0
1503,3/06/2018 5:15,19,28,24,20,91,4,0
1504,3/06/2018 5:20,21,31,27,22,101,4,0
1505,3/06/2018 5:25,24,35,31,26,116,4,0
1506,3/06/2018 5:30,28,41,36,30,135,4,0
1507,3/06/2018 5:35,30,44,39,32,145,4,0
1508,3/06/2018 5:40,33,48,42,34,157,4,0
1509,3/06/2018 5:45,34,49,44,36,163,4,0
1510,3/06/2018 5:50,36,52,46,38,172,4,0
1511,3/06/2018 5:55,38,55,49,40,182,4,0
1512,3/06/2018 6:00,38,55,49,40,182,4,0
1513,3/06/2018 6:05,37,54,48,39,178,4,0
1514,3/06/2018 6:10,41,59,52,43,195,4,0
1515,3/06/2018 6:15,43,63,56,46,208,4,0
1516,3/06/2018 6:20,52,75,66,54,247,4,0
1517,3/06/2018 6:25,52,76,67,55,250,4,0
1518,3/06/2018 6:30,54,79,70,57,260,4,0
1519,3/06/2018 6:35,55,79,70,58,262,4,0
1520,3/06/2018 6:40,58,83,74,60,275,4,0
1521,3/06/2018 6:45,59,86,76,62,283,4,0
1522,3/06/2018 6:50,59,86,76,62,283,4,0
1523,3/06/2018 6:55,52,76,67,55,250,4,0
1524,3/06/2018 7:00,51,75,66,54,246,4,0
1525,3/06/2018 7:05,60,87,77,63,287,4,0
1526,3/06/2018 7:10,61,89,79,65,294,4,0
1527,3/06/2018 7:15,63,92,81,66,302,4,0
1528,3/06/2018 7:20,63,92,81,67,303,4,0
1529,3/06/2018 7:25,65,95,84,68,312,4,0
1530,3/06/2018 7:30,65,94,83,68,310,4,0
1531,3/06/2018 7:35,65,95,84,69,313,4,0
1532,3/06/2018 7:40,66,96,85,69,316,4,0
1533,3/06/2018 7:45,66,96,84,69,315,4,0
1534,3/06/2018 7:50,66,96,85,69,316,4,0
1535,3/06/2018 7:55,64,93,82,67,306,4,0
1536,3/06/2018 8:00,61,89,79,65,294,4,0
1537,3/06/2018 8:05,56,81,71,58,266,4,0
1538,3/06/2018 8:10,54,79,70,57,260,4,0
1539,3/06/2018 8:15,52,76,67,55,250,4,0
1540,3/06/2018 8:20,60,87,77,63,287,4,0
1541,3/06/2018 8:25,55,79,70,57,261,4,0
1542,3/06/2018 8:30,53,77,68,56,254,4,0
1543,3/06/2018 8:35,54,78,69,56,257,4,0
1544,3/06/2018 8:40,56,82,72,59,269,4,0
1545,3/06/2018 8:45,57,82,73,59,271,4,0
1546,3/06/2018 8:50,56,81,72,59,268,4,0
1547,3/06/2018 8:55,53,77,68,56,254,4,0
1548,3/06/2018 9:00,50,73,65,53,241,4,0
1549,3/06/2018 9:05,50,72,64,52,238,4,0
1550,3/06/2018 9:10,49,71,63,51,234,4,0
1551,3/06/2018 9:15,44,64,57,47,212,4,0
1552,3/06/2018 9:20,45,66,58,48,217,4,0
1553,3/06/2018 9:25,48,70,62,50,230,4,0
1554,3/06/2018 9:30,48,70,62,50,230,4,0
1555,3/06/2018 9:35,49,71,62,51,233,4,0
1556,3/06/2018 9:40,49,70,62,51,232,4,0
1557,3/06/2018 9:45,48,69,61,50,228,4,0
1558,3/06/2018 9:50,46,67,59,49,221,4,0
1559,3/06/2018 9:55,43,62,55,45,205,4,0
1560,3/06/2018 10:00,43,62,55,45,205,4,0
1561,3/06/2018 10:05,43,63,55,45,206,4,0
1562,3/06/2018 10:10,44,64,57,46,211,4,0
1563,3/06/2018 10:15,44,64,56,46,210,4,0
1564,3/06/2018 10:20,44,64,57,47,212,4,0
1565,3/06/2018 10:25,44,63,56,46,209,4,0
1566,3/06/2018 10:30,45,65,58,47,215,4,0
1567,3/06/2018 10:35,46,66,58,48,218,4,0
1568,3/06/2018 10:40,45,66,58,48,217,4,0
1569,3/06/2018 10:45,44,64,57,46,211,4,0
1570,3/06/2018 10:50,44,64,57,46,211,4,0
1571,3/06/2018 10:55,44,64,57,46,211,4,0
1572,3/06/2018 11:00,43,63,55,45,206,4,0
1573,3/06/2018 11:05,44,64,56,46,210,4,0
1574,3/06/2018 11:10,46,67,59,49,221,4,0
1575,3/06/2018 11:15,46,67,59,49,221,4,0
1576,3/06/2018 11:20,47,68,60,49,224,4,0
1577,3/06/2018 11:25,47,69,61,50,227,4,0
1578,3/06/2018 11:30,48,70,62,51,231,4,0
1579,3/06/2018 11:35,48,69,61,50,228,4,0
1580,3/06/2018 11:40,48,70,62,51,231,4,0
1581,3/06/2018 11:45,49,71,63,51,234,4,0
1582,3/06/2018 11:50,48,70,62,51,231,4,0
1583,3/06/2018 11:55,48,69,61,50,228,4,0
1584,3/06/2018 12:00,49,71,63,52,235,4,0
1585,3/06/2018 12:05,50,72,64,52,238,4,0
1586,3/06/2018 12:10,49,72,63,52,236,4,0
1587,3/06/2018 12:15,50,72,64,52,238,4,0
1588,3/06/2018 12:20,51,73,65,53,242,4,0
1589,3/06/2018 12:25,50,73,64,53,240,4,0
1590,3/06/2018 12:30,50,73,64,52,239,4,0
1591,3/06/2018 12:35,50,73,64,53,240,4,0
1592,3/06/2018 12:40,51,73,65,53,242,4,0
1593,3/06/2018 12:45,52,75,66,54,247,4,0
1594,3/06/2018 12:50,51,73,65,53,242,4,0
1595,3/06/2018 12:55,51,75,66,54,246,4,0
1596,3/06/2018 13:00,51,74,65,54,244,4,0
1597,3/06/2018 13:05,51,74,65,54,244,4,0
1598,3/06/2018 13:10,51,73,65,53,242,4,0
1599,3/06/2018 13:15,51,74,66,54,245,4,0
1600,3/06/2018 13:20,52,76,67,55,250,4,0
1601,3/06/2018 13:25,52,76,67,55,250,4,0
1602,3/06/2018 13:30,52,76,67,55,250,4,0
1603,3/06/2018 13:35,53,76,68,55,252,4,0
1604,3/06/2018 13:40,54,78,69,56,257,4,0
1605,3/06/2018 13:45,54,79,69,57,259,4,0
1606,3/06/2018 13:50,53,77,68,56,254,4,0
1607,3/06/2018 13:55,54,78,69,56,257,4,0
1608,3/06/2018 14:00,53,77,68,56,254,4,0
1609,3/06/2018 14:05,54,78,69,56,257,4,0
1610,3/06/2018 14:10,54,79,69,57,259,4,0
1611,3/06/2018 14:15,57,82,73,59,271,4,0
1612,3/06/2018 14:20,56,82,72,59,269,4,0
1613,3/06/2018 14:25,57,82,73,59,271,4,0
1614,3/06/2018 14:30,58,84,74,61,277,4,0
1615,3/06/2018 14:35,60,88,77,63,288,4,0
1616,3/06/2018 14:40,62,90,80,65,297,4,0
1617,3/06/2018 14:45,62,90,80,65,297,4,0
1618,3/06/2018 14:50,61,88,78,64,291,4,0
1619,3/06/2018 14:55,60,88,77,63,288,4,0
1620,3/06/2018 15:00,60,87,77,63,287,4,0
1621,3/06/2018 15:05,59,85,75,61,280,4,0
1622,3/06/2018 15:10,59,86,76,62,283,4,0
1623,3/06/2018 15:15,58,85,75,61,279,4,0
1624,3/06/2018 15:20,63,91,80,66,300,4,0
1625,3/06/2018 15:25,63,91,80,66,300,4,0
1626,3/06/2018 15:30,64,93,82,67,306,4,0
1627,3/06/2018 15:35,67,97,85,70,319,4,0
1628,3/06/2018 15:40,66,96,85,70,317,4,0
1629,3/06/2018 15:45,66,96,85,69,316,4,0
1630,3/06/2018 15:50,64,93,82,67,306,4,0
1631,3/06/2018 15:55,63,91,81,66,301,4,0
1632,3/06/2018 16:00,64,92,81,67,304,4,0
1633,3/06/2018 16:05,65,94,83,68,310,4,0
1634,3/06/2018 16:10,66,95,84,69,314,4,0
1635,3/06/2018 16:15,66,96,84,69,315,4,0
1636,3/06/2018 16:20,66,96,84,69,315,4,0
1637,3/06/2018 16:25,65,95,84,68,312,4,0
1638,3/06/2018 16:30,62,90,80,65,297,4,0
1639,3/06/2018 16:35,65,94,83,68,310,4,0
1640,3/06/2018 16:40,66,96,84,69,315,4,0
1641,3/06/2018 16:45,67,97,85,70,319,4,0
1642,3/06/2018 16:50,67,97,85,70,319,4,0
1643,3/06/2018 16:55,63,92,81,67,303,4,0
1644,3/06/2018 17:00,62,90,79,65,296,4,0
1645,3/06/2018 17:05,67,97,85,70,319,4,0
1646,3/06/2018 17:10,68,99,87,71,325,4,0
1647,3/06/2018 17:15,67,97,85,70,319,4,0
1648,3/06/2018 17:20,66,96,85,70,317,4,0
1649,3/06/2018 17:25,66,96,85,70,317,4,0
1650,3/06/2018 17:30,73,106,94,77,350,4,0
1651,3/06/2018 17:35,73,106,93,76,348,4,0
1652,3/06/2018 17:40,72,104,92,75,343,4,0
1653,3/06/2018 17:45,63,92,81,67,303,4,0
1654,3/06/2018 17:50,63,91,81,66,301,4,0
1655,3/06/2018 17:55,62,90,80,65,297,4,0
1656,3/06/2018 18:00,61,88,78,64,291,4,0
1657,3/06/2018 18:05,58,83,74,60,275,4,0
1658,3/06/2018 18:10,58,84,74,61,277,4,0
1659,3/06/2018 18:15,58,84,74,61,277,4,0
1660,3/06/2018 18:20,60,86,76,63,285,4,0
1661,3/06/2018 18:25,58,84,75,61,278,4,0
1662,3/06/2018 18:30,57,83,73,60,273,4,0
1663,3/06/2018 18:35,56,82,72,59,269,4,0
1664,3/06/2018 18:40,54,79,69,57,259,4,0
1665,3/06/2018 18:45,51,74,66,54,245,4,0
1666,3/06/2018 18:50,49,71,63,51,234,4,0
1667,3/06/2018 18:55,45,66,58,48,217,4,0
1668,3/06/2018 19:00,51,73,65,53,242,4,0
1669,3/06/2018 19:05,50,73,64,53,240,4,0
1670,3/06/2018 19:10,50,73,64,52,239,4,0
1671,3/06/2018 19:15,46,67,59,49,221,4,0
1672,3/06/2018 19:20,44,64,57,47,212,4,0
1673,3/06/2018 19:25,43,62,55,45,205,4,0
1674,3/06/2018 19:30,41,59,53,43,196,4,0
1675,3/06/2018 19:35,40,59,52,42,193,4,0
1676,3/06/2018 19:40,39,57,50,41,187,4,0
1677,3/06/2018 19:45,37,54,48,39,178,4,0
1678,3/06/2018 19:50,37,53,47,38,175,4,0
1679,3/06/2018 19:55,36,52,46,38,172,4,0
1680,3/06/2018 20:00,35,50,44,36,165,4,0
1681,3/06/2018 20:05,35,51,45,37,168,4,0
1682,3/06/2018 20:10,35,50,44,36,165,4,0
1683,3/06/2018 20:15,35,50,44,36,165,4,0
1684,3/06/2018 20:20,34,49,43,35,161,4,0
1685,3/06/2018 20:25,33,48,42,34,157,4,0
1686,3/06/2018 20:30,33,47,42,34,156,4,0
1687,3/06/2018 20:35,32,46,41,34,153,4,0
1688,3/06/2018 20:40,32,46,41,33,152,4,0
1689,3/06/2018 20:45,31,46,40,33,150,4,0
1690,3/06/2018 20:50,31,44,39,32,146,4,0
1691,3/06/2018 20:55,29,43,38,31,141,4,0
1692,3/06/2018 21:00,30,43,38,31,142,4,0
1693,3/06/2018 21:05,31,45,40,33,149,4,0
1694,3/06/2018 21:10,32,46,40,33,151,4,0
1695,3/06/2018 21:15,32,46,41,33,152,4,0
1696,3/06/2018 21:20,31,46,40,33,150,4,0
1697,3/06/2018 21:25,30,44,39,32,145,4,0
1698,3/06/2018 21:30,29,42,37,30,138,4,0
1699,3/06/2018 21:35,28,41,36,30,135,4,0
1700,3/06/2018 21:40,29,42,37,31,139,4,0
1701,3/06/2018 21:45,29,42,37,30,138,4,0
1702,3/06/2018 21:50,28,40,35,29,132,4,0
1703,3/06/2018 21:55,27,39,34,28,128,4,0
1704,3/06/2018 22:00,26,38,34,28,126,4,0
1705,3/06/2018 22:05,26,38,34,27,125,4,0
1706,3/06/2018 22:10,26,38,33,27,124,4,0
1707,3/06/2018 22:15,26,38,34,27,125,4,0
1708,3/06/2018 22:20,24,35,31,25,115,4,0
1709,3/06/2018 22:25,23,33,29,24,109,4,0
1710,3/06/2018 22:30,22,32,28,23,105,4,0
1711,3/06/2018 22:35,22,32,28,23,105,4,0
1712,3/06/2018 22:40,21,30,27,22,100,4,0
1713,3/06/2018 22:45,20,29,25,21,95,4,0
1714,3/06/2018 22:50,19,28,24,20,91,4,0
1715,3/06/2018 22:55,18,26,23,19,86,4,0
1716,3/06/2018 23:00,17,25,22,18,82,4,0
1717,3/06/2018 23:05,17,25,22,18,82,4,0
1718,3/06/2018 23:10,18,26,23,19,86,4,0
1719,3/06/2018 23:15,17,24,21,18,80,4,0
1720,3/06/2018 23:20,16,23,20,16,75,4,0
1721,3/06/2018 23:25,15,22,19,16,72,4,0
1722,3/06/2018 23:30,14,21,18,15,68,4,0
1723,3/06/2018 23:35,14,20,18,14,66,4,0
1724,3/06/2018 23:40,13,19,17,14,63,4,0
1725,3/06/2018 23:45,13,19,17,14,63,4,0
1726,3/06/2018 23:50,12,18,16,13,59,4,0
1727,3/06/2018 23:55,12,17,15,12,56,4,0
1728,3/07/2018 0:00,11,16,14,12,53,4,0
1729,3/07/2018 0:05,11,15,14,11,51,4,0
1730,3/07/2018 0:10,11,16,14,12,53,4,0
1731,3/07/2018 0:15,11,15,14,11,51,4,0
1732,3/07/2018 0:20,10,15,13,11,49,4,0
1733,3/07/2018 0:25,9,14,12,10,45,4,0
1734,3/07/2018 0:30,9,12,11,9,41,4,0
1735,3/07/2018 0:35,9,13,11,9,42,4,0
1736,3/07/2018 0:40,9,12,11,9,41,4,0
1737,3/07/2018 0:45,8,12,10,9,39,4,0
1738,3/07/2018 0:50,8,11,10,8,37,4,0
1739,3/07/2018 0:55,7,10,9,7,33,4,0
1740,3/07/2018 1:00,7,10,9,7,33,4,0
1741,3/07/2018 1:05,7,10,9,7,33,4,0
1742,3/07/2018 1:10,7,10,9,7,33,4,0
1743,3/07/2018 1:15,6,9,8,7,30,4,0
1744,3/07/2018 1:20,6,9,8,7,30,4,0
1745,3/07/2018 1:25,6,9,8,6,29,4,0
1746,3/07/2018 1:30,6,8,8,6,28,4,0
1747,3/07/2018 1:35,6,8,7,6,27,4,0
1748,3/07/2018 1:40,6,8,8,6,28,4,0
1749,3/07/2018 1:45,6,8,8,6,28,4,0
1750,3/07/2018 1:50,5,8,7,6,26,4,0
1751,3/07/2018 1:55,5,7,6,5,23,4,0
1752,3/07/2018 2:00,5,7,6,5,23,4,0
1753,3/07/2018 2:05,5,8,7,6,26,4,0
1754,3/07/2018 2:10,5,8,7,5,25,4,0
1755,3/07/2018 2:15,5,8,7,5,25,4,0
1756,3/07/2018 2:20,5,8,7,5,25,4,0
1757,3/07/2018 2:25,5,7,6,5,23,4,0
1758,3/07/2018 2:30,5,7,6,5,23,4,0
1759,3/07/2018 2:35,5,7,6,5,23,4,0
1760,3/07/2018 2:40,5,7,6,5,23,4,0
1761,3/07/2018 2:45,5,7,6,5,23,4,0
1762,3/07/2018 2:50,5,7,6,5,23,4,0
1763,3/07/2018 2:55,5,7,6,5,23,4,0
1764,3/07/2018 3:00,5,7,6,5,23,4,0
1765,3/07/2018 3:05,5,7,6,5,23,4,0
1766,3/07/2018 3:10,5,7,6,5,23,4,0
1767,3/07/2018 3:15,5,8,7,5,25,4,0
1768,3/07/2018 3:20,5,8,7,6,26,4,0
1769,3/07/2018 3:25,6,8,7,6,27,4,0
1770,3/07/2018 3:30,6,9,8,6,29,4,0
1771,3/07/2018 3:35,6,9,8,7,30,4,0
1772,3/07/2018 3:40,7,10,9,7,33,4,0
1773,3/07/2018 3:45,7,10,9,7,33,4,0
1774,3/07/2018 3:50,7,10,9,7,33,4,0
1775,3/07/2018 3:55,6,9,8,7,30,4,0
1776,3/07/2018 4:00,6,9,8,7,30,4,0
1777,3/07/2018 4:05,7,10,9,7,33,4,0
1778,3/07/2018 4:10,8,12,11,9,40,4,0
1779,3/07/2018 4:15,9,13,11,9,42,4,0
1780,3/07/2018 4:20,10,14,13,10,47,4,0
1781,3/07/2018 4:25,11,16,14,11,52,4,0
1782,3/07/2018 4:30,13,18,16,13,60,4,0
1783,3/07/2018 4:35,14,20,18,15,67,4,0
1784,3/07/2018 4:40,16,23,20,16,75,4,0
1785,3/07/2018 4:45,16,23,20,17,76,4,0
1786,3/07/2018 4:50,16,24,21,17,78,4,0
1787,3/07/2018 4:55,17,24,21,18,80,4,0
1788,3/07/2018 5:00,19,27,24,20,90,4,0
1789,3/07/2018 5:05,22,32,29,23,106,4,0
1790,3/07/2018 5:10,26,38,34,27,125,4,0
1791,3/07/2018 5:15,28,41,36,30,135,4,0
1792,3/07/2018 5:20,32,47,42,34,155,4,0
1793,3/07/2018 5:25,35,50,44,36,165,4,0
1794,3/07/2018 5:30,40,58,51,42,191,4,0
1795,3/07/2018 5:35,45,65,57,47,214,4,0
1796,3/07/2018 5:40,46,67,59,48,220,4,0
1797,3/07/2018 5:45,47,68,60,49,224,4,0
1798,3/07/2018 5:50,47,68,60,49,224,4,0
1799,3/07/2018 5:55,44,64,57,47,212,4,0
1800,3/07/2018 6:00,45,65,57,47,214,4,0
1801,3/07/2018 6:05,47,68,60,49,224,4,0
1802,3/07/2018 6:10,51,73,65,53,242,4,0
1803,3/07/2018 6:15,53,77,68,56,254,4,0
1804,3/07/2018 6:20,58,84,75,61,278,4,0
1805,3/07/2018 6:25,59,86,76,62,283,4,0
1806,3/07/2018 6:30,61,89,79,64,293,4,0
1807,3/07/2018 6:35,64,93,82,67,306,4,0
1808,3/07/2018 6:40,66,96,85,70,317,4,0
1809,3/07/2018 6:45,68,99,87,72,326,4,0
1810,3/07/2018 6:50,67,97,85,70,319,4,0
1811,3/07/2018 6:55,66,96,85,69,316,4,0
1812,3/07/2018 7:00,66,96,85,69,316,4,0
1813,3/07/2018 7:05,66,96,85,70,317,4,0
1814,3/07/2018 7:10,69,100,88,72,329,4,0
1815,3/07/2018 7:15,71,103,91,74,339,4,0
1816,3/07/2018 7:20,73,106,93,76,348,4,0
1817,3/07/2018 7:25,71,103,91,75,340,4,0
1818,3/07/2018 7:30,74,107,94,77,352,4,0
1819,3/07/2018 7:35,74,107,95,77,353,4,0
1820,3/07/2018 7:40,74,108,95,78,355,4,0
1821,3/07/2018 7:45,74,108,95,78,355,4,0
1822,3/07/2018 7:50,73,106,94,77,350,4,0
1823,3/07/2018 7:55,70,102,90,74,336,4,0
1824,3/07/2018 8:00,68,99,88,72,327,4,0
1825,3/07/2018 8:05,69,100,88,72,329,4,0
1826,3/07/2018 8:10,68,99,87,72,326,4,0
1827,3/07/2018 8:15,68,99,87,71,325,4,0
1828,3/07/2018 8:20,69,100,89,73,331,4,0
1829,3/07/2018 8:25,67,97,86,70,320,4,0
1830,3/07/2018 8:30,65,94,83,68,310,4,0
1831,3/07/2018 8:35,62,90,79,65,296,4,0
1832,3/07/2018 8:40,63,91,80,66,300,4,0
1833,3/07/2018 8:45,63,91,80,66,300,4,0
1834,3/07/2018 8:50,61,89,78,64,292,4,0
1835,3/07/2018 8:55,59,86,76,62,283,4,0
1836,3/07/2018 9:00,57,83,73,60,273,4,0
1837,3/07/2018 9:05,56,81,71,58,266,4,0
1838,3/07/2018 9:10,56,81,72,59,268,4,0
1839,3/07/2018 9:15,55,80,71,58,264,4,0
1840,3/07/2018 9:20,55,80,71,58,264,4,0
1841,3/07/2018 9:25,54,79,70,57,260,4,0
1842,3/07/2018 9:30,54,79,70,57,260,4,0
1843,3/07/2018 9:35,54,79,69,57,259,4,0
1844,3/07/2018 9:40,56,81,71,58,266,4,0
1845,3/07/2018 9:45,56,81,72,59,268,4,0
1846,3/07/2018 9:50,54,78,69,57,258,4,0
1847,3/07/2018 9:55,53,77,68,56,254,4,0
1848,3/07/2018 10:00,52,76,67,55,250,4,0
1849,3/07/2018 10:05,52,76,67,55,250,4,0
1850,3/07/2018 10:10,52,76,67,55,250,4,0
1851,3/07/2018 10:15,52,75,66,54,247,4,0
1852,3/07/2018 10:20,52,76,67,55,250,4,0
1853,3/07/2018 10:25,52,76,67,55,250,4,0
1854,3/07/2018 10:30,51,74,65,54,244,4,0
1855,3/07/2018 10:35,52,75,66,54,247,4,0
1856,3/07/2018 10:40,52,76,67,55,250,4,0
1857,3/07/2018 10:45,52,75,66,54,247,4,0
1858,3/07/2018 10:50,52,75,66,54,247,4,0
1859,3/07/2018 10:55,51,74,65,54,244,4,0
1860,3/07/2018 11:00,51,74,66,54,245,4,0
1861,3/07/2018 11:05,51,74,65,54,244,4,0
1862,3/07/2018 11:10,52,76,67,55,250,4,0
1863,3/07/2018 11:15,51,75,66,54,246,4,0
1864,3/07/2018 11:20,52,76,67,55,250,4,0
1865,3/07/2018 11:25,52,76,67,55,250,4,0
1866,3/07/2018 11:30,52,76,67,55,250,4,0
1867,3/07/2018 11:35,52,76,67,55,250,4,0
1868,3/07/2018 11:40,53,77,68,56,254,4,0
1869,3/07/2018 11:45,53,77,68,56,254,4,0
1870,3/07/2018 11:50,53,76,68,55,252,4,0
1871,3/07/2018 11:55,51,74,66,54,245,4,0
0,3/07/2018 11:00,51,74,66,54,245,4,0
1,3/07/2018 11:05,51,74,65,54,244,4,0
2,3/07/2018 11:10,52,76,67,55,250,4,0
3,3/07/2018 11:15,51,75,66,54,246,4,0
4,3/07/2018 11:20,52,76,67,55,250,4,0
5,3/07/2018 11:25,52,76,67,55,250,4,0
6,3/07/2018 11:30,52,76,67,55,250,4,0
7,3/07/2018 11:35,52,76,67,55,250,4,0
8,3/07/2018 11:40,53,77,68,56,254,4,0
9,3/07/2018 11:45,53,77,68,56,254,4,0
10,3/07/2018 11:50,53,76,68,55,252,4,0
11,3/07/2018 11:55,51,74,66,54,245,4,0
12,3/07/2018 12:00,52,76,67,55,250,4,0
13,3/07/2018 12:05,52,76,67,55,250,4,0
14,3/07/2018 12:10,53,77,68,56,254,4,0
15,3/07/2018 12:15,53,77,68,56,254,4,0
16,3/07/2018 12:20,53,77,68,56,254,4,0
17,3/07/2018 12:25,53,76,68,55,252,4,0
18,3/07/2018 12:30,53,77,68,56,254,4,0
19,3/07/2018 12:35,53,77,68,56,254,4,0
20,3/07/2018 12:40,54,78,69,56,257,4,0
21,3/07/2018 12:45,54,78,69,56,257,4,0
22,3/07/2018 12:50,54,78,69,56,257,4,0
23,3/07/2018 12:55,53,77,68,56,254,4,0
24,3/07/2018 13:00,53,77,68,56,254,4,0
25,3/07/2018 13:05,53,77,68,56,254,4,0
26,3/07/2018 13:10,55,79,70,57,261,4,0
27,3/07/2018 13:15,55,79,70,57,261,4,0
28,3/07/2018 13:20,55,79,70,57,261,4,0
29,3/07/2018 13:25,54,78,69,56,257,4,0
30,3/07/2018 13:30,54,78,69,57,258,4,0
31,3/07/2018 13:35,55,80,71,58,264,4,0
32,3/07/2018 13:40,56,81,71,58,266,4,0
33,3/07/2018 13:45,56,82,72,59,269,4,0
34,3/07/2018 13:50,57,82,73,59,271,4,0
35,3/07/2018 13:55,57,82,73,59,271,4,0
36,3/07/2018 14:00,56,82,72,59,269,4,0
37,3/07/2018 14:05,58,83,74,60,275,4,0
38,3/07/2018 14:10,59,85,75,62,281,4,0
39,3/07/2018 14:15,60,87,77,63,287,4,0
40,3/07/2018 14:20,60,87,77,63,287,4,0
41,3/07/2018 14:25,59,86,76,62,283,4,0
42,3/07/2018 14:30,60,86,76,63,285,4,0
43,3/07/2018 14:35,61,89,79,65,294,4,0
44,3/07/2018 14:40,65,95,84,68,312,4,0
45,3/07/2018 14:45,66,96,85,69,316,4,0
46,3/07/2018 14:50,64,93,83,68,308,4,0
47,3/07/2018 14:55,63,92,81,66,302,4,0
48,3/07/2018 15:00,63,91,81,66,301,4,0
49,3/07/2018 15:05,65,94,83,68,310,4,0
50,3/07/2018 15:10,67,97,86,70,320,4,0
51,3/07/2018 15:15,68,98,87,71,324,4,0
52,3/07/2018 15:20,67,97,85,70,319,4,0
53,3/07/2018 15:25,67,97,86,70,320,4,0
54,3/07/2018 15:30,67,97,85,70,319,4,0
55,3/07/2018 15:35,71,103,91,75,340,4,0
56,3/07/2018 15:40,74,107,95,78,354,4,0
57,3/07/2018 15:45,74,107,94,77,352,4,0
58,3/07/2018 15:50,72,104,92,76,344,4,0
59,3/07/2018 15:55,70,101,89,73,333,4,0
60,3/07/2018 16:00,68,99,88,72,327,4,0
61,3/07/2018 16:05,70,102,90,74,336,4,0
62,3/07/2018 16:10,73,105,93,76,347,4,0
63,3/07/2018 16:15,72,104,92,75,343,4,0
64,3/07/2018 16:20,72,104,92,75,343,4,0
65,3/07/2018 16:25,71,103,91,74,339,4,0
66,3/07/2018 16:30,70,102,90,74,336,4,0
67,3/07/2018 16:35,73,106,94,77,350,4,0
68,3/07/2018 16:40,74,108,95,78,355,4,0
69,3/07/2018 16:45,75,109,96,79,359,4,0
70,3/07/2018 16:50,75,109,96,79,359,4,0
71,3/07/2018 16:55,73,105,93,76,347,4,0
72,3/07/2018 17:00,72,105,92,76,345,4,0
73,3/07/2018 17:05,74,107,95,78,354,4,0
74,3/07/2018 17:10,77,111,98,81,367,4,0
75,3/07/2018 17:15,76,110,98,80,364,4,0
76,3/07/2018 17:20,75,110,97,79,361,4,0
77,3/07/2018 17:25,74,108,95,78,355,4,0
78,3/07/2018 17:30,73,105,93,76,347,4,0
79,3/07/2018 17:35,74,108,95,78,355,4,0
80,3/07/2018 17:40,71,103,91,75,340,4,0
81,3/07/2018 17:45,71,103,91,75,340,4,0
82,3/07/2018 17:50,70,102,90,74,336,4,0
83,3/07/2018 17:55,68,99,87,71,325,4,0
84,3/07/2018 18:00,67,97,85,70,319,4,0
85,3/07/2018 18:05,67,97,86,70,320,4,0
86,3/07/2018 18:10,67,97,86,70,320,4,0
87,3/07/2018 18:15,66,96,85,69,316,4,0
88,3/07/2018 18:20,65,95,84,68,312,4,0
89,3/07/2018 18:25,64,92,81,67,304,4,0
90,3/07/2018 18:30,62,90,79,65,296,4,0
91,3/07/2018 18:35,63,91,81,66,301,4,0
92,3/07/2018 18:40,58,84,74,61,277,4,0
93,3/07/2018 18:45,56,82,72,59,269,4,0
94,3/07/2018 18:50,55,79,70,58,262,4,0
95,3/07/2018 18:55,54,78,69,57,258,4,0
96,3/07/2018 19:00,52,76,67,55,250,4,0
97,3/07/2018 19:05,52,75,66,54,247,4,0
98,3/07/2018 19:10,51,74,66,54,245,4,0
99,3/07/2018 19:15,51,73,65,53,242,4,0
100,3/07/2018 19:20,48,70,62,51,231,4,0
101,3/07/2018 19:25,46,66,58,48,218,4,0
102,3/07/2018 19:30,46,66,58,48,218,4,0
103,3/07/2018 19:35,44,64,57,46,211,4,0
104,3/07/2018 19:40,42,62,54,45,203,4,0
105,3/07/2018 19:45,41,60,53,43,197,4,0
106,3/07/2018 19:50,40,58,51,42,191,4,0
107,3/07/2018 19:55,39,57,50,41,187,4,0
108,3/07/2018 20:00,37,54,47,39,177,4,0
109,3/07/2018 20:05,37,54,48,39,178,4,0
110,3/07/2018 20:10,37,54,48,39,178,4,0
111,3/07/2018 20:15,37,53,47,39,176,4,0
112,3/07/2018 20:20,36,52,46,38,172,4,0
113,3/07/2018 20:25,35,51,45,37,168,4,0
114,3/07/2018 20:30,34,50,44,36,164,4,0
115,3/07/2018 20:35,34,49,43,35,161,4,0
116,3/07/2018 20:40,34,49,43,35,161,4,0
117,3/07/2018 20:45,33,48,43,35,159,4,0
118,3/07/2018 20:50,32,47,41,34,154,4,0
119,3/07/2018 20:55,32,47,41,34,154,4,0
120,3/07/2018 21:00,31,45,40,33,149,4,0
121,3/07/2018 21:05,32,47,42,34,155,4,0
122,3/07/2018 21:10,33,48,42,35,158,4,0
123,3/07/2018 21:15,34,50,44,36,164,4,0
124,3/07/2018 21:20,34,49,44,36,163,4,0
125,3/07/2018 21:25,33,48,42,35,158,4,0
126,3/07/2018 21:30,32,46,41,34,153,4,0
127,3/07/2018 21:35,31,46,40,33,150,4,0
128,3/07/2018 21:40,31,44,39,32,146,4,0
129,3/07/2018 21:45,30,43,38,31,142,4,0
130,3/07/2018 21:50,28,41,36,30,135,4,0
131,3/07/2018 21:55,29,42,37,30,138,4,0
132,3/07/2018 22:00,28,41,36,29,134,4,0
133,3/07/2018 22:05,28,41,36,29,134,4,0
134,3/07/2018 22:10,28,40,36,29,133,4,0
135,3/07/2018 22:15,28,40,35,29,132,4,0
136,3/07/2018 22:20,27,39,34,28,128,4,0
137,3/07/2018 22:25,25,36,32,26,119,4,0
138,3/07/2018 22:30,24,35,31,26,116,4,0
139,3/07/2018 22:35,24,34,30,25,113,4,0
140,3/07/2018 22:40,23,34,30,24,111,4,0
141,3/07/2018 22:45,22,32,29,23,106,4,0
142,3/07/2018 22:50,21,31,27,22,101,4,0
143,3/07/2018 22:55,20,30,26,22,98,4,0
144,3/07/2018 23:00,19,27,24,20,90,4,0
145,3/07/2018 23:05,19,27,24,20,90,4,0
146,3/07/2018 23:10,19,28,25,20,92,4,0
147,3/07/2018 23:15,19,27,24,20,90,4,0
148,3/07/2018 23:20,18,26,23,19,86,4,0
149,3/07/2018 23:25,17,24,21,18,80,4,0
150,3/07/2018 23:30,16,24,21,17,78,4,0
151,3/07/2018 23:35,16,23,21,17,77,4,0
152,3/07/2018 23:40,16,23,20,17,76,4,0
153,3/07/2018 23:45,15,22,19,16,72,4,0
154,3/07/2018 23:50,14,20,18,15,67,4,0
155,3/07/2018 23:55,13,19,17,14,63,4,0
156,3/08/2018 0:00,12,18,16,13,59,4,0
157,3/08/2018 0:05,13,18,16,13,60,4,0
158,3/08/2018 0:10,12,18,16,13,59,4,0
159,3/08/2018 0:15,12,17,15,13,57,4,0
160,3/08/2018 0:20,11,16,14,12,53,4,0
161,3/08/2018 0:25,10,15,13,11,49,4,0
162,3/08/2018 0:30,10,14,12,10,46,4,0
163,3/08/2018 0:35,10,14,13,10,47,4,0
164,3/08/2018 0:40,10,14,12,10,46,4,0
165,3/08/2018 0:45,9,13,12,10,44,4,0
166,3/08/2018 0:50,9,12,11,9,41,4,0
167,3/08/2018 0:55,8,11,10,8,37,4,0
168,3/08/2018 1:00,7,11,9,8,35,4,0
169,3/08/2018 1:05,7,11,9,8,35,4,0
170,3/08/2018 1:10,8,11,10,8,37,4,0
171,3/08/2018 1:15,7,11,9,8,35,4,0
172,3/08/2018 1:20,7,10,9,7,33,4,0
173,3/08/2018 1:25,7,10,9,7,33,4,0
174,3/08/2018 1:30,6,9,8,7,30,4,0
175,3/08/2018 1:35,6,9,8,7,30,4,0
176,3/08/2018 1:40,7,10,9,7,33,4,0
177,3/08/2018 1:45,6,9,8,7,30,4,0
178,3/08/2018 1:50,6,9,8,7,30,4,0
179,3/08/2018 1:55,6,8,7,6,27,4,0
180,3/08/2018 2:00,6,8,7,6,27,4,0
181,3/08/2018 2:05,6,8,8,6,28,4,0
182,3/08/2018 2:10,6,9,8,6,29,4,0
183,3/08/2018 2:15,6,8,8,6,28,4,0
184,3/08/2018 2:20,6,9,8,6,29,4,0
185,3/08/2018 2:25,6,8,7,6,27,4,0
186,3/08/2018 2:30,6,8,7,6,27,4,0
187,3/08/2018 2:35,6,8,7,6,27,4,0
188,3/08/2018 2:40,6,8,8,6,28,4,0
189,3/08/2018 2:45,5,8,7,6,26,4,0
190,3/08/2018 2:50,5,8,7,5,25,4,0
191,3/08/2018 2:55,5,7,6,5,23,4,0
192,3/08/2018 3:00,5,7,6,5,23,4,0
193,3/08/2018 3:05,5,8,7,5,25,4,0
194,3/08/2018 3:10,6,8,7,6,27,4,0
195,3/08/2018 3:15,5,8,7,6,26,4,0
196,3/08/2018 3:20,6,8,8,6,28,4,0
197,3/08/2018 3:25,6,9,8,6,29,4,0
198,3/08/2018 3:30,6,9,8,7,30,4,0
199,3/08/2018 3:35,7,10,9,7,33,4,0
200,3/08/2018 3:40,7,10,9,7,33,4,0
201,3/08/2018 3:45,7,11,9,8,35,4,0
202,3/08/2018 3:50,7,10,9,7,33,4,0
203,3/08/2018 3:55,7,10,9,7,33,4,0
204,3/08/2018 4:00,7,10,9,7,33,4,0
205,3/08/2018 4:05,7,11,9,8,35,4,0
206,3/08/2018 4:10,8,12,11,9,40,4,0
207,3/08/2018 4:15,9,14,12,10,45,4,0
208,3/08/2018 4:20,10,15,13,11,49,4,0
209,3/08/2018 4:25,11,16,14,12,53,4,0
210,3/08/2018 4:30,13,19,16,13,61,4,0
211,3/08/2018 4:35,14,21,18,15,68,4,0
212,3/08/2018 4:40,16,23,21,17,77,4,0
213,3/08/2018 4:45,17,24,21,17,79,4,0
214,3/08/2018 4:50,17,25,22,18,82,4,0
215,3/08/2018 4:55,17,25,22,18,82,4,0
216,3/08/2018 5:00,19,27,24,20,90,4,0
217,3/08/2018 5:05,22,32,29,23,106,4,0
218,3/08/2018 5:10,26,38,33,27,124,4,0
219,3/08/2018 5:15,29,42,37,31,139,4,0
220,3/08/2018 5:20,33,48,42,35,158,4,0
221,3/08/2018 5:25,36,52,46,38,172,4,0
222,3/08/2018 5:30,41,59,52,43,195,4,0
223,3/08/2018 5:35,44,64,56,46,210,4,0
224,3/08/2018 5:40,47,69,61,50,227,4,0
225,3/08/2018 5:45,48,70,62,51,231,4,0
226,3/08/2018 5:50,46,67,59,49,221,4,0
227,3/08/2018 5:55,45,65,57,47,214,4,0
228,3/08/2018 6:00,45,65,58,47,215,4,0
229,3/08/2018 6:05,48,69,61,50,228,4,0
230,3/08/2018 6:10,53,76,68,55,252,4,0
231,3/08/2018 6:15,56,81,72,59,268,4,0
232,3/08/2018 6:20,59,85,75,61,280,4,0
233,3/08/2018 6:25,60,87,77,63,287,4,0
234,3/08/2018 6:30,62,90,79,65,296,4,0
235,3/08/2018 6:35,64,93,82,67,306,4,0
236,3/08/2018 6:40,67,97,86,70,320,4,0
237,3/08/2018 6:45,67,97,86,70,320,4,0
238,3/08/2018 6:50,67,97,86,70,320,4,0
239,3/08/2018 6:55,65,95,84,69,313,4,0
240,3/08/2018 7:00,65,94,83,68,310,4,0
241,3/08/2018 7:05,66,96,84,69,315,4,0
242,3/08/2018 7:10,68,99,87,72,326,4,0
243,3/08/2018 7:15,70,102,90,74,336,4,0
244,3/08/2018 7:20,72,104,92,75,343,4,0
245,3/08/2018 7:25,71,103,91,75,340,4,0
246,3/08/2018 7:30,71,103,91,75,340,4,0
247,3/08/2018 7:35,73,105,93,76,347,4,0
248,3/08/2018 7:40,73,106,94,77,350,4,0
249,3/08/2018 7:45,73,106,94,77,350,4,0
250,3/08/2018 7:50,74,107,95,78,354,4,0
251,3/08/2018 7:55,71,103,91,75,340,4,0
252,3/08/2018 8:00,69,101,89,73,332,4,0
253,3/08/2018 8:05,68,98,87,71,324,4,0
254,3/08/2018 8:10,67,98,86,71,322,4,0
255,3/08/2018 8:15,66,96,85,70,317,4,0
256,3/08/2018 8:20,67,97,85,70,319,4,0
257,3/08/2018 8:25,65,94,83,68,310,4,0
258,3/08/2018 8:30,63,92,81,67,303,4,0
259,3/08/2018 8:35,63,91,81,66,301,4,0
260,3/08/2018 8:40,63,91,80,66,300,4,0
261,3/08/2018 8:45,63,91,80,66,300,4,0
262,3/08/2018 8:50,61,89,79,65,294,4,0
263,3/08/2018 8:55,58,85,75,61,279,4,0
264,3/08/2018 9:00,56,82,72,59,269,4,0
265,3/08/2018 9:05,56,81,71,58,266,4,0
266,3/08/2018 9:10,55,80,71,58,264,4,0
267,3/08/2018 9:15,56,81,71,58,266,4,0
268,3/08/2018 9:20,55,80,71,58,264,4,0
269,3/08/2018 9:25,55,80,70,58,263,4,0
270,3/08/2018 9:30,55,79,70,58,262,4,0
271,3/08/2018 9:35,55,80,71,58,264,4,0
272,3/08/2018 9:40,55,80,71,58,264,4,0
273,3/08/2018 9:45,55,79,70,58,262,4,0
274,3/08/2018 9:50,55,80,70,58,263,4,0
275,3/08/2018 9:55,54,78,69,56,257,4,0
276,3/08/2018 10:00,51,74,66,54,245,4,0
277,3/08/2018 10:05,52,76,67,55,250,4,0
278,3/08/2018 10:10,52,75,66,54,247,4,0
279,3/08/2018 10:15,53,76,68,55,252,4,0
280,3/08/2018 10:20,52,76,67,55,250,4,0
281,3/08/2018 10:25,52,76,67,55,250,4,0
282,3/08/2018 10:30,52,75,66,54,247,4,0
283,3/08/2018 10:35,51,74,65,54,244,4,0
284,3/08/2018 10:40,52,76,67,55,250,4,0
285,3/08/2018 10:45,53,77,68,56,254,4,0
286,3/08/2018 10:50,53,77,68,56,254,4,0
287,3/08/2018 10:55,52,76,67,55,250,4,0
288,3/08/2018 11:00,51,74,66,54,245,4,0
289,3/08/2018 11:05,52,76,67,55,250,4,0
290,3/08/2018 11:10,52,75,66,54,247,4,0
291,3/08/2018 11:15,51,75,66,54,246,4,0
292,3/08/2018 11:20,52,76,67,55,250,4,0
293,3/08/2018 11:25,52,76,67,55,250,4,0
294,3/08/2018 11:30,53,77,68,56,254,4,0
295,3/08/2018 11:35,54,78,69,57,258,4,0
296,3/08/2018 11:40,54,78,69,56,257,4,0
297,3/08/2018 11:45,53,77,68,56,254,4,0
298,3/08/2018 11:50,54,78,69,56,257,4,0
299,3/08/2018 11:55,53,76,68,55,252,4,0
300,3/08/2018 12:00,53,77,68,56,254,4,0
301,3/08/2018 12:05,54,78,69,56,257,4,0
302,3/08/2018 12:10,54,78,69,56,257,4,0
303,3/08/2018 12:15,54,78,69,57,258,4,0
304,3/08/2018 12:20,55,79,70,57,261,4,0
305,3/08/2018 12:25,54,79,70,57,260,4,0
306,3/08/2018 12:30,54,78,69,56,257,4,0
307,3/08/2018 12:35,54,78,69,56,257,4,0
308,3/08/2018 12:40,54,78,69,56,257,4,0
309,3/08/2018 12:45,55,80,70,58,263,4,0
310,3/08/2018 12:50,55,79,70,58,262,4,0
311,3/08/2018 12:55,54,79,70,57,260,4,0
312,3/08/2018 13:00,54,78,69,56,257,4,0
313,3/08/2018 13:05,54,78,69,57,258,4,0
314,3/08/2018 13:10,55,80,70,58,263,4,0
315,3/08/2018 13:15,55,80,70,58,263,4,0
316,3/08/2018 13:20,55,80,71,58,264,4,0
317,3/08/2018 13:25,55,80,70,58,263,4,0
318,3/08/2018 13:30,55,80,71,58,264,4,0
319,3/08/2018 13:35,56,81,72,59,268,4,0
320,3/08/2018 13:40,56,81,71,58,266,4,0
321,3/08/2018 13:45,56,82,72,59,269,4,0
322,3/08/2018 13:50,56,82,72,59,269,4,0
323,3/08/2018 13:55,56,82,72,59,269,4,0
324,3/08/2018 14:00,56,82,72,59,269,4,0
325,3/08/2018 14:05,57,83,73,60,273,4,0
326,3/08/2018 14:10,59,85,75,61,280,4,0
327,3/08/2018 14:15,60,86,76,63,285,4,0
328,3/08/2018 14:20,60,87,77,63,287,4,0
329,3/08/2018 14:25,60,86,76,63,285,4,0
330,3/08/2018 14:30,60,87,77,63,287,4,0
331,3/08/2018 14:35,63,91,80,66,300,4,0
332,3/08/2018 14:40,65,95,84,69,313,4,0
333,3/08/2018 14:45,66,96,85,69,316,4,0
334,3/08/2018 14:50,65,94,83,68,310,4,0
335,3/08/2018 14:55,64,93,82,67,306,4,0
336,3/08/2018 15:00,64,93,82,67,306,4,0
337,3/08/2018 15:05,65,94,83,68,310,4,0
338,3/08/2018 15:10,66,96,85,69,316,4,0
339,3/08/2018 15:15,66,96,85,69,316,4,0
340,3/08/2018 15:20,66,96,85,70,317,4,0
341,3/08/2018 15:25,66,96,85,70,317,4,0
342,3/08/2018 15:30,66,96,85,70,317,4,0
343,3/08/2018 15:35,70,102,90,74,336,4,0
344,3/08/2018 15:40,73,106,93,76,348,4,0
345,3/08/2018 15:45,73,105,93,76,347,4,0
346,3/08/2018 15:50,72,104,92,76,344,4,0
347,3/08/2018 15:55,69,100,88,72,329,4,0
348,3/08/2018 16:00,68,99,88,72,327,4,0
349,3/08/2018 16:05,69,100,89,73,331,4,0
350,3/08/2018 16:10,71,103,91,75,340,4,0
351,3/08/2018 16:15,71,103,91,74,339,4,0
352,3/08/2018 16:20,72,104,92,76,344,4,0
353,3/08/2018 16:25,69,100,89,73,331,4,0
354,3/08/2018 16:30,71,103,91,74,339,4,0
355,3/08/2018 16:35,72,104,92,75,343,4,0
356,3/08/2018 16:40,74,107,95,77,353,4,0
357,3/08/2018 16:45,74,107,95,77,353,4,0
358,3/08/2018 16:50,75,109,96,79,359,4,0
359,3/08/2018 16:55,72,105,93,76,346,4,0
360,3/08/2018 17:00,72,104,92,76,344,4,0
361,3/08/2018 17:05,74,107,95,77,353,4,0
362,3/08/2018 17:10,76,110,98,80,364,4,0
363,3/08/2018 17:15,76,110,97,80,363,4,0
364,3/08/2018 17:20,77,112,99,81,369,4,0
365,3/08/2018 17:25,73,105,93,76,347,4,0
366,3/08/2018 17:30,72,104,92,76,344,4,0
367,3/08/2018 17:35,72,104,92,75,343,4,0
368,3/08/2018 17:40,72,104,92,75,343,4,0
369,3/08/2018 17:45,71,103,91,75,340,4,0
370,3/08/2018 17:50,71,103,91,75,340,4,0
371,3/08/2018 17:55,69,100,88,72,329,4,0
372,3/08/2018 18:00,67,97,86,70,320,4,0
373,3/08/2018 18:05,67,97,86,70,320,4,0
374,3/08/2018 18:10,67,97,86,70,320,4,0
375,3/08/2018 18:15,66,96,85,70,317,4,0
376,3/08/2018 18:20,67,97,86,70,320,4,0
377,3/08/2018 18:25,64,93,83,68,308,4,0
378,3/08/2018 18:30,63,92,81,66,302,4,0
379,3/08/2018 18:35,62,90,79,65,296,4,0
380,3/08/2018 18:40,60,87,77,63,287,4,0
381,3/08/2018 18:45,59,86,76,62,283,4,0
382,3/08/2018 18:50,57,83,73,60,273,4,0
383,3/08/2018 18:55,55,80,71,58,264,4,0
384,3/08/2018 19:00,55,79,70,57,261,4,0
385,3/08/2018 19:05,54,78,69,56,257,4,0
386,3/08/2018 19:10,54,79,70,57,260,4,0
387,3/08/2018 19:15,51,75,66,54,246,4,0
388,3/08/2018 19:20,50,73,64,52,239,4,0
389,3/08/2018 19:25,48,70,62,51,231,4,0
390,3/08/2018 19:30,47,68,60,49,224,4,0
391,3/08/2018 19:35,46,67,59,48,220,4,0
392,3/08/2018 19:40,45,66,58,48,217,4,0
393,3/08/2018 19:45,43,63,55,45,206,4,0
394,3/08/2018 19:50,42,61,54,44,201,4,0
395,3/08/2018 19:55,40,58,51,42,191,4,0
396,3/08/2018 20:00,40,57,51,41,189,4,0
397,3/08/2018 20:05,38,56,49,40,183,4,0
398,3/08/2018 20:10,38,55,49,40,182,4,0
399,3/08/2018 20:15,38,55,48,40,181,4,0
400,3/08/2018 20:20,38,55,49,40,182,4,0
401,3/08/2018 20:25,37,53,47,39,176,4,0
402,3/08/2018 20:30,35,51,45,37,168,4,0
403,3/08/2018 20:35,35,51,45,37,168,4,0
404,3/08/2018 20:40,35,51,45,37,168,4,0
405,3/08/2018 20:45,35,50,44,36,165,4,0
406,3/08/2018 20:50,34,50,44,36,164,4,0
407,3/08/2018 20:55,33,48,43,35,159,4,0
408,3/08/2018 21:00,33,48,42,34,157,4,0
409,3/08/2018 21:05,34,49,44,36,163,4,0
410,3/08/2018 21:10,35,51,45,37,168,4,0
411,3/08/2018 21:15,36,52,46,38,172,4,0
412,3/08/2018 21:20,36,52,46,37,171,4,0
413,3/08/2018 21:25,35,50,44,36,165,4,0
414,3/08/2018 21:30,33,48,43,35,159,4,0
415,3/08/2018 21:35,33,49,43,35,160,4,0
416,3/08/2018 21:40,33,48,43,35,159,4,0
417,3/08/2018 21:45,32,46,41,34,153,4,0
418,3/08/2018 21:50,31,46,40,33,150,4,0
419,3/08/2018 21:55,30,44,39,32,145,4,0
420,3/08/2018 22:00,30,43,38,31,142,4,0
421,3/08/2018 22:05,29,42,37,31,139,4,0
422,3/08/2018 22:10,30,43,38,31,142,4,0
423,3/08/2018 22:15,29,42,38,31,140,4,0
424,3/08/2018 22:20,29,43,38,31,141,4,0
425,3/08/2018 22:25,27,40,35,29,131,4,0
426,3/08/2018 22:30,27,39,35,29,130,4,0
427,3/08/2018 22:35,26,37,33,27,123,4,0
428,3/08/2018 22:40,25,36,32,26,119,4,0
429,3/08/2018 22:45,25,36,32,26,119,4,0
430,3/08/2018 22:50,23,33,29,24,109,4,0
431,3/08/2018 22:55,22,31,28,23,104,4,0
432,3/08/2018 23:00,20,29,26,21,96,4,0
433,3/08/2018 23:05,21,30,27,22,100,4,0
434,3/08/2018 23:10,21,30,27,22,100,4,0
435,3/08/2018 23:15,19,28,25,20,92,4,0
436,3/08/2018 23:20,19,27,24,20,90,4,0
437,3/08/2018 23:25,18,26,23,19,86,4,0
438,3/08/2018 23:30,17,25,22,18,82,4,0
439,3/08/2018 23:35,17,24,21,18,80,4,0
440,3/08/2018 23:40,16,23,21,17,77,4,0
441,3/08/2018 23:45,16,23,20,16,75,4,0
442,3/08/2018 23:50,15,22,19,16,72,4,0
443,3/08/2018 23:55,14,20,18,15,67,4,0
444,3/09/2018 0:00,13,19,16,13,61,4,0
445,3/09/2018 0:05,13,19,16,13,61,4,0
446,3/09/2018 0:10,13,19,17,14,63,4,0
447,3/09/2018 0:15,12,18,16,13,59,4,0
448,3/09/2018 0:20,12,17,15,12,56,4,0
449,3/09/2018 0:25,10,15,13,11,49,4,0
450,3/09/2018 0:30,11,15,14,11,51,4,0
451,3/09/2018 0:35,11,15,14,11,51,4,0
452,3/09/2018 0:40,10,15,13,11,49,4,0
453,3/09/2018 0:45,10,14,13,10,47,4,0
454,3/09/2018 0:50,9,13,12,10,44,4,0
455,3/09/2018 0:55,9,13,11,9,42,4,0
456,3/09/2018 1:00,8,12,10,8,38,4,0
457,3/09/2018 1:05,8,12,10,9,39,4,0
458,3/09/2018 1:10,8,12,10,8,38,4,0
459,3/09/2018 1:15,8,12,10,9,39,4,0
460,3/09/2018 1:20,8,12,10,8,38,4,0
461,3/09/2018 1:25,7,11,9,8,35,4,0
462,3/09/2018 1:30,7,11,9,8,35,4,0
463,3/09/2018 1:35,7,11,9,8,35,4,0
464,3/09/2018 1:40,8,11,10,8,37,4,0
465,3/09/2018 1:45,7,11,9,8,35,4,0
466,3/09/2018 1:50,7,10,9,7,33,4,0
467,3/09/2018 1:55,7,10,9,7,33,4,0
468,3/09/2018 2:00,7,10,9,7,33,4,0
469,3/09/2018 2:05,7,10,9,7,33,4,0
470,3/09/2018 2:10,7,10,9,7,33,4,0
471,3/09/2018 2:15,7,10,9,7,33,4,0
472,3/09/2018 2:20,6,9,8,7,30,4,0
473,3/09/2018 2:25,6,9,8,7,30,4,0
474,3/09/2018 2:30,6,9,8,7,30,4,0
475,3/09/2018 2:35,6,9,8,7,30,4,0
476,3/09/2018 2:40,7,10,9,7,33,4,0
477,3/09/2018 2:45,6,9,8,7,30,4,0
478,3/09/2018 2:50,6,9,8,6,29,4,0
479,3/09/2018 2:55,6,8,7,6,27,4,0
480,3/09/2018 3:00,6,8,7,6,27,4,0
481,3/09/2018 3:05,6,8,7,6,27,4,0
482,3/09/2018 3:10,6,8,8,6,28,4,0
483,3/09/2018 3:15,6,9,8,7,30,4,0
484,3/09/2018 3:20,6,9,8,7,30,4,0
485,3/09/2018 3:25,7,10,9,7,33,4,0
486,3/09/2018 3:30,7,10,9,7,33,4,0
487,3/09/2018 3:35,7,11,9,8,35,4,0
488,3/09/2018 3:40,8,11,10,8,37,4,0
489,3/09/2018 3:45,8,11,10,8,37,4,0
490,3/09/2018 3:50,7,10,9,7,33,4,0
491,3/09/2018 3:55,7,10,9,7,33,4,0
492,3/09/2018 4:00,7,11,9,8,35,4,0
493,3/09/2018 4:05,8,12,10,9,39,4,0
494,3/09/2018 4:10,9,13,11,9,42,4,0
495,3/09/2018 4:15,10,14,13,10,47,4,0
496,3/09/2018 4:20,11,16,14,12,53,4,0
497,3/09/2018 4:25,11,16,14,12,53,4,0
498,3/09/2018 4:30,13,19,16,13,61,4,0
499,3/09/2018 4:35,15,21,19,15,70,4,0
500,3/09/2018 4:40,16,23,20,17,76,4,0
501,3/09/2018 4:45,17,24,21,18,80,4,0
502,3/09/2018 4:50,17,25,22,18,82,4,0
503,3/09/2018 4:55,17,25,22,18,82,4,0
504,3/09/2018 5:00,19,28,24,20,91,4,0
505,3/09/2018 5:05,21,31,27,22,101,4,0
506,3/09/2018 5:10,25,36,32,26,119,4,0
507,3/09/2018 5:15,28,41,36,30,135,4,0
508,3/09/2018 5:20,32,46,41,34,153,4,0
509,3/09/2018 5:25,35,50,44,36,165,4,0
510,3/09/2018 5:30,38,55,49,40,182,4,0
511,3/09/2018 5:35,42,61,54,44,201,4,0
512,3/09/2018 5:40,44,64,57,47,212,4,0
513,3/09/2018 5:45,45,65,57,47,214,4,0
514,3/09/2018 5:50,46,66,58,48,218,4,0
515,3/09/2018 5:55,44,64,57,47,212,4,0
516,3/09/2018 6:00,44,64,56,46,210,4,0
517,3/09/2018 6:05,47,68,60,49,224,4,0
518,3/09/2018 6:10,51,74,65,53,243,4,0
519,3/09/2018 6:15,55,80,70,58,263,4,0
520,3/09/2018 6:20,57,83,73,60,273,4,0
521,3/09/2018 6:25,59,85,75,62,281,4,0
522,3/09/2018 6:30,61,89,78,64,292,4,0
523,3/09/2018 6:35,63,91,81,66,301,4,0
524,3/09/2018 6:40,66,95,84,69,314,4,0
525,3/09/2018 6:45,66,96,85,70,317,4,0
526,3/09/2018 6:50,67,97,85,70,319,4,0
527,3/09/2018 6:55,64,93,82,67,306,4,0
528,3/09/2018 7:00,64,93,83,68,308,4,0
529,3/09/2018 7:05,66,96,85,69,316,4,0
530,3/09/2018 7:10,68,99,88,72,327,4,0
531,3/09/2018 7:15,70,102,90,74,336,4,0
532,3/09/2018 7:20,73,105,93,76,347,4,0
533,3/09/2018 7:25,73,105,93,76,347,4,0
534,3/09/2018 7:30,72,105,93,76,346,4,0
535,3/09/2018 7:35,73,106,93,76,348,4,0
536,3/09/2018 7:40,73,106,94,77,350,4,0
537,3/09/2018 7:45,75,109,96,79,359,4,0
538,3/09/2018 7:50,74,107,95,78,354,4,0
539,3/09/2018 7:55,72,104,92,75,343,4,0
540,3/09/2018 8:00,69,100,89,73,331,4,0
541,3/09/2018 8:05,69,100,88,72,329,4,0
542,3/09/2018 8:10,69,100,88,72,329,4,0
543,3/09/2018 8:15,68,99,88,72,327,4,0
544,3/09/2018 8:20,68,99,88,72,327,4,0
545,3/09/2018 8:25,66,96,85,70,317,4,0
546,3/09/2018 8:30,64,93,83,68,308,4,0
547,3/09/2018 8:35,64,93,82,67,306,4,0
548,3/09/2018 8:40,64,93,83,68,308,4,0
549,3/09/2018 8:45,62,90,80,65,297,4,0
550,3/09/2018 8:50,61,89,79,65,294,4,0
551,3/09/2018 8:55,59,86,76,62,283,4,0
552,3/09/2018 9:00,58,83,74,60,275,4,0
553,3/09/2018 9:05,56,82,72,59,269,4,0
554,3/09/2018 9:10,57,82,73,59,271,4,0
555,3/09/2018 9:15,55,80,71,58,264,4,0
556,3/09/2018 9:20,56,82,72,59,269,4,0
557,3/09/2018 9:25,56,81,72,59,268,4,0
558,3/09/2018 9:30,56,81,72,59,268,4,0
559,3/09/2018 9:35,56,81,72,59,268,4,0
560,3/09/2018 9:40,57,82,73,59,271,4,0
561,3/09/2018 9:45,56,82,72,59,269,4,0
562,3/09/2018 9:50,56,81,71,58,266,4,0
563,3/09/2018 9:55,54,79,70,57,260,4,0
564,3/09/2018 10:00,53,77,68,56,254,4,0
565,3/09/2018 10:05,54,79,70,57,260,4,0
566,3/09/2018 10:10,54,79,70,57,260,4,0
567,3/09/2018 10:15,55,79,70,58,262,4,0
568,3/09/2018 10:20,56,81,71,58,266,4,0
569,3/09/2018 10:25,55,80,70,58,263,4,0
570,3/09/2018 10:30,55,80,70,58,263,4,0
571,3/09/2018 10:35,55,80,70,58,263,4,0
572,3/09/2018 10:40,56,81,71,58,266,4,0
573,3/09/2018 10:45,56,81,71,58,266,4,0
574,3/09/2018 10:50,55,79,70,58,262,4,0
575,3/09/2018 10:55,54,78,69,57,258,4,0
576,3/09/2018 11:00,54,79,69,57,259,4,0
577,3/09/2018 11:05,54,78,69,56,257,4,0
578,3/09/2018 11:10,54,79,70,57,260,4,0
579,3/09/2018 11:15,54,79,70,57,260,4,0
580,3/09/2018 11:20,55,80,71,58,264,4,0
581,3/09/2018 11:25,55,80,71,58,264,4,0
582,3/09/2018 11:30,57,82,73,59,271,4,0
583,3/09/2018 11:35,56,81,72,59,268,4,0
584,3/09/2018 11:40,58,83,74,60,275,4,0
585,3/09/2018 11:45,57,83,73,60,273,4,0
586,3/09/2018 11:50,58,84,74,61,277,4,0
587,3/09/2018 11:55,56,81,72,59,268,4,0
588,3/09/2018 12:00,56,81,72,59,268,4,0
589,3/09/2018 12:05,58,83,74,60,275,4,0
590,3/09/2018 12:10,57,83,73,60,273,4,0
591,3/09/2018 12:15,58,84,75,61,278,4,0
592,3/09/2018 12:20,58,85,75,61,279,4,0
593,3/09/2018 12:25,58,84,75,61,278,4,0
594,3/09/2018 12:30,58,84,75,61,278,4,0
595,3/09/2018 12:35,58,84,74,61,277,4,0
596,3/09/2018 12:40,59,85,75,61,280,4,0
597,3/09/2018 12:45,59,85,75,62,281,4,0
598,3/09/2018 12:50,58,85,75,61,279,4,0
599,3/09/2018 12:55,59,85,75,61,280,4,0
600,3/09/2018 13:00,58,84,75,61,278,4,0
601,3/09/2018 13:05,59,85,75,61,280,4,0
602,3/09/2018 13:10,58,85,75,61,279,4,0
603,3/09/2018 13:15,59,86,76,62,283,4,0
604,3/09/2018 13:20,60,87,77,63,287,4,0
605,3/09/2018 13:25,60,87,77,63,287,4,0
606,3/09/2018 13:30,59,85,75,62,281,4,0
607,3/09/2018 13:35,60,87,77,63,287,4,0
608,3/09/2018 13:40,61,88,78,64,291,4,0
609,3/09/2018 13:45,60,88,77,63,288,4,0
610,3/09/2018 13:50,61,88,78,64,291,4,0
611,3/09/2018 13:55,61,89,78,64,292,4,0
612,3/09/2018 14:00,61,88,78,64,291,4,0
613,3/09/2018 14:05,61,89,78,64,292,4,0
614,3/09/2018 14:10,63,91,80,66,300,4,0
615,3/09/2018 14:15,63,92,81,66,302,4,0
616,3/09/2018 14:20,64,93,82,67,306,4,0
617,3/09/2018 14:25,64,93,82,67,306,4,0
618,3/09/2018 14:30,65,94,83,68,310,4,0
619,3/09/2018 14:35,65,94,83,68,310,4,0
620,3/09/2018 14:40,68,98,87,71,324,4,0
621,3/09/2018 14:45,70,101,89,73,333,4,0
622,3/09/2018 14:50,67,97,85,70,319,4,0
623,3/09/2018 14:55,66,96,85,70,317,4,0
624,3/09/2018 15:00,67,97,86,70,320,4,0
625,3/09/2018 15:05,69,100,88,72,329,4,0
626,3/09/2018 15:10,70,101,89,73,333,4,0
627,3/09/2018 15:15,69,101,89,73,332,4,0
628,3/09/2018 15:20,70,102,90,74,336,4,0
629,3/09/2018 15:25,69,100,88,72,329,4,0
630,3/09/2018 15:30,68,99,87,71,325,4,0
631,3/09/2018 15:35,70,102,90,74,336,4,0
632,3/09/2018 15:40,72,104,92,76,344,4,0
633,3/09/2018 15:45,73,105,93,76,347,4,0
634,3/09/2018 15:50,72,104,92,76,344,4,0
635,3/09/2018 15:55,70,102,90,74,336,4,0
636,3/09/2018 16:00,70,102,90,74,336,4,0
637,3/09/2018 16:05,71,103,91,75,340,4,0
638,3/09/2018 16:10,72,105,93,76,346,4,0
639,3/09/2018 16:15,73,106,93,76,348,4,0
640,3/09/2018 16:20,73,106,93,76,348,4,0
641,3/09/2018 16:25,72,104,92,75,343,4,0
642,3/09/2018 16:30,71,103,91,75,340,4,0
643,3/09/2018 16:35,72,104,92,76,344,4,0
644,3/09/2018 16:40,74,107,95,78,354,4,0
645,3/09/2018 16:45,74,107,94,77,352,4,0
646,3/09/2018 16:50,74,108,95,78,355,4,0
647,3/09/2018 16:55,72,105,92,76,345,4,0
648,3/09/2018 17:00,72,105,93,76,346,4,0
649,3/09/2018 17:05,74,107,95,78,354,4,0
650,3/09/2018 17:10,75,110,97,79,361,4,0
651,3/09/2018 17:15,75,110,97,79,361,4,0
652,3/09/2018 17:20,76,110,97,80,363,4,0
653,3/09/2018 17:25,74,108,95,78,355,4,0
654,3/09/2018 17:30,73,105,93,76,347,4,0
655,3/09/2018 17:35,72,105,92,76,345,4,0
656,3/09/2018 17:40,73,106,93,76,348,4,0
657,3/09/2018 17:45,72,104,92,75,343,4,0
658,3/09/2018 17:50,70,102,90,74,336,4,0
659,3/09/2018 17:55,70,102,90,74,336,4,0
660,3/09/2018 18:00,69,100,88,72,329,4,0
661,3/09/2018 18:05,69,100,88,72,329,4,0
662,3/09/2018 18:10,69,100,88,72,329,4,0
663,3/09/2018 18:15,68,99,87,72,326,4,0
664,3/09/2018 18:20,68,98,87,71,324,4,0
665,3/09/2018 18:25,66,96,85,69,316,4,0
666,3/09/2018 18:30,64,93,83,68,308,4,0
667,3/09/2018 18:35,64,93,83,68,308,4,0
668,3/09/2018 18:40,63,91,80,66,300,4,0
669,3/09/2018 18:45,61,89,79,65,294,4,0
670,3/09/2018 18:50,61,89,78,64,292,4,0
671,3/09/2018 18:55,59,86,76,62,283,4,0
672,3/09/2018 19:00,58,83,74,60,275,4,0
673,3/09/2018 19:05,57,83,73,60,273,4,0
674,3/09/2018 19:10,57,83,73,60,273,4,0
675,3/09/2018 19:15,56,82,72,59,269,4,0
676,3/09/2018 19:20,55,80,70,58,263,4,0
677,3/09/2018 19:25,54,78,69,56,257,4,0
678,3/09/2018 19:30,52,76,67,55,250,4,0
679,3/09/2018 19:35,51,74,66,54,245,4,0
680,3/09/2018 19:40,51,74,65,53,243,4,0
681,3/09/2018 19:45,49,71,62,51,233,4,0
682,3/09/2018 19:50,49,71,63,51,234,4,0
683,3/09/2018 19:55,47,68,60,49,224,4,0
684,3/09/2018 20:00,48,69,61,50,228,4,0
685,3/09/2018 20:05,46,66,59,48,219,4,0
686,3/09/2018 20:10,46,66,58,48,218,4,0
687,3/09/2018 20:15,45,65,58,47,215,4,0
688,3/09/2018 20:20,44,63,56,46,209,4,0
689,3/09/2018 20:25,43,63,56,46,208,4,0
690,3/09/2018 20:30,43,62,55,45,205,4,0
691,3/09/2018 20:35,41,59,53,43,196,4,0
692,3/09/2018 20:40,41,59,52,43,195,4,0
693,3/09/2018 20:45,40,58,51,42,191,4,0
694,3/09/2018 20:50,38,56,49,40,183,4,0
695,3/09/2018 20:55,39,56,50,41,186,4,0
696,3/09/2018 21:00,38,56,49,40,183,4,0
697,3/09/2018 21:05,39,57,50,41,187,4,0
698,3/09/2018 21:10,40,57,51,41,189,4,0
699,3/09/2018 21:15,40,58,51,42,191,4,0
700,3/09/2018 21:20,39,56,50,41,186,4,0
701,3/09/2018 21:25,39,56,50,41,186,4,0
702,3/09/2018 21:30,37,54,48,39,178,4,0
703,3/09/2018 21:35,37,54,47,39,177,4,0
704,3/09/2018 21:40,36,52,46,38,172,4,0
705,3/09/2018 21:45,37,53,47,39,176,4,0
706,3/09/2018 21:50,36,52,46,38,172,4,0
707,3/09/2018 21:55,35,51,45,37,168,4,0
708,3/09/2018 22:00,35,51,45,37,168,4,0
709,3/09/2018 22:05,36,52,46,37,171,4,0
710,3/09/2018 22:10,36,52,46,38,172,4,0
711,3/09/2018 22:15,35,51,45,37,168,4,0
712,3/09/2018 22:20,35,51,45,37,168,4,0
713,3/09/2018 22:25,33,48,43,35,159,4,0
714,3/09/2018 22:30,33,47,42,34,156,4,0
715,3/09/2018 22:35,32,46,40,33,151,4,0
716,3/09/2018 22:40,31,46,40,33,150,4,0
717,3/09/2018 22:45,31,45,40,33,149,4,0
718,3/09/2018 22:50,29,43,38,31,141,4,0
719,3/09/2018 22:55,29,42,37,30,138,4,0
720,3/09/2018 23:00,27,39,35,29,130,4,0
721,3/09/2018 23:05,27,39,34,28,128,4,0
722,3/09/2018 23:10,27,39,34,28,128,4,0
723,3/09/2018 23:15,27,39,35,29,130,4,0
724,3/09/2018 23:20,25,36,32,26,119,4,0
725,3/09/2018 23:25,24,35,31,25,115,4,0
726,3/09/2018 23:30,24,34,30,25,113,4,0
727,3/09/2018 23:35,23,34,30,25,112,4,0
728,3/09/2018 23:40,23,33,29,24,109,4,0
729,3/09/2018 23:45,22,32,28,23,105,4,0
730,3/09/2018 23:50,21,30,27,22,100,4,0
731,3/09/2018 23:55,20,29,26,21,96,4,0
732,3/10/2018 0:00,19,27,24,20,90,4,0
733,3/10/2018 0:05,19,28,24,20,91,4,0
734,3/10/2018 0:10,19,27,24,20,90,4,0
735,3/10/2018 0:15,18,26,23,19,86,4,0
736,3/10/2018 0:20,18,26,23,19,86,4,0
737,3/10/2018 0:25,17,24,21,17,79,4,0
738,3/10/2018 0:30,16,23,20,16,75,4,0
739,3/10/2018 0:35,15,22,20,16,73,4,0
740,3/10/2018 0:40,15,22,20,16,73,4,0
741,3/10/2018 0:45,15,21,19,15,70,4,0
742,3/10/2018 0:50,14,21,18,15,68,4,0
743,3/10/2018 0:55,14,20,18,15,67,4,0
744,3/10/2018 1:00,13,19,17,14,63,4,0
745,3/10/2018 1:05,13,19,17,14,63,4,0
746,3/10/2018 1:10,13,19,17,14,63,4,0
747,3/10/2018 1:15,13,18,16,13,60,4,0
748,3/10/2018 1:20,13,18,16,13,60,4,0
749,3/10/2018 1:25,12,17,15,12,56,4,0
750,3/10/2018 1:30,2,3,3,2,10,4,0
751,3/10/2018 1:35,12,17,15,12,56,4,0
752,3/10/2018 1:40,12,17,15,12,56,4,0
753,3/10/2018 1:45,11,16,14,11,52,4,0
754,3/10/2018 1:50,11,16,14,12,53,4,0
755,3/10/2018 1:55,11,15,14,11,51,4,0
756,3/10/2018 2:00,11,16,14,11,52,4,0
757,3/10/2018 2:05,11,15,14,11,51,4,0
758,3/10/2018 2:10,11,16,14,11,52,4,0
759,3/10/2018 2:15,10,15,13,11,49,4,0
760,3/10/2018 2:20,10,15,13,11,49,4,0
761,3/10/2018 2:25,10,14,12,10,46,4,0
762,3/10/2018 2:30,9,13,12,10,44,4,0
763,3/10/2018 2:35,9,13,11,9,42,4,0
764,3/10/2018 2:40,9,13,11,9,42,4,0
765,3/10/2018 2:45,8,12,11,9,40,4,0
766,3/10/2018 2:50,8,12,11,9,40,4,0
767,3/10/2018 2:55,8,11,10,8,37,4,0
768,3/10/2018 3:00,7,11,9,8,35,4,0
769,3/10/2018 3:05,7,10,9,7,33,4,0
770,3/10/2018 3:10,7,11,9,8,35,4,0
771,3/10/2018 3:15,7,11,9,8,35,4,0
772,3/10/2018 3:20,7,10,9,7,33,4,0
773,3/10/2018 3:25,7,10,9,7,33,4,0
774,3/10/2018 3:30,7,10,9,7,33,4,0
775,3/10/2018 3:35,7,11,9,8,35,4,0
776,3/10/2018 3:40,8,11,10,8,37,4,0
777,3/10/2018 3:45,7,11,9,8,35,4,0
778,3/10/2018 3:50,7,10,9,7,33,4,0
779,3/10/2018 3:55,6,9,8,7,30,4,0
780,3/10/2018 4:00,6,9,8,7,30,4,0
781,3/10/2018 4:05,6,9,8,7,30,4,0
782,3/10/2018 4:10,7,11,9,8,35,4,0
783,3/10/2018 4:15,8,11,10,8,37,4,0
784,3/10/2018 4:20,8,12,11,9,40,4,0
785,3/10/2018 4:25,8,12,11,9,40,4,0
786,3/10/2018 4:30,9,13,11,9,42,4,0
787,3/10/2018 4:35,9,14,12,10,45,4,0
788,3/10/2018 4:40,10,15,13,11,49,4,0
789,3/10/2018 4:45,10,15,13,11,49,4,0
790,3/10/2018 4:50,10,14,13,10,47,4,0
791,3/10/2018 4:55,9,14,12,10,45,4,0
792,3/10/2018 5:00,10,14,13,10,47,4,0
793,3/10/2018 5:05,11,16,14,11,52,4,0
794,3/10/2018 5:10,12,18,16,13,59,4,0
795,3/10/2018 5:15,13,19,17,14,63,4,0
796,3/10/2018 5:20,14,21,18,15,68,4,0
797,3/10/2018 5:25,15,22,20,16,73,4,0
798,3/10/2018 5:30,16,24,21,17,78,4,0
799,3/10/2018 5:35,18,26,23,19,86,4,0
800,3/10/2018 5:40,19,28,25,20,92,4,0
801,3/10/2018 5:45,20,29,25,21,95,4,0
802,3/10/2018 5:50,19,28,24,20,91,4,0
803,3/10/2018 5:55,18,26,23,19,86,4,0
804,3/10/2018 6:00,18,26,23,19,86,4,0
805,3/10/2018 6:05,19,27,24,20,90,4,0
806,3/10/2018 6:10,20,29,26,21,96,4,0
807,3/10/2018 6:15,21,31,27,22,101,4,0
808,3/10/2018 6:20,22,32,29,23,106,4,0
809,3/10/2018 6:25,23,34,30,24,111,4,0
810,3/10/2018 6:30,25,36,32,26,119,4,0
811,3/10/2018 6:35,26,38,34,28,126,4,0
812,3/10/2018 6:40,28,41,36,30,135,4,0
813,3/10/2018 6:45,29,42,37,30,138,4,0
814,3/10/2018 6:50,29,42,37,30,138,4,0
815,3/10/2018 6:55,27,39,35,29,130,4,0
816,3/10/2018 7:00,27,39,35,28,129,4,0
817,3/10/2018 7:05,28,40,35,29,132,4,0
818,3/10/2018 7:10,29,42,37,30,138,4,0
819,3/10/2018 7:15,31,45,39,32,147,4,0
820,3/10/2018 7:20,32,46,41,33,152,4,0
821,3/10/2018 7:25,34,49,43,35,161,4,0
822,3/10/2018 7:30,34,49,44,36,163,4,0
823,3/10/2018 7:35,37,53,47,38,175,4,0
824,3/10/2018 7:40,40,58,51,42,191,4,0
825,3/10/2018 7:45,41,59,52,43,195,4,0
826,3/10/2018 7:50,41,59,52,43,195,4,0
827,3/10/2018 7:55,40,58,51,42,191,4,0
828,3/10/2018 8:00,38,56,49,40,183,4,0
829,3/10/2018 8:05,38,56,49,40,183,4,0
830,3/10/2018 8:10,39,57,50,41,187,4,0
831,3/10/2018 8:15,40,59,52,42,193,4,0
832,3/10/2018 8:20,41,59,52,43,195,4,0
833,3/10/2018 8:25,42,61,54,44,201,4,0
834,3/10/2018 8:30,43,63,55,45,206,4,0
835,3/10/2018 8:35,46,66,59,48,219,4,0
836,3/10/2018 8:40,47,69,61,50,227,4,0
837,3/10/2018 8:45,49,71,63,52,235,4,0
838,3/10/2018 8:50,49,71,62,51,233,4,0
839,3/10/2018 8:55,47,68,60,49,224,4,0
840,3/10/2018 9:00,46,67,59,49,221,4,0
841,3/10/2018 9:05,44,64,57,47,212,4,0
842,3/10/2018 9:10,45,66,58,47,216,4,0
843,3/10/2018 9:15,47,68,60,49,224,4,0
844,3/10/2018 9:20,49,71,62,51,233,4,0
845,3/10/2018 9:25,49,71,63,51,234,4,0
846,3/10/2018 9:30,51,74,65,53,243,4,0
847,3/10/2018 9:35,51,74,65,54,244,4,0
848,3/10/2018 9:40,53,76,68,55,252,4,0
849,3/10/2018 9:45,54,78,69,56,257,4,0
850,3/10/2018 9:50,52,76,67,55,250,4,0
851,3/10/2018 9:55,51,73,65,53,242,4,0
852,3/10/2018 10:00,51,74,65,54,244,4,0
853,3/10/2018 10:05,51,75,66,54,246,4,0
854,3/10/2018 10:10,52,75,66,54,247,4,0
855,3/10/2018 10:15,52,76,67,55,250,4,0
856,3/10/2018 10:20,52,75,66,54,247,4,0
857,3/10/2018 10:25,52,76,67,55,250,4,0
858,3/10/2018 10:30,54,78,69,56,257,4,0
859,3/10/2018 10:35,55,79,70,58,262,4,0
860,3/10/2018 10:40,55,80,70,58,263,4,0
861,3/10/2018 10:45,55,80,71,58,264,4,0
862,3/10/2018 10:50,56,81,71,58,266,4,0
863,3/10/2018 10:55,55,79,70,57,261,4,0
864,3/10/2018 11:00,55,79,70,57,261,4,0
865,3/10/2018 11:05,55,80,71,58,264,4,0
866,3/10/2018 11:10,56,82,72,59,269,4,0
867,3/10/2018 11:15,57,82,73,59,271,4,0
868,3/10/2018 11:20,57,83,73,60,273,4,0
869,3/10/2018 11:25,57,83,73,60,273,4,0
870,3/10/2018 11:30,57,83,73,60,273,4,0
871,3/10/2018 11:35,58,85,75,61,279,4,0
872,3/10/2018 11:40,58,84,74,61,277,4,0
873,3/10/2018 11:45,58,84,75,61,278,4,0
874,3/10/2018 11:50,58,85,75,61,279,4,0
875,3/10/2018 11:55,57,83,73,60,273,4,0
876,3/10/2018 12:00,58,83,74,60,275,4,0
877,3/10/2018 12:05,59,86,76,62,283,4,0
878,3/10/2018 12:10,60,86,76,63,285,4,0
879,3/10/2018 12:15,60,87,77,63,287,4,0
880,3/10/2018 12:20,60,87,77,63,287,4,0
881,3/10/2018 12:25,59,86,76,62,283,4,0
882,3/10/2018 12:30,59,85,75,62,281,4,0
883,3/10/2018 12:35,58,85,75,61,279,4,0
884,3/10/2018 12:40,59,85,75,61,280,4,0
885,3/10/2018 12:45,59,86,76,62,283,4,0
886,3/10/2018 12:50,59,86,76,62,283,4,0
887,3/10/2018 12:55,58,85,75,61,279,4,0
888,3/10/2018 13:00,58,83,74,60,275,4,0
889,3/10/2018 13:05,58,85,75,61,279,4,0
890,3/10/2018 13:10,58,85,75,61,279,4,0
891,3/10/2018 13:15,59,86,76,62,283,4,0
892,3/10/2018 13:20,59,85,75,62,281,4,0
893,3/10/2018 13:25,59,86,76,62,283,4,0
894,3/10/2018 13:30,59,86,76,62,283,4,0
895,3/10/2018 13:35,58,85,75,61,279,4,0
896,3/10/2018 13:40,59,86,76,62,283,4,0
897,3/10/2018 13:45,59,85,75,61,280,4,0
898,3/10/2018 13:50,59,86,76,62,283,4,0
899,3/10/2018 13:55,57,83,73,60,273,4,0
900,3/10/2018 14:00,58,83,74,60,275,4,0
901,3/10/2018 14:05,58,84,74,61,277,4,0
902,3/10/2018 14:10,59,85,75,61,280,4,0
903,3/10/2018 14:15,59,86,76,62,283,4,0
904,3/10/2018 14:20,58,85,75,61,279,4,0
905,3/10/2018 14:25,59,86,76,62,283,4,0
906,3/10/2018 14:30,58,84,74,61,277,4,0
907,3/10/2018 14:35,60,86,76,63,285,4,0
908,3/10/2018 14:40,59,86,76,62,283,4,0
909,3/10/2018 14:45,60,87,77,63,287,4,0
910,3/10/2018 14:50,60,87,77,63,287,4,0
911,3/10/2018 14:55,59,85,75,61,280,4,0
912,3/10/2018 15:00,59,85,75,61,280,4,0
913,3/10/2018 15:05,59,85,75,62,281,4,0
914,3/10/2018 15:10,60,87,77,63,287,4,0
915,3/10/2018 15:15,60,87,77,63,287,4,0
916,3/10/2018 15:20,61,89,79,65,294,4,0
917,3/10/2018 15:25,60,87,77,63,287,4,0
918,3/10/2018 15:30,60,87,77,63,287,4,0
919,3/10/2018 15:35,61,88,78,64,291,4,0
920,3/10/2018 15:40,60,87,77,63,287,4,0
921,3/10/2018 15:45,60,87,77,63,287,4,0
922,3/10/2018 15:50,60,88,77,63,288,4,0
923,3/10/2018 15:55,60,86,76,63,285,4,0
924,3/10/2018 16:00,60,86,76,63,285,4,0
925,3/10/2018 16:05,60,86,76,63,285,4,0
926,3/10/2018 16:10,60,87,77,63,287,4,0
927,3/10/2018 16:15,60,88,77,63,288,4,0
928,3/10/2018 16:20,61,89,78,64,292,4,0
929,3/10/2018 16:25,60,87,77,63,287,4,0
930,3/10/2018 16:30,60,87,77,63,287,4,0
931,3/10/2018 16:35,60,87,77,63,287,4,0
932,3/10/2018 16:40,60,87,77,63,287,4,0
933,3/10/2018 16:45,60,87,77,63,287,4,0
934,3/10/2018 16:50,61,88,78,64,291,4,0
935,3/10/2018 16:55,58,85,75,61,279,4,0
936,3/10/2018 17:00,59,85,75,61,280,4,0
937,3/10/2018 17:05,59,85,75,62,281,4,0
938,3/10/2018 17:10,60,87,77,63,287,4,0
939,3/10/2018 17:15,60,87,77,63,287,4,0
940,3/10/2018 17:20,62,90,80,65,297,4,0
941,3/10/2018 17:25,59,86,76,62,283,4,0
942,3/10/2018 17:30,58,85,75,61,279,4,0
943,3/10/2018 17:35,58,84,75,61,278,4,0
944,3/10/2018 17:40,58,84,74,61,277,4,0
945,3/10/2018 17:45,57,82,73,59,271,4,0
946,3/10/2018 17:50,57,83,73,60,273,4,0
947,3/10/2018 17:55,56,81,72,59,268,4,0
948,3/10/2018 18:00,55,80,70,58,263,4,0
949,3/10/2018 18:05,56,81,72,59,268,4,0
950,3/10/2018 18:10,56,81,71,58,266,4,0
951,3/10/2018 18:15,55,80,70,58,263,4,0
952,3/10/2018 18:20,55,80,70,58,263,4,0
953,3/10/2018 18:25,53,77,68,56,254,4,0
954,3/10/2018 18:30,53,77,68,56,254,4,0
955,3/10/2018 18:35,52,75,66,54,247,4,0
956,3/10/2018 18:40,51,74,65,53,243,4,0
957,3/10/2018 18:45,50,73,65,53,241,4,0
958,3/10/2018 18:50,49,72,63,52,236,4,0
959,3/10/2018 18:55,49,71,63,52,235,4,0
960,3/10/2018 19:00,48,69,61,50,228,4,0
961,3/10/2018 19:05,48,70,62,50,230,4,0
962,3/10/2018 19:10,47,68,60,49,224,4,0
963,3/10/2018 19:15,48,69,61,50,228,4,0
964,3/10/2018 19:20,46,67,59,49,221,4,0
965,3/10/2018 19:25,45,65,57,47,214,4,0
966,3/10/2018 19:30,44,64,56,46,210,4,0
967,3/10/2018 19:35,43,62,55,45,205,4,0
968,3/10/2018 19:40,43,63,55,45,206,4,0
969,3/10/2018 19:45,42,61,54,44,201,4,0
970,3/10/2018 19:50,41,60,53,43,197,4,0
971,3/10/2018 19:55,40,58,51,42,191,4,0
972,3/10/2018 20:00,41,59,52,43,195,4,0
973,3/10/2018 20:05,40,57,51,41,189,4,0
974,3/10/2018 20:10,39,57,50,41,187,4,0
975,3/10/2018 20:15,39,57,50,41,187,4,0
976,3/10/2018 20:20,38,56,49,40,183,4,0
977,3/10/2018 20:25,38,55,49,40,182,4,0
978,3/10/2018 20:30,37,54,48,39,178,4,0
979,3/10/2018 20:35,37,54,48,39,178,4,0
980,3/10/2018 20:40,38,55,48,40,181,4,0
981,3/10/2018 20:45,37,54,47,39,177,4,0
982,3/10/2018 20:50,36,52,46,38,172,4,0
983,3/10/2018 20:55,36,53,47,38,174,4,0
984,3/10/2018 21:00,36,52,46,37,171,4,0
985,3/10/2018 21:05,36,52,46,38,172,4,0
986,3/10/2018 21:10,35,51,45,37,168,4,0
987,3/10/2018 21:15,36,52,46,38,172,4,0
988,3/10/2018 21:20,36,52,46,37,171,4,0
989,3/10/2018 21:25,35,51,45,37,168,4,0
990,3/10/2018 21:30,35,51,45,37,168,4,0
991,3/10/2018 21:35,35,51,45,37,168,4,0
992,3/10/2018 21:40,36,52,46,37,171,4,0
993,3/10/2018 21:45,36,52,46,37,171,4,0
994,3/10/2018 21:50,34,50,44,36,164,4,0
995,3/10/2018 21:55,34,49,44,36,163,4,0
996,3/10/2018 22:00,34,49,44,36,163,4,0
997,3/10/2018 22:05,35,50,44,36,165,4,0
998,3/10/2018 22:10,36,52,46,37,171,4,0
999,3/10/2018 22:15,35,50,44,36,165,4,0
1000,3/10/2018 22:20,35,50,44,36,165,4,0
1001,3/10/2018 22:25,34,49,43,36,162,4,0
1002,3/10/2018 22:30,34,49,43,35,161,4,0
1003,3/10/2018 22:35,33,48,43,35,159,4,0
1004,3/10/2018 22:40,33,48,42,34,157,4,0
1005,3/10/2018 22:45,32,46,41,33,152,4,0
1006,3/10/2018 22:50,31,45,40,33,149,4,0
1007,3/10/2018 22:55,29,42,37,31,139,4,0
1008,3/10/2018 23:00,28,41,36,30,135,4,0
1009,3/10/2018 23:05,29,42,37,31,139,4,0
1010,3/10/2018 23:10,29,42,37,31,139,4,0
1011,3/10/2018 23:15,28,41,36,30,135,4,0
1012,3/10/2018 23:20,29,42,37,31,139,4,0
1013,3/10/2018 23:25,27,39,35,29,130,4,0
1014,3/10/2018 23:30,27,39,35,29,130,4,0
1015,3/10/2018 23:35,26,37,33,27,123,4,0
1016,3/10/2018 23:40,25,37,32,27,121,4,0
1017,3/10/2018 23:45,25,36,32,26,119,4,0
1018,3/10/2018 23:50,24,34,30,25,113,4,0
1019,3/10/2018 23:55,23,33,29,24,109,4,0
1020,3/11/2018 0:00,22,31,28,23,104,4,0
1021,3/11/2018 0:05,21,31,27,22,101,4,0
1022,3/11/2018 0:10,21,30,27,22,100,4,0
1023,3/11/2018 0:15,20,29,26,21,96,4,0
1024,3/11/2018 0:20,19,28,25,20,92,4,0
1025,3/11/2018 0:25,19,27,24,20,90,4,0
1026,3/11/2018 0:30,17,25,22,18,82,4,0
1027,3/11/2018 0:35,17,25,22,18,82,4,0
1028,3/11/2018 0:40,17,24,21,17,79,4,0
1029,3/11/2018 0:45,16,23,20,17,76,4,0
1030,3/11/2018 0:50,16,23,20,16,75,4,0
1031,3/11/2018 0:55,14,21,18,15,68,4,0
1032,3/11/2018 1:00,14,21,18,15,68,4,0
1033,3/11/2018 1:05,14,20,17,14,65,4,0
1034,3/11/2018 1:10,14,20,17,14,65,4,0
1035,3/11/2018 1:15,13,19,17,14,63,4,0
1036,3/11/2018 1:20,14,20,17,14,65,4,0
1037,3/11/2018 1:25,12,18,16,13,59,4,0
1038,3/11/2018 1:30,12,18,16,13,59,4,0
1039,3/11/2018 1:35,12,18,16,13,59,4,0
1040,3/11/2018 1:40,12,18,16,13,59,4,0
1041,3/11/2018 1:45,12,17,15,13,57,4,0
1042,3/11/2018 1:50,12,17,15,12,56,4,0
1043,3/11/2018 1:55,11,16,14,12,53,4,0
1044,3/11/2018 3:00,7,10,9,7,33,4,0
1045,3/11/2018 3:05,7,10,9,7,33,4,0
1046,3/11/2018 3:10,6,9,8,7,30,4,0
1047,3/11/2018 3:15,6,9,8,7,30,4,0
1048,3/11/2018 3:20,6,9,8,7,30,4,0
1049,3/11/2018 3:25,6,8,8,6,28,4,0
1050,3/11/2018 3:30,6,8,8,6,28,4,0
1051,3/11/2018 3:35,6,8,8,6,28,4,0
1052,3/11/2018 3:40,5,8,7,5,25,4,0
1053,3/11/2018 3:45,5,8,7,6,26,4,0
1054,3/11/2018 3:50,5,8,7,5,25,4,0
1055,3/11/2018 3:55,5,7,6,5,23,4,0
1056,3/11/2018 4:00,5,7,6,5,23,4,0
1057,3/11/2018 4:05,5,7,6,5,23,4,0
1058,3/11/2018 4:10,5,7,6,5,23,4,0
1059,3/11/2018 4:15,5,7,6,5,23,4,0
1060,3/11/2018 4:20,5,7,6,5,23,4,0
1061,3/11/2018 4:25,5,7,6,5,23,4,0
1062,3/11/2018 4:30,5,7,6,5,23,4,0
1063,3/11/2018 4:35,5,8,7,6,26,4,0
1064,3/11/2018 4:40,5,8,7,6,26,4,0
1065,3/11/2018 4:45,6,8,7,6,27,4,0
1066,3/11/2018 4:50,6,8,8,6,28,4,0
1067,3/11/2018 4:55,6,8,7,6,27,4,0
1068,3/11/2018 5:00,6,8,7,6,27,4,0
1069,3/11/2018 5:05,6,9,8,7,30,4,0
1070,3/11/2018 5:10,6,9,8,7,30,4,0
1071,3/11/2018 5:15,7,10,9,7,33,4,0
1072,3/11/2018 5:20,7,11,9,8,35,4,0
1073,3/11/2018 5:25,8,11,10,8,37,4,0
1074,3/11/2018 5:30,9,12,11,9,41,4,0
1075,3/11/2018 5:35,9,13,12,9,43,4,0
1076,3/11/2018 5:40,10,14,12,10,46,4,0
1077,3/11/2018 5:45,10,14,13,10,47,4,0
1078,3/11/2018 5:50,10,14,12,10,46,4,0
1079,3/11/2018 5:55,9,13,12,10,44,4,0
1080,3/11/2018 6:00,9,14,12,10,45,4,0
1081,3/11/2018 6:05,10,15,13,11,49,4,0
1082,3/11/2018 6:10,11,15,14,11,51,4,0
1083,3/11/2018 6:15,12,17,15,12,56,4,0
1084,3/11/2018 6:20,12,18,16,13,59,4,0
1085,3/11/2018 6:25,13,18,16,13,60,4,0
1086,3/11/2018 6:30,13,19,17,14,63,4,0
1087,3/11/2018 6:35,14,20,18,14,66,4,0
1088,3/11/2018 6:40,15,21,19,15,70,4,0
1089,3/11/2018 6:45,15,21,19,15,70,4,0
1090,3/11/2018 6:50,15,22,20,16,73,4,0
1091,3/11/2018 6:55,14,21,18,15,68,4,0
1092,3/11/2018 7:00,14,20,18,14,66,4,0
1093,3/11/2018 7:05,14,21,18,15,68,4,0
1094,3/11/2018 7:10,15,22,20,16,73,4,0
1095,3/11/2018 7:15,16,23,20,17,76,4,0
1096,3/11/2018 7:20,17,25,22,18,82,4,0
1097,3/11/2018 7:25,18,25,23,18,84,4,0
1098,3/11/2018 7:30,18,26,23,19,86,4,0
1099,3/11/2018 7:35,19,28,25,20,92,4,0
1100,3/11/2018 7:40,21,30,27,22,100,4,0
1101,3/11/2018 7:45,21,31,27,22,101,4,0
1102,3/11/2018 7:50,22,32,28,23,105,4,0
1103,3/11/2018 7:55,22,31,28,23,104,4,0
1104,3/11/2018 8:00,21,30,27,22,100,4,0
1105,3/11/2018 8:05,22,31,28,23,104,4,0
1106,3/11/2018 8:10,22,32,29,23,106,4,0
1107,3/11/2018 8:15,24,34,30,25,113,4,0
1108,3/11/2018 8:20,26,37,33,27,123,4,0
1109,3/11/2018 8:25,26,37,33,27,123,4,0
1110,3/11/2018 8:30,26,38,34,27,125,4,0
1111,3/11/2018 8:35,28,40,36,29,133,4,0
1112,3/11/2018 8:40,29,42,38,31,140,4,0
1113,3/11/2018 8:45,31,44,39,32,146,4,0
1114,3/11/2018 8:50,31,45,40,33,149,4,0
1115,3/11/2018 8:55,31,45,40,33,149,4,0
1116,3/11/2018 9:00,30,44,39,32,145,4,0
1117,3/11/2018 9:05,30,44,39,32,145,4,0
1118,3/11/2018 9:10,31,46,40,33,150,4,0
1119,3/11/2018 9:15,33,48,42,35,158,4,0
1120,3/11/2018 9:20,35,50,44,36,165,4,0
1121,3/11/2018 9:25,35,51,45,37,168,4,0
1122,3/11/2018 9:30,37,53,47,39,176,4,0
1123,3/11/2018 9:35,39,56,50,41,186,4,0
1124,3/11/2018 9:40,40,58,51,42,191,4,0
1125,3/11/2018 9:45,41,60,53,43,197,4,0
1126,3/11/2018 9:50,41,60,53,43,197,4,0
1127,3/11/2018 9:55,41,59,53,43,196,4,0
1128,3/11/2018 10:00,41,59,52,43,195,4,0
1129,3/11/2018 10:05,40,58,51,42,191,4,0
1130,3/11/2018 10:10,41,59,53,43,196,4,0
1131,3/11/2018 10:15,43,62,55,45,205,4,0
1132,3/11/2018 10:20,43,62,55,45,205,4,0
1133,3/11/2018 10:25,44,64,56,46,210,4,0
1134,3/11/2018 10:30,45,65,57,47,214,4,0
1135,3/11/2018 10:35,45,65,57,47,214,4,0
1136,3/11/2018 10:40,47,68,60,49,224,4,0
1137,3/11/2018 10:45,47,68,60,49,224,4,0
1138,3/11/2018 10:50,47,68,60,49,224,4,0
1139,3/11/2018 10:55,47,68,60,49,224,4,0
1140,3/11/2018 11:00,46,66,58,48,218,4,0
1141,3/11/2018 11:05,46,66,58,48,218,4,0
1142,3/11/2018 11:10,46,66,59,48,219,4,0
1143,3/11/2018 11:15,46,67,59,49,221,4,0
1144,3/11/2018 11:20,48,69,61,50,228,4,0
1145,3/11/2018 11:25,48,69,61,50,228,4,0
1146,3/11/2018 11:30,48,70,62,51,231,4,0
1147,3/11/2018 11:35,48,70,62,51,231,4,0
1148,3/11/2018 11:40,50,72,64,52,238,4,0
1149,3/11/2018 11:45,50,72,64,52,238,4,0
1150,3/11/2018 11:50,50,72,64,52,238,4,0
1151,3/11/2018 11:55,49,72,63,52,236,4,0
1152,3/11/2018 12:00,49,70,62,51,232,4,0
1153,3/11/2018 12:05,49,70,62,51,232,4,0
1154,3/11/2018 12:10,50,72,64,52,238,4,0
1155,3/11/2018 12:15,51,73,65,53,242,4,0
1156,3/11/2018 12:20,50,73,65,53,241,4,0
1157,3/11/2018 12:25,50,73,64,52,239,4,0
1158,3/11/2018 12:30,51,74,66,54,245,4,0
1159,3/11/2018 12:35,51,74,66,54,245,4,0
1160,3/11/2018 12:40,52,76,67,55,250,4,0
1161,3/11/2018 12:45,54,79,70,57,260,4,0
1162,3/11/2018 12:50,53,77,68,56,254,4,0
1163,3/11/2018 12:55,54,79,70,57,260,4,0
1164,3/11/2018 13:00,52,76,67,55,250,4,0
1165,3/11/2018 13:05,53,76,68,55,252,4,0
1166,3/11/2018 13:10,53,77,68,56,254,4,0
1167,3/11/2018 13:15,53,77,68,56,254,4,0
1168,3/11/2018 13:20,53,77,68,56,254,4,0
1169,3/11/2018 13:25,53,77,68,56,254,4,0
1170,3/11/2018 13:30,53,77,68,56,254,4,0
1171,3/11/2018 13:35,53,77,68,56,254,4,0
1172,3/11/2018 13:40,52,75,66,54,247,4,0
1173,3/11/2018 13:45,52,75,66,54,247,4,0
1174,3/11/2018 13:50,52,76,67,55,250,4,0
1175,3/11/2018 13:55,53,76,68,55,252,4,0
1176,3/11/2018 14:00,52,76,67,55,250,4,0
1177,3/11/2018 14:05,52,76,67,55,250,4,0
1178,3/11/2018 14:10,52,76,67,55,250,4,0
1179,3/11/2018 14:15,53,76,68,55,252,4,0
1180,3/11/2018 14:20,53,77,68,56,254,4,0
1181,3/11/2018 14:25,53,77,68,56,254,4,0
1182,3/11/2018 14:30,52,76,67,55,250,4,0
1183,3/11/2018 14:35,53,77,68,56,254,4,0
1184,3/11/2018 14:40,52,76,67,55,250,4,0
1185,3/11/2018 14:45,53,76,68,55,252,4,0
1186,3/11/2018 14:50,52,76,67,55,250,4,0
1187,3/11/2018 14:55,53,77,68,56,254,4,0
1188,3/11/2018 15:00,52,76,67,55,250,4,0
1189,3/11/2018 15:05,52,76,67,55,250,4,0
1190,3/11/2018 15:10,53,77,68,56,254,4,0
1191,3/11/2018 15:15,54,78,69,57,258,4,0
1192,3/11/2018 15:20,53,77,68,56,254,4,0
1193,3/11/2018 15:25,53,77,68,56,254,4,0
1194,3/11/2018 15:30,52,76,67,55,250,4,0
1195,3/11/2018 15:35,52,76,67,55,250,4,0
1196,3/11/2018 15:40,52,75,66,54,247,4,0
1197,3/11/2018 15:45,51,75,66,54,246,4,0
1198,3/11/2018 15:50,50,72,64,52,238,4,0
1199,3/11/2018 15:55,51,73,65,53,242,4,0
1200,3/11/2018 16:00,50,73,65,53,241,4,0
1201,3/11/2018 16:05,52,75,66,54,247,4,0
1202,3/11/2018 16:10,54,79,70,57,260,4,0
1203,3/11/2018 16:15,54,79,70,57,260,4,0
1204,3/11/2018 16:20,52,76,67,55,250,4,0
1205,3/11/2018 16:25,52,76,67,55,250,4,0
1206,3/11/2018 16:30,52,76,67,55,250,4,0
1207,3/11/2018 16:35,52,76,67,55,250,4,0
1208,3/11/2018 16:40,53,76,68,55,252,4,0
1209,3/11/2018 16:45,52,76,67,55,250,4,0
1210,3/11/2018 16:50,53,77,68,56,254,4,0
1211,3/11/2018 16:55,53,77,68,56,254,4,0
1212,3/11/2018 17:00,51,74,66,54,245,4,0
1213,3/11/2018 17:05,52,76,67,55,250,4,0
1214,3/11/2018 17:10,53,77,68,56,254,4,0
1215,3/11/2018 17:15,53,76,68,55,252,4,0
1216,3/11/2018 17:20,54,78,69,56,257,4,0
1217,3/11/2018 17:25,52,76,67,55,250,4,0
1218,3/11/2018 17:30,52,76,67,55,250,4,0
1219,3/11/2018 17:35,52,75,66,54,247,4,0
1220,3/11/2018 17:40,52,76,67,55,250,4,0
1221,3/11/2018 17:45,51,74,65,53,243,4,0
1222,3/11/2018 17:50,51,74,65,54,244,4,0
1223,3/11/2018 17:55,50,73,64,52,239,4,0
1224,3/11/2018 18:00,49,70,62,51,232,4,0
1225,3/11/2018 18:05,48,70,62,50,230,4,0
1226,3/11/2018 18:10,48,70,62,50,230,4,0
1227,3/11/2018 18:15,51,73,65,53,242,4,0
1228,3/11/2018 18:20,50,73,65,53,241,4,0
1229,3/11/2018 18:25,47,69,61,50,227,4,0
1230,3/11/2018 18:30,47,68,60,49,224,4,0
1231,3/11/2018 18:35,46,66,59,48,219,4,0
1232,3/11/2018 18:40,45,66,58,48,217,4,0
1233,3/11/2018 18:45,45,66,58,47,216,4,0
1234,3/11/2018 18:50,45,65,57,47,214,4,0
1235,3/11/2018 18:55,44,64,56,46,210,4,0
1236,3/11/2018 19:00,43,62,55,45,205,4,0
1237,3/11/2018 19:05,43,62,55,45,205,4,0
1238,3/11/2018 19:10,42,62,54,45,203,4,0
1239,3/11/2018 19:15,42,62,54,45,203,4,0
1240,3/11/2018 19:20,43,62,55,45,205,4,0
1241,3/11/2018 19:25,42,61,54,44,201,4,0
1242,3/11/2018 19:30,41,60,53,43,197,4,0
1243,3/11/2018 19:35,40,59,52,42,193,4,0
1244,3/11/2018 19:40,40,58,51,42,191,4,0
1245,3/11/2018 19:45,40,58,51,42,191,4,0
1246,3/11/2018 19:50,38,56,49,40,183,4,0
1247,3/11/2018 19:55,38,56,49,40,183,4,0
1248,3/11/2018 20:00,38,55,48,40,181,4,0
1249,3/11/2018 20:05,39,56,50,41,186,4,0
1250,3/11/2018 20:10,38,55,49,40,182,4,0
1251,3/11/2018 20:15,38,55,48,40,181,4,0
1252,3/11/2018 20:20,38,56,49,40,183,4,0
1253,3/11/2018 20:25,38,55,49,40,182,4,0
1254,3/11/2018 20:30,37,54,47,39,177,4,0
1255,3/11/2018 20:35,35,51,45,37,168,4,0
1256,3/11/2018 20:40,35,51,45,37,168,4,0
1257,3/11/2018 20:45,34,49,44,36,163,4,0
1258,3/11/2018 20:50,34,50,44,36,164,4,0
1259,3/11/2018 20:55,33,48,42,35,158,4,0
1260,3/11/2018 21:00,32,46,41,33,152,4,0
1261,3/11/2018 21:05,32,46,41,34,153,4,0
1262,3/11/2018 21:10,32,46,41,34,153,4,0
1263,3/11/2018 21:15,32,46,41,34,153,4,0
1264,3/11/2018 21:20,32,47,42,34,155,4,0
1265,3/11/2018 21:25,31,45,40,33,149,4,0
1266,3/11/2018 21:30,31,45,40,32,148,4,0
1267,3/11/2018 21:35,30,44,39,32,145,4,0
1268,3/11/2018 21:40,31,44,39,32,146,4,0
1269,3/11/2018 21:45,30,43,38,31,142,4,0
1270,3/11/2018 21:50,29,42,38,31,140,4,0
1271,3/11/2018 21:55,28,40,35,29,132,4,0
1272,3/11/2018 22:00,27,40,35,29,131,4,0
1273,3/11/2018 22:05,27,39,35,29,130,4,0
1274,3/11/2018 22:10,27,39,34,28,128,4,0
1275,3/11/2018 22:15,27,39,34,28,128,4,0
1276,3/11/2018 22:20,26,37,33,27,123,4,0
1277,3/11/2018 22:25,25,36,32,26,119,4,0
1278,3/11/2018 22:30,23,33,29,24,109,4,0
1279,3/11/2018 22:35,23,33,29,24,109,4,0
1280,3/11/2018 22:40,23,33,29,24,109,4,0
1281,3/11/2018 22:45,22,32,29,23,106,4,0
1282,3/11/2018 22:50,20,29,26,21,96,4,0
1283,3/11/2018 22:55,19,27,24,20,90,4,0
1284,3/11/2018 23:00,18,26,23,19,86,4,0
1285,3/11/2018 23:05,18,26,23,19,86,4,0
1286,3/11/2018 23:10,18,26,23,19,86,4,0
1287,3/11/2018 23:15,17,25,22,18,82,4,0
1288,3/11/2018 23:20,17,25,22,18,82,4,0
1289,3/11/2018 23:25,16,23,20,17,76,4,0
1290,3/11/2018 23:30,15,22,20,16,73,4,0
1291,3/11/2018 23:35,15,21,19,15,70,4,0
1292,3/11/2018 23:40,14,21,18,15,68,4,0
1293,3/11/2018 23:45,13,19,17,14,63,4,0
1294,3/11/2018 23:50,13,19,16,13,61,4,0
1295,3/11/2018 23:55,12,17,15,13,57,4,0
1296,3/12/2018 0:00,11,16,14,12,53,4,0
1297,3/12/2018 0:05,11,16,14,11,52,4,0
1298,3/12/2018 0:10,11,15,14,11,51,4,0
1299,3/12/2018 0:15,10,15,13,11,49,4,0
1300,3/12/2018 0:20,10,15,13,11,49,4,0
1301,3/12/2018 0:25,9,14,12,10,45,4,0
1302,3/12/2018 0:30,9,13,12,9,43,4,0
1303,3/12/2018 0:35,8,12,11,9,40,4,0
1304,3/12/2018 0:40,8,12,10,9,39,4,0
1305,3/12/2018 0:45,8,12,10,8,38,4,0
1306,3/12/2018 0:50,8,11,10,8,37,4,0
1307,3/12/2018 0:55,7,11,9,8,35,4,0
1308,3/12/2018 1:00,6,9,8,7,30,4,0
1309,3/12/2018 1:05,6,9,8,7,30,4,0
1310,3/12/2018 1:10,6,9,8,6,29,4,0
1311,3/12/2018 1:15,6,9,8,7,30,4,0
1312,3/12/2018 1:20,6,9,8,6,29,4,0
1313,3/12/2018 1:25,6,8,8,6,28,4,0
1314,3/12/2018 1:30,6,8,8,6,28,4,0
1315,3/12/2018 1:35,6,8,7,6,27,4,0
1316,3/12/2018 1:40,6,8,7,6,27,4,0
1317,3/12/2018 1:45,6,8,7,6,27,4,0
1318,3/12/2018 1:50,5,8,7,6,26,4,0
1319,3/12/2018 1:55,5,8,7,6,26,4,0
1320,3/12/2018 2:00,5,8,7,5,25,4,0
1321,3/12/2018 2:05,5,8,7,5,25,4,0
1322,3/12/2018 2:10,5,8,7,6,26,4,0
1323,3/12/2018 2:15,5,8,7,5,25,4,0
1324,3/12/2018 2:20,5,8,7,5,25,4,0
1325,3/12/2018 2:25,5,7,6,5,23,4,0
1326,3/12/2018 2:30,5,7,6,5,23,4,0
1327,3/12/2018 2:35,5,7,6,5,23,4,0
1328,3/12/2018 2:40,5,7,6,5,23,4,0
1329,3/12/2018 2:45,5,7,6,5,23,4,0
1330,3/12/2018 2:50,5,7,6,5,23,4,0
1331,3/12/2018 2:55,5,7,6,5,23,4,0
1332,3/12/2018 3:00,5,7,6,5,23,4,0
1333,3/12/2018 3:05,5,7,6,5,23,4,0
1334,3/12/2018 3:10,5,7,6,5,23,4,0
1335,3/12/2018 3:15,5,7,6,5,23,4,0
1336,3/12/2018 3:20,5,8,7,6,26,4,0
1337,3/12/2018 3:25,5,8,7,6,26,4,0
1338,3/12/2018 3:30,6,8,8,6,28,4,0
1339,3/12/2018 3:35,6,9,8,7,30,4,0
1340,3/12/2018 3:40,7,10,9,7,33,4,0
1341,3/12/2018 3:45,7,10,9,7,33,4,0
1342,3/12/2018 3:50,6,9,8,7,30,4,0
1343,3/12/2018 3:55,6,9,8,7,30,4,0
1344,3/12/2018 4:00,7,10,9,7,33,4,0
1345,3/12/2018 4:05,7,11,9,8,35,4,0
1346,3/12/2018 4:10,8,12,10,8,38,4,0
1347,3/12/2018 4:15,9,13,12,9,43,4,0
1348,3/12/2018 4:20,10,15,13,11,49,4,0
1349,3/12/2018 4:25,11,16,14,12,53,4,0
1350,3/12/2018 4:30,12,18,16,13,59,4,0
1351,3/12/2018 4:35,15,21,19,15,70,4,0
1352,3/12/2018 4:40,15,22,20,16,73,4,0
1353,3/12/2018 4:45,16,23,20,17,76,4,0
1354,3/12/2018 4:50,17,24,21,18,80,4,0
1355,3/12/2018 4:55,17,25,22,18,82,4,0
1356,3/12/2018 5:00,18,26,23,19,86,4,0
1357,3/12/2018 5:05,21,31,27,22,101,4,0
1358,3/12/2018 5:10,25,36,32,26,119,4,0
1359,3/12/2018 5:15,28,41,36,29,134,4,0
1360,3/12/2018 5:20,32,46,40,33,151,4,0
1361,3/12/2018 5:25,33,49,43,35,160,4,0
1362,3/12/2018 5:30,38,56,49,40,183,4,0
1363,3/12/2018 5:35,42,61,54,44,201,4,0
1364,3/12/2018 5:40,44,64,57,47,212,4,0
1365,3/12/2018 5:45,46,66,59,48,219,4,0
1366,3/12/2018 5:50,47,68,60,49,224,4,0
1367,3/12/2018 5:55,46,67,59,49,221,4,0
1368,3/12/2018 6:00,43,63,55,45,206,4,0
1369,3/12/2018 6:05,46,67,59,48,220,4,0
1370,3/12/2018 6:10,50,72,64,52,238,4,0
1371,3/12/2018 6:15,53,77,68,56,254,4,0
1372,3/12/2018 6:20,56,81,72,59,268,4,0
1373,3/12/2018 6:25,57,83,73,60,273,4,0
1374,3/12/2018 6:30,59,86,76,62,283,4,0
1375,3/12/2018 6:35,62,90,80,65,297,4,0
1376,3/12/2018 6:40,68,98,87,71,324,4,0
1377,3/12/2018 6:45,69,100,88,72,329,4,0
1378,3/12/2018 6:50,69,100,88,72,329,4,0
1379,3/12/2018 6:55,63,92,81,67,303,4,0
1380,3/12/2018 7:00,62,90,79,65,296,4,0
1381,3/12/2018 7:05,63,91,80,66,300,4,0
1382,3/12/2018 7:10,66,96,84,69,315,4,0
1383,3/12/2018 7:15,67,98,86,71,322,4,0
1384,3/12/2018 7:20,69,101,89,73,332,4,0
1385,3/12/2018 7:25,69,100,88,72,329,4,0
1386,3/12/2018 7:30,73,106,94,77,350,4,0
1387,3/12/2018 7:35,73,106,94,77,350,4,0
1388,3/12/2018 7:40,70,102,90,74,336,4,0
1389,3/12/2018 7:45,69,100,88,72,329,4,0
1390,3/12/2018 7:50,68,99,87,71,325,4,0
1391,3/12/2018 7:55,67,97,86,70,320,4,0
1392,3/12/2018 8:00,64,93,83,68,308,4,0
1393,3/12/2018 8:05,65,94,83,68,310,4,0
1394,3/12/2018 8:10,65,95,84,68,312,4,0
1395,3/12/2018 8:15,69,100,89,73,331,4,0
1396,3/12/2018 8:20,70,101,89,73,333,4,0
1397,3/12/2018 8:25,66,96,85,70,317,4,0
1398,3/12/2018 8:30,62,90,79,65,296,4,0
1399,3/12/2018 8:35,61,88,78,64,291,4,0
1400,3/12/2018 8:40,61,88,78,64,291,4,0
1401,3/12/2018 8:45,60,87,77,63,287,4,0
1402,3/12/2018 8:50,58,85,75,61,279,4,0
1403,3/12/2018 8:55,56,81,72,59,268,4,0
1404,3/12/2018 9:00,54,79,70,57,260,4,0
1405,3/12/2018 9:05,53,77,68,56,254,4,0
1406,3/12/2018 9:10,53,77,68,56,254,4,0
1407,3/12/2018 9:15,53,76,68,55,252,4,0
1408,3/12/2018 9:20,54,78,69,56,257,4,0
1409,3/12/2018 9:25,54,79,69,57,259,4,0
1410,3/12/2018 9:30,54,79,69,57,259,4,0
1411,3/12/2018 9:35,53,77,68,56,254,4,0
1412,3/12/2018 9:40,54,78,69,56,257,4,0
1413,3/12/2018 9:45,53,77,68,56,254,4,0
1414,3/12/2018 9:50,53,76,68,55,252,4,0
1415,3/12/2018 9:55,52,75,66,54,247,4,0
1416,3/12/2018 10:00,51,74,65,54,244,4,0
1417,3/12/2018 10:05,51,74,65,54,244,4,0
1418,3/12/2018 10:10,51,74,65,54,244,4,0
1419,3/12/2018 10:15,51,74,65,53,243,4,0
1420,3/12/2018 10:20,51,73,65,53,242,4,0
1421,3/12/2018 10:25,52,75,66,54,247,4,0
1422,3/12/2018 10:30,51,73,65,53,242,4,0
1423,3/12/2018 10:35,51,74,65,53,243,4,0
1424,3/12/2018 10:40,51,75,66,54,246,4,0
1425,3/12/2018 10:45,51,74,66,54,245,4,0
1426,3/12/2018 10:50,51,74,65,54,244,4,0
1427,3/12/2018 10:55,51,74,66,54,245,4,0
1428,3/12/2018 11:00,50,73,65,53,241,4,0
1429,3/12/2018 11:05,51,74,65,53,243,4,0
1430,3/12/2018 11:10,50,73,65,53,241,4,0
1431,3/12/2018 11:15,50,73,64,53,240,4,0
1432,3/12/2018 11:20,51,73,65,53,242,4,0
1433,3/12/2018 11:25,51,74,65,54,244,4,0
1434,3/12/2018 11:30,52,75,66,54,247,4,0
1435,3/12/2018 11:35,52,76,67,55,250,4,0
1436,3/12/2018 11:40,53,77,68,56,254,4,0
1437,3/12/2018 11:45,52,76,67,55,250,4,0
1438,3/12/2018 11:50,52,76,67,55,250,4,0
1439,3/12/2018 11:55,52,75,66,54,247,4,0
1440,3/12/2018 12:00,51,75,66,54,246,4,0
1441,3/12/2018 12:05,52,76,67,55,250,4,0
1442,3/12/2018 12:10,52,76,67,55,250,4,0
1443,3/12/2018 12:15,54,78,69,56,257,4,0
1444,3/12/2018 12:20,53,77,68,56,254,4,0
1445,3/12/2018 12:25,53,76,68,55,252,4,0
1446,3/12/2018 12:30,52,76,67,55,250,4,0
1447,3/12/2018 12:35,53,77,68,56,254,4,0
1448,3/12/2018 12:40,54,78,69,56,257,4,0
1449,3/12/2018 12:45,54,78,69,57,258,4,0
1450,3/12/2018 12:50,53,77,68,56,254,4,0
1451,3/12/2018 12:55,53,77,68,56,254,4,0
1452,3/12/2018 13:00,52,76,67,55,250,4,0
1453,3/12/2018 13:05,52,76,67,55,250,4,0
1454,3/12/2018 13:10,54,78,69,56,257,4,0
1455,3/12/2018 13:15,52,76,67,55,250,4,0
1456,3/12/2018 13:20,54,78,69,56,257,4,0
1457,3/12/2018 13:25,53,77,68,56,254,4,0
1458,3/12/2018 13:30,54,78,69,56,257,4,0
1459,3/12/2018 13:35,55,79,70,58,262,4,0
1460,3/12/2018 13:40,55,80,70,58,263,4,0
1461,3/12/2018 13:45,56,82,72,59,269,4,0
1462,3/12/2018 13:50,55,80,71,58,264,4,0
1463,3/12/2018 13:55,55,80,71,58,264,4,0
1464,3/12/2018 14:00,55,80,71,58,264,4,0
1465,3/12/2018 14:05,56,82,72,59,269,4,0
1466,3/12/2018 14:10,58,84,74,61,277,4,0
1467,3/12/2018 14:15,58,84,75,61,278,4,0
1468,3/12/2018 14:20,58,84,74,61,277,4,0
1469,3/12/2018 14:25,57,83,73,60,273,4,0
1470,3/12/2018 14:30,60,86,76,63,285,4,0
1471,3/12/2018 14:35,61,88,78,64,291,4,0
1472,3/12/2018 14:40,64,93,82,67,306,4,0
1473,3/12/2018 14:45,64,93,82,67,306,4,0
1474,3/12/2018 14:50,64,93,82,67,306,4,0
1475,3/12/2018 14:55,63,92,81,67,303,4,0
1476,3/12/2018 15:00,63,92,81,66,302,4,0
1477,3/12/2018 15:05,64,93,83,68,308,4,0
1478,3/12/2018 15:10,65,94,83,68,310,4,0
1479,3/12/2018 15:15,66,96,85,70,317,4,0
1480,3/12/2018 15:20,65,95,84,68,312,4,0
1481,3/12/2018 15:25,65,95,84,69,313,4,0
1482,3/12/2018 15:30,66,95,84,69,314,4,0
1483,3/12/2018 15:35,68,99,87,71,325,4,0
1484,3/12/2018 15:40,73,105,93,76,347,4,0
1485,3/12/2018 15:45,73,105,93,76,347,4,0
1486,3/12/2018 15:50,71,103,91,75,340,4,0
1487,3/12/2018 15:55,69,101,89,73,332,4,0
1488,3/12/2018 16:00,67,97,86,70,320,4,0
1489,3/12/2018 16:05,69,100,88,72,329,4,0
1490,3/12/2018 16:10,71,103,91,74,339,4,0
1491,3/12/2018 16:15,72,104,92,76,344,4,0
1492,3/12/2018 16:20,71,103,91,75,340,4,0
1493,3/12/2018 16:25,70,101,89,73,333,4,0
1494,3/12/2018 16:30,68,99,88,72,327,4,0
1495,3/12/2018 16:35,71,103,91,75,340,4,0
1496,3/12/2018 16:40,73,106,94,77,350,4,0
1497,3/12/2018 16:45,73,105,93,76,347,4,0
1498,3/12/2018 16:50,72,104,92,75,343,4,0
1499,3/12/2018 16:55,69,101,89,73,332,4,0
1500,3/12/2018 17:00,69,100,88,72,329,4,0
1501,3/12/2018 17:05,72,104,92,75,343,4,0
1502,3/12/2018 17:10,75,109,96,79,359,4,0
1503,3/12/2018 17:15,75,109,96,79,359,4,0
1504,3/12/2018 17:20,74,107,95,77,353,4,0
1505,3/12/2018 17:25,72,104,92,75,343,4,0
1506,3/12/2018 17:30,69,100,89,73,331,4,0
1507,3/12/2018 17:35,70,102,90,74,336,4,0
1508,3/12/2018 17:40,70,102,90,74,336,4,0
1509,3/12/2018 17:45,69,101,89,73,332,4,0
1510,3/12/2018 17:50,68,98,87,71,324,4,0
1511,3/12/2018 17:55,66,96,85,70,317,4,0
1512,3/12/2018 18:00,65,94,83,68,310,4,0
1513,3/12/2018 18:05,64,93,82,67,306,4,0
1514,3/12/2018 18:10,65,94,83,68,310,4,0
1515,3/12/2018 18:15,64,93,82,67,306,4,0
1516,3/12/2018 18:20,63,91,80,66,300,4,0
1517,3/12/2018 18:25,61,89,79,64,293,4,0
1518,3/12/2018 18:30,60,88,77,63,288,4,0
1519,3/12/2018 18:35,58,85,75,61,279,4,0
1520,3/12/2018 18:40,58,83,74,60,275,4,0
1521,3/12/2018 18:45,56,81,72,59,268,4,0
1522,3/12/2018 18:50,54,78,69,57,258,4,0
1523,3/12/2018 18:55,51,74,66,54,245,4,0
1524,3/12/2018 19:00,49,71,63,52,235,4,0
1525,3/12/2018 19:05,50,73,64,52,239,4,0
1526,3/12/2018 19:10,50,72,64,52,238,4,0
1527,3/12/2018 19:15,49,71,63,51,234,4,0
1528,3/12/2018 19:20,47,68,60,49,224,4,0
1529,3/12/2018 19:25,47,68,60,49,224,4,0
1530,3/12/2018 19:30,46,67,59,49,221,4,0
1531,3/12/2018 19:35,45,65,57,47,214,4,0
1532,3/12/2018 19:40,41,59,53,43,196,4,0
1533,3/12/2018 19:45,40,58,51,42,191,4,0
1534,3/12/2018 19:50,38,56,49,40,183,4,0
1535,3/12/2018 19:55,36,52,46,38,172,4,0
1536,3/12/2018 20:00,35,50,44,36,165,4,0
1537,3/12/2018 20:05,36,53,47,38,174,4,0
1538,3/12/2018 20:10,36,52,46,38,172,4,0
1539,3/12/2018 20:15,36,52,46,38,172,4,0
1540,3/12/2018 20:20,35,50,44,36,165,4,0
1541,3/12/2018 20:25,33,48,43,35,159,4,0
1542,3/12/2018 20:30,33,47,42,34,156,4,0
1543,3/12/2018 20:35,32,47,41,34,154,4,0
1544,3/12/2018 20:40,32,47,41,34,154,4,0
1545,3/12/2018 20:45,33,47,42,34,156,4,0
1546,3/12/2018 20:50,28,41,36,30,135,4,0
1547,3/12/2018 20:55,28,41,36,29,134,4,0
1548,3/12/2018 21:00,29,42,38,31,140,4,0
1549,3/12/2018 21:05,31,45,39,32,147,4,0
1550,3/12/2018 21:10,31,46,40,33,150,4,0
1551,3/12/2018 21:15,32,46,40,33,151,4,0
1552,3/12/2018 21:20,31,45,39,32,147,4,0
1553,3/12/2018 21:25,30,44,39,32,145,4,0
1554,3/12/2018 21:30,29,42,38,31,140,4,0
1555,3/12/2018 21:35,29,42,37,31,139,4,0
1556,3/12/2018 21:40,29,42,37,30,138,4,0
1557,3/12/2018 21:45,28,41,36,29,134,4,0
1558,3/12/2018 21:50,27,40,35,29,131,4,0
1559,3/12/2018 21:55,27,40,35,29,131,4,0
1560,3/12/2018 22:00,26,38,34,28,126,4,0
1561,3/12/2018 22:05,26,38,34,28,126,4,0
1562,3/12/2018 22:10,27,39,34,28,128,4,0
1563,3/12/2018 22:15,26,37,33,27,123,4,0
1564,3/12/2018 22:20,24,35,31,25,115,4,0
1565,3/12/2018 22:25,23,33,29,24,109,4,0
1566,3/12/2018 22:30,22,32,28,23,105,4,0
1567,3/12/2018 22:35,22,32,28,23,105,4,0
1568,3/12/2018 22:40,21,31,27,22,101,4,0
1569,3/12/2018 22:45,20,29,25,21,95,4,0
1570,3/12/2018 22:50,19,27,24,20,90,4,0
1571,3/12/2018 22:55,18,25,23,18,84,4,0
1572,3/12/2018 23:00,17,24,21,17,79,4,0
1573,3/12/2018 23:05,17,24,21,18,80,4,0
1574,3/12/2018 23:10,17,25,22,18,82,4,0
1575,3/12/2018 23:15,17,24,21,18,80,4,0
1576,3/12/2018 23:20,15,22,19,16,72,4,0
1577,3/12/2018 23:25,14,20,18,15,67,4,0
1578,3/12/2018 23:30,14,20,18,14,66,4,0
1579,3/12/2018 23:35,14,20,18,14,66,4,0
1580,3/12/2018 23:40,14,20,17,14,65,4,0
1581,3/12/2018 23:45,13,19,17,14,63,4,0
1582,3/12/2018 23:50,12,18,16,13,59,4,0
1583,3/12/2018 23:55,11,16,14,12,53,4,0
1584,3/13/2018 0:00,10,15,13,11,49,4,0
1585,3/13/2018 0:05,10,14,12,10,46,4,0
1586,3/13/2018 0:10,10,15,13,11,49,4,0
1587,3/13/2018 0:15,11,16,14,12,53,4,0
1588,3/13/2018 0:20,12,17,15,12,56,4,0
1589,3/13/2018 0:25,11,16,14,12,53,4,0
1590,3/13/2018 0:30,10,15,13,11,49,4,0
1591,3/13/2018 0:35,10,15,13,11,49,4,0
1592,3/13/2018 0:40,10,15,13,11,49,4,0
1593,3/13/2018 0:45,10,14,12,10,46,4,0
1594,3/13/2018 0:50,9,13,12,9,43,4,0
1595,3/13/2018 0:55,9,13,11,9,42,4,0
1596,3/13/2018 1:00,8,12,10,9,39,4,0
1597,3/13/2018 1:05,8,12,10,9,39,4,0
1598,3/13/2018 1:10,8,12,10,9,39,4,0
1599,3/13/2018 1:15,8,11,10,8,37,4,0
1600,3/13/2018 1:20,8,12,10,8,38,4,0
1601,3/13/2018 1:25,7,11,9,8,35,4,0
1602,3/13/2018 1:30,8,11,10,8,37,4,0
1603,3/13/2018 1:35,8,12,10,9,39,4,0
1604,3/13/2018 1:40,8,12,11,9,40,4,0
1605,3/13/2018 1:45,8,12,10,8,38,4,0
1606,3/13/2018 1:50,8,11,10,8,37,4,0
1607,3/13/2018 1:55,7,11,9,8,35,4,0
1608,3/13/2018 2:00,7,11,9,8,35,4,0
1609,3/13/2018 2:05,10,14,13,10,47,4,0
1610,3/13/2018 2:10,11,16,14,11,52,4,0
1611,3/13/2018 2:15,8,11,10,8,37,4,0
1612,3/13/2018 2:20,7,11,9,8,35,4,0
1613,3/13/2018 2:25,7,10,9,7,33,4,0
1614,3/13/2018 2:30,7,10,9,7,33,4,0
1615,3/13/2018 2:35,7,10,9,7,33,4,0
1616,3/13/2018 2:40,7,10,9,7,33,4,0
1617,3/13/2018 2:45,7,10,9,7,33,4,0
1618,3/13/2018 2:50,6,9,8,7,30,4,0
1619,3/13/2018 2:55,6,9,8,7,30,4,0
1620,3/13/2018 3:00,6,9,8,6,29,4,0
1621,3/13/2018 3:05,6,9,8,6,29,4,0
1622,3/13/2018 3:10,6,9,8,7,30,4,0
1623,3/13/2018 3:15,7,10,9,7,33,4,0
1624,3/13/2018 3:20,7,11,9,8,35,4,0
1625,3/13/2018 3:25,7,11,9,8,35,4,0
1626,3/13/2018 3:30,8,12,10,8,38,4,0
1627,3/13/2018 3:35,8,11,10,8,37,4,0
1628,3/13/2018 3:40,8,12,10,8,38,4,0
1629,3/13/2018 3:45,8,11,10,8,37,4,0
1630,3/13/2018 3:50,8,11,10,8,37,4,0
1631,3/13/2018 3:55,8,11,10,8,37,4,0
1632,3/13/2018 4:00,8,11,10,8,37,4,0
1633,3/13/2018 4:05,8,12,10,9,39,4,0
1634,3/13/2018 4:10,9,12,11,9,41,4,0
1635,3/13/2018 4:15,9,14,12,10,45,4,0
1636,3/13/2018 4:20,10,14,13,10,47,4,0
1637,3/13/2018 4:25,10,15,13,11,49,4,0
1638,3/13/2018 4:30,11,16,14,11,52,4,0
1639,3/13/2018 4:35,12,17,15,12,56,4,0
1640,3/13/2018 4:40,11,16,14,11,52,4,0
1641,3/13/2018 4:45,12,17,15,13,57,4,0
1642,3/13/2018 4:50,12,17,15,12,56,4,0
1643,3/13/2018 4:55,13,19,17,14,63,4,0
1644,3/13/2018 5:00,14,20,17,14,65,4,0
1645,3/13/2018 5:05,15,22,19,16,72,4,0
1646,3/13/2018 5:10,17,24,21,18,80,4,0
1647,3/13/2018 5:15,19,28,24,20,91,4,0
1648,3/13/2018 5:20,21,31,27,22,101,4,0
1649,3/13/2018 5:25,24,35,31,26,116,4,0
1650,3/13/2018 5:30,28,41,36,30,135,4,0
1651,3/13/2018 5:35,30,44,39,32,145,4,0
1652,3/13/2018 5:40,33,48,42,34,157,4,0
1653,3/13/2018 5:45,34,49,44,36,163,4,0
1654,3/13/2018 5:50,36,52,46,38,172,4,0
1655,3/13/2018 5:55,38,55,49,40,182,4,0
1656,3/13/2018 6:00,38,55,49,40,182,4,0
1657,3/13/2018 6:05,37,54,48,39,178,4,0
1658,3/13/2018 6:10,41,59,52,43,195,4,0
1659,3/13/2018 6:15,43,63,56,46,208,4,0
1660,3/13/2018 6:20,52,75,66,54,247,4,0
1661,3/13/2018 6:25,52,76,67,55,250,4,0
1662,3/13/2018 6:30,54,79,70,57,260,4,0
1663,3/13/2018 6:35,55,79,70,58,262,4,0
1664,3/13/2018 6:40,58,83,74,60,275,4,0
1665,3/13/2018 6:45,59,86,76,62,283,4,0
1666,3/13/2018 6:50,59,86,76,62,283,4,0
1667,3/13/2018 6:55,52,76,67,55,250,4,0
1668,3/13/2018 7:00,51,75,66,54,246,4,0
1669,3/13/2018 7:05,60,87,77,63,287,4,0
1670,3/13/2018 7:10,61,89,79,65,294,4,0
1671,3/13/2018 7:15,63,92,81,66,302,4,0
1672,3/13/2018 7:20,63,92,81,67,303,4,0
1673,3/13/2018 7:25,65,95,84,68,312,4,0
1674,3/13/2018 7:30,65,94,83,68,310,4,0
1675,3/13/2018 7:35,65,95,84,69,313,4,0
1676,3/13/2018 7:40,66,96,85,69,316,4,0
1677,3/13/2018 7:45,66,96,84,69,315,4,0
1678,3/13/2018 7:50,66,96,85,69,316,4,0
1679,3/13/2018 7:55,64,93,82,67,306,4,0
1680,3/13/2018 8:00,61,89,79,65,294,4,0
1681,3/13/2018 8:05,56,81,71,58,266,4,0
1682,3/13/2018 8:10,54,79,70,57,260,4,0
1683,3/13/2018 8:15,52,76,67,55,250,4,0
1684,3/13/2018 8:20,60,87,77,63,287,4,0
1685,3/13/2018 8:25,55,79,70,57,261,4,0
1686,3/13/2018 8:30,53,77,68,56,254,4,0
1687,3/13/2018 8:35,54,78,69,56,257,4,0
1688,3/13/2018 8:40,56,82,72,59,269,4,0
1689,3/13/2018 8:45,57,82,73,59,271,4,0
1690,3/13/2018 8:50,56,81,72,59,268,4,0
1691,3/13/2018 8:55,53,77,68,56,254,4,0
1692,3/13/2018 9:00,50,73,65,53,241,4,0
1693,3/13/2018 9:05,50,72,64,52,238,4,0
1694,3/13/2018 9:10,49,71,63,51,234,4,0
1695,3/13/2018 9:15,44,64,57,47,212,4,0
1696,3/13/2018 9:20,45,66,58,48,217,4,0
1697,3/13/2018 9:25,48,70,62,50,230,4,0
1698,3/13/2018 9:30,48,70,62,50,230,4,0
1699,3/13/2018 9:35,49,71,62,51,233,4,0
1700,3/13/2018 9:40,49,70,62,51,232,4,0
1701,3/13/2018 9:45,48,69,61,50,228,4,0
1702,3/13/2018 9:50,46,67,59,49,221,4,0
1703,3/13/2018 9:55,43,62,55,45,205,4,0
1704,3/13/2018 10:00,43,62,55,45,205,4,0
1705,3/13/2018 10:05,43,63,55,45,206,4,0
1706,3/13/2018 10:10,44,64,57,46,211,4,0
1707,3/13/2018 10:15,44,64,56,46,210,4,0
1708,3/13/2018 10:20,44,64,57,47,212,4,0
1709,3/13/2018 10:25,44,63,56,46,209,4,0
1710,3/13/2018 10:30,45,65,58,47,215,4,0
1711,3/13/2018 10:35,46,66,58,48,218,4,0
1712,3/13/2018 10:40,45,66,58,48,217,4,0
1713,3/13/2018 10:45,44,64,57,46,211,4,0
1714,3/13/2018 10:50,44,64,57,46,211,4,0
1715,3/13/2018 10:55,44,64,57,46,211,4,0
1716,3/13/2018 11:00,43,63,55,45,206,4,0
1717,3/13/2018 11:05,44,64,56,46,210,4,0
1718,3/13/2018 11:10,46,67,59,49,221,4,0
1719,3/13/2018 11:15,46,67,59,49,221,4,0
1720,3/13/2018 11:20,47,68,60,49,224,4,0
1721,3/13/2018 11:25,47,69,61,50,227,4,0
1722,3/13/2018 11:30,48,70,62,51,231,4,0
1723,3/13/2018 11:35,48,69,61,50,228,4,0
1724,3/13/2018 11:40,48,70,62,51,231,4,0
1725,3/13/2018 11:45,49,71,63,51,234,4,0
1726,3/13/2018 11:50,48,70,62,51,231,4,0
1727,3/13/2018 11:55,48,69,61,50,228,4,0
0,3/13/2018 11:00,43,63,55,45,206,4,0
1,3/13/2018 11:05,44,64,56,46,210,4,0
2,3/13/2018 11:10,46,67,59,49,221,4,0
3,3/13/2018 11:15,46,67,59,49,221,4,0
4,3/13/2018 11:20,47,68,60,49,224,4,0
5,3/13/2018 11:25,47,69,61,50,227,4,0
6,3/13/2018 11:30,48,70,62,51,231,4,0
7,3/13/2018 11:35,48,69,61,50,228,4,0
8,3/13/2018 11:40,48,70,62,51,231,4,0
9,3/13/2018 11:45,49,71,63,51,234,4,0
10,3/13/2018 11:50,48,70,62,51,231,4,0
11,3/13/2018 11:55,48,69,61,50,228,4,0
12,3/13/2018 12:00,49,71,63,52,235,4,0
13,3/13/2018 12:05,50,72,64,52,238,4,0
14,3/13/2018 12:10,49,72,63,52,236,4,0
15,3/13/2018 12:15,50,72,64,52,238,4,0
16,3/13/2018 12:20,51,73,65,53,242,4,0
17,3/13/2018 12:25,50,73,64,53,240,4,0
18,3/13/2018 12:30,50,73,64,52,239,4,0
19,3/13/2018 12:35,50,73,64,53,240,4,0
20,3/13/2018 12:40,51,73,65,53,242,4,0
21,3/13/2018 12:45,52,75,66,54,247,4,0
22,3/13/2018 12:50,51,73,65,53,242,4,0
23,3/13/2018 12:55,51,75,66,54,246,4,0
24,3/13/2018 13:00,51,74,65,54,244,4,0
25,3/13/2018 13:05,51,74,65,54,244,4,0
26,3/13/2018 13:10,51,73,65,53,242,4,0
27,3/13/2018 13:15,51,74,66,54,245,4,0
28,3/13/2018 13:20,52,76,67,55,250,4,0
29,3/13/2018 13:25,52,76,67,55,250,4,0
30,3/13/2018 13:30,52,76,67,55,250,4,0
31,3/13/2018 13:35,53,76,68,55,252,4,0
32,3/13/2018 13:40,54,78,69,56,257,4,0
33,3/13/2018 13:45,54,79,69,57,259,4,0
34,3/13/2018 13:50,53,77,68,56,254,4,0
35,3/13/2018 13:55,54,78,69,56,257,4,0
36,3/13/2018 14:00,53,77,68,56,254,4,0
37,3/13/2018 14:05,54,78,69,56,257,4,0
38,3/13/2018 14:10,54,79,69,57,259,4,0
39,3/13/2018 14:15,57,82,73,59,271,4,0
40,3/13/2018 14:20,56,82,72,59,269,4,0
41,3/13/2018 14:25,57,82,73,59,271,4,0
42,3/13/2018 14:30,58,84,74,61,277,4,0
43,3/13/2018 14:35,60,88,77,63,288,4,0
44,3/13/2018 14:40,62,90,80,65,297,4,0
45,3/13/2018 14:45,62,90,80,65,297,4,0
46,3/13/2018 14:50,61,88,78,64,291,4,0
47,3/13/2018 14:55,60,88,77,63,288,4,0
48,3/13/2018 15:00,60,87,77,63,287,4,0
49,3/13/2018 15:05,59,85,75,61,280,4,0
50,3/13/2018 15:10,59,86,76,62,283,4,0
51,3/13/2018 15:15,58,85,75,61,279,4,0
52,3/13/2018 15:20,63,91,80,66,300,4,0
53,3/13/2018 15:25,63,91,80,66,300,4,0
54,3/13/2018 15:30,64,93,82,67,306,4,0
55,3/13/2018 15:35,67,97,85,70,319,4,0
56,3/13/2018 15:40,66,96,85,70,317,4,0
57,3/13/2018 15:45,66,96,85,69,316,4,0
58,3/13/2018 15:50,64,93,82,67,306,4,0
59,3/13/2018 15:55,63,91,81,66,301,4,0
60,3/13/2018 16:00,64,92,81,67,304,4,0
61,3/13/2018 16:05,65,94,83,68,310,4,0
62,3/13/2018 16:10,66,95,84,69,314,4,0
63,3/13/2018 16:15,66,96,84,69,315,4,0
64,3/13/2018 16:20,66,96,84,69,315,4,0
65,3/13/2018 16:25,65,95,84,68,312,4,0
66,3/13/2018 16:30,62,90,80,65,297,4,0
67,3/13/2018 16:35,65,94,83,68,310,4,0
68,3/13/2018 16:40,66,96,84,69,315,4,0
69,3/13/2018 16:45,67,97,85,70,319,4,0
70,3/13/2018 16:50,67,97,85,70,319,4,0
71,3/13/2018 16:55,63,92,81,67,303,4,0
72,3/13/2018 17:00,62,90,79,65,296,4,0
73,3/13/2018 17:05,67,97,85,70,319,4,0
74,3/13/2018 17:10,68,99,87,71,325,4,0
75,3/13/2018 17:15,67,97,85,70,319,4,0
76,3/13/2018 17:20,66,96,85,70,317,4,0
77,3/13/2018 17:25,66,96,85,70,317,4,0
78,3/13/2018 17:30,73,106,94,77,350,4,0
79,3/13/2018 17:35,73,106,93,76,348,4,0
80,3/13/2018 17:40,72,104,92,75,343,4,0
81,3/13/2018 17:45,63,92,81,67,303,4,0
82,3/13/2018 17:50,63,91,81,66,301,4,0
83,3/13/2018 17:55,62,90,80,65,297,4,0
84,3/13/2018 18:00,61,88,78,64,291,4,0
85,3/13/2018 18:05,58,83,74,60,275,4,0
86,3/13/2018 18:10,58,84,74,61,277,4,0
87,3/13/2018 18:15,58,84,74,61,277,4,0
88,3/13/2018 18:20,60,86,76,63,285,4,0
89,3/13/2018 18:25,58,84,75,61,278,4,0
90,3/13/2018 18:30,57,83,73,60,273,4,0
91,3/13/2018 18:35,56,82,72,59,269,4,0
92,3/13/2018 18:40,54,79,69,57,259,4,0
93,3/13/2018 18:45,51,74,66,54,245,4,0
94,3/13/2018 18:50,49,71,63,51,234,4,0
95,3/13/2018 18:55,45,66,58,48,217,4,0
96,3/13/2018 19:00,51,73,65,53,242,4,0
97,3/13/2018 19:05,50,73,64,53,240,4,0
98,3/13/2018 19:10,50,73,64,52,239,4,0
99,3/13/2018 19:15,46,67,59,49,221,4,0
100,3/13/2018 19:20,44,64,57,47,212,4,0
101,3/13/2018 19:25,43,62,55,45,205,4,0
102,3/13/2018 19:30,41,59,53,43,196,4,0
103,3/13/2018 19:35,40,59,52,42,193,4,0
104,3/13/2018 19:40,39,57,50,41,187,4,0
105,3/13/2018 19:45,37,54,48,39,178,4,0
106,3/13/2018 19:50,37,53,47,38,175,4,0
107,3/13/2018 19:55,36,52,46,38,172,4,0
108,3/13/2018 20:00,35,50,44,36,165,4,0
109,3/13/2018 20:05,35,51,45,37,168,4,0
110,3/13/2018 20:10,35,50,44,36,165,4,0
111,3/13/2018 20:15,35,50,44,36,165,4,0
112,3/13/2018 20:20,34,49,43,35,161,4,0
113,3/13/2018 20:25,33,48,42,34,157,4,0
114,3/13/2018 20:30,33,47,42,34,156,4,0
115,3/13/2018 20:35,32,46,41,34,153,4,0
116,3/13/2018 20:40,32,46,41,33,152,4,0
117,3/13/2018 20:45,31,46,40,33,150,4,0
118,3/13/2018 20:50,31,44,39,32,146,4,0
119,3/13/2018 20:55,29,43,38,31,141,4,0
120,3/13/2018 21:00,30,43,38,31,142,4,0
121,3/13/2018 21:05,31,45,40,33,149,4,0
122,3/13/2018 21:10,32,46,40,33,151,4,0
123,3/13/2018 21:15,32,46,41,33,152,4,0
124,3/13/2018 21:20,31,46,40,33,150,4,0
125,3/13/2018 21:25,30,44,39,32,145,4,0
126,3/13/2018 21:30,29,42,37,30,138,4,0
127,3/13/2018 21:35,28,41,36,30,135,4,0
128,3/13/2018 21:40,29,42,37,31,139,4,0
129,3/13/2018 21:45,29,42,37,30,138,4,0
130,3/13/2018 21:50,28,40,35,29,132,4,0
131,3/13/2018 21:55,27,39,34,28,128,4,0
132,3/13/2018 22:00,26,38,34,28,126,4,0
133,3/13/2018 22:05,26,38,34,27,125,4,0
134,3/13/2018 22:10,26,38,33,27,124,4,0
135,3/13/2018 22:15,26,38,34,27,125,4,0
136,3/13/2018 22:20,24,35,31,25,115,4,0
137,3/13/2018 22:25,23,33,29,24,109,4,0
138,3/13/2018 22:30,22,32,28,23,105,4,0
139,3/13/2018 22:35,22,32,28,23,105,4,0
140,3/13/2018 22:40,21,30,27,22,100,4,0
141,3/13/2018 22:45,20,29,25,21,95,4,0
142,3/13/2018 22:50,19,28,24,20,91,4,0
143,3/13/2018 22:55,18,26,23,19,86,4,0
144,3/13/2018 23:00,17,25,22,18,82,4,0
145,3/13/2018 23:05,17,25,22,18,82,4,0
146,3/13/2018 23:10,18,26,23,19,86,4,0
147,3/13/2018 23:15,17,24,21,18,80,4,0
148,3/13/2018 23:20,16,23,20,16,75,4,0
149,3/13/2018 23:25,15,22,19,16,72,4,0
150,3/13/2018 23:30,14,21,18,15,68,4,0
151,3/13/2018 23:35,14,20,18,14,66,4,0
152,3/13/2018 23:40,13,19,17,14,63,4,0
153,3/13/2018 23:45,13,19,17,14,63,4,0
154,3/13/2018 23:50,12,18,16,13,59,4,0
155,3/13/2018 23:55,12,17,15,12,56,4,0
156,3/14/2018 0:00,11,16,14,12,53,4,0
157,3/14/2018 0:05,11,15,14,11,51,4,0
158,3/14/2018 0:10,11,16,14,12,53,4,0
159,3/14/2018 0:15,11,15,14,11,51,4,0
160,3/14/2018 0:20,10,15,13,11,49,4,0
161,3/14/2018 0:25,9,14,12,10,45,4,0
162,3/14/2018 0:30,9,12,11,9,41,4,0
163,3/14/2018 0:35,9,13,11,9,42,4,0
164,3/14/2018 0:40,9,12,11,9,41,4,0
165,3/14/2018 0:45,8,12,10,9,39,4,0
166,3/14/2018 0:50,8,11,10,8,37,4,0
167,3/14/2018 0:55,7,10,9,7,33,4,0
168,3/14/2018 1:00,7,10,9,7,33,4,0
169,3/14/2018 1:05,7,10,9,7,33,4,0
170,3/14/2018 1:10,7,10,9,7,33,4,0
171,3/14/2018 1:15,6,9,8,7,30,4,0
172,3/14/2018 1:20,6,9,8,7,30,4,0
173,3/14/2018 1:25,6,9,8,6,29,4,0
174,3/14/2018 1:30,6,8,8,6,28,4,0
175,3/14/2018 1:35,6,8,7,6,27,4,0
176,3/14/2018 1:40,6,8,8,6,28,4,0
177,3/14/2018 1:45,6,8,8,6,28,4,0
178,3/14/2018 1:50,5,8,7,6,26,4,0
179,3/14/2018 1:55,5,7,6,5,23,4,0
180,3/14/2018 2:00,5,7,6,5,23,4,0
181,3/14/2018 2:05,5,8,7,6,26,4,0
182,3/14/2018 2:10,5,8,7,5,25,4,0
183,3/14/2018 2:15,5,8,7,5,25,4,0
184,3/14/2018 2:20,5,8,7,5,25,4,0
185,3/14/2018 2:25,5,7,6,5,23,4,0
186,3/14/2018 2:30,5,7,6,5,23,4,0
187,3/14/2018 2:35,5,7,6,5,23,4,0
188,3/14/2018 2:40,5,7,6,5,23,4,0
189,3/14/2018 2:45,5,7,6,5,23,4,0
190,3/14/2018 2:50,5,7,6,5,23,4,0
191,3/14/2018 2:55,5,7,6,5,23,4,0
192,3/14/2018 3:00,5,7,6,5,23,4,0
193,3/14/2018 3:05,5,7,6,5,23,4,0
194,3/14/2018 3:10,5,7,6,5,23,4,0
195,3/14/2018 3:15,5,8,7,5,25,4,0
196,3/14/2018 3:20,5,8,7,6,26,4,0
197,3/14/2018 3:25,6,8,7,6,27,4,0
198,3/14/2018 3:30,6,9,8,6,29,4,0
199,3/14/2018 3:35,6,9,8,7,30,4,0
200,3/14/2018 3:40,7,10,9,7,33,4,0
201,3/14/2018 3:45,7,10,9,7,33,4,0
202,3/14/2018 3:50,7,10,9,7,33,4,0
203,3/14/2018 3:55,6,9,8,7,30,4,0
204,3/14/2018 4:00,6,9,8,7,30,4,0
205,3/14/2018 4:05,7,10,9,7,33,4,0
206,3/14/2018 4:10,8,12,11,9,40,4,0
207,3/14/2018 4:15,9,13,11,9,42,4,0
208,3/14/2018 4:20,10,14,13,10,47,4,0
209,3/14/2018 4:25,11,16,14,11,52,4,0
210,3/14/2018 4:30,13,18,16,13,60,4,0
211,3/14/2018 4:35,14,20,18,15,67,4,0
212,3/14/2018 4:40,16,23,20,16,75,4,0
213,3/14/2018 4:45,16,23,20,17,76,4,0
214,3/14/2018 4:50,16,24,21,17,78,4,0
215,3/14/2018 4:55,17,24,21,18,80,4,0
216,3/14/2018 5:00,19,27,24,20,90,4,0
217,3/14/2018 5:05,22,32,29,23,106,4,0
218,3/14/2018 5:10,26,38,34,27,125,4,0
219,3/14/2018 5:15,28,41,36,30,135,4,0
220,3/14/2018 5:20,32,47,42,34,155,4,0
221,3/14/2018 5:25,35,50,44,36,165,4,0
222,3/14/2018 5:30,40,58,51,42,191,4,0
223,3/14/2018 5:35,45,65,57,47,214,4,0
224,3/14/2018 5:40,46,67,59,48,220,4,0
225,3/14/2018 5:45,47,68,60,49,224,4,0
226,3/14/2018 5:50,47,68,60,49,224,4,0
227,3/14/2018 5:55,44,64,57,47,212,4,0
228,3/14/2018 6:00,45,65,57,47,214,4,0
229,3/14/2018 6:05,47,68,60,49,224,4,0
230,3/14/2018 6:10,51,73,65,53,242,4,0
231,3/14/2018 6:15,53,77,68,56,254,4,0
232,3/14/2018 6:20,58,84,75,61,278,4,0
233,3/14/2018 6:25,59,86,76,62,283,4,0
234,3/14/2018 6:30,61,89,79,64,293,4,0
235,3/14/2018 6:35,64,93,82,67,306,4,0
236,3/14/2018 6:40,66,96,85,70,317,4,0
237,3/14/2018 6:45,68,99,87,72,326,4,0
238,3/14/2018 6:50,67,97,85,70,319,4,0
239,3/14/2018 6:55,66,96,85,69,316,4,0
240,3/14/2018 7:00,66,96,85,69,316,4,0
241,3/14/2018 7:05,66,96,85,70,317,4,0
242,3/14/2018 7:10,69,100,88,72,329,4,0
243,3/14/2018 7:15,71,103,91,74,339,4,0
244,3/14/2018 7:20,73,106,93,76,348,4,0
245,3/14/2018 7:25,71,103,91,75,340,4,0
246,3/14/2018 7:30,74,107,94,77,352,4,0
247,3/14/2018 7:35,74,107,95,77,353,4,0
248,3/14/2018 7:40,74,108,95,78,355,4,0
249,3/14/2018 7:45,74,108,95,78,355,4,0
250,3/14/2018 7:50,73,106,94,77,350,4,0
251,3/14/2018 7:55,70,102,90,74,336,4,0
252,3/14/2018 8:00,68,99,88,72,327,4,0
253,3/14/2018 8:05,69,100,88,72,329,4,0
254,3/14/2018 8:10,68,99,87,72,326,4,0
255,3/14/2018 8:15,68,99,87,71,325,4,0
256,3/14/2018 8:20,69,100,89,73,331,4,0
257,3/14/2018 8:25,67,97,86,70,320,4,0
258,3/14/2018 8:30,65,94,83,68,310,4,0
259,3/14/2018 8:35,62,90,79,65,296,4,0
260,3/14/2018 8:40,63,91,80,66,300,4,0
261,3/14/2018 8:45,63,91,80,66,300,4,0
262,3/14/2018 8:50,61,89,78,64,292,4,0
263,3/14/2018 8:55,59,86,76,62,283,4,0
264,3/14/2018 9:00,57,83,73,60,273,4,0
265,3/14/2018 9:05,56,81,71,58,266,4,0
266,3/14/2018 9:10,56,81,72,59,268,4,0
267,3/14/2018 9:15,55,80,71,58,264,4,0
268,3/14/2018 9:20,55,80,71,58,264,4,0
269,3/14/2018 9:25,54,79,70,57,260,4,0
270,3/14/2018 9:30,54,79,70,57,260,4,0
271,3/14/2018 9:35,54,79,69,57,259,4,0
272,3/14/2018 9:40,56,81,71,58,266,4,0
273,3/14/2018 9:45,56,81,72,59,268,4,0
274,3/14/2018 9:50,54,78,69,57,258,4,0
275,3/14/2018 9:55,53,77,68,56,254,4,0
276,3/14/2018 10:00,52,76,67,55,250,4,0
277,3/14/2018 10:05,52,76,67,55,250,4,0
278,3/14/2018 10:10,52,76,67,55,250,4,0
279,3/14/2018 10:15,52,75,66,54,247,4,0
280,3/14/2018 10:20,52,76,67,55,250,4,0
281,3/14/2018 10:25,52,76,67,55,250,4,0
282,3/14/2018 10:30,51,74,65,54,244,4,0
283,3/14/2018 10:35,52,75,66,54,247,4,0
284,3/14/2018 10:40,52,76,67,55,250,4,0
285,3/14/2018 10:45,52,75,66,54,247,4,0
286,3/14/2018 10:50,52,75,66,54,247,4,0
287,3/14/2018 10:55,51,74,65,54,244,4,0
288,3/14/2018 11:00,51,74,66,54,245,4,0
289,3/14/2018 11:05,51,74,65,54,244,4,0
290,3/14/2018 11:10,52,76,67,55,250,4,0
291,3/14/2018 11:15,51,75,66,54,246,4,0
292,3/14/2018 11:20,52,76,67,55,250,4,0
293,3/14/2018 11:25,52,76,67,55,250,4,0
294,3/14/2018 11:30,52,76,67,55,250,4,0
295,3/14/2018 11:35,52,76,67,55,250,4,0
296,3/14/2018 11:40,53,77,68,56,254,4,0
297,3/14/2018 11:45,53,77,68,56,254,4,0
298,3/14/2018 11:50,53,76,68,55,252,4,0
299,3/14/2018 11:55,51,74,66,54,245,4,0
300,3/14/2018 12:00,52,76,67,55,250,4,0
301,3/14/2018 12:05,52,76,67,55,250,4,0
302,3/14/2018 12:10,53,77,68,56,254,4,0
303,3/14/2018 12:15,53,77,68,56,254,4,0
304,3/14/2018 12:20,53,77,68,56,254,4,0
305,3/14/2018 12:25,53,76,68,55,252,4,0
306,3/14/2018 12:30,53,77,68,56,254,4,0
307,3/14/2018 12:35,53,77,68,56,254,4,0
308,3/14/2018 12:40,54,78,69,56,257,4,0
309,3/14/2018 12:45,54,78,69,56,257,4,0
310,3/14/2018 12:50,54,78,69,56,257,4,0
311,3/14/2018 12:55,53,77,68,56,254,4,0
312,3/14/2018 13:00,53,77,68,56,254,4,0
313,3/14/2018 13:05,53,77,68,56,254,4,0
314,3/14/2018 13:10,55,79,70,57,261,4,0
315,3/14/2018 13:15,55,79,70,57,261,4,0
316,3/14/2018 13:20,55,79,70,57,261,4,0
317,3/14/2018 13:25,54,78,69,56,257,4,0
318,3/14/2018 13:30,54,78,69,57,258,4,0
319,3/14/2018 13:35,55,80,71,58,264,4,0
320,3/14/2018 13:40,56,81,71,58,266,4,0
321,3/14/2018 13:45,56,82,72,59,269,4,0
322,3/14/2018 13:50,57,82,73,59,271,4,0
323,3/14/2018 13:55,57,82,73,59,271,4,0
324,3/14/2018 14:00,56,82,72,59,269,4,0
325,3/14/2018 14:05,58,83,74,60,275,4,0
326,3/14/2018 14:10,59,85,75,62,281,4,0
327,3/14/2018 14:15,60,87,77,63,287,4,0
328,3/14/2018 14:20,60,87,77,63,287,4,0
329,3/14/2018 14:25,59,86,76,62,283,4,0
330,3/14/2018 14:30,60,86,76,63,285,4,0
331,3/14/2018 14:35,61,89,79,65,294,4,0
332,3/14/2018 14:40,65,95,84,68,312,4,0
333,3/14/2018 14:45,66,96,85,69,316,4,0
334,3/14/2018 14:50,64,93,83,68,308,4,0
335,3/14/2018 14:55,63,92,81,66,302,4,0
336,3/14/2018 15:00,63,91,81,66,301,4,0
337,3/14/2018 15:05,65,94,83,68,310,4,0
338,3/14/2018 15:10,67,97,86,70,320,4,0
339,3/14/2018 15:15,68,98,87,71,324,4,0
340,3/14/2018 15:20,67,97,85,70,319,4,0
341,3/14/2018 15:25,67,97,86,70,320,4,0
342,3/14/2018 15:30,67,97,85,70,319,4,0
343,3/14/2018 15:35,71,103,91,75,340,4,0
344,3/14/2018 15:40,74,107,95,78,354,4,0
345,3/14/2018 15:45,74,107,94,77,352,4,0
346,3/14/2018 15:50,72,104,92,76,344,4,0
347,3/14/2018 15:55,70,101,89,73,333,4,0
348,3/14/2018 16:00,68,99,88,72,327,4,0
349,3/14/2018 16:05,70,102,90,74,336,4,0
350,3/14/2018 16:10,73,105,93,76,347,4,0
351,3/14/2018 16:15,72,104,92,75,343,4,0
352,3/14/2018 16:20,72,104,92,75,343,4,0
353,3/14/2018 16:25,71,103,91,74,339,4,0
354,3/14/2018 16:30,70,102,90,74,336,4,0
355,3/14/2018 16:35,73,106,94,77,350,4,0
356,3/14/2018 16:40,74,108,95,78,355,4,0
357,3/14/2018 16:45,75,109,96,79,359,4,0
358,3/14/2018 16:50,75,109,96,79,359,4,0
359,3/14/2018 16:55,73,105,93,76,347,4,0
360,3/14/2018 17:00,72,105,92,76,345,4,0
361,3/14/2018 17:05,74,107,95,78,354,4,0
362,3/14/2018 17:10,77,111,98,81,367,4,0
363,3/14/2018 17:15,76,110,98,80,364,4,0
364,3/14/2018 17:20,75,110,97,79,361,4,0
365,3/14/2018 17:25,74,108,95,78,355,4,0
366,3/14/2018 17:30,73,105,93,76,347,4,0
367,3/14/2018 17:35,74,108,95,78,355,4,0
368,3/14/2018 17:40,71,103,91,75,340,4,0
369,3/14/2018 17:45,71,103,91,75,340,4,0
370,3/14/2018 17:50,70,102,90,74,336,4,0
371,3/14/2018 17:55,68,99,87,71,325,4,0
372,3/14/2018 18:00,67,97,85,70,319,4,0
373,3/14/2018 18:05,67,97,86,70,320,4,0
374,3/14/2018 18:10,67,97,86,70,320,4,0
375,3/14/2018 18:15,66,96,85,69,316,4,0
376,3/14/2018 18:20,65,95,84,68,312,4,0
377,3/14/2018 18:25,64,92,81,67,304,4,0
378,3/14/2018 18:30,62,90,79,65,296,4,0
379,3/14/2018 18:35,63,91,81,66,301,4,0
380,3/14/2018 18:40,58,84,74,61,277,4,0
381,3/14/2018 18:45,56,82,72,59,269,4,0
382,3/14/2018 18:50,55,79,70,58,262,4,0
383,3/14/2018 18:55,54,78,69,57,258,4,0
384,3/14/2018 19:00,52,76,67,55,250,4,0
385,3/14/2018 19:05,52,75,66,54,247,4,0
386,3/14/2018 19:10,51,74,66,54,245,4,0
387,3/14/2018 19:15,51,73,65,53,242,4,0
388,3/14/2018 19:20,48,70,62,51,231,4,0
389,3/14/2018 19:25,46,66,58,48,218,4,0
390,3/14/2018 19:30,46,66,58,48,218,4,0
391,3/14/2018 19:35,44,64,57,46,211,4,0
392,3/14/2018 19:40,42,62,54,45,203,4,0
393,3/14/2018 19:45,41,60,53,43,197,4,0
394,3/14/2018 19:50,40,58,51,42,191,4,0
395,3/14/2018 19:55,39,57,50,41,187,4,0
396,3/14/2018 20:00,37,54,47,39,177,4,0
397,3/14/2018 20:05,37,54,48,39,178,4,0
398,3/14/2018 20:10,37,54,48,39,178,4,0
399,3/14/2018 20:15,37,53,47,39,176,4,0
400,3/14/2018 20:20,36,52,46,38,172,4,0
401,3/14/2018 20:25,35,51,45,37,168,4,0
402,3/14/2018 20:30,34,50,44,36,164,4,0
403,3/14/2018 20:35,34,49,43,35,161,4,0
404,3/14/2018 20:40,34,49,43,35,161,4,0
405,3/14/2018 20:45,33,48,43,35,159,4,0
406,3/14/2018 20:50,32,47,41,34,154,4,0
407,3/14/2018 20:55,32,47,41,34,154,4,0
408,3/14/2018 21:00,31,45,40,33,149,4,0
409,3/14/2018 21:05,32,47,42,34,155,4,0
410,3/14/2018 21:10,33,48,42,35,158,4,0
411,3/14/2018 21:15,34,50,44,36,164,4,0
412,3/14/2018 21:20,34,49,44,36,163,4,0
413,3/14/2018 21:25,33,48,42,35,158,4,0
414,3/14/2018 21:30,32,46,41,34,153,4,0
415,3/14/2018 21:35,31,46,40,33,150,4,0
416,3/14/2018 21:40,31,44,39,32,146,4,0
417,3/14/2018 21:45,30,43,38,31,142,4,0
418,3/14/2018 21:50,28,41,36,30,135,4,0
419,3/14/2018 21:55,29,42,37,30,138,4,0
420,3/14/2018 22:00,28,41,36,29,134,4,0
421,3/14/2018 22:05,28,41,36,29,134,4,0
422,3/14/2018 22:10,28,40,36,29,133,4,0
423,3/14/2018 22:15,28,40,35,29,132,4,0
424,3/14/2018 22:20,27,39,34,28,128,4,0
425,3/14/2018 22:25,25,36,32,26,119,4,0
426,3/14/2018 22:30,24,35,31,26,116,4,0
427,3/14/2018 22:35,24,34,30,25,113,4,0
428,3/14/2018 22:40,23,34,30,24,111,4,0
429,3/14/2018 22:45,22,32,29,23,106,4,0
430,3/14/2018 22:50,21,31,27,22,101,4,0
431,3/14/2018 22:55,20,30,26,22,98,4,0
432,3/14/2018 23:00,19,27,24,20,90,4,0
433,3/14/2018 23:05,19,27,24,20,90,4,0
434,3/14/2018 23:10,19,28,25,20,92,4,0
435,3/14/2018 23:15,19,27,24,20,90,4,0
436,3/14/2018 23:20,18,26,23,19,86,4,0
437,3/14/2018 23:25,17,24,21,18,80,4,0
438,3/14/2018 23:30,16,24,21,17,78,4,0
439,3/14/2018 23:35,16,23,21,17,77,4,0
440,3/14/2018 23:40,16,23,20,17,76,4,0
441,3/14/2018 23:45,15,22,19,16,72,4,0
442,3/14/2018 23:50,14,20,18,15,67,4,0
443,3/14/2018 23:55,13,19,17,14,63,4,0
444,3/15/2018 0:00,12,18,16,13,59,4,0
445,3/15/2018 0:05,13,18,16,13,60,4,0
446,3/15/2018 0:10,12,18,16,13,59,4,0
447,3/15/2018 0:15,12,17,15,13,57,4,0
448,3/15/2018 0:20,11,16,14,12,53,4,0
449,3/15/2018 0:25,10,15,13,11,49,4,0
450,3/15/2018 0:30,10,14,12,10,46,4,0
451,3/15/2018 0:35,10,14,13,10,47,4,0
452,3/15/2018 0:40,10,14,12,10,46,4,0
453,3/15/2018 0:45,9,13,12,10,44,4,0
454,3/15/2018 0:50,9,12,11,9,41,4,0
455,3/15/2018 0:55,8,11,10,8,37,4,0
456,3/15/2018 1:00,7,11,9,8,35,4,0
457,3/15/2018 1:05,7,11,9,8,35,4,0
458,3/15/2018 1:10,8,11,10,8,37,4,0
459,3/15/2018 1:15,7,11,9,8,35,4,0
460,3/15/2018 1:20,7,10,9,7,33,4,0
461,3/15/2018 1:25,7,10,9,7,33,4,0
462,3/15/2018 1:30,6,9,8,7,30,4,0
463,3/15/2018 1:35,6,9,8,7,30,4,0
464,3/15/2018 1:40,7,10,9,7,33,4,0
465,3/15/2018 1:45,6,9,8,7,30,4,0
466,3/15/2018 1:50,6,9,8,7,30,4,0
467,3/15/2018 1:55,6,8,7,6,27,4,0
468,3/15/2018 2:00,6,8,7,6,27,4,0
469,3/15/2018 2:05,6,8,8,6,28,4,0
470,3/15/2018 2:10,6,9,8,6,29,4,0
471,3/15/2018 2:15,6,8,8,6,28,4,0
472,3/15/2018 2:20,6,9,8,6,29,4,0
473,3/15/2018 2:25,6,8,7,6,27,4,0
474,3/15/2018 2:30,6,8,7,6,27,4,0
475,3/15/2018 2:35,6,8,7,6,27,4,0
476,3/15/2018 2:40,6,8,8,6,28,4,0
477,3/15/2018 2:45,5,8,7,6,26,4,0
478,3/15/2018 2:50,5,8,7,5,25,4,0
479,3/15/2018 2:55,5,7,6,5,23,4,0
480,3/15/2018 3:00,5,7,6,5,23,4,0
481,3/15/2018 3:05,5,8,7,5,25,4,0
482,3/15/2018 3:10,6,8,7,6,27,4,0
483,3/15/2018 3:15,5,8,7,6,26,4,0
484,3/15/2018 3:20,6,8,8,6,28,4,0
485,3/15/2018 3:25,6,9,8,6,29,4,0
486,3/15/2018 3:30,6,9,8,7,30,4,0
487,3/15/2018 3:35,7,10,9,7,33,4,0
488,3/15/2018 3:40,7,10,9,7,33,4,0
489,3/15/2018 3:45,7,11,9,8,35,4,0
490,3/15/2018 3:50,7,10,9,7,33,4,0
491,3/15/2018 3:55,7,10,9,7,33,4,0
492,3/15/2018 4:00,7,10,9,7,33,4,0
493,3/15/2018 4:05,7,11,9,8,35,4,0
494,3/15/2018 4:10,8,12,11,9,40,4,0
495,3/15/2018 4:15,9,14,12,10,45,4,0
496,3/15/2018 4:20,10,15,13,11,49,4,0
497,3/15/2018 4:25,11,16,14,12,53,4,0
498,3/15/2018 4:30,13,19,16,13,61,4,0
499,3/15/2018 4:35,14,21,18,15,68,4,0
500,3/15/2018 4:40,16,23,21,17,77,4,0
501,3/15/2018 4:45,17,24,21,17,79,4,0
502,3/15/2018 4:50,17,25,22,18,82,4,0
503,3/15/2018 4:55,17,25,22,18,82,4,0
504,3/15/2018 5:00,19,27,24,20,90,4,0
505,3/15/2018 5:05,22,32,29,23,106,4,0
506,3/15/2018 5:10,26,38,33,27,124,4,0
507,3/15/2018 5:15,29,42,37,31,139,4,0
508,3/15/2018 5:20,33,48,42,35,158,4,0
509,3/15/2018 5:25,36,52,46,38,172,4,0
510,3/15/2018 5:30,41,59,52,43,195,4,0
511,3/15/2018 5:35,44,64,56,46,210,4,0
512,3/15/2018 5:40,47,69,61,50,227,4,0
513,3/15/2018 5:45,48,70,62,51,231,4,0
514,3/15/2018 5:50,46,67,59,49,221,4,0
515,3/15/2018 5:55,45,65,57,47,214,4,0
516,3/15/2018 6:00,45,65,58,47,215,4,0
517,3/15/2018 6:05,48,69,61,50,228,4,0
518,3/15/2018 6:10,53,76,68,55,252,4,0
519,3/15/2018 6:15,56,81,72,59,268,4,0
520,3/15/2018 6:20,59,85,75,61,280,4,0
521,3/15/2018 6:25,60,87,77,63,287,4,0
522,3/15/2018 6:30,62,90,79,65,296,4,0
523,3/15/2018 6:35,64,93,82,67,306,4,0
524,3/15/2018 6:40,67,97,86,70,320,4,0
525,3/15/2018 6:45,67,97,86,70,320,4,0
526,3/15/2018 6:50,67,97,86,70,320,4,0
527,3/15/2018 6:55,65,95,84,69,313,4,0
528,3/15/2018 7:00,65,94,83,68,310,4,0
529,3/15/2018 7:05,66,96,84,69,315,4,0
530,3/15/2018 7:10,68,99,87,72,326,4,0
531,3/15/2018 7:15,70,102,90,74,336,4,0
532,3/15/2018 7:20,72,104,92,75,343,4,0
533,3/15/2018 7:25,71,103,91,75,340,4,0
534,3/15/2018 7:30,71,103,91,75,340,4,0
535,3/15/2018 7:35,73,105,93,76,347,4,0
536,3/15/2018 7:40,73,106,94,77,350,4,0
537,3/15/2018 7:45,73,106,94,77,350,4,0
538,3/15/2018 7:50,74,107,95,78,354,4,0
539,3/15/2018 7:55,71,103,91,75,340,4,0
540,3/15/2018 8:00,69,101,89,73,332,4,0
541,3/15/2018 8:05,68,98,87,71,324,4,0
542,3/15/2018 8:10,67,98,86,71,322,4,0
543,3/15/2018 8:15,66,96,85,70,317,4,0
544,3/15/2018 8:20,67,97,85,70,319,4,0
545,3/15/2018 8:25,65,94,83,68,310,4,0
546,3/15/2018 8:30,63,92,81,67,303,4,0
547,3/15/2018 8:35,63,91,81,66,301,4,0
548,3/15/2018 8:40,63,91,80,66,300,4,0
549,3/15/2018 8:45,63,91,80,66,300,4,0
550,3/15/2018 8:50,61,89,79,65,294,4,0
551,3/15/2018 8:55,58,85,75,61,279,4,0
552,3/15/2018 9:00,56,82,72,59,269,4,0
553,3/15/2018 9:05,56,81,71,58,266,4,0
554,3/15/2018 9:10,55,80,71,58,264,4,0
555,3/15/2018 9:15,56,81,71,58,266,4,0
556,3/15/2018 9:20,55,80,71,58,264,4,0
557,3/15/2018 9:25,55,80,70,58,263,4,0
558,3/15/2018 9:30,55,79,70,58,262,4,0
559,3/15/2018 9:35,55,80,71,58,264,4,0
560,3/15/2018 9:40,55,80,71,58,264,4,0
561,3/15/2018 9:45,55,79,70,58,262,4,0
562,3/15/2018 9:50,55,80,70,58,263,4,0
563,3/15/2018 9:55,54,78,69,56,257,4,0
564,3/15/2018 10:00,51,74,66,54,245,4,0
565,3/15/2018 10:05,52,76,67,55,250,4,0
566,3/15/2018 10:10,52,75,66,54,247,4,0
567,3/15/2018 10:15,53,76,68,55,252,4,0
568,3/15/2018 10:20,52,76,67,55,250,4,0
569,3/15/2018 10:25,52,76,67,55,250,4,0
570,3/15/2018 10:30,52,75,66,54,247,4,0
571,3/15/2018 10:35,51,74,65,54,244,4,0
572,3/15/2018 10:40,52,76,67,55,250,4,0
573,3/15/2018 10:45,53,77,68,56,254,4,0
574,3/15/2018 10:50,53,77,68,56,254,4,0
575,3/15/2018 10:55,52,76,67,55,250,4,0
576,3/15/2018 11:00,51,74,66,54,245,4,0
577,3/15/2018 11:05,52,76,67,55,250,4,0
578,3/15/2018 11:10,52,75,66,54,247,4,0
579,3/15/2018 11:15,51,75,66,54,246,4,0
580,3/15/2018 11:20,52,76,67,55,250,4,0
581,3/15/2018 11:25,52,76,67,55,250,4,0
582,3/15/2018 11:30,53,77,68,56,254,4,0
583,3/15/2018 11:35,54,78,69,57,258,4,0
584,3/15/2018 11:40,54,78,69,56,257,4,0
585,3/15/2018 11:45,53,77,68,56,254,4,0
586,3/15/2018 11:50,54,78,69,56,257,4,0
587,3/15/2018 11:55,53,76,68,55,252,4,0
588,3/15/2018 12:00,53,77,68,56,254,4,0
589,3/15/2018 12:05,54,78,69,56,257,4,0
590,3/15/2018 12:10,54,78,69,56,257,4,0
591,3/15/2018 12:15,54,78,69,57,258,4,0
592,3/15/2018 12:20,55,79,70,57,261,4,0
593,3/15/2018 12:25,54,79,70,57,260,4,0
594,3/15/2018 12:30,54,78,69,56,257,4,0
595,3/15/2018 12:35,54,78,69,56,257,4,0
596,3/15/2018 12:40,54,78,69,56,257,4,0
597,3/15/2018 12:45,55,80,70,58,263,4,0
598,3/15/2018 12:50,55,79,70,58,262,4,0
599,3/15/2018 12:55,54,79,70,57,260,4,0
600,3/15/2018 13:00,54,78,69,56,257,4,0
601,3/15/2018 13:05,54,78,69,57,258,4,0
602,3/15/2018 13:10,55,80,70,58,263,4,0
603,3/15/2018 13:15,55,80,70,58,263,4,0
604,3/15/2018 13:20,55,80,71,58,264,4,0
605,3/15/2018 13:25,55,80,70,58,263,4,0
606,3/15/2018 13:30,55,80,71,58,264,4,0
607,3/15/2018 13:35,56,81,72,59,268,4,0
608,3/15/2018 13:40,56,81,71,58,266,4,0
609,3/15/2018 13:45,56,82,72,59,269,4,0
610,3/15/2018 13:50,56,82,72,59,269,4,0
611,3/15/2018 13:55,56,82,72,59,269,4,0
612,3/15/2018 14:00,56,82,72,59,269,4,0
613,3/15/2018 14:05,57,83,73,60,273,4,0
614,3/15/2018 14:10,59,85,75,61,280,4,0
615,3/15/2018 14:15,60,86,76,63,285,4,0
616,3/15/2018 14:20,60,87,77,63,287,4,0
617,3/15/2018 14:25,60,86,76,63,285,4,0
618,3/15/2018 14:30,60,87,77,63,287,4,0
619,3/15/2018 14:35,63,91,80,66,300,4,0
620,3/15/2018 14:40,65,95,84,69,313,4,0
621,3/15/2018 14:45,66,96,85,69,316,4,0
622,3/15/2018 14:50,65,94,83,68,310,4,0
623,3/15/2018 14:55,64,93,82,67,306,4,0
624,3/15/2018 15:00,64,93,82,67,306,4,0
625,3/15/2018 15:05,65,94,83,68,310,4,0
626,3/15/2018 15:10,66,96,85,69,316,4,0
627,3/15/2018 15:15,66,96,85,69,316,4,0
628,3/15/2018 15:20,66,96,85,70,317,4,0
629,3/15/2018 15:25,66,96,85,70,317,4,0
630,3/15/2018 15:30,66,96,85,70,317,4,0
631,3/15/2018 15:35,70,102,90,74,336,4,0
632,3/15/2018 15:40,73,106,93,76,348,4,0
633,3/15/2018 15:45,73,105,93,76,347,4,0
634,3/15/2018 15:50,72,104,92,76,344,4,0
635,3/15/2018 15:55,69,100,88,72,329,4,0
636,3/15/2018 16:00,68,99,88,72,327,4,0
637,3/15/2018 16:05,69,100,89,73,331,4,0
638,3/15/2018 16:10,71,103,91,75,340,4,0
639,3/15/2018 16:15,71,103,91,74,339,4,0
640,3/15/2018 16:20,72,104,92,76,344,4,0
641,3/15/2018 16:25,69,100,89,73,331,4,0
642,3/15/2018 16:30,71,103,91,74,339,4,0
643,3/15/2018 16:35,72,104,92,75,343,4,0
644,3/15/2018 16:40,74,107,95,77,353,4,0
645,3/15/2018 16:45,74,107,95,77,353,4,0
646,3/15/2018 16:50,75,109,96,79,359,4,0
647,3/15/2018 16:55,72,105,93,76,346,4,0
648,3/15/2018 17:00,72,104,92,76,344,4,0
649,3/15/2018 17:05,74,107,95,77,353,4,0
650,3/15/2018 17:10,76,110,98,80,364,4,0
651,3/15/2018 17:15,76,110,97,80,363,4,0
652,3/15/2018 17:20,77,112,99,81,369,4,0
653,3/15/2018 17:25,73,105,93,76,347,4,0
654,3/15/2018 17:30,72,104,92,76,344,4,0
655,3/15/2018 17:35,72,104,92,75,343,4,0
656,3/15/2018 17:40,72,104,92,75,343,4,0
657,3/15/2018 17:45,71,103,91,75,340,4,0
658,3/15/2018 17:50,71,103,91,75,340,4,0
659,3/15/2018 17:55,69,100,88,72,329,4,0
660,3/15/2018 18:00,67,97,86,70,320,4,0
661,3/15/2018 18:05,67,97,86,70,320,4,0
662,3/15/2018 18:10,67,97,86,70,320,4,0
663,3/15/2018 18:15,66,96,85,70,317,4,0
664,3/15/2018 18:20,67,97,86,70,320,4,0
665,3/15/2018 18:25,64,93,83,68,308,4,0
666,3/15/2018 18:30,63,92,81,66,302,4,0
667,3/15/2018 18:35,62,90,79,65,296,4,0
668,3/15/2018 18:40,60,87,77,63,287,4,0
669,3/15/2018 18:45,59,86,76,62,283,4,0
670,3/15/2018 18:50,57,83,73,60,273,4,0
671,3/15/2018 18:55,55,80,71,58,264,4,0
672,3/15/2018 19:00,55,79,70,57,261,4,0
673,3/15/2018 19:05,54,78,69,56,257,4,0
674,3/15/2018 19:10,54,79,70,57,260,4,0
675,3/15/2018 19:15,51,75,66,54,246,4,0
676,3/15/2018 19:20,50,73,64,52,239,4,0
677,3/15/2018 19:25,48,70,62,51,231,4,0
678,3/15/2018 19:30,47,68,60,49,224,4,0
679,3/15/2018 19:35,46,67,59,48,220,4,0
680,3/15/2018 19:40,45,66,58,48,217,4,0
681,3/15/2018 19:45,43,63,55,45,206,4,0
682,3/15/2018 19:50,42,61,54,44,201,4,0
683,3/15/2018 19:55,40,58,51,42,191,4,0
684,3/15/2018 20:00,40,57,51,41,189,4,0
685,3/15/2018 20:05,38,56,49,40,183,4,0
686,3/15/2018 20:10,38,55,49,40,182,4,0
687,3/15/2018 20:15,38,55,48,40,181,4,0
688,3/15/2018 20:20,38,55,49,40,182,4,0
689,3/15/2018 20:25,37,53,47,39,176,4,0
690,3/15/2018 20:30,35,51,45,37,168,4,0
691,3/15/2018 20:35,35,51,45,37,168,4,0
692,3/15/2018 20:40,35,51,45,37,168,4,0
693,3/15/2018 20:45,35,50,44,36,165,4,0
694,3/15/2018 20:50,34,50,44,36,164,4,0
695,3/15/2018 20:55,33,48,43,35,159,4,0
696,3/15/2018 21:00,33,48,42,34,157,4,0
697,3/15/2018 21:05,34,49,44,36,163,4,0
698,3/15/2018 21:10,35,51,45,37,168,4,0
699,3/15/2018 21:15,36,52,46,38,172,4,0
700,3/15/2018 21:20,36,52,46,37,171,4,0
701,3/15/2018 21:25,35,50,44,36,165,4,0
702,3/15/2018 21:30,33,48,43,35,159,4,0
703,3/15/2018 21:35,33,49,43,35,160,4,0
704,3/15/2018 21:40,33,48,43,35,159,4,0
705,3/15/2018 21:45,32,46,41,34,153,4,0
706,3/15/2018 21:50,31,46,40,33,150,4,0
707,3/15/2018 21:55,30,44,39,32,145,4,0
708,3/15/2018 22:00,30,43,38,31,142,4,0
709,3/15/2018 22:05,29,42,37,31,139,4,0
710,3/15/2018 22:10,30,43,38,31,142,4,0
711,3/15/2018 22:15,29,42,38,31,140,4,0
712,3/15/2018 22:20,29,43,38,31,141,4,0
713,3/15/2018 22:25,27,40,35,29,131,4,0
714,3/15/2018 22:30,27,39,35,29,130,4,0
715,3/15/2018 22:35,26,37,33,27,123,4,0
716,3/15/2018 22:40,25,36,32,26,119,4,0
717,3/15/2018 22:45,25,36,32,26,119,4,0
718,3/15/2018 22:50,23,33,29,24,109,4,0
719,3/15/2018 22:55,22,31,28,23,104,4,0
720,3/15/2018 23:00,20,29,26,21,96,4,0
721,3/15/2018 23:05,21,30,27,22,100,4,0
722,3/15/2018 23:10,21,30,27,22,100,4,0
723,3/15/2018 23:15,19,28,25,20,92,4,0
724,3/15/2018 23:20,19,27,24,20,90,4,0
725,3/15/2018 23:25,18,26,23,19,86,4,0
726,3/15/2018 23:30,17,25,22,18,82,4,0
727,3/15/2018 23:35,17,24,21,18,80,4,0
728,3/15/2018 23:40,16,23,21,17,77,4,0
729,3/15/2018 23:45,16,23,20,16,75,4,0
730,3/15/2018 23:50,15,22,19,16,72,4,0
731,3/15/2018 23:55,14,20,18,15,67,4,0
732,3/16/2018 0:00,13,19,16,13,61,4,0
733,3/16/2018 0:05,13,19,16,13,61,4,0
734,3/16/2018 0:10,13,19,17,14,63,4,0
735,3/16/2018 0:15,12,18,16,13,59,4,0
736,3/16/2018 0:20,12,17,15,12,56,4,0
737,3/16/2018 0:25,10,15,13,11,49,4,0
738,3/16/2018 0:30,11,15,14,11,51,4,0
739,3/16/2018 0:35,11,15,14,11,51,4,0
740,3/16/2018 0:40,10,15,13,11,49,4,0
741,3/16/2018 0:45,10,14,13,10,47,4,0
742,3/16/2018 0:50,9,13,12,10,44,4,0
743,3/16/2018 0:55,9,13,11,9,42,4,0
744,3/16/2018 1:00,8,12,10,8,38,4,0
745,3/16/2018 1:05,8,12,10,9,39,4,0
746,3/16/2018 1:10,8,12,10,8,38,4,0
747,3/16/2018 1:15,8,12,10,9,39,4,0
748,3/16/2018 1:20,8,12,10,8,38,4,0
749,3/16/2018 1:25,7,11,9,8,35,4,0
750,3/16/2018 1:30,7,11,9,8,35,4,0
751,3/16/2018 1:35,7,11,9,8,35,4,0
752,3/16/2018 1:40,8,11,10,8,37,4,0
753,3/16/2018 1:45,7,11,9,8,35,4,0
754,3/16/2018 1:50,7,10,9,7,33,4,0
755,3/16/2018 1:55,7,10,9,7,33,4,0
756,3/16/2018 2:00,7,10,9,7,33,4,0
757,3/16/2018 2:05,7,10,9,7,33,4,0
758,3/16/2018 2:10,7,10,9,7,33,4,0
759,3/16/2018 2:15,7,10,9,7,33,4,0
760,3/16/2018 2:20,6,9,8,7,30,4,0
761,3/16/2018 2:25,6,9,8,7,30,4,0
762,3/16/2018 2:30,6,9,8,7,30,4,0
763,3/16/2018 2:35,6,9,8,7,30,4,0
764,3/16/2018 2:40,7,10,9,7,33,4,0
765,3/16/2018 2:45,6,9,8,7,30,4,0
766,3/16/2018 2:50,6,9,8,6,29,4,0
767,3/16/2018 2:55,6,8,7,6,27,4,0
768,3/16/2018 3:00,6,8,7,6,27,4,0
769,3/16/2018 3:05,6,8,7,6,27,4,0
770,3/16/2018 3:10,6,8,8,6,28,4,0
771,3/16/2018 3:15,6,9,8,7,30,4,0
772,3/16/2018 3:20,6,9,8,7,30,4,0
773,3/16/2018 3:25,7,10,9,7,33,4,0
774,3/16/2018 3:30,7,10,9,7,33,4,0
775,3/16/2018 3:35,7,11,9,8,35,4,0
776,3/16/2018 3:40,8,11,10,8,37,4,0
777,3/16/2018 3:45,8,11,10,8,37,4,0
778,3/16/2018 3:50,7,10,9,7,33,4,0
779,3/16/2018 3:55,7,10,9,7,33,4,0
780,3/16/2018 4:00,7,11,9,8,35,4,0
781,3/16/2018 4:05,8,12,10,9,39,4,0
782,3/16/2018 4:10,9,13,11,9,42,4,0
783,3/16/2018 4:15,10,14,13,10,47,4,0
784,3/16/2018 4:20,11,16,14,12,53,4,0
785,3/16/2018 4:25,11,16,14,12,53,4,0
786,3/16/2018 4:30,13,19,16,13,61,4,0
787,3/16/2018 4:35,15,21,19,15,70,4,0
788,3/16/2018 4:40,16,23,20,17,76,4,0
789,3/16/2018 4:45,17,24,21,18,80,4,0
790,3/16/2018 4:50,17,25,22,18,82,4,0
791,3/16/2018 4:55,17,25,22,18,82,4,0
792,3/16/2018 5:00,19,28,24,20,91,4,0
793,3/16/2018 5:05,21,31,27,22,101,4,0
794,3/16/2018 5:10,25,36,32,26,119,4,0
795,3/16/2018 5:15,28,41,36,30,135,4,0
796,3/16/2018 5:20,32,46,41,34,153,4,0
797,3/16/2018 5:25,35,50,44,36,165,4,0
798,3/16/2018 5:30,38,55,49,40,182,4,0
799,3/16/2018 5:35,42,61,54,44,201,4,0
800,3/16/2018 5:40,44,64,57,47,212,4,0
801,3/16/2018 5:45,45,65,57,47,214,4,0
802,3/16/2018 5:50,46,66,58,48,218,4,0
803,3/16/2018 5:55,44,64,57,47,212,4,0
804,3/16/2018 6:00,44,64,56,46,210,4,0
805,3/16/2018 6:05,47,68,60,49,224,4,0
806,3/16/2018 6:10,51,74,65,53,243,4,0
807,3/16/2018 6:15,55,80,70,58,263,4,0
808,3/16/2018 6:20,57,83,73,60,273,4,0
809,3/16/2018 6:25,59,85,75,62,281,4,0
810,3/16/2018 6:30,61,89,78,64,292,4,0
811,3/16/2018 6:35,63,91,81,66,301,4,0
812,3/16/2018 6:40,66,95,84,69,314,4,0
813,3/16/2018 6:45,66,96,85,70,317,4,0
814,3/16/2018 6:50,67,97,85,70,319,4,0
815,3/16/2018 6:55,64,93,82,67,306,4,0
816,3/16/2018 7:00,64,93,83,68,308,4,0
817,3/16/2018 7:05,66,96,85,69,316,4,0
818,3/16/2018 7:10,68,99,88,72,327,4,0
819,3/16/2018 7:15,70,102,90,74,336,4,0
820,3/16/2018 7:20,73,105,93,76,347,4,0
821,3/16/2018 7:25,73,105,93,76,347,4,0
822,3/16/2018 7:30,72,105,93,76,346,4,0
823,3/16/2018 7:35,73,106,93,76,348,4,0
824,3/16/2018 7:40,73,106,94,77,350,4,0
825,3/16/2018 7:45,75,109,96,79,359,4,0
826,3/16/2018 7:50,74,107,95,78,354,4,0
827,3/16/2018 7:55,72,104,92,75,343,4,0
828,3/16/2018 8:00,69,100,89,73,331,4,0
829,3/16/2018 8:05,69,100,88,72,329,4,0
830,3/16/2018 8:10,69,100,88,72,329,4,0
831,3/16/2018 8:15,68,99,88,72,327,4,0
832,3/16/2018 8:20,68,99,88,72,327,4,0
833,3/16/2018 8:25,66,96,85,70,317,4,0
834,3/16/2018 8:30,64,93,83,68,308,4,0
835,3/16/2018 8:35,64,93,82,67,306,4,0
836,3/16/2018 8:40,64,93,83,68,308,4,0
837,3/16/2018 8:45,62,90,80,65,297,4,0
838,3/16/2018 8:50,61,89,79,65,294,4,0
839,3/16/2018 8:55,59,86,76,62,283,4,0
840,3/16/2018 9:00,58,83,74,60,275,4,0
841,3/16/2018 9:05,56,82,72,59,269,4,0
842,3/16/2018 9:10,57,82,73,59,271,4,0
843,3/16/2018 9:15,55,80,71,58,264,4,0
844,3/16/2018 9:20,56,82,72,59,269,4,0
845,3/16/2018 9:25,56,81,72,59,268,4,0
846,3/16/2018 9:30,56,81,72,59,268,4,0
847,3/16/2018 9:35,56,81,72,59,268,4,0
848,3/16/2018 9:40,57,82,73,59,271,4,0
849,3/16/2018 9:45,56,82,72,59,269,4,0
850,3/16/2018 9:50,56,81,71,58,266,4,0
851,3/16/2018 9:55,54,79,70,57,260,4,0
852,3/16/2018 10:00,53,77,68,56,254,4,0
853,3/16/2018 10:05,54,79,70,57,260,4,0
854,3/16/2018 10:10,54,79,70,57,260,4,0
855,3/16/2018 10:15,55,79,70,58,262,4,0
856,3/16/2018 10:20,56,81,71,58,266,4,0
857,3/16/2018 10:25,55,80,70,58,263,4,0
858,3/16/2018 10:30,55,80,70,58,263,4,0
859,3/16/2018 10:35,55,80,70,58,263,4,0
860,3/16/2018 10:40,56,81,71,58,266,4,0
861,3/16/2018 10:45,56,81,71,58,266,4,0
862,3/16/2018 10:50,55,79,70,58,262,4,0
863,3/16/2018 10:55,54,78,69,57,258,4,0
864,3/16/2018 11:00,54,79,69,57,259,4,0
865,3/16/2018 11:05,54,78,69,56,257,4,0
866,3/16/2018 11:10,54,79,70,57,260,4,0
867,3/16/2018 11:15,54,79,70,57,260,4,0
868,3/16/2018 11:20,55,80,71,58,264,4,0
869,3/16/2018 11:25,55,80,71,58,264,4,0
870,3/16/2018 11:30,57,82,73,59,271,4,0
871,3/16/2018 11:35,56,81,72,59,268,4,0
872,3/16/2018 11:40,58,83,74,60,275,4,0
873,3/16/2018 11:45,57,83,73,60,273,4,0
874,3/16/2018 11:50,58,84,74,61,277,4,0
875,3/16/2018 11:55,56,81,72,59,268,4,0
876,3/16/2018 12:00,56,81,72,59,268,4,0
877,3/16/2018 12:05,58,83,74,60,275,4,0
878,3/16/2018 12:10,57,83,73,60,273,4,0
879,3/16/2018 12:15,58,84,75,61,278,4,0
880,3/16/2018 12:20,58,85,75,61,279,4,0
881,3/16/2018 12:25,58,84,75,61,278,4,0
882,3/16/2018 12:30,58,84,75,61,278,4,0
883,3/16/2018 12:35,58,84,74,61,277,4,0
884,3/16/2018 12:40,59,85,75,61,280,4,0
885,3/16/2018 12:45,59,85,75,62,281,4,0
886,3/16/2018 12:50,58,85,75,61,279,4,0
887,3/16/2018 12:55,59,85,75,61,280,4,0
888,3/16/2018 13:00,58,84,75,61,278,4,0
889,3/16/2018 13:05,59,85,75,61,280,4,0
890,3/16/2018 13:10,58,85,75,61,279,4,0
891,3/16/2018 13:15,59,86,76,62,283,4,0
892,3/16/2018 13:20,60,87,77,63,287,4,0
893,3/16/2018 13:25,60,87,77,63,287,4,0
894,3/16/2018 13:30,59,85,75,62,281,4,0
895,3/16/2018 13:35,60,87,77,63,287,4,0
896,3/16/2018 13:40,61,88,78,64,291,4,0
897,3/16/2018 13:45,60,88,77,63,288,4,0
898,3/16/2018 13:50,61,88,78,64,291,4,0
899,3/16/2018 13:55,61,89,78,64,292,4,0
900,3/16/2018 14:00,61,88,78,64,291,4,0
901,3/16/2018 14:05,61,89,78,64,292,4,0
902,3/16/2018 14:10,63,91,80,66,300,4,0
903,3/16/2018 14:15,63,92,81,66,302,4,0
904,3/16/2018 14:20,64,93,82,67,306,4,0
905,3/16/2018 14:25,64,93,82,67,306,4,0
906,3/16/2018 14:30,65,94,83,68,310,4,0
907,3/16/2018 14:35,65,94,83,68,310,4,0
908,3/16/2018 14:40,68,98,87,71,324,4,0
909,3/16/2018 14:45,70,101,89,73,333,4,0
910,3/16/2018 14:50,67,97,85,70,319,4,0
911,3/16/2018 14:55,66,96,85,70,317,4,0
912,3/16/2018 15:00,67,97,86,70,320,4,0
913,3/16/2018 15:05,69,100,88,72,329,4,0
914,3/16/2018 15:10,70,101,89,73,333,4,0
915,3/16/2018 15:15,69,101,89,73,332,4,0
916,3/16/2018 15:20,70,102,90,74,336,4,0
917,3/16/2018 15:25,69,100,88,72,329,4,0
918,3/16/2018 15:30,68,99,87,71,325,4,0
919,3/16/2018 15:35,70,102,90,74,336,4,0
920,3/16/2018 15:40,72,104,92,76,344,4,0
921,3/16/2018 15:45,73,105,93,76,347,4,0
922,3/16/2018 15:50,72,104,92,76,344,4,0
923,3/16/2018 15:55,70,102,90,74,336,4,0
924,3/16/2018 16:00,70,102,90,74,336,4,0
925,3/16/2018 16:05,71,103,91,75,340,4,0
926,3/16/2018 16:10,72,105,93,76,346,4,0
927,3/16/2018 16:15,73,106,93,76,348,4,0
928,3/16/2018 16:20,73,106,93,76,348,4,0
929,3/16/2018 16:25,72,104,92,75,343,4,0
930,3/16/2018 16:30,71,103,91,75,340,4,0
931,3/16/2018 16:35,72,104,92,76,344,4,0
932,3/16/2018 16:40,74,107,95,78,354,4,0
933,3/16/2018 16:45,74,107,94,77,352,4,0
934,3/16/2018 16:50,74,108,95,78,355,4,0
935,3/16/2018 16:55,72,105,92,76,345,4,0
936,3/16/2018 17:00,72,105,93,76,346,4,0
937,3/16/2018 17:05,74,107,95,78,354,4,0
938,3/16/2018 17:10,75,110,97,79,361,4,0
939,3/16/2018 17:15,75,110,97,79,361,4,0
940,3/16/2018 17:20,76,110,97,80,363,4,0
941,3/16/2018 17:25,74,108,95,78,355,4,0
942,3/16/2018 17:30,73,105,93,76,347,4,0
943,3/16/2018 17:35,72,105,92,76,345,4,0
944,3/16/2018 17:40,73,106,93,76,348,4,0
945,3/16/2018 17:45,72,104,92,75,343,4,0
946,3/16/2018 17:50,70,102,90,74,336,4,0
947,3/16/2018 17:55,70,102,90,74,336,4,0
948,3/16/2018 18:00,69,100,88,72,329,4,0
949,3/16/2018 18:05,69,100,88,72,329,4,0
950,3/16/2018 18:10,69,100,88,72,329,4,0
951,3/16/2018 18:15,68,99,87,72,326,4,0
952,3/16/2018 18:20,68,98,87,71,324,4,0
953,3/16/2018 18:25,66,96,85,69,316,4,0
954,3/16/2018 18:30,64,93,83,68,308,4,0
955,3/16/2018 18:35,64,93,83,68,308,4,0
956,3/16/2018 18:40,63,91,80,66,300,4,0
957,3/16/2018 18:45,61,89,79,65,294,4,0
958,3/16/2018 18:50,61,89,78,64,292,4,0
959,3/16/2018 18:55,59,86,76,62,283,4,0
960,3/16/2018 19:00,58,83,74,60,275,4,0
961,3/16/2018 19:05,57,83,73,60,273,4,0
962,3/16/2018 19:10,57,83,73,60,273,4,0
963,3/16/2018 19:15,56,82,72,59,269,4,0
964,3/16/2018 19:20,55,80,70,58,263,4,0
965,3/16/2018 19:25,54,78,69,56,257,4,0
966,3/16/2018 19:30,52,76,67,55,250,4,0
967,3/16/2018 19:35,51,74,66,54,245,4,0
968,3/16/2018 19:40,51,74,65,53,243,4,0
969,3/16/2018 19:45,49,71,62,51,233,4,0
970,3/16/2018 19:50,49,71,63,51,234,4,0
971,3/16/2018 19:55,47,68,60,49,224,4,0
972,3/16/2018 20:00,48,69,61,50,228,4,0
973,3/16/2018 20:05,46,66,59,48,219,4,0
974,3/16/2018 20:10,46,66,58,48,218,4,0
975,3/16/2018 20:15,45,65,58,47,215,4,0
976,3/16/2018 20:20,44,63,56,46,209,4,0
977,3/16/2018 20:25,43,63,56,46,208,4,0
978,3/16/2018 20:30,43,62,55,45,205,4,0
979,3/16/2018 20:35,41,59,53,43,196,4,0
980,3/16/2018 20:40,41,59,52,43,195,4,0
981,3/16/2018 20:45,40,58,51,42,191,4,0
982,3/16/2018 20:50,38,56,49,40,183,4,0
983,3/16/2018 20:55,39,56,50,41,186,4,0
984,3/16/2018 21:00,38,56,49,40,183,4,0
985,3/16/2018 21:05,39,57,50,41,187,4,0
986,3/16/2018 21:10,40,57,51,41,189,4,0
987,3/16/2018 21:15,40,58,51,42,191,4,0
988,3/16/2018 21:20,39,56,50,41,186,4,0
989,3/16/2018 21:25,39,56,50,41,186,4,0
990,3/16/2018 21:30,37,54,48,39,178,4,0
991,3/16/2018 21:35,37,54,47,39,177,4,0
992,3/16/2018 21:40,36,52,46,38,172,4,0
993,3/16/2018 21:45,37,53,47,39,176,4,0
994,3/16/2018 21:50,36,52,46,38,172,4,0
995,3/16/2018 21:55,35,51,45,37,168,4,0
996,3/16/2018 22:00,35,51,45,37,168,4,0
997,3/16/2018 22:05,36,52,46,37,171,4,0
998,3/16/2018 22:10,36,52,46,38,172,4,0
999,3/16/2018 22:15,35,51,45,37,168,4,0
1000,3/16/2018 22:20,35,51,45,37,168,4,0
1001,3/16/2018 22:25,33,48,43,35,159,4,0
1002,3/16/2018 22:30,33,47,42,34,156,4,0
1003,3/16/2018 22:35,32,46,40,33,151,4,0
1004,3/16/2018 22:40,31,46,40,33,150,4,0
1005,3/16/2018 22:45,31,45,40,33,149,4,0
1006,3/16/2018 22:50,29,43,38,31,141,4,0
1007,3/16/2018 22:55,29,42,37,30,138,4,0
1008,3/16/2018 23:00,27,39,35,29,130,4,0
1009,3/16/2018 23:05,27,39,34,28,128,4,0
1010,3/16/2018 23:10,27,39,34,28,128,4,0
1011,3/16/2018 23:15,27,39,35,29,130,4,0
1012,3/16/2018 23:20,25,36,32,26,119,4,0
1013,3/16/2018 23:25,24,35,31,25,115,4,0
1014,3/16/2018 23:30,24,34,30,25,113,4,0
1015,3/16/2018 23:35,23,34,30,25,112,4,0
1016,3/16/2018 23:40,23,33,29,24,109,4,0
1017,3/16/2018 23:45,22,32,28,23,105,4,0
1018,3/16/2018 23:50,21,30,27,22,100,4,0
1019,3/16/2018 23:55,20,29,26,21,96,4,0
1020,3/17/2018 0:00,44,52,46,41,183,4,0
1021,3/17/2018 0:05,49,56,50,44,199,4,0
1022,3/17/2018 0:10,51,58,51,46,206,4,0
1023,3/17/2018 0:15,44,52,46,41,183,4,0
1024,3/17/2018 0:20,38,46,42,37,163,4,0
1025,3/17/2018 0:25,40,47,42,37,166,4,0
1026,3/17/2018 0:30,41,49,42,37,169,4,0
1027,3/17/2018 0:35,38,46,41,35,160,4,0
1028,3/17/2018 0:40,42,49,42,38,171,4,0
1029,3/17/2018 0:45,31,39,35,30,135,4,0
1030,3/17/2018 0:50,39,47,41,36,163,4,0
1031,3/17/2018 0:55,44,51,45,40,180,4,0
1032,3/17/2018 1:00,38,47,41,36,162,4,0
1033,3/17/2018 1:05,31,40,36,32,139,4,0
1034,3/17/2018 1:10,39,47,42,38,166,4,0
1035,3/17/2018 1:15,37,46,41,36,160,4,0
1036,3/17/2018 1:20,32,42,37,31,142,4,0
1037,3/17/2018 1:25,29,39,34,30,132,4,0
1038,3/17/2018 1:30,32,42,36,32,142,4,0
1039,3/17/2018 1:35,31,40,35,30,136,4,0
1040,3/17/2018 1:40,29,40,34,29,132,4,0
1041,3/17/2018 1:45,35,43,37,31,146,4,0
1042,3/17/2018 1:50,34,43,38,32,147,4,0
1043,3/17/2018 1:55,34,43,37,31,145,4,0
1044,3/17/2018 2:00,35,43,37,33,148,4,0
1045,3/17/2018 2:05,38,46,40,34,158,4,0
1046,3/17/2018 2:10,30,40,35,30,135,4,0
1047,3/17/2018 2:15,27,37,33,28,125,4,0
1048,3/17/2018 2:20,32,42,37,31,142,4,0
1049,3/17/2018 2:25,32,42,38,33,145,4,0
1050,3/17/2018 2:30,28,38,34,29,129,4,0
1051,3/17/2018 2:35,31,41,37,32,141,4,0
1052,3/17/2018 2:40,32,41,36,30,139,4,0
1053,3/17/2018 2:45,30,41,36,30,137,4,0
1054,3/17/2018 2:50,32,42,38,33,145,4,0
1055,3/17/2018 2:55,27,37,31,26,121,4,0
1056,3/17/2018 3:00,29,39,34,29,131,4,0
1057,3/17/2018 3:05,21,32,28,23,104,4,0
1058,3/17/2018 3:10,28,38,32,26,124,4,0
1059,3/17/2018 3:15,24,34,31,27,116,4,0
1060,3/17/2018 3:20,27,37,32,26,122,4,0
1061,3/17/2018 3:25,28,37,33,29,127,4,0
1062,3/17/2018 3:30,33,42,37,32,144,4,0
1063,3/17/2018 3:35,32,42,36,29,139,4,0
1064,3/17/2018 3:40,31,40,35,31,137,4,0
1065,3/17/2018 3:45,33,42,37,32,144,4,0
1066,3/17/2018 3:50,28,37,33,27,125,4,0
1067,3/17/2018 3:55,30,39,35,29,133,4,0
1068,3/17/2018 4:00,27,37,33,27,124,4,0
1069,3/17/2018 4:05,26,36,32,27,121,4,0
1070,3/17/2018 4:10,29,39,34,29,131,4,0
1071,3/17/2018 4:15,28,38,33,29,128,4,0
1072,3/17/2018 4:20,26,36,30,25,117,4,0
1073,3/17/2018 4:25,33,42,37,32,144,4,0
1074,3/17/2018 4:30,36,45,39,33,153,4,0
1075,3/17/2018 4:35,36,44,39,34,153,4,0
1076,3/17/2018 4:40,46,53,47,42,188,4,0
1077,3/17/2018 4:45,48,55,49,44,196,4,0
1078,3/17/2018 4:50,43,51,45,40,179,4,0
1079,3/17/2018 4:55,37,46,41,37,161,4,0
1080,3/17/2018 5:00,38,47,40,35,160,4,0
1081,3/17/2018 5:05,41,50,45,40,176,4,0
1082,3/17/2018 5:10,44,52,46,41,183,4,0
1083,3/17/2018 5:15,47,54,48,42,191,4,0
1084,3/17/2018 5:20,48,55,48,43,194,4,0
1085,3/17/2018 5:25,46,54,47,42,189,4,0
1086,3/17/2018 5:30,50,57,50,45,202,4,0
1087,3/17/2018 5:35,56,62,55,49,222,4,0
1088,3/17/2018 5:40,62,67,59,53,241,4,0
1089,3/17/2018 5:45,61,67,59,52,239,4,0
1090,3/17/2018 5:50,62,67,59,53,241,4,0
1091,3/17/2018 5:55,56,62,55,50,223,4,0
1092,3/17/2018 6:00,56,62,55,49,222,4,0
1093,3/17/2018 6:05,49,55,49,42,195,4,0
1094,3/17/2018 6:10,57,64,56,50,227,4,0
1095,3/17/2018 6:15,50,56,49,44,199,4,0
1096,3/17/2018 6:20,54,60,53,47,214,4,0
1097,3/17/2018 6:25,48,55,49,42,194,4,0
1098,3/17/2018 6:30,59,64,57,50,230,4,0
1099,3/17/2018 6:35,63,68,60,53,244,4,0
1100,3/17/2018 6:40,67,72,63,57,259,4,0
1101,3/17/2018 6:45,67,71,63,56,257,4,0
1102,3/17/2018 6:50,69,74,65,59,267,4,0
1103,3/17/2018 6:55,70,74,65,59,268,4,0
1104,3/17/2018 7:00,61,67,59,54,241,4,0
1105,3/17/2018 7:05,55,61,54,48,218,4,0
1106,3/17/2018 7:10,56,62,54,48,220,4,0
1107,3/17/2018 7:15,62,68,60,54,244,4,0
1108,3/17/2018 7:20,66,72,63,56,257,4,0
1109,3/17/2018 7:25,71,75,66,59,271,4,0
1110,3/17/2018 7:30,75,79,69,62,285,4,0
1111,3/17/2018 7:35,77,81,71,64,293,4,0
1112,3/17/2018 7:40,74,79,69,62,284,4,0
1113,3/17/2018 7:45,87,90,79,71,327,4,0
1114,3/17/2018 7:50,88,90,79,71,328,4,0
1115,3/17/2018 7:55,83,86,75,68,312,4,0
1116,3/17/2018 8:00,80,83,73,66,302,4,0
1117,3/17/2018 8:05,86,88,78,70,322,4,0
1118,3/17/2018 8:10,77,81,72,65,295,4,0
1119,3/17/2018 8:15,75,79,69,63,286,4,0
1120,3/17/2018 8:20,89,91,80,72,332,4,0
1121,3/17/2018 8:25,90,92,80,73,335,4,0
1122,3/17/2018 8:30,88,90,79,71,328,4,0
1123,3/17/2018 8:35,89,91,80,72,332,4,0
1124,3/17/2018 8:40,99,100,88,79,366,4,0
1125,3/17/2018 8:45,96,97,85,77,355,4,0
1126,3/17/2018 8:50,94,96,85,76,351,4,0
1127,3/17/2018 8:55,107,106,93,84,390,4,0
1128,3/17/2018 9:00,86,89,78,71,324,4,0
1129,3/17/2018 9:05,83,86,76,69,314,4,0
1130,3/17/2018 9:10,78,82,72,65,297,4,0
1131,3/17/2018 9:15,94,96,84,76,350,4,0
1132,3/17/2018 9:20,91,93,82,74,340,4,0
1133,3/17/2018 9:25,89,92,80,72,333,4,0
1134,3/17/2018 9:30,97,98,86,78,359,4,0
1135,3/17/2018 9:35,105,105,91,83,384,4,0
1136,3/17/2018 9:40,110,109,96,87,402,4,0
1137,3/17/2018 9:45,99,100,88,79,366,4,0
1138,3/17/2018 9:50,108,108,95,86,397,4,0
1139,3/17/2018 9:55,102,103,91,82,378,4,0
1140,3/17/2018 10:00,105,106,93,84,388,4,0
1141,3/17/2018 10:05,89,92,80,73,334,4,0
1142,3/17/2018 10:10,103,104,91,82,380,4,0
1143,3/17/2018 10:15,95,96,84,76,351,4,0
1144,3/17/2018 10:20,96,98,87,78,359,4,0
1145,3/17/2018 10:25,97,98,86,78,359,4,0
1146,3/17/2018 10:30,90,92,80,73,335,4,0
1147,3/17/2018 10:35,109,109,95,87,400,4,0
1148,3/17/2018 10:40,102,103,90,82,377,4,0
1149,3/17/2018 10:45,106,107,94,85,392,4,0
1150,3/17/2018 10:50,107,107,94,85,393,4,0
1151,3/17/2018 10:55,95,96,85,76,352,4,0
1152,3/17/2018 11:00,103,103,91,82,379,4,0
1153,3/17/2018 11:05,103,103,91,82,379,4,0
1154,3/17/2018 11:10,105,105,92,83,385,4,0
1155,3/17/2018 11:15,96,98,86,78,358,4,0
1156,3/17/2018 11:20,108,109,95,86,398,4,0
1157,3/17/2018 11:25,99,100,87,79,365,4,0
1158,3/17/2018 11:30,111,110,96,87,404,4,0
1159,3/17/2018 11:35,112,111,97,88,408,4,0
1160,3/17/2018 11:40,119,117,103,93,432,4,0
1161,3/17/2018 11:45,114,114,100,91,419,4,0
1162,3/17/2018 11:50,117,115,100,91,423,4,0
1163,3/17/2018 11:55,105,106,93,84,388,4,0
1164,3/17/2018 12:00,101,102,90,81,374,4,0
1165,3/17/2018 12:05,108,107,94,85,394,4,0
1166,3/17/2018 12:10,101,102,90,81,374,4,0
1167,3/17/2018 12:15,113,112,98,89,412,4,0
1168,3/17/2018 12:20,114,113,99,90,416,4,0
1169,3/17/2018 12:25,111,111,97,88,407,4,0
1170,3/17/2018 12:30,111,111,97,88,407,4,0
1171,3/17/2018 12:35,119,118,103,94,434,4,0
1172,3/17/2018 12:40,118,117,103,93,431,4,0
1173,3/17/2018 12:45,126,124,109,99,458,4,0
1174,3/17/2018 12:50,120,118,103,94,435,4,0
1175,3/17/2018 12:55,117,115,101,92,425,4,0
1176,3/17/2018 13:00,111,111,97,88,407,4,0
1177,3/17/2018 13:05,119,118,103,94,434,4,0
1178,3/17/2018 13:10,106,106,93,85,390,4,0
1179,3/17/2018 13:15,123,121,105,96,445,4,0
1180,3/17/2018 13:20,124,122,107,97,450,4,0
1181,3/17/2018 13:25,114,113,100,90,417,4,0
1182,3/17/2018 13:30,122,121,106,96,445,4,0
1183,3/17/2018 13:35,132,128,111,101,472,4,0
1184,3/17/2018 13:40,127,125,109,99,460,4,0
1185,3/17/2018 13:45,119,118,104,94,435,4,0
1186,3/17/2018 13:50,120,118,104,94,436,4,0
1187,3/17/2018 13:55,111,111,97,88,407,4,0
1188,3/17/2018 14:00,116,115,101,92,424,4,0
1189,3/17/2018 14:05,119,118,104,94,435,4,0
1190,3/17/2018 14:10,106,106,93,84,389,4,0
1191,3/17/2018 14:15,110,109,96,87,402,4,0
1192,3/17/2018 14:20,111,111,98,88,408,4,0
1193,3/17/2018 14:25,106,106,93,84,389,4,0
1194,3/17/2018 14:30,109,108,94,86,397,4,0
1195,3/17/2018 14:35,119,118,103,93,433,4,0
1196,3/17/2018 14:40,119,117,103,93,432,4,0
1197,3/17/2018 14:45,120,118,104,94,436,4,0
1198,3/17/2018 14:50,119,118,103,94,434,4,0
1199,3/17/2018 14:55,121,120,106,96,443,4,0
1200,3/17/2018 15:00,123,122,108,98,451,4,0
1201,3/17/2018 15:05,133,130,114,104,481,4,0
1202,3/17/2018 15:10,133,130,114,103,480,4,0
1203,3/17/2018 15:15,126,124,108,98,456,4,0
1204,3/17/2018 15:20,124,122,106,96,448,4,0
1205,3/17/2018 15:25,113,112,99,90,414,4,0
1206,3/17/2018 15:30,108,108,95,86,397,4,0
1207,3/17/2018 15:35,110,110,97,88,405,4,0
1208,3/17/2018 15:40,115,114,100,91,420,4,0
1209,3/17/2018 15:45,135,131,113,103,482,4,0
1210,3/17/2018 15:50,114,113,99,90,416,4,0
1211,3/17/2018 15:55,106,106,93,85,390,4,0
1212,3/17/2018 16:00,113,112,98,89,412,4,0
1213,3/17/2018 16:05,114,113,99,90,416,4,0
1214,3/17/2018 16:10,120,118,104,94,436,4,0
1215,3/17/2018 16:15,112,112,99,89,412,4,0
1216,3/17/2018 16:20,107,107,94,85,393,4,0
1217,3/17/2018 16:25,124,121,106,96,447,4,0
1218,3/17/2018 16:30,103,104,91,82,380,4,0
1219,3/17/2018 16:35,122,120,104,95,441,4,0
1220,3/17/2018 16:40,123,121,105,96,445,4,0
1221,3/17/2018 16:45,119,117,102,93,431,4,0
1222,3/17/2018 16:50,138,134,116,106,494,4,0
1223,3/17/2018 16:55,119,118,103,94,434,4,0
1224,3/17/2018 17:00,117,116,101,92,426,4,0
1225,3/17/2018 17:05,124,122,107,98,451,4,0
1226,3/17/2018 17:10,122,120,105,96,443,4,0
1227,3/17/2018 17:15,118,117,103,93,431,4,0
1228,3/17/2018 17:20,123,121,107,97,448,4,0
1229,3/17/2018 17:25,114,113,99,90,416,4,0
1230,3/17/2018 17:30,112,112,98,89,411,4,0
1231,3/17/2018 17:35,108,107,94,85,394,4,0
1232,3/17/2018 17:40,106,106,93,84,389,4,0
1233,3/17/2018 17:45,109,109,96,87,401,4,0
1234,3/17/2018 17:50,106,106,93,84,389,4,0
1235,3/17/2018 17:55,112,112,98,89,411,4,0
1236,3/17/2018 18:00,116,115,101,92,424,4,0
1237,3/17/2018 18:05,99,100,88,79,366,4,0
1238,3/17/2018 18:10,118,117,102,93,430,4,0
1239,3/17/2018 18:15,112,111,98,89,410,4,0
1240,3/17/2018 18:20,109,109,96,87,401,4,0
1241,3/17/2018 18:25,104,105,92,83,384,4,0
1242,3/17/2018 18:30,102,103,90,81,376,4,0
1243,3/17/2018 18:35,116,115,101,92,424,4,0
1244,3/17/2018 18:40,111,110,96,87,404,4,0
1245,3/17/2018 18:45,104,104,92,83,383,4,0
1246,3/17/2018 18:50,100,101,89,80,370,4,0
1247,3/17/2018 18:55,105,106,93,84,388,4,0
1248,3/17/2018 19:00,90,92,81,73,336,4,0
1249,3/17/2018 19:05,93,95,83,75,346,4,0
1250,3/17/2018 19:10,101,101,89,81,372,4,0
1251,3/17/2018 19:15,87,90,79,71,327,4,0
1252,3/17/2018 19:20,91,93,82,74,340,4,0
1253,3/17/2018 19:25,88,91,80,72,331,4,0
1254,3/17/2018 19:30,102,103,90,82,377,4,0
1255,3/17/2018 19:35,87,90,79,71,327,4,0
1256,3/17/2018 19:40,83,86,76,68,313,4,0
1257,3/17/2018 19:45,89,92,80,73,334,4,0
1258,3/17/2018 19:50,84,87,77,69,317,4,0
1259,3/17/2018 19:55,84,87,76,69,316,4,0
1260,3/17/2018 20:00,83,86,76,68,313,4,0
1261,3/17/2018 20:05,87,90,79,71,327,4,0
1262,3/17/2018 20:10,75,79,69,62,285,4,0
1263,3/17/2018 20:15,81,84,74,66,305,4,0
1264,3/17/2018 20:20,85,88,77,70,320,4,0
1265,3/17/2018 20:25,81,84,74,67,306,4,0
1266,3/17/2018 20:30,89,91,80,73,333,4,0
1267,3/17/2018 20:35,90,92,81,73,336,4,0
1268,3/17/2018 20:40,88,91,80,73,332,4,0
1269,3/17/2018 20:45,85,88,78,70,321,4,0
1270,3/17/2018 20:50,85,88,77,70,320,4,0
1271,3/17/2018 20:55,81,84,74,67,306,4,0
1272,3/17/2018 21:00,79,82,73,66,300,4,0
1273,3/17/2018 21:05,86,89,78,71,324,4,0
1274,3/17/2018 21:10,84,87,77,68,316,4,0
1275,3/17/2018 21:15,79,83,72,65,299,4,0
1276,3/17/2018 21:20,78,82,72,65,297,4,0
1277,3/17/2018 21:25,86,88,77,70,321,4,0
1278,3/17/2018 21:30,88,91,80,72,331,4,0
1279,3/17/2018 21:35,82,85,75,68,310,4,0
1280,3/17/2018 21:40,84,87,76,69,316,4,0
1281,3/17/2018 21:45,81,85,74,67,307,4,0
1282,3/17/2018 21:50,82,85,75,68,310,4,0
1283,3/17/2018 21:55,71,76,67,60,274,4,0
1284,3/17/2018 22:00,76,80,70,64,290,4,0
1285,3/17/2018 22:05,71,76,66,60,273,4,0
1286,3/17/2018 22:10,84,87,77,70,318,4,0
1287,3/17/2018 22:15,84,86,76,69,315,4,0
1288,3/17/2018 22:20,74,78,69,62,283,4,0
1289,3/17/2018 22:25,81,84,74,67,306,4,0
1290,3/17/2018 22:30,74,78,69,62,283,4,0
1291,3/17/2018 22:35,82,86,75,68,311,4,0
1292,3/17/2018 22:40,72,76,67,60,275,4,0
1293,3/17/2018 22:45,81,84,74,67,306,4,0
1294,3/17/2018 22:50,71,76,66,60,273,4,0
1295,3/17/2018 22:55,61,67,59,53,240,4,0
1296,3/17/2018 23:00,75,79,70,63,287,4,0
1297,3/17/2018 23:05,66,71,62,55,254,4,0
1298,3/17/2018 23:10,66,71,63,56,256,4,0
1299,3/17/2018 23:15,67,73,64,57,261,4,0
1300,3/17/2018 23:20,62,68,60,54,244,4,0
1301,3/17/2018 23:25,59,65,58,52,234,4,0
1302,3/17/2018 23:30,53,60,54,48,215,4,0
1303,3/17/2018 23:35,59,65,57,51,232,4,0
1304,3/17/2018 23:40,59,65,58,52,234,4,0
1305,3/17/2018 23:45,63,69,60,54,246,4,0
1306,3/17/2018 23:50,61,67,59,53,240,4,0
1307,3/17/2018 23:55,52,59,52,47,210,4,0
1308,3/18/2018 0:00,51,57,51,46,205,4,0
1309,3/18/2018 0:05,47,55,49,44,195,4,0
1310,3/18/2018 0:10,47,53,47,42,189,4,0
1311,3/18/2018 0:15,48,55,49,42,194,4,0
1312,3/18/2018 0:20,45,53,48,43,189,4,0
1313,3/18/2018 0:25,47,54,47,41,189,4,0
1314,3/18/2018 0:30,47,55,48,43,193,4,0
1315,3/18/2018 0:35,53,60,53,48,214,4,0
1316,3/18/2018 0:40,57,63,56,51,227,4,0
1317,3/18/2018 0:45,48,55,48,43,194,4,0
1318,3/18/2018 0:50,38,46,41,36,161,4,0
1319,3/18/2018 0:55,39,47,41,36,163,4,0
1320,3/18/2018 1:00,40,48,42,37,167,4,0
1321,3/18/2018 1:05,38,47,41,35,161,4,0
1322,3/18/2018 1:10,37,45,40,35,157,4,0
1323,3/18/2018 1:15,44,52,46,39,181,4,0
1324,3/18/2018 1:20,33,42,36,32,143,4,0
1325,3/18/2018 1:25,39,48,43,38,168,4,0
1326,3/18/2018 1:30,39,47,41,36,163,4,0
1327,3/18/2018 1:35,36,45,40,36,157,4,0
1328,3/18/2018 1:40,40,48,42,38,168,4,0
1329,3/18/2018 1:45,35,44,38,34,151,4,0
1330,3/18/2018 1:50,34,42,37,33,146,4,0
1331,3/18/2018 1:55,32,40,35,31,138,4,0
1332,3/18/2018 2:00,41,49,42,35,167,4,0
1333,3/18/2018 2:05,35,45,39,34,153,4,0
1334,3/18/2018 2:10,34,44,39,34,151,4,0
1335,3/18/2018 2:15,34,44,39,35,152,4,0
1336,3/18/2018 2:20,46,53,46,40,185,4,0
1337,3/18/2018 2:25,30,40,35,31,136,4,0
1338,3/18/2018 2:30,37,45,40,34,156,4,0
1339,3/18/2018 2:35,33,42,38,33,146,4,0
1340,3/18/2018 2:40,32,42,38,34,146,4,0
1341,3/18/2018 2:45,26,35,31,26,118,4,0
1342,3/18/2018 2:50,33,42,36,30,141,4,0
1343,3/18/2018 2:55,27,37,32,28,124,4,0
1344,3/18/2018 3:00,31,40,34,30,135,4,0
1345,3/18/2018 3:05,34,44,38,32,148,4,0
1346,3/18/2018 3:10,33,42,37,33,145,4,0
1347,3/18/2018 3:15,33,43,38,34,148,4,0
1348,3/18/2018 3:20,27,38,33,29,127,4,0
1349,3/18/2018 3:25,24,33,29,24,110,4,0
1350,3/18/2018 3:30,23,34,32,27,116,4,0
1351,3/18/2018 3:35,24,33,29,24,110,4,0
1352,3/18/2018 3:40,27,36,33,29,125,4,0
1353,3/18/2018 3:45,27,37,33,27,124,4,0
1354,3/18/2018 3:50,29,37,33,29,128,4,0
1355,3/18/2018 3:55,26,37,34,28,125,4,0
1356,3/18/2018 4:00,26,36,30,24,116,4,0
1357,3/18/2018 4:05,19,30,27,22,98,4,0
1358,3/18/2018 4:10,22,32,28,25,107,4,0
1359,3/18/2018 4:15,23,34,28,23,108,4,0
1360,3/18/2018 4:20,24,34,31,27,116,4,0
1361,3/18/2018 4:25,23,34,30,26,113,4,0
1362,3/18/2018 4:30,24,34,30,24,112,4,0
1363,3/18/2018 4:35,27,36,31,26,120,4,0
1364,3/18/2018 4:40,30,39,34,29,132,4,0
1365,3/18/2018 4:45,34,44,38,32,148,4,0
1366,3/18/2018 4:50,34,44,38,32,148,4,0
1367,3/18/2018 4:55,24,35,31,25,115,4,0
1368,3/18/2018 5:00,28,37,33,29,127,4,0
1369,3/18/2018 5:05,31,40,35,31,137,4,0
1370,3/18/2018 5:10,32,42,37,30,141,4,0
1371,3/18/2018 5:15,36,44,38,32,150,4,0
1372,3/18/2018 5:20,29,37,33,29,128,4,0
1373,3/18/2018 5:25,34,43,38,34,149,4,0
1374,3/18/2018 5:30,40,48,42,36,166,4,0
1375,3/18/2018 5:35,38,46,41,36,161,4,0
1376,3/18/2018 5:40,39,48,43,38,168,4,0
1377,3/18/2018 5:45,38,45,40,35,158,4,0
1378,3/18/2018 5:50,35,45,40,36,156,4,0
1379,3/18/2018 5:55,37,45,40,35,157,4,0
1380,3/18/2018 6:00,32,40,36,31,139,4,0
1381,3/18/2018 6:05,34,42,37,32,145,4,0
1382,3/18/2018 6:10,27,37,32,26,122,4,0
1383,3/18/2018 6:15,31,40,35,30,136,4,0
1384,3/18/2018 6:20,37,45,39,35,156,4,0
1385,3/18/2018 6:25,41,50,44,38,173,4,0
1386,3/18/2018 6:30,37,46,42,37,162,4,0
1387,3/18/2018 6:35,39,47,41,36,163,4,0
1388,3/18/2018 6:40,52,59,52,47,210,4,0
1389,3/18/2018 6:45,44,53,46,40,183,4,0
1390,3/18/2018 6:50,40,48,41,35,164,4,0
1391,3/18/2018 6:55,41,49,42,37,169,4,0
1392,3/18/2018 7:00,45,52,46,41,184,4,0
1393,3/18/2018 7:05,34,43,37,33,147,4,0
1394,3/18/2018 7:10,36,44,39,34,153,4,0
1395,3/18/2018 7:15,40,49,42,36,167,4,0
1396,3/18/2018 7:20,41,48,43,37,169,4,0
1397,3/18/2018 7:25,45,53,47,42,187,4,0
1398,3/18/2018 7:30,40,49,43,37,169,4,0
1399,3/18/2018 7:35,47,54,48,43,192,4,0
1400,3/18/2018 7:40,50,57,51,45,203,4,0
1401,3/18/2018 7:45,49,57,50,44,200,4,0
1402,3/18/2018 7:50,53,60,54,48,215,4,0
1403,3/18/2018 7:55,61,66,58,51,236,4,0
1404,3/18/2018 8:00,46,53,46,39,184,4,0
1405,3/18/2018 8:05,49,57,51,45,202,4,0
1406,3/18/2018 8:10,57,63,55,48,223,4,0
1407,3/18/2018 8:15,50,56,50,44,200,4,0
1408,3/18/2018 8:20,55,62,55,49,221,4,0
1409,3/18/2018 8:25,56,62,54,48,220,4,0
1410,3/18/2018 8:30,58,64,56,50,228,4,0
1411,3/18/2018 8:35,70,75,66,60,271,4,0
1412,3/18/2018 8:40,66,71,63,57,257,4,0
1413,3/18/2018 8:45,71,76,67,61,275,4,0
1414,3/18/2018 8:50,66,70,62,55,253,4,0
1415,3/18/2018 8:55,63,69,61,55,248,4,0
1416,3/18/2018 9:00,59,65,58,52,234,4,0
1417,3/18/2018 9:05,61,67,59,53,240,4,0
1418,3/18/2018 9:10,67,73,64,58,262,4,0
1419,3/18/2018 9:15,56,62,55,49,222,4,0
1420,3/18/2018 9:20,77,81,71,63,292,4,0
1421,3/18/2018 9:25,77,81,71,65,294,4,0
1422,3/18/2018 9:30,71,76,67,60,274,4,0
1423,3/18/2018 9:35,76,80,71,64,291,4,0
1424,3/18/2018 9:40,78,82,72,65,297,4,0
1425,3/18/2018 9:45,78,81,72,65,296,4,0
1426,3/18/2018 9:50,88,91,80,72,331,4,0
1427,3/18/2018 9:55,82,85,75,67,309,4,0
1428,3/18/2018 10:00,75,79,70,63,287,4,0
1429,3/18/2018 10:05,80,84,74,67,305,4,0
1430,3/18/2018 10:10,74,79,69,63,285,4,0
1431,3/18/2018 10:15,78,82,72,65,297,4,0
1432,3/18/2018 10:20,92,94,83,75,344,4,0
1433,3/18/2018 10:25,89,91,80,73,333,4,0
1434,3/18/2018 10:30,94,95,84,76,349,4,0
1435,3/18/2018 10:35,91,94,82,74,341,4,0
1436,3/18/2018 10:40,84,87,77,69,317,4,0
1437,3/18/2018 10:45,88,90,79,72,329,4,0
1438,3/18/2018 10:50,103,104,91,83,381,4,0
1439,3/18/2018 10:55,89,92,80,73,334,4,0
1440,3/18/2018 11:00,108,108,94,86,396,4,0
1441,3/18/2018 11:05,83,86,76,68,313,4,0
1442,3/18/2018 11:10,96,97,85,77,355,4,0
1443,3/18/2018 11:15,97,98,86,78,359,4,0
1444,3/18/2018 11:20,86,89,78,70,323,4,0
1445,3/18/2018 11:25,81,85,74,67,307,4,0
1446,3/18/2018 11:30,94,96,84,76,350,4,0
1447,3/18/2018 11:35,92,94,83,75,344,4,0
1448,3/18/2018 11:40,89,91,80,72,332,4,0
1449,3/18/2018 11:45,102,103,90,81,376,4,0
1450,3/18/2018 11:50,93,95,83,76,347,4,0
1451,3/18/2018 11:55,101,102,89,81,373,4,0
1452,3/18/2018 12:00,99,100,88,80,367,4,0
1453,3/18/2018 12:05,103,103,90,82,378,4,0
1454,3/18/2018 12:10,102,103,90,82,377,4,0
1455,3/18/2018 12:15,102,103,90,82,377,4,0
1456,3/18/2018 12:20,108,108,94,86,396,4,0
1457,3/18/2018 12:25,101,102,89,81,373,4,0
1458,3/18/2018 12:30,103,104,91,82,380,4,0
1459,3/18/2018 12:35,99,100,88,80,367,4,0
1460,3/18/2018 12:40,108,109,95,87,399,4,0
1461,3/18/2018 12:45,107,107,94,85,393,4,0
1462,3/18/2018 12:50,100,101,88,80,369,4,0
1463,3/18/2018 12:55,124,122,107,97,450,4,0
1464,3/18/2018 13:00,103,104,91,83,381,4,0
1465,3/18/2018 13:05,108,108,94,86,396,4,0
1466,3/18/2018 13:10,106,106,93,85,390,4,0
1467,3/18/2018 13:15,113,112,99,90,414,4,0
1468,3/18/2018 13:20,106,107,93,85,391,4,0
1469,3/18/2018 13:25,110,110,96,87,403,4,0
1470,3/18/2018 13:30,122,120,104,95,441,4,0
1471,3/18/2018 13:35,113,112,98,89,412,4,0
1472,3/18/2018 13:40,103,104,92,83,382,4,0
1473,3/18/2018 13:45,104,105,92,84,385,4,0
1474,3/18/2018 13:50,103,104,91,82,380,4,0
1475,3/18/2018 13:55,100,101,88,80,369,4,0
1476,3/18/2018 14:00,108,108,95,86,397,4,0
1477,3/18/2018 14:05,104,104,92,83,383,4,0
1478,3/18/2018 14:10,125,122,107,98,452,4,0
1479,3/18/2018 14:15,114,113,99,90,416,4,0
1480,3/18/2018 14:20,86,89,78,71,324,4,0
1481,3/18/2018 14:25,109,109,95,86,399,4,0
1482,3/18/2018 14:30,103,103,91,82,379,4,0
1483,3/18/2018 14:35,124,121,105,96,446,4,0
1484,3/18/2018 14:40,127,124,108,98,457,4,0
1485,3/18/2018 14:45,118,117,102,93,430,4,0
1486,3/18/2018 14:50,107,108,96,86,397,4,0
1487,3/18/2018 14:55,107,107,94,85,393,4,0
1488,3/18/2018 15:00,109,109,96,87,401,4,0
1489,3/18/2018 15:05,116,115,101,91,423,4,0
1490,3/18/2018 15:10,107,107,94,85,393,4,0
1491,3/18/2018 15:15,106,106,92,84,388,4,0
1492,3/18/2018 15:20,120,118,103,94,435,4,0
1493,3/18/2018 15:25,118,116,101,92,427,4,0
1494,3/18/2018 15:30,110,110,96,87,403,4,0
1495,3/18/2018 15:35,99,100,88,80,367,4,0
1496,3/18/2018 15:40,104,105,92,84,385,4,0
1497,3/18/2018 15:45,102,103,91,82,378,4,0
1498,3/18/2018 15:50,101,102,90,81,374,4,0
1499,3/18/2018 15:55,116,115,101,91,423,4,0
1500,3/18/2018 16:00,106,106,93,85,390,4,0
1501,3/18/2018 16:05,106,106,93,85,390,4,0
1502,3/18/2018 16:10,109,109,96,87,401,4,0
1503,3/18/2018 16:15,118,117,101,92,428,4,0
1504,3/18/2018 16:20,110,110,96,88,404,4,0
1505,3/18/2018 16:25,100,101,89,80,370,4,0
1506,3/18/2018 16:30,104,105,92,83,384,4,0
1507,3/18/2018 16:35,102,102,90,81,375,4,0
1508,3/18/2018 16:40,107,107,94,85,393,4,0
1509,3/18/2018 16:45,104,104,91,83,382,4,0
1510,3/18/2018 16:50,98,99,87,79,363,4,0
1511,3/18/2018 16:55,107,107,94,85,393,4,0
1512,3/18/2018 17:00,101,102,89,81,373,4,0
1513,3/18/2018 17:05,94,96,84,76,350,4,0
1514,3/18/2018 17:10,104,104,91,83,382,4,0
1515,3/18/2018 17:15,109,108,95,86,398,4,0
1516,3/18/2018 17:20,104,104,91,83,382,4,0
1517,3/18/2018 17:25,98,99,86,79,362,4,0
1518,3/18/2018 17:30,85,88,78,70,321,4,0
1519,3/18/2018 17:35,107,107,94,85,393,4,0
1520,3/18/2018 17:40,93,95,83,75,346,4,0
1521,3/18/2018 17:45,86,89,78,71,324,4,0
1522,3/18/2018 17:50,92,94,83,74,343,4,0
1523,3/18/2018 17:55,98,99,86,79,362,4,0
1524,3/18/2018 18:00,84,88,77,69,318,4,0
1525,3/18/2018 18:05,90,92,81,73,336,4,0
1526,3/18/2018 18:10,91,93,82,74,340,4,0
1527,3/18/2018 18:15,94,96,84,76,350,4,0
1528,3/18/2018 18:20,84,87,76,69,316,4,0
1529,3/18/2018 18:25,82,85,75,68,310,4,0
1530,3/18/2018 18:30,89,92,81,73,335,4,0
1531,3/18/2018 18:35,89,92,81,73,335,4,0
1532,3/18/2018 18:40,80,83,73,66,302,4,0
1533,3/18/2018 18:45,87,90,79,71,327,4,0
1534,3/18/2018 18:50,83,86,76,69,314,4,0
1535,3/18/2018 18:55,84,87,76,69,316,4,0
1536,3/18/2018 19:00,77,81,71,65,294,4,0
1537,3/18/2018 19:05,81,84,74,67,306,4,0
1538,3/18/2018 19:10,89,91,80,72,332,4,0
1539,3/18/2018 19:15,93,95,84,76,348,4,0
1540,3/18/2018 19:20,78,82,72,65,297,4,0
1541,3/18/2018 19:25,87,90,79,71,327,4,0
1542,3/18/2018 19:30,82,85,75,68,310,4,0
1543,3/18/2018 19:35,73,78,69,61,281,4,0
1544,3/18/2018 19:40,88,90,79,72,329,4,0
1545,3/18/2018 19:45,79,83,73,66,301,4,0
1546,3/18/2018 19:50,83,85,75,67,310,4,0
1547,3/18/2018 19:55,78,81,72,64,295,4,0
1548,3/18/2018 20:00,93,95,84,76,348,4,0
1549,3/18/2018 20:05,79,83,73,66,301,4,0
1550,3/18/2018 20:10,80,84,74,66,304,4,0
1551,3/18/2018 20:15,95,97,85,76,353,4,0
1552,3/18/2018 20:20,89,92,80,73,334,4,0
1553,3/18/2018 20:25,74,78,69,62,283,4,0
1554,3/18/2018 20:30,87,89,78,71,325,4,0
1555,3/18/2018 20:35,77,81,72,65,295,4,0
1556,3/18/2018 20:40,79,83,73,66,301,4,0
1557,3/18/2018 20:45,79,83,73,66,301,4,0
1558,3/18/2018 20:50,80,83,73,66,302,4,0
1559,3/18/2018 20:55,84,87,77,69,317,4,0
1560,3/18/2018 21:00,84,87,77,69,317,4,0
1561,3/18/2018 21:05,67,73,64,57,261,4,0
1562,3/18/2018 21:10,68,73,64,58,263,4,0
1563,3/18/2018 21:15,77,81,71,64,293,4,0
1564,3/18/2018 21:20,66,71,63,56,256,4,0
1565,3/18/2018 21:25,77,81,71,64,293,4,0
1566,3/18/2018 21:30,73,77,68,61,279,4,0
1567,3/18/2018 21:35,68,73,65,58,264,4,0
1568,3/18/2018 21:40,66,71,62,55,254,4,0
1569,3/18/2018 21:45,72,77,68,61,278,4,0
1570,3/18/2018 21:50,74,79,69,63,285,4,0
1571,3/18/2018 21:55,62,67,59,53,241,4,0
1572,3/18/2018 22:00,52,58,51,46,207,4,0
1573,3/18/2018 22:05,62,68,60,54,244,4,0
1574,3/18/2018 22:10,69,73,65,58,265,4,0
1575,3/18/2018 22:15,55,62,55,49,221,4,0
1576,3/18/2018 22:20,65,70,61,54,250,4,0
1577,3/18/2018 22:25,60,66,58,52,236,4,0
1578,3/18/2018 22:30,58,64,57,52,231,4,0
1579,3/18/2018 22:35,52,59,53,47,211,4,0
1580,3/18/2018 22:40,61,66,59,52,238,4,0
1581,3/18/2018 22:45,48,56,49,44,197,4,0
1582,3/18/2018 22:50,46,53,46,40,185,4,0
1583,3/18/2018 22:55,48,55,48,43,194,4,0
1584,3/18/2018 23:00,49,56,50,45,200,4,0
1585,3/18/2018 23:05,40,48,42,37,167,4,0
1586,3/18/2018 23:10,39,48,42,38,167,4,0
1587,3/18/2018 23:15,46,53,46,41,186,4,0
1588,3/18/2018 23:20,37,46,40,35,158,4,0
1589,3/18/2018 23:25,41,49,43,36,169,4,0
1590,3/18/2018 23:30,46,54,49,44,193,4,0
1591,3/18/2018 23:35,42,49,43,38,172,4,0
1592,3/18/2018 23:40,38,46,39,35,158,4,0
1593,3/18/2018 23:45,43,51,46,40,180,4,0
1594,3/18/2018 23:50,35,43,38,32,148,4,0
1595,3/18/2018 23:55,35,44,39,35,153,4,0
1596,3/19/2018 0:00,34,42,37,31,144,4,0
1597,3/19/2018 0:05,34,43,38,33,148,4,0
1598,3/19/2018 0:10,32,42,36,30,140,4,0
1599,3/19/2018 0:15,32,41,36,31,140,4,0
1600,3/19/2018 0:20,29,40,34,29,132,4,0
1601,3/19/2018 0:25,29,38,34,27,128,4,0
1602,3/19/2018 0:30,32,42,37,31,142,4,0
1603,3/19/2018 0:35,33,42,37,31,143,4,0
1604,3/19/2018 0:40,28,38,33,28,127,4,0
1605,3/19/2018 0:45,31,40,34,30,135,4,0
1606,3/19/2018 0:50,32,40,34,30,136,4,0
1607,3/19/2018 0:55,27,35,32,27,121,4,0
1608,3/19/2018 1:00,27,36,32,28,123,4,0
1609,3/19/2018 1:05,24,33,28,24,109,4,0
1610,3/19/2018 1:10,26,36,32,27,121,4,0
1611,3/19/2018 1:15,25,34,29,24,112,4,0
1612,3/19/2018 1:20,26,36,32,27,121,4,0
1613,3/19/2018 1:25,21,33,30,24,108,4,0
1614,3/19/2018 1:30,27,38,33,27,125,4,0
1615,3/19/2018 1:35,22,32,27,22,103,4,0
1616,3/19/2018 1:40,22,32,27,23,104,4,0
1617,3/19/2018 1:45,21,33,29,23,106,4,0
1618,3/19/2018 1:50,22,32,29,24,107,4,0
1619,3/19/2018 1:55,25,36,32,26,119,4,0
1620,3/19/2018 2:00,20,31,27,22,100,4,0
1621,3/19/2018 2:05,22,33,28,22,105,4,0
1622,3/19/2018 2:10,24,33,28,22,107,4,0
1623,3/19/2018 2:15,23,34,30,25,112,4,0
1624,3/19/2018 2:20,24,35,30,25,114,4,0
1625,3/19/2018 2:25,20,31,28,23,102,4,0
1626,3/19/2018 2:30,19,29,24,19,91,4,0
1627,3/19/2018 2:35,22,32,28,24,106,4,0
1628,3/19/2018 2:40,17,29,25,21,92,4,0
1629,3/19/2018 2:45,25,34,30,25,114,4,0
1630,3/19/2018 2:50,25,36,32,26,119,4,0
1631,3/19/2018 2:55,27,37,32,26,122,4,0
1632,3/19/2018 3:00,24,35,31,25,115,4,0
1633,3/19/2018 3:05,22,33,28,23,106,4,0
1634,3/19/2018 3:10,22,31,26,22,101,4,0
1635,3/19/2018 3:15,30,40,35,29,134,4,0
1636,3/19/2018 3:20,22,33,29,24,108,4,0
1637,3/19/2018 3:25,31,40,34,29,134,4,0
1638,3/19/2018 3:30,28,38,32,26,124,4,0
1639,3/19/2018 3:35,26,36,32,26,120,4,0
1640,3/19/2018 3:40,32,41,36,32,141,4,0
1641,3/19/2018 3:45,39,47,41,36,163,4,0
1642,3/19/2018 3:50,35,43,38,33,149,4,0
1643,3/19/2018 3:55,33,41,36,32,142,4,0
1644,3/19/2018 4:00,31,40,35,31,137,4,0
1645,3/19/2018 4:05,30,39,34,30,133,4,0
1646,3/19/2018 4:10,33,43,37,33,146,4,0
1647,3/19/2018 4:15,42,51,45,40,178,4,0
1648,3/19/2018 4:20,44,51,45,40,180,4,0
1649,3/19/2018 4:25,55,62,54,49,220,4,0
1650,3/19/2018 4:30,60,66,58,52,236,4,0
1651,3/19/2018 4:35,61,67,60,54,242,4,0
1652,3/19/2018 4:40,73,77,68,61,279,4,0
1653,3/19/2018 4:45,80,84,74,67,305,4,0
1654,3/19/2018 4:50,84,87,76,69,316,4,0
1655,3/19/2018 4:55,80,84,74,67,305,4,0
1656,3/19/2018 5:00,82,85,74,67,308,4,0
1657,3/19/2018 5:05,75,79,70,62,286,4,0
1658,3/19/2018 5:10,81,85,74,67,307,4,0
1659,3/19/2018 5:15,101,102,89,80,372,4,0
1660,3/19/2018 5:20,110,110,96,87,403,4,0
1661,3/19/2018 5:25,103,104,91,82,380,4,0
1662,3/19/2018 5:30,122,121,106,96,445,4,0
1663,3/19/2018 5:35,126,124,109,99,458,4,0
1664,3/19/2018 5:40,134,132,116,105,487,4,0
1665,3/19/2018 5:45,125,123,108,98,454,4,0
1666,3/19/2018 5:50,119,118,105,95,437,4,0
1667,3/19/2018 5:55,79,83,73,65,300,4,0
1668,3/19/2018 6:00,114,114,100,90,418,4,0
1669,3/19/2018 6:05,112,112,97,89,410,4,0
1670,3/19/2018 6:10,136,134,117,106,493,4,0
1671,3/19/2018 6:15,131,129,113,102,475,4,0
1672,3/19/2018 6:20,137,134,117,106,494,4,0
1673,3/19/2018 6:25,133,130,115,104,482,4,0
1674,3/19/2018 6:30,127,125,111,101,464,4,0
1675,3/19/2018 6:35,142,138,120,109,509,4,0
1676,3/19/2018 6:40,135,130,113,103,481,4,0
1677,3/19/2018 6:45,131,129,113,102,475,4,0
1678,3/19/2018 6:50,141,137,119,109,506,4,0
1679,3/19/2018 6:55,117,117,103,94,431,4,0
1680,3/19/2018 7:00,120,120,106,97,443,4,0
1681,3/19/2018 7:05,129,127,111,102,469,4,0
1682,3/19/2018 7:10,115,115,101,92,423,4,0
1683,3/19/2018 7:15,127,126,112,102,467,4,0
1684,3/19/2018 7:20,123,122,108,98,451,4,0
1685,3/19/2018 7:25,135,131,115,106,487,4,0
1686,3/19/2018 7:30,131,128,113,102,474,4,0
1687,3/19/2018 7:35,133,129,112,102,476,4,0
1688,3/19/2018 7:40,121,119,105,96,441,4,0
1689,3/19/2018 7:45,114,114,100,90,418,4,0
1690,3/19/2018 7:50,126,124,109,101,460,4,0
1691,3/19/2018 7:55,110,110,97,87,404,4,0
1692,3/19/2018 8:00,115,114,99,90,418,4,0
1693,3/19/2018 8:05,116,116,102,93,427,4,0
1694,3/19/2018 8:10,121,120,106,96,443,4,0
1695,3/19/2018 8:15,133,130,115,105,483,4,0
1696,3/19/2018 8:20,124,122,107,97,450,4,0
1697,3/19/2018 8:25,127,124,108,99,458,4,0
1698,3/19/2018 8:30,130,126,111,102,469,4,0
1699,3/19/2018 8:35,130,127,110,100,467,4,0
1700,3/19/2018 8:40,124,121,105,96,446,4,0
1701,3/19/2018 8:45,124,121,105,96,446,4,0
1702,3/19/2018 8:50,131,129,113,102,475,4,0
1703,3/19/2018 8:55,128,127,112,103,470,4,0
1704,3/19/2018 9:00,128,126,110,100,464,4,0
1705,3/19/2018 9:05,116,115,101,91,423,4,0
1706,3/19/2018 9:10,114,114,100,91,419,4,0
1707,3/19/2018 9:15,113,112,97,89,411,4,0
1708,3/19/2018 9:20,109,108,95,86,398,4,0
1709,3/19/2018 9:25,115,114,99,90,418,4,0
1710,3/19/2018 9:30,119,118,103,93,433,4,0
1711,3/19/2018 9:35,107,107,93,85,392,4,0
1712,3/19/2018 9:40,106,106,93,84,389,4,0
1713,3/19/2018 9:45,107,107,94,85,393,4,0
1714,3/19/2018 9:50,116,115,100,91,422,4,0
1715,3/19/2018 9:55,100,101,89,80,370,4,0
1716,3/19/2018 10:00,107,107,93,85,392,4,0
1717,3/19/2018 10:05,102,103,91,82,378,4,0
1718,3/19/2018 10:10,90,92,81,74,337,4,0
1719,3/19/2018 10:15,100,101,88,80,369,4,0
1720,3/19/2018 10:20,102,103,90,82,377,4,0
1721,3/19/2018 10:25,103,103,90,82,378,4,0
1722,3/19/2018 10:30,102,103,90,82,377,4,0
1723,3/19/2018 10:35,99,100,88,79,366,4,0
1724,3/19/2018 10:40,97,98,86,78,359,4,0
1725,3/19/2018 10:45,97,98,87,78,360,4,0
1726,3/19/2018 10:50,100,101,89,81,371,4,0
1727,3/19/2018 10:55,109,108,94,86,397,4,0
1728,3/19/2018 11:00,94,96,84,76,350,4,0
1729,3/19/2018 11:05,118,117,102,93,430,4,0
1730,3/19/2018 11:10,114,113,99,90,416,4,0
1731,3/19/2018 11:15,107,107,93,85,392,4,0
1732,3/19/2018 11:20,106,106,93,84,389,4,0
1733,3/19/2018 11:25,111,111,98,88,408,4,0
1734,3/19/2018 11:30,114,114,100,90,418,4,0
1735,3/19/2018 11:35,104,105,92,83,384,4,0
1736,3/19/2018 11:40,108,109,95,86,398,4,0
1737,3/19/2018 11:45,111,111,97,88,407,4,0
1738,3/19/2018 11:50,103,103,91,82,379,4,0
1739,3/19/2018 11:55,101,102,90,81,374,4,0
0,3/19/2018 11:00,94,96,84,76,350,4,0
1,3/19/2018 11:05,118,117,102,93,430,4,0
2,3/19/2018 11:10,114,113,99,90,416,4,0
3,3/19/2018 11:15,107,107,93,85,392,4,0
4,3/19/2018 11:20,106,106,93,84,389,4,0
5,3/19/2018 11:25,111,111,98,88,408,4,0
6,3/19/2018 11:30,114,114,100,90,418,4,0
7,3/19/2018 11:35,104,105,92,83,384,4,0
8,3/19/2018 11:40,108,109,95,86,398,4,0
9,3/19/2018 11:45,111,111,97,88,407,4,0
10,3/19/2018 11:50,103,103,91,82,379,4,0
11,3/19/2018 11:55,101,102,90,81,374,4,0
12,3/19/2018 12:00,103,104,91,82,380,4,0
13,3/19/2018 12:05,103,103,90,82,378,4,0
14,3/19/2018 12:10,107,107,94,85,393,4,0
15,3/19/2018 12:15,108,107,94,85,394,4,0
16,3/19/2018 12:20,102,103,90,82,377,4,0
17,3/19/2018 12:25,104,104,92,83,383,4,0
18,3/19/2018 12:30,111,110,97,88,406,4,0
19,3/19/2018 12:35,100,101,88,80,369,4,0
20,3/19/2018 12:40,97,98,86,78,359,4,0
21,3/19/2018 12:45,110,109,95,87,401,4,0
22,3/19/2018 12:50,98,99,87,78,362,4,0
23,3/19/2018 12:55,103,104,90,82,379,4,0
24,3/19/2018 13:00,101,102,90,81,374,4,0
25,3/19/2018 13:05,120,117,102,93,432,4,0
26,3/19/2018 13:10,100,101,89,80,370,4,0
27,3/19/2018 13:15,102,103,90,82,377,4,0
28,3/19/2018 13:20,106,106,93,84,389,4,0
29,3/19/2018 13:25,115,115,101,91,422,4,0
30,3/19/2018 13:30,113,112,98,89,412,4,0
31,3/19/2018 13:35,122,121,105,96,444,4,0
32,3/19/2018 13:40,119,118,104,94,435,4,0
33,3/19/2018 13:45,116,115,101,92,424,4,0
34,3/19/2018 13:50,122,120,105,95,442,4,0
35,3/19/2018 13:55,126,124,108,98,456,4,0
36,3/19/2018 14:00,109,109,95,86,399,4,0
37,3/19/2018 14:05,118,116,102,93,429,4,0
38,3/19/2018 14:10,132,128,111,102,473,4,0
39,3/19/2018 14:15,111,111,98,88,408,4,0
40,3/19/2018 14:20,104,105,91,83,383,4,0
41,3/19/2018 14:25,120,118,104,94,436,4,0
42,3/19/2018 14:30,110,109,96,87,402,4,0
43,3/19/2018 14:35,119,118,102,93,432,4,0
44,3/19/2018 14:40,117,116,102,92,427,4,0
45,3/19/2018 14:45,108,108,95,87,398,4,0
46,3/19/2018 14:50,115,114,100,91,420,4,0
47,3/19/2018 14:55,101,102,90,81,374,4,0
48,3/19/2018 15:00,110,110,97,87,404,4,0
49,3/19/2018 15:05,115,114,101,92,422,4,0
50,3/19/2018 15:10,110,110,97,87,404,4,0
51,3/19/2018 15:15,116,115,101,91,423,4,0
52,3/19/2018 15:20,129,126,109,100,464,4,0
53,3/19/2018 15:25,120,118,103,94,435,4,0
54,3/19/2018 15:30,124,123,108,97,452,4,0
55,3/19/2018 15:35,114,113,99,90,416,4,0
56,3/19/2018 15:40,118,117,103,93,431,4,0
57,3/19/2018 15:45,121,118,103,94,436,4,0
58,3/19/2018 15:50,107,107,94,85,393,4,0
59,3/19/2018 15:55,127,124,109,99,459,4,0
60,3/19/2018 16:00,112,112,98,89,411,4,0
61,3/19/2018 16:05,127,125,110,99,461,4,0
62,3/19/2018 16:10,116,116,102,92,426,4,0
63,3/19/2018 16:15,119,118,102,93,432,4,0
64,3/19/2018 16:20,129,127,111,101,468,4,0
65,3/19/2018 16:25,111,111,97,88,407,4,0
66,3/19/2018 16:30,127,125,109,99,460,4,0
67,3/19/2018 16:35,122,120,105,96,443,4,0
68,3/19/2018 16:40,121,120,105,95,441,4,0
69,3/19/2018 16:45,124,123,108,97,452,4,0
70,3/19/2018 16:50,127,124,108,99,458,4,0
71,3/19/2018 16:55,106,106,93,84,389,4,0
72,3/19/2018 17:00,118,117,103,93,431,4,0
73,3/19/2018 17:05,121,120,105,95,441,4,0
74,3/19/2018 17:10,129,128,112,101,470,4,0
75,3/19/2018 17:15,125,123,108,98,454,4,0
76,3/19/2018 17:20,138,134,117,107,496,4,0
77,3/19/2018 17:25,126,123,107,98,454,4,0
78,3/19/2018 17:30,122,121,106,96,445,4,0
79,3/19/2018 17:35,117,117,102,93,429,4,0
80,3/19/2018 17:40,120,119,104,94,437,4,0
81,3/19/2018 17:45,120,119,105,94,438,4,0
82,3/19/2018 17:50,124,122,108,97,451,4,0
83,3/19/2018 17:55,112,112,98,89,411,4,0
84,3/19/2018 18:00,117,116,101,92,426,4,0
85,3/19/2018 18:05,108,107,94,85,394,4,0
86,3/19/2018 18:10,119,117,102,93,431,4,0
87,3/19/2018 18:15,116,115,100,91,422,4,0
88,3/19/2018 18:20,116,115,101,91,423,4,0
89,3/19/2018 18:25,115,114,99,90,418,4,0
90,3/19/2018 18:30,119,118,103,94,434,4,0
91,3/19/2018 18:35,114,113,98,90,415,4,0
92,3/19/2018 18:40,114,113,98,89,414,4,0
93,3/19/2018 18:45,105,105,92,83,385,4,0
94,3/19/2018 18:50,107,108,95,85,395,4,0
95,3/19/2018 18:55,100,101,88,80,369,4,0
96,3/19/2018 19:00,86,89,78,70,323,4,0
97,3/19/2018 19:05,89,92,80,73,334,4,0
98,3/19/2018 19:10,103,103,90,82,378,4,0
99,3/19/2018 19:15,90,92,81,73,336,4,0
100,3/19/2018 19:20,101,102,89,81,373,4,0
101,3/19/2018 19:25,89,91,80,73,333,4,0
102,3/19/2018 19:30,89,92,81,73,335,4,0
103,3/19/2018 19:35,88,91,80,72,331,4,0
104,3/19/2018 19:40,75,79,70,63,287,4,0
105,3/19/2018 19:45,85,88,77,69,319,4,0
106,3/19/2018 19:50,81,85,74,67,307,4,0
107,3/19/2018 19:55,71,76,67,61,275,4,0
108,3/19/2018 20:00,83,86,76,68,313,4,0
109,3/19/2018 20:05,80,84,74,66,304,4,0
110,3/19/2018 20:10,80,84,74,66,304,4,0
111,3/19/2018 20:15,81,85,75,67,308,4,0
112,3/19/2018 20:20,73,78,68,62,281,4,0
113,3/19/2018 20:25,76,80,71,63,290,4,0
114,3/19/2018 20:30,77,81,71,64,293,4,0
115,3/19/2018 20:35,78,81,72,64,295,4,0
116,3/19/2018 20:40,74,78,68,61,281,4,0
117,3/19/2018 20:45,82,85,74,67,308,4,0
118,3/19/2018 20:50,85,88,77,69,319,4,0
119,3/19/2018 20:55,70,74,65,58,267,4,0
120,3/19/2018 21:00,63,68,60,54,245,4,0
121,3/19/2018 21:05,70,74,66,60,270,4,0
122,3/19/2018 21:10,61,67,59,53,240,4,0
123,3/19/2018 21:15,73,77,68,62,280,4,0
124,3/19/2018 21:20,77,81,72,65,295,4,0
125,3/19/2018 21:25,69,74,65,59,267,4,0
126,3/19/2018 21:30,81,84,74,67,306,4,0
127,3/19/2018 21:35,69,74,65,59,267,4,0
128,3/19/2018 21:40,76,80,71,64,291,4,0
129,3/19/2018 21:45,61,66,58,52,237,4,0
130,3/19/2018 21:50,71,76,67,59,273,4,0
131,3/19/2018 21:55,66,71,63,56,256,4,0
132,3/19/2018 22:00,65,70,62,55,252,4,0
133,3/19/2018 22:05,65,70,62,56,253,4,0
134,3/19/2018 22:10,63,68,60,53,244,4,0
135,3/19/2018 22:15,71,76,66,60,273,4,0
136,3/19/2018 22:20,57,64,56,50,227,4,0
137,3/19/2018 22:25,62,68,60,54,244,4,0
138,3/19/2018 22:30,55,62,54,49,220,4,0
139,3/19/2018 22:35,59,65,57,51,232,4,0
140,3/19/2018 22:40,55,62,55,48,220,4,0
141,3/19/2018 22:45,59,65,57,50,231,4,0
142,3/19/2018 22:50,48,56,49,44,197,4,0
143,3/19/2018 22:55,41,49,43,39,172,4,0
144,3/19/2018 23:00,43,50,44,39,176,4,0
145,3/19/2018 23:05,53,59,52,46,210,4,0
146,3/19/2018 23:10,47,55,48,43,193,4,0
147,3/19/2018 23:15,43,51,45,40,179,4,0
148,3/19/2018 23:20,42,51,45,40,178,4,0
149,3/19/2018 23:25,48,56,50,44,198,4,0
150,3/19/2018 23:30,39,47,40,34,160,4,0
151,3/19/2018 23:35,40,49,43,37,169,4,0
152,3/19/2018 23:40,41,50,44,38,173,4,0
153,3/19/2018 23:45,47,55,48,42,192,4,0
154,3/19/2018 23:50,38,47,42,37,164,4,0
155,3/19/2018 23:55,38,47,41,37,163,4,0
156,3/20/2018 0:00,36,45,40,35,156,4,0
157,3/20/2018 0:05,32,41,36,32,141,4,0
158,3/20/2018 0:10,33,43,38,33,147,4,0
159,3/20/2018 0:15,38,46,41,36,161,4,0
160,3/20/2018 0:20,33,42,37,33,145,4,0
161,3/20/2018 0:25,32,42,37,31,142,4,0
162,3/20/2018 0:30,34,42,37,32,145,4,0
163,3/20/2018 0:35,34,43,37,33,147,4,0
164,3/20/2018 0:40,32,42,37,33,144,4,0
165,3/20/2018 0:45,33,42,37,33,145,4,0
166,3/20/2018 0:50,31,41,37,32,141,4,0
167,3/20/2018 0:55,29,39,35,29,132,4,0
168,3/20/2018 1:00,24,35,31,28,118,4,0
169,3/20/2018 1:05,25,36,32,28,121,4,0
170,3/20/2018 1:10,27,36,32,26,121,4,0
171,3/20/2018 1:15,25,36,32,27,120,4,0
172,3/20/2018 1:20,26,37,32,28,123,4,0
173,3/20/2018 1:25,25,35,31,26,117,4,0
174,3/20/2018 1:30,30,38,34,30,132,4,0
175,3/20/2018 1:35,19,30,27,22,98,4,0
176,3/20/2018 1:40,25,36,32,29,122,4,0
177,3/20/2018 1:45,26,36,31,27,120,4,0
178,3/20/2018 1:50,23,34,30,25,112,4,0
179,3/20/2018 1:55,26,36,32,27,121,4,0
180,3/20/2018 2:00,24,35,31,27,117,4,0
181,3/20/2018 2:05,22,32,28,22,104,4,0
182,3/20/2018 2:10,23,33,29,23,108,4,0
183,3/20/2018 2:15,24,35,30,24,113,4,0
184,3/20/2018 2:20,22,32,29,24,107,4,0
185,3/20/2018 2:25,22,33,29,24,108,4,0
186,3/20/2018 2:30,22,33,29,24,108,4,0
187,3/20/2018 2:35,23,33,30,25,111,4,0
188,3/20/2018 2:40,23,34,30,25,112,4,0
189,3/20/2018 2:45,24,35,31,26,116,4,0
190,3/20/2018 2:50,26,35,31,27,119,4,0
191,3/20/2018 2:55,26,37,32,27,122,4,0
192,3/20/2018 3:00,26,36,31,26,119,4,0
193,3/20/2018 3:05,23,32,28,24,107,4,0
194,3/20/2018 3:10,23,32,27,23,105,4,0
195,3/20/2018 3:15,28,38,33,27,126,4,0
196,3/20/2018 3:20,28,38,34,30,130,4,0
197,3/20/2018 3:25,23,34,30,24,111,4,0
198,3/20/2018 3:30,26,37,33,27,123,4,0
199,3/20/2018 3:35,34,43,38,34,149,4,0
200,3/20/2018 3:40,31,40,35,31,137,4,0
201,3/20/2018 3:45,35,43,37,33,148,4,0
202,3/20/2018 3:50,35,44,39,34,152,4,0
203,3/20/2018 3:55,30,40,35,31,136,4,0
204,3/20/2018 4:00,30,40,35,29,134,4,0
205,3/20/2018 4:05,41,49,43,38,171,4,0
206,3/20/2018 4:10,30,41,35,31,137,4,0
207,3/20/2018 4:15,40,48,43,38,169,4,0
208,3/20/2018 4:20,43,51,45,40,179,4,0
209,3/20/2018 4:25,53,59,52,46,210,4,0
210,3/20/2018 4:30,55,62,55,49,221,4,0
211,3/20/2018 4:35,66,71,62,56,255,4,0
212,3/20/2018 4:40,79,82,72,65,298,4,0
213,3/20/2018 4:45,80,84,74,66,304,4,0
214,3/20/2018 4:50,81,84,74,66,305,4,0
215,3/20/2018 4:55,83,86,76,68,313,4,0
216,3/20/2018 5:00,77,80,71,64,292,4,0
217,3/20/2018 5:05,81,84,74,66,305,4,0
218,3/20/2018 5:10,90,92,81,73,336,4,0
219,3/20/2018 5:15,106,106,93,84,389,4,0
220,3/20/2018 5:20,103,104,91,82,380,4,0
221,3/20/2018 5:25,112,111,97,88,408,4,0
222,3/20/2018 5:30,112,112,98,89,411,4,0
223,3/20/2018 5:35,126,125,109,99,459,4,0
224,3/20/2018 5:40,134,130,113,103,480,4,0
225,3/20/2018 5:45,139,136,119,108,502,4,0
226,3/20/2018 5:50,136,133,117,106,492,4,0
227,3/20/2018 5:55,108,108,95,86,397,4,0
228,3/20/2018 6:00,115,115,101,92,423,4,0
229,3/20/2018 6:05,112,112,99,90,413,4,0
230,3/20/2018 6:10,132,129,114,103,478,4,0
231,3/20/2018 6:15,133,131,115,104,483,4,0
232,3/20/2018 6:20,142,139,122,110,513,4,0
233,3/20/2018 6:25,128,126,111,100,465,4,0
234,3/20/2018 6:30,148,142,123,113,526,4,0
235,3/20/2018 6:35,146,142,123,112,523,4,0
236,3/20/2018 6:40,128,126,111,101,466,4,0
237,3/20/2018 6:45,138,134,118,107,497,4,0
238,3/20/2018 6:50,132,130,116,106,484,4,0
239,3/20/2018 6:55,136,134,119,109,498,4,0
240,3/20/2018 7:00,146,142,125,113,526,4,0
241,3/20/2018 7:05,121,120,106,96,443,4,0
242,3/20/2018 7:10,131,129,113,102,475,4,0
243,3/20/2018 7:15,123,121,106,96,446,4,0
244,3/20/2018 7:20,145,140,123,112,520,4,0
245,3/20/2018 7:25,123,122,107,97,449,4,0
246,3/20/2018 7:30,136,134,119,109,498,4,0
247,3/20/2018 7:35,142,139,120,110,511,4,0
248,3/20/2018 7:40,131,129,115,105,480,4,0
249,3/20/2018 7:45,134,131,116,106,487,4,0
250,3/20/2018 7:50,144,140,122,111,517,4,0
251,3/20/2018 7:55,138,135,119,107,499,4,0
252,3/20/2018 8:00,135,132,116,107,490,4,0
253,3/20/2018 8:05,129,127,112,103,471,4,0
254,3/20/2018 8:10,127,126,112,102,467,4,0
255,3/20/2018 8:15,142,137,121,111,511,4,0
256,3/20/2018 8:20,125,123,107,98,453,4,0
257,3/20/2018 8:25,110,110,97,87,404,4,0
258,3/20/2018 8:30,111,111,98,89,409,4,0
259,3/20/2018 8:35,125,123,107,97,452,4,0
260,3/20/2018 8:40,133,130,114,104,481,4,0
261,3/20/2018 8:45,139,134,117,108,498,4,0
262,3/20/2018 8:50,126,123,107,98,454,4,0
263,3/20/2018 8:55,124,121,106,97,448,4,0
264,3/20/2018 9:00,112,112,100,90,414,4,0
265,3/20/2018 9:05,108,108,95,86,397,4,0
266,3/20/2018 9:10,115,114,100,91,420,4,0
267,3/20/2018 9:15,125,122,106,97,450,4,0
268,3/20/2018 9:20,117,116,102,93,428,4,0
269,3/20/2018 9:25,114,114,99,90,417,4,0
270,3/20/2018 9:30,116,114,100,91,421,4,0
271,3/20/2018 9:35,111,110,97,88,406,4,0
272,3/20/2018 9:40,111,110,96,87,404,4,0
273,3/20/2018 9:45,114,114,100,91,419,4,0
274,3/20/2018 9:50,114,113,100,91,418,4,0
275,3/20/2018 9:55,106,106,94,84,390,4,0
276,3/20/2018 10:00,106,106,92,84,388,4,0
277,3/20/2018 10:05,105,105,92,83,385,4,0
278,3/20/2018 10:10,111,110,96,87,404,4,0
279,3/20/2018 10:15,115,114,99,90,418,4,0
280,3/20/2018 10:20,114,113,99,90,416,4,0
281,3/20/2018 10:25,105,105,92,84,386,4,0
282,3/20/2018 10:30,110,109,95,87,401,4,0
283,3/20/2018 10:35,109,109,96,87,401,4,0
284,3/20/2018 10:40,116,114,100,91,421,4,0
285,3/20/2018 10:45,96,97,85,77,355,4,0
286,3/20/2018 10:50,107,107,93,85,392,4,0
287,3/20/2018 10:55,113,113,99,90,415,4,0
288,3/20/2018 11:00,93,95,84,75,347,4,0
289,3/20/2018 11:05,104,104,91,83,382,4,0
290,3/20/2018 11:10,94,95,83,76,348,4,0
291,3/20/2018 11:15,98,99,87,79,363,4,0
292,3/20/2018 11:20,111,110,96,87,404,4,0
293,3/20/2018 11:25,106,106,93,84,389,4,0
294,3/20/2018 11:30,109,109,96,87,401,4,0
295,3/20/2018 11:35,109,109,97,88,403,4,0
296,3/20/2018 11:40,119,119,104,95,437,4,0
297,3/20/2018 11:45,106,107,94,85,392,4,0
298,3/20/2018 11:50,111,111,97,88,407,4,0
299,3/20/2018 11:55,106,107,94,84,391,4,0
300,3/20/2018 12:00,104,104,91,83,382,4,0
301,3/20/2018 12:05,101,102,90,81,374,4,0
302,3/20/2018 12:10,98,99,86,78,361,4,0
303,3/20/2018 12:15,106,106,93,84,389,4,0
304,3/20/2018 12:20,103,104,91,82,380,4,0
305,3/20/2018 12:25,113,112,98,89,412,4,0
306,3/20/2018 12:30,106,106,93,84,389,4,0
307,3/20/2018 12:35,126,123,107,97,453,4,0
308,3/20/2018 12:40,114,113,99,90,416,4,0
309,3/20/2018 12:45,111,111,98,88,408,4,0
310,3/20/2018 12:50,109,108,95,86,398,4,0
311,3/20/2018 12:55,101,102,89,81,373,4,0
312,3/20/2018 13:00,101,102,89,81,373,4,0
313,3/20/2018 13:05,111,110,97,88,406,4,0
314,3/20/2018 13:10,107,107,93,85,392,4,0
315,3/20/2018 13:15,113,113,99,90,415,4,0
316,3/20/2018 13:20,105,105,92,84,386,4,0
317,3/20/2018 13:25,114,113,99,90,416,4,0
318,3/20/2018 13:30,116,115,102,93,426,4,0
319,3/20/2018 13:35,116,115,102,93,426,4,0
320,3/20/2018 13:40,96,98,86,78,358,4,0
321,3/20/2018 13:45,108,108,95,86,397,4,0
322,3/20/2018 13:50,108,107,94,85,394,4,0
323,3/20/2018 13:55,109,108,94,86,397,4,0
324,3/20/2018 14:00,98,99,87,79,363,4,0
325,3/20/2018 14:05,109,109,95,87,400,4,0
326,3/20/2018 14:10,112,111,97,88,408,4,0
327,3/20/2018 14:15,108,108,95,86,397,4,0
328,3/20/2018 14:20,99,100,88,79,366,4,0
329,3/20/2018 14:25,111,111,97,88,407,4,0
330,3/20/2018 14:30,116,115,101,91,423,4,0
331,3/20/2018 14:35,111,110,96,87,404,4,0
332,3/20/2018 14:40,121,120,105,96,442,4,0
333,3/20/2018 14:45,115,114,99,90,418,4,0
334,3/20/2018 14:50,112,112,98,89,411,4,0
335,3/20/2018 14:55,131,129,114,103,477,4,0
336,3/20/2018 15:00,109,109,96,86,400,4,0
337,3/20/2018 15:05,117,115,101,92,425,4,0
338,3/20/2018 15:10,128,125,109,99,461,4,0
339,3/20/2018 15:15,106,107,95,86,394,4,0
340,3/20/2018 15:20,118,117,103,93,431,4,0
341,3/20/2018 15:25,114,113,100,90,417,4,0
342,3/20/2018 15:30,124,123,107,97,451,4,0
343,3/20/2018 15:35,120,118,104,94,436,4,0
344,3/20/2018 15:40,126,125,109,99,459,4,0
345,3/20/2018 15:45,125,124,109,98,456,4,0
346,3/20/2018 15:50,128,125,108,99,460,4,0
347,3/20/2018 15:55,126,125,110,101,462,4,0
348,3/20/2018 16:00,124,123,107,97,451,4,0
349,3/20/2018 16:05,110,110,97,87,404,4,0
350,3/20/2018 16:10,114,114,100,90,418,4,0
351,3/20/2018 16:15,120,119,105,95,439,4,0
352,3/20/2018 16:20,118,117,103,93,431,4,0
353,3/20/2018 16:25,126,124,108,98,456,4,0
354,3/20/2018 16:30,115,114,100,91,420,4,0
355,3/20/2018 16:35,132,130,114,103,479,4,0
356,3/20/2018 16:40,130,127,112,102,471,4,0
357,3/20/2018 16:45,126,124,109,99,458,4,0
358,3/20/2018 16:50,129,127,111,101,468,4,0
359,3/20/2018 16:55,110,109,95,86,400,4,0
360,3/20/2018 17:00,115,114,100,91,420,4,0
361,3/20/2018 17:05,120,119,104,94,437,4,0
362,3/20/2018 17:10,118,117,103,93,431,4,0
363,3/20/2018 17:15,120,119,105,96,440,4,0
364,3/20/2018 17:20,130,127,110,100,467,4,0
365,3/20/2018 17:25,133,130,114,104,481,4,0
366,3/20/2018 17:30,126,123,108,98,455,4,0
367,3/20/2018 17:35,107,107,94,85,393,4,0
368,3/20/2018 17:40,123,122,107,96,448,4,0
369,3/20/2018 17:45,111,111,98,88,408,4,0
370,3/20/2018 17:50,108,108,95,86,397,4,0
371,3/20/2018 17:55,105,106,93,84,388,4,0
372,3/20/2018 18:00,100,101,89,80,370,4,0
373,3/20/2018 18:05,109,110,98,88,405,4,0
374,3/20/2018 18:10,111,111,97,88,407,4,0
375,3/20/2018 18:15,113,113,99,90,415,4,0
376,3/20/2018 18:20,116,116,102,92,426,4,0
377,3/20/2018 18:25,102,103,90,81,376,4,0
378,3/20/2018 18:30,111,111,97,88,407,4,0
379,3/20/2018 18:35,97,98,87,78,360,4,0
380,3/20/2018 18:40,117,116,102,92,427,4,0
381,3/20/2018 18:45,104,104,91,82,381,4,0
382,3/20/2018 18:50,104,104,92,83,383,4,0
383,3/20/2018 18:55,99,100,88,79,366,4,0
384,3/20/2018 19:00,107,107,93,85,392,4,0
385,3/20/2018 19:05,90,92,81,73,336,4,0
386,3/20/2018 19:10,89,91,80,72,332,4,0
387,3/20/2018 19:15,101,102,89,80,372,4,0
388,3/20/2018 19:20,112,112,98,89,411,4,0
389,3/20/2018 19:25,43,62,55,45,205,4,0
390,3/20/2018 19:30,41,59,53,43,196,4,0
391,3/20/2018 19:35,94,96,84,76,350,4,0
392,3/20/2018 19:40,91,93,82,74,340,4,0
393,3/20/2018 19:45,98,99,87,79,363,4,0
394,3/20/2018 19:50,91,93,82,74,340,4,0
395,3/20/2018 19:55,86,88,78,70,322,4,0
396,3/20/2018 20:00,90,93,81,73,337,4,0
397,3/20/2018 20:05,86,89,78,71,324,4,0
398,3/20/2018 20:10,83,86,76,69,314,4,0
399,3/20/2018 20:15,94,96,84,76,350,4,0
400,3/20/2018 20:20,89,91,80,72,332,4,0
401,3/20/2018 20:25,81,84,73,66,304,4,0
402,3/20/2018 20:30,80,83,73,66,302,4,0
403,3/20/2018 20:35,78,82,72,65,297,4,0
404,3/20/2018 20:40,80,83,73,65,301,4,0
405,3/20/2018 20:45,82,85,75,67,309,4,0
406,3/20/2018 20:50,78,82,72,65,297,4,0
407,3/20/2018 20:55,82,85,75,67,309,4,0
408,3/20/2018 21:00,75,79,69,63,286,4,0
409,3/20/2018 21:05,76,80,70,63,289,4,0
410,3/20/2018 21:10,87,90,79,71,327,4,0
411,3/20/2018 21:15,74,78,69,62,283,4,0
412,3/20/2018 21:20,77,81,72,65,295,4,0
413,3/20/2018 21:25,74,78,69,61,282,4,0
414,3/20/2018 21:30,77,81,71,64,293,4,0
415,3/20/2018 21:35,66,71,63,56,256,4,0
416,3/20/2018 21:40,75,79,69,62,285,4,0
417,3/20/2018 21:45,67,72,63,56,258,4,0
418,3/20/2018 21:50,68,73,64,58,263,4,0
419,3/20/2018 21:55,72,77,67,61,277,4,0
420,3/20/2018 22:00,66,70,62,55,253,4,0
421,3/20/2018 22:05,62,68,60,54,244,4,0
422,3/20/2018 22:10,62,68,60,54,244,4,0
423,3/20/2018 22:15,73,77,68,61,279,4,0
424,3/20/2018 22:20,57,64,56,50,227,4,0
425,3/20/2018 22:25,57,64,57,51,229,4,0
426,3/20/2018 22:30,62,68,59,52,241,4,0
427,3/20/2018 22:35,55,62,54,47,218,4,0
428,3/20/2018 22:40,60,66,58,52,236,4,0
429,3/20/2018 22:45,56,62,54,48,220,4,0
430,3/20/2018 22:50,63,69,61,55,248,4,0
431,3/20/2018 22:55,47,55,49,43,194,4,0
432,3/20/2018 23:00,51,58,51,46,206,4,0
433,3/20/2018 23:05,53,59,52,46,210,4,0
434,3/20/2018 23:10,50,57,49,44,200,4,0
435,3/20/2018 23:15,42,49,44,39,174,4,0
436,3/20/2018 23:20,47,54,48,43,192,4,0
437,3/20/2018 23:25,46,54,48,43,191,4,0
438,3/20/2018 23:30,40,49,44,39,172,4,0
439,3/20/2018 23:35,41,50,45,40,176,4,0
440,3/20/2018 23:40,39,47,42,37,165,4,0
441,3/20/2018 23:45,44,51,45,40,180,4,0
442,3/20/2018 23:50,46,54,48,43,191,4,0
443,3/20/2018 23:55,35,44,39,35,153,4,0
444,3/21/2018 0:00,43,51,45,40,179,4,0
445,3/21/2018 0:05,37,46,42,38,163,4,0
446,3/21/2018 0:10,33,42,37,33,145,4,0
447,3/21/2018 0:15,36,44,39,34,153,4,0
448,3/21/2018 0:20,35,45,39,35,154,4,0
449,3/21/2018 0:25,29,39,33,28,129,4,0
450,3/21/2018 0:30,37,46,40,33,156,4,0
451,3/21/2018 0:35,36,45,40,35,156,4,0
452,3/21/2018 0:40,28,38,35,31,132,4,0
453,3/21/2018 0:45,29,40,36,32,137,4,0
454,3/21/2018 0:50,34,42,37,33,146,4,0
455,3/21/2018 0:55,27,38,34,28,127,4,0
456,3/21/2018 1:00,24,35,31,25,115,4,0
457,3/21/2018 1:05,29,39,35,31,134,4,0
458,3/21/2018 1:10,25,36,31,27,119,4,0
459,3/21/2018 1:15,27,37,33,28,125,4,0
460,3/21/2018 1:20,32,41,37,31,141,4,0
461,3/21/2018 1:25,31,40,35,29,135,4,0
462,3/21/2018 1:30,26,35,31,28,120,4,0
463,3/21/2018 1:35,24,34,30,26,114,4,0
464,3/21/2018 1:40,29,38,34,28,129,4,0
465,3/21/2018 1:45,23,33,29,24,109,4,0
466,3/21/2018 1:50,23,34,30,24,111,4,0
467,3/21/2018 1:55,27,37,33,28,125,4,0
468,3/21/2018 2:00,23,33,28,23,107,4,0
469,3/21/2018 2:05,26,35,30,25,116,4,0
470,3/21/2018 2:10,19,30,28,22,99,4,0
471,3/21/2018 2:15,22,34,30,26,112,4,0
472,3/21/2018 2:20,25,36,31,25,117,4,0
473,3/21/2018 2:25,26,36,32,27,121,4,0
474,3/21/2018 2:30,21,32,29,24,106,4,0
475,3/21/2018 2:35,24,35,31,26,116,4,0
476,3/21/2018 2:40,28,37,33,29,127,4,0
477,3/21/2018 2:45,27,37,32,28,124,4,0
478,3/21/2018 2:50,28,38,34,29,129,4,0
479,3/21/2018 2:55,25,34,29,25,113,4,0
480,3/21/2018 3:00,22,32,28,24,106,4,0
481,3/21/2018 3:05,26,36,31,25,118,4,0
482,3/21/2018 3:10,34,44,39,33,150,4,0
483,3/21/2018 3:15,28,38,33,27,126,4,0
484,3/21/2018 3:20,30,41,36,29,136,4,0
485,3/21/2018 3:25,24,34,28,25,111,4,0
486,3/21/2018 3:30,28,36,32,28,124,4,0
487,3/21/2018 3:35,30,40,35,31,136,4,0
488,3/21/2018 3:40,36,44,39,34,153,4,0
489,3/21/2018 3:45,35,43,38,34,150,4,0
490,3/21/2018 3:50,40,48,42,37,167,4,0
491,3/21/2018 3:55,35,43,37,32,147,4,0
492,3/21/2018 4:00,30,38,34,30,132,4,0
493,3/21/2018 4:05,35,43,38,33,149,4,0
494,3/21/2018 4:10,37,46,42,38,163,4,0
495,3/21/2018 4:15,45,52,46,40,183,4,0
496,3/21/2018 4:20,47,53,47,42,189,4,0
497,3/21/2018 4:25,52,59,52,46,209,4,0
498,3/21/2018 4:30,60,66,59,52,237,4,0
499,3/21/2018 4:35,58,64,56,51,229,4,0
500,3/21/2018 4:40,87,90,79,71,327,4,0
501,3/21/2018 4:45,85,88,77,70,320,4,0
502,3/21/2018 4:50,78,82,72,64,296,4,0
503,3/21/2018 4:55,76,79,70,63,288,4,0
504,3/21/2018 5:00,81,84,74,67,306,4,0
505,3/21/2018 5:05,80,83,73,67,303,4,0
506,3/21/2018 5:10,77,80,71,63,291,4,0
507,3/21/2018 5:15,100,101,89,80,370,4,0
508,3/21/2018 5:20,108,108,95,86,397,4,0
509,3/21/2018 5:25,102,103,90,82,377,4,0
510,3/21/2018 5:30,114,114,100,91,419,4,0
511,3/21/2018 5:35,142,139,120,110,511,4,0
512,3/21/2018 5:40,137,135,118,107,497,4,0
513,3/21/2018 5:45,119,119,104,94,436,4,0
514,3/21/2018 5:50,124,122,107,97,450,4,0
515,3/21/2018 5:55,125,123,108,98,454,4,0
516,3/21/2018 6:00,118,117,102,93,430,4,0
517,3/21/2018 6:05,126,124,109,99,458,4,0
518,3/21/2018 6:10,111,110,96,87,404,4,0
519,3/21/2018 6:15,125,124,110,100,459,4,0
520,3/21/2018 6:20,133,130,114,103,480,4,0
521,3/21/2018 6:25,136,133,117,107,493,4,0
522,3/21/2018 6:30,135,133,117,106,491,4,0
523,3/21/2018 6:35,121,120,107,97,445,4,0
524,3/21/2018 6:40,128,126,110,100,464,4,0
525,3/21/2018 6:45,109,109,95,86,399,4,0
526,3/21/2018 6:50,133,130,114,103,480,4,0
527,3/21/2018 6:55,141,136,119,109,505,4,0
528,3/21/2018 7:00,126,123,108,98,455,4,0
529,3/21/2018 7:05,122,121,106,97,446,4,0
530,3/21/2018 7:10,143,139,124,113,519,4,0
531,3/21/2018 7:15,153,147,129,120,549,4,0
532,3/21/2018 7:20,135,131,115,105,486,4,0
533,3/21/2018 7:25,138,135,118,108,499,4,0
534,3/21/2018 7:30,114,113,99,90,416,4,0
535,3/21/2018 7:35,143,139,122,111,515,4,0
536,3/21/2018 7:40,156,150,131,119,556,4,0
537,3/21/2018 7:45,107,107,93,85,392,4,0
538,3/21/2018 7:50,141,136,118,108,503,4,0
539,3/21/2018 7:55,110,110,96,88,404,4,0
540,3/21/2018 8:00,128,126,110,100,464,4,0
541,3/21/2018 8:05,139,136,120,109,504,4,0
542,3/21/2018 8:10,124,122,107,97,450,4,0
543,3/21/2018 8:15,132,129,114,104,479,4,0
544,3/21/2018 8:20,121,121,107,98,447,4,0
545,3/21/2018 8:25,112,112,98,89,411,4,0
546,3/21/2018 8:30,128,127,113,103,471,4,0
547,3/21/2018 8:35,133,132,117,107,489,4,0
548,3/21/2018 8:40,125,124,110,100,459,4,0
549,3/21/2018 8:45,111,112,99,90,412,4,0
550,3/21/2018 8:50,119,118,105,96,438,4,0
551,3/21/2018 8:55,111,111,97,88,407,4,0
552,3/21/2018 9:00,109,109,96,87,401,4,0
553,3/21/2018 9:05,98,100,88,79,365,4,0
554,3/21/2018 9:10,111,110,96,87,404,4,0
555,3/21/2018 9:15,108,108,94,86,396,4,0
556,3/21/2018 9:20,116,114,100,91,421,4,0
557,3/21/2018 9:25,109,109,95,86,399,4,0
558,3/21/2018 9:30,108,108,94,85,395,4,0
559,3/21/2018 9:35,128,127,112,101,468,4,0
560,3/21/2018 9:40,107,107,94,85,393,4,0
561,3/21/2018 9:45,108,108,95,86,397,4,0
562,3/21/2018 9:50,115,113,99,90,417,4,0
563,3/21/2018 9:55,114,113,99,90,416,4,0
564,3/21/2018 10:00,105,105,93,84,387,4,0
565,3/21/2018 10:05,115,114,100,91,420,4,0
566,3/21/2018 10:10,103,103,90,82,378,4,0
567,3/21/2018 10:15,107,107,94,85,393,4,0
568,3/21/2018 10:20,114,113,99,90,416,4,0
569,3/21/2018 10:25,107,107,93,85,392,4,0
570,3/21/2018 10:30,100,101,89,81,371,4,0
571,3/21/2018 10:35,106,106,93,84,389,4,0
572,3/21/2018 10:40,100,101,89,80,370,4,0
573,3/21/2018 10:45,102,102,89,81,374,4,0
574,3/21/2018 10:50,104,104,92,83,383,4,0
575,3/21/2018 10:55,89,92,81,73,335,4,0
576,3/21/2018 11:00,102,103,90,82,377,4,0
577,3/21/2018 11:05,110,109,95,86,400,4,0
578,3/21/2018 11:10,101,102,90,81,374,4,0
579,3/21/2018 11:15,101,102,89,81,373,4,0
580,3/21/2018 11:20,107,107,94,85,393,4,0
581,3/21/2018 11:25,106,106,92,84,388,4,0
582,3/21/2018 11:30,94,96,85,77,352,4,0
583,3/21/2018 11:35,93,95,83,76,347,4,0
584,3/21/2018 11:40,101,103,90,82,376,4,0
585,3/21/2018 11:45,105,106,93,85,389,4,0
586,3/21/2018 11:50,95,96,85,76,352,4,0
587,3/21/2018 11:55,97,99,87,78,361,4,0
588,3/21/2018 12:00,103,103,90,82,378,4,0
589,3/21/2018 12:05,96,97,85,77,355,4,0
590,3/21/2018 12:10,104,104,91,83,382,4,0
591,3/21/2018 12:15,100,101,89,81,371,4,0
592,3/21/2018 12:20,95,97,85,77,354,4,0
593,3/21/2018 12:25,99,99,87,79,364,4,0
594,3/21/2018 12:30,102,103,90,82,377,4,0
595,3/21/2018 12:35,99,100,88,80,367,4,0
596,3/21/2018 12:40,101,102,90,81,374,4,0
597,3/21/2018 12:45,93,95,83,75,346,4,0
598,3/21/2018 12:50,89,91,80,72,332,4,0
599,3/21/2018 12:55,93,95,84,75,347,4,0
600,3/21/2018 13:00,96,98,86,77,357,4,0
601,3/21/2018 13:05,105,105,92,84,386,4,0
602,3/21/2018 13:10,105,105,92,83,385,4,0
603,3/21/2018 13:15,108,108,95,86,397,4,0
604,3/21/2018 13:20,103,103,90,82,378,4,0
605,3/21/2018 13:25,106,106,93,84,389,4,0
606,3/21/2018 13:30,108,107,94,85,394,4,0
607,3/21/2018 13:35,100,101,89,80,370,4,0
608,3/21/2018 13:40,112,111,97,88,408,4,0
609,3/21/2018 13:45,112,112,99,90,413,4,0
610,3/21/2018 13:50,107,108,95,86,396,4,0
611,3/21/2018 13:55,109,109,95,86,399,4,0
612,3/21/2018 14:00,105,105,92,84,386,4,0
613,3/21/2018 14:05,114,113,98,89,414,4,0
614,3/21/2018 14:10,103,105,93,84,385,4,0
615,3/21/2018 14:15,106,106,93,84,389,4,0
616,3/21/2018 14:20,104,105,92,83,384,4,0
617,3/21/2018 14:25,108,109,96,87,400,4,0
618,3/21/2018 14:30,106,107,94,85,392,4,0
619,3/21/2018 14:35,124,122,108,99,453,4,0
620,3/21/2018 14:40,116,116,102,92,426,4,0
621,3/21/2018 14:45,122,121,106,97,446,4,0
622,3/21/2018 14:50,127,124,108,98,457,4,0
623,3/21/2018 14:55,113,112,99,90,414,4,0
624,3/21/2018 15:00,122,121,105,96,444,4,0
625,3/21/2018 15:05,119,118,104,94,435,4,0
626,3/21/2018 15:10,125,122,106,97,450,4,0
627,3/21/2018 15:15,95,97,85,77,354,4,0
628,3/21/2018 15:20,103,104,92,83,382,4,0
629,3/21/2018 15:25,119,117,102,93,431,4,0
630,3/21/2018 15:30,118,117,103,94,432,4,0
631,3/21/2018 15:35,122,120,106,97,445,4,0
632,3/21/2018 15:40,127,125,110,101,463,4,0
633,3/21/2018 15:45,128,126,111,102,467,4,0
634,3/21/2018 15:50,120,118,103,93,434,4,0
635,3/21/2018 15:55,116,115,102,92,425,4,0
636,3/21/2018 16:00,115,114,99,90,418,4,0
637,3/21/2018 16:05,113,113,99,90,415,4,0
638,3/21/2018 16:10,100,102,89,81,372,4,0
639,3/21/2018 16:15,122,120,104,95,441,4,0
640,3/21/2018 16:20,126,124,109,100,459,4,0
641,3/21/2018 16:25,116,115,101,92,424,4,0
642,3/21/2018 16:30,111,111,97,88,407,4,0
643,3/21/2018 16:35,120,119,104,95,438,4,0
644,3/21/2018 16:40,137,133,117,106,493,4,0
645,3/21/2018 16:45,115,115,101,91,422,4,0
646,3/21/2018 16:50,129,125,109,99,462,4,0
647,3/21/2018 16:55,108,108,95,86,397,4,0
648,3/21/2018 17:00,117,115,100,91,423,4,0
649,3/21/2018 17:05,108,109,97,88,402,4,0
650,3/21/2018 17:10,123,121,107,96,447,4,0
651,3/21/2018 17:15,117,117,103,93,430,4,0
652,3/21/2018 17:20,126,124,108,98,456,4,0
653,3/21/2018 17:25,104,105,92,84,385,4,0
654,3/21/2018 17:30,98,99,87,79,363,4,0
655,3/21/2018 17:35,112,111,97,88,408,4,0
656,3/21/2018 17:40,114,113,99,90,416,4,0
657,3/21/2018 17:45,110,110,96,87,403,4,0
658,3/21/2018 17:50,125,123,107,98,453,4,0
659,3/21/2018 17:55,113,113,99,90,415,4,0
660,3/21/2018 18:00,114,113,98,90,415,4,0
661,3/21/2018 18:05,102,104,92,83,381,4,0
662,3/21/2018 18:10,108,108,95,86,397,4,0
663,3/21/2018 18:15,109,109,96,87,401,4,0
664,3/21/2018 18:20,106,106,93,84,389,4,0
665,3/21/2018 18:25,106,107,94,85,392,4,0
666,3/21/2018 18:30,102,103,90,82,377,4,0
667,3/21/2018 18:35,111,111,97,88,407,4,0
668,3/21/2018 18:40,113,112,98,89,412,4,0
669,3/21/2018 18:45,112,111,98,89,410,4,0
670,3/21/2018 18:50,109,110,96,87,402,4,0
671,3/21/2018 18:55,101,102,89,81,373,4,0
672,3/21/2018 19:00,104,105,93,84,386,4,0
673,3/21/2018 19:05,90,92,81,73,336,4,0
674,3/21/2018 19:10,99,99,87,79,364,4,0
675,3/21/2018 19:15,104,104,92,83,383,4,0
676,3/21/2018 19:20,93,95,84,76,348,4,0
677,3/21/2018 19:25,92,94,83,75,344,4,0
678,3/21/2018 19:30,86,89,78,71,324,4,0
679,3/21/2018 19:35,99,100,87,79,365,4,0
680,3/21/2018 19:40,85,88,77,70,320,4,0
681,3/21/2018 19:45,79,82,73,65,299,4,0
682,3/21/2018 19:50,91,94,82,74,341,4,0
683,3/21/2018 19:55,85,88,77,70,320,4,0
684,3/21/2018 20:00,68,73,64,57,262,4,0
685,3/21/2018 20:05,78,82,72,65,297,4,0
686,3/21/2018 20:10,83,86,75,67,311,4,0
687,3/21/2018 20:15,77,81,71,63,292,4,0
688,3/21/2018 20:20,85,88,78,70,321,4,0
689,3/21/2018 20:25,75,79,70,63,287,4,0
690,3/21/2018 20:30,75,79,70,63,287,4,0
691,3/21/2018 20:35,73,78,68,62,281,4,0
692,3/21/2018 20:40,76,80,70,64,290,4,0
693,3/21/2018 20:45,74,78,68,60,280,4,0
694,3/21/2018 20:50,81,84,74,66,305,4,0
695,3/21/2018 20:55,75,79,70,63,287,4,0
696,3/21/2018 21:00,74,78,69,62,283,4,0
697,3/21/2018 21:05,76,80,70,63,289,4,0
698,3/21/2018 21:10,77,81,71,64,293,4,0
699,3/21/2018 21:15,79,82,72,65,298,4,0
700,3/21/2018 21:20,82,85,75,68,310,4,0
701,3/21/2018 21:25,84,87,76,69,316,4,0
702,3/21/2018 21:30,81,84,74,67,306,4,0
703,3/21/2018 21:35,73,78,69,61,281,4,0
704,3/21/2018 21:40,81,84,74,67,306,4,0
705,3/21/2018 21:45,74,79,69,62,284,4,0
706,3/21/2018 21:50,59,65,57,51,232,4,0
707,3/21/2018 21:55,64,70,61,54,249,4,0
708,3/21/2018 22:00,59,65,58,52,234,4,0
709,3/21/2018 22:05,63,68,60,54,245,4,0
710,3/21/2018 22:10,60,66,59,53,238,4,0
711,3/21/2018 22:15,66,71,62,56,255,4,0
712,3/21/2018 22:20,65,71,62,56,254,4,0
713,3/21/2018 22:25,62,67,59,53,241,4,0
714,3/21/2018 22:30,61,67,59,53,240,4,0
715,3/21/2018 22:35,52,59,52,47,210,4,0
716,3/21/2018 22:40,59,65,58,52,234,4,0
717,3/21/2018 22:45,55,61,54,48,218,4,0
718,3/21/2018 22:50,54,61,54,47,216,4,0
719,3/21/2018 22:55,60,66,57,50,233,4,0
720,3/21/2018 23:00,42,50,44,39,175,4,0
721,3/21/2018 23:05,50,57,51,45,203,4,0
722,3/21/2018 23:10,50,56,50,43,199,4,0
723,3/21/2018 23:15,46,54,47,42,189,4,0
724,3/21/2018 23:20,51,58,51,46,206,4,0
725,3/21/2018 23:25,47,53,47,42,189,4,0
726,3/21/2018 23:30,55,62,55,50,222,4,0
727,3/21/2018 23:35,43,50,43,37,173,4,0
728,3/21/2018 23:40,43,51,45,40,179,4,0
729,3/21/2018 23:45,42,51,45,38,176,4,0
730,3/21/2018 23:50,41,50,44,39,174,4,0
731,3/21/2018 23:55,36,45,40,35,156,4,0
732,3/22/2018 0:00,39,47,43,38,167,4,0
733,3/22/2018 0:05,35,43,37,32,147,4,0
734,3/22/2018 0:10,36,44,40,35,155,4,0
735,3/22/2018 0:15,35,44,37,31,147,4,0
736,3/22/2018 0:20,39,47,41,33,160,4,0
737,3/22/2018 0:25,33,41,37,30,141,4,0
738,3/22/2018 0:30,28,37,31,27,123,4,0
739,3/22/2018 0:35,31,40,34,29,134,4,0
740,3/22/2018 0:40,33,42,36,30,141,4,0
741,3/22/2018 0:45,33,41,37,31,142,4,0
742,3/22/2018 0:50,29,38,35,27,129,4,0
743,3/22/2018 0:55,28,37,34,30,129,4,0
744,3/22/2018 1:00,27,36,33,26,122,4,0
745,3/22/2018 1:05,28,37,32,26,123,4,0
746,3/22/2018 1:10,29,38,32,26,125,4,0
747,3/22/2018 1:15,31,40,35,31,137,4,0
748,3/22/2018 1:20,33,41,38,30,142,4,0
749,3/22/2018 1:25,28,37,31,26,122,4,0
750,3/22/2018 1:30,25,34,29,25,113,4,0
751,3/22/2018 1:35,23,33,29,25,110,4,0
752,3/22/2018 1:40,23,32,28,23,106,4,0
753,3/22/2018 1:45,31,39,33,29,132,4,0
754,3/22/2018 1:50,24,34,28,22,108,4,0
755,3/22/2018 1:55,27,36,31,22,116,4,0
756,3/22/2018 2:00,24,33,28,24,109,4,0
757,3/22/2018 2:05,22,31,27,22,102,4,0
758,3/22/2018 2:10,27,36,30,26,119,4,0
759,3/22/2018 2:15,23,32,27,23,105,4,0
760,3/22/2018 2:20,20,30,26,22,98,4,0
761,3/22/2018 2:25,25,34,29,22,110,4,0
762,3/22/2018 2:30,24,34,28,25,111,4,0
763,3/22/2018 2:35,19,29,25,22,95,4,0
764,3/22/2018 2:40,19,29,24,20,92,4,0
765,3/22/2018 2:45,37,46,39,31,153,4,0
766,3/22/2018 2:50,33,41,35,27,136,4,0
767,3/22/2018 2:55,28,37,31,26,122,4,0
768,3/22/2018 3:00,25,34,29,22,110,4,0
769,3/22/2018 3:05,21,30,28,25,104,4,0
770,3/22/2018 3:10,27,36,31,26,120,4,0
771,3/22/2018 3:15,26,35,30,23,114,4,0
772,3/22/2018 3:20,27,36,33,29,125,4,0
773,3/22/2018 3:25,25,34,30,27,116,4,0
774,3/22/2018 3:30,29,38,34,30,131,4,0
775,3/22/2018 3:35,32,40,34,30,136,4,0
776,3/22/2018 3:40,31,40,34,28,133,4,0
777,3/22/2018 3:45,40,47,41,36,164,4,0
778,3/22/2018 3:50,31,40,34,28,133,4,0
779,3/22/2018 3:55,35,43,39,35,152,4,0
780,3/22/2018 4:00,28,37,34,30,129,4,0
781,3/22/2018 4:05,33,41,35,31,140,4,0
782,3/22/2018 4:10,36,44,40,35,155,4,0
783,3/22/2018 4:15,44,51,44,39,178,4,0
784,3/22/2018 4:20,39,46,40,35,160,4,0
785,3/22/2018 4:25,47,54,46,41,188,4,0
786,3/22/2018 4:30,57,63,54,48,222,4,0
787,3/22/2018 4:35,55,61,53,47,216,4,0
788,3/22/2018 4:40,69,74,65,59,267,4,0
789,3/22/2018 4:45,74,78,69,62,283,4,0
790,3/22/2018 4:50,75,80,70,62,287,4,0
791,3/22/2018 4:55,68,73,64,57,262,4,0
792,3/22/2018 5:00,55,61,53,47,216,4,0
793,3/22/2018 5:05,65,70,61,54,250,4,0
794,3/22/2018 5:10,81,84,74,67,306,4,0
795,3/22/2018 5:15,78,81,72,65,296,4,0
796,3/22/2018 5:20,98,100,88,79,365,4,0
797,3/22/2018 5:25,94,96,85,76,351,4,0
798,3/22/2018 5:30,106,107,95,85,393,4,0
799,3/22/2018 5:35,117,115,101,91,424,4,0
800,3/22/2018 5:40,132,129,112,102,475,4,0
801,3/22/2018 5:45,122,121,105,95,443,4,0
802,3/22/2018 5:50,122,121,105,95,443,4,0
803,3/22/2018 5:55,114,114,101,91,420,4,0
804,3/22/2018 6:00,107,107,94,85,393,4,0
805,3/22/2018 6:05,96,98,86,78,358,4,0
806,3/22/2018 6:10,122,121,107,97,447,4,0
807,3/22/2018 6:15,131,129,115,103,478,4,0
808,3/22/2018 6:20,140,136,118,107,501,4,0
809,3/22/2018 6:25,131,129,115,103,478,4,0
810,3/22/2018 6:30,127,125,109,99,460,4,0
811,3/22/2018 6:35,124,122,107,97,450,4,0
812,3/22/2018 6:40,138,134,117,106,495,4,0
813,3/22/2018 6:45,129,127,110,100,466,4,0
814,3/22/2018 6:50,133,131,116,105,485,4,0
815,3/22/2018 6:55,116,115,100,92,423,4,0
816,3/22/2018 7:00,110,110,96,87,403,4,0
817,3/22/2018 7:05,108,108,94,85,395,4,0
818,3/22/2018 7:10,128,126,110,99,463,4,0
819,3/22/2018 7:15,124,122,107,97,450,4,0
820,3/22/2018 7:20,120,118,104,95,437,4,0
821,3/22/2018 7:25,122,121,107,97,447,4,0
822,3/22/2018 7:30,136,134,119,107,496,4,0
823,3/22/2018 7:35,123,122,108,98,451,4,0
824,3/22/2018 7:40,114,114,101,91,420,4,0
825,3/22/2018 7:45,102,104,91,82,379,4,0
826,3/22/2018 7:50,117,117,103,93,430,4,0
827,3/22/2018 7:55,133,131,116,105,485,4,0
828,3/22/2018 8:00,112,112,99,89,412,4,0
829,3/22/2018 8:05,98,100,88,79,365,4,0
830,3/22/2018 8:10,90,93,82,74,339,4,0
831,3/22/2018 8:15,91,92,81,73,337,4,0
832,3/22/2018 8:20,101,102,91,82,376,4,0
833,3/22/2018 8:25,109,109,97,89,404,4,0
834,3/22/2018 8:30,106,107,95,86,394,4,0
835,3/22/2018 8:35,106,107,95,86,394,4,0
836,3/22/2018 8:40,108,108,94,85,395,4,0
837,3/22/2018 8:45,121,121,108,99,449,4,0
838,3/22/2018 8:50,104,105,93,85,387,4,0
839,3/22/2018 8:55,94,96,84,76,350,4,0
840,3/22/2018 9:00,98,99,87,79,363,4,0
841,3/22/2018 9:05,113,112,98,89,412,4,0
842,3/22/2018 9:10,103,104,91,82,380,4,0
843,3/22/2018 9:15,94,96,85,76,351,4,0
844,3/22/2018 9:20,93,95,83,75,346,4,0
845,3/22/2018 9:25,94,96,85,76,351,4,0
846,3/22/2018 9:30,103,104,92,83,382,4,0
847,3/22/2018 9:35,102,104,91,82,379,4,0
848,3/22/2018 9:40,82,85,75,67,309,4,0
849,3/22/2018 9:45,89,91,80,72,332,4,0
850,3/22/2018 9:50,98,99,87,79,363,4,0
851,3/22/2018 9:55,86,89,79,70,324,4,0
852,3/22/2018 10:00,91,94,83,74,342,4,0
853,3/22/2018 10:05,96,98,87,78,359,4,0
854,3/22/2018 10:10,84,88,77,69,318,4,0
855,3/22/2018 10:15,98,99,87,79,363,4,0
856,3/22/2018 10:20,94,96,85,76,351,4,0
857,3/22/2018 10:25,100,101,88,80,369,4,0
858,3/22/2018 10:30,89,92,81,73,335,4,0
859,3/22/2018 10:35,78,81,71,64,294,4,0
860,3/22/2018 10:40,91,94,83,74,342,4,0
861,3/22/2018 10:45,89,91,80,72,332,4,0
862,3/22/2018 10:50,88,90,79,71,328,4,0
863,3/22/2018 10:55,85,88,78,70,321,4,0
864,3/22/2018 11:00,90,93,82,74,339,4,0
865,3/22/2018 11:05,93,96,84,75,348,4,0
866,3/22/2018 11:10,90,93,82,74,339,4,0
867,3/22/2018 11:15,102,103,90,81,376,4,0
868,3/22/2018 11:20,86,89,78,71,324,4,0
869,3/22/2018 11:25,99,101,89,81,370,4,0
870,3/22/2018 11:30,93,95,83,75,346,4,0
871,3/22/2018 11:35,96,98,86,78,358,4,0
872,3/22/2018 11:40,89,91,80,72,332,4,0
873,3/22/2018 11:45,95,97,86,78,356,4,0
874,3/22/2018 11:50,99,101,88,80,368,4,0
875,3/22/2018 11:55,91,94,83,74,342,4,0
876,3/22/2018 12:00,96,98,87,78,359,4,0
877,3/22/2018 12:05,88,91,80,72,331,4,0
878,3/22/2018 12:10,95,97,86,78,356,4,0
879,3/22/2018 12:15,104,105,93,84,386,4,0
880,3/22/2018 12:20,98,99,87,79,363,4,0
881,3/22/2018 12:25,88,90,79,71,328,4,0
882,3/22/2018 12:30,92,95,83,75,345,4,0
883,3/22/2018 12:35,100,101,88,80,369,4,0
884,3/22/2018 12:40,107,107,94,85,393,4,0
885,3/22/2018 12:45,103,104,91,82,380,4,0
886,3/22/2018 12:50,106,107,94,85,392,4,0
887,3/22/2018 12:55,101,103,91,81,376,4,0
888,3/22/2018 13:00,99,101,89,80,369,4,0
889,3/22/2018 13:05,93,95,83,75,346,4,0
890,3/22/2018 13:10,102,103,90,81,376,4,0
891,3/22/2018 13:15,108,108,94,85,395,4,0
892,3/22/2018 13:20,102,103,90,81,376,4,0
893,3/22/2018 13:25,99,101,89,81,370,4,0
894,3/22/2018 13:30,100,101,88,80,369,4,0
895,3/22/2018 13:35,89,92,81,73,335,4,0
896,3/22/2018 13:40,105,105,92,83,385,4,0
897,3/22/2018 13:45,83,87,76,68,314,4,0
898,3/22/2018 13:50,109,110,97,87,403,4,0
899,3/22/2018 13:55,102,103,92,83,380,4,0
900,3/22/2018 14:00,105,105,92,83,385,4,0
901,3/22/2018 14:05,99,101,89,80,369,4,0
902,3/22/2018 14:10,104,105,93,84,386,4,0
903,3/22/2018 14:15,98,99,87,79,363,4,0
904,3/22/2018 14:20,113,113,100,90,416,4,0
905,3/22/2018 14:25,117,115,101,91,424,4,0
906,3/22/2018 14:30,107,108,95,86,396,4,0
907,3/22/2018 14:35,108,108,94,85,395,4,0
908,3/22/2018 14:40,121,121,107,96,445,4,0
909,3/22/2018 14:45,116,115,100,91,422,4,0
910,3/22/2018 14:50,121,119,104,94,438,4,0
911,3/22/2018 14:55,124,122,107,97,450,4,0
912,3/22/2018 15:00,112,111,97,88,408,4,0
913,3/22/2018 15:05,119,119,105,95,438,4,0
914,3/22/2018 15:10,116,115,100,91,422,4,0
915,3/22/2018 15:15,109,109,97,89,404,4,0
916,3/22/2018 15:20,122,121,107,97,447,4,0
917,3/22/2018 15:25,108,109,96,87,400,4,0
918,3/22/2018 15:30,117,117,103,93,430,4,0
919,3/22/2018 15:35,127,125,109,99,460,4,0
920,3/22/2018 15:40,131,128,112,101,472,4,0
921,3/22/2018 15:45,111,112,99,89,411,4,0
922,3/22/2018 15:50,122,121,105,95,443,4,0
923,3/22/2018 15:55,116,116,103,92,427,4,0
924,3/22/2018 16:00,126,125,111,100,462,4,0
925,3/22/2018 16:05,101,103,91,81,376,4,0
926,3/22/2018 16:10,123,122,108,98,451,4,0
927,3/22/2018 16:15,108,109,96,87,400,4,0
928,3/22/2018 16:20,122,121,105,95,443,4,0
929,3/22/2018 16:25,112,112,99,89,412,4,0
930,3/22/2018 16:30,112,111,97,88,408,4,0
931,3/22/2018 16:35,124,123,109,98,454,4,0
932,3/22/2018 16:40,98,100,88,79,365,4,0
933,3/22/2018 16:45,130,127,111,101,469,4,0
934,3/22/2018 16:50,110,111,98,88,407,4,0
935,3/22/2018 16:55,133,131,116,105,485,4,0
936,3/22/2018 17:00,98,100,88,79,365,4,0
937,3/22/2018 17:05,97,99,87,78,361,4,0
938,3/22/2018 17:10,117,115,101,91,424,4,0
939,3/22/2018 17:15,105,105,92,83,385,4,0
940,3/22/2018 17:20,107,108,95,86,396,4,0
941,3/22/2018 17:25,100,102,90,81,373,4,0
942,3/22/2018 17:30,115,114,99,90,418,4,0
943,3/22/2018 17:35,97,99,87,78,361,4,0
944,3/22/2018 17:40,110,110,96,87,403,4,0
945,3/22/2018 17:45,108,108,94,85,395,4,0
946,3/22/2018 17:50,116,115,100,91,422,4,0
947,3/22/2018 17:55,98,100,88,79,365,4,0
948,3/22/2018 18:00,96,98,87,78,359,4,0
949,3/22/2018 18:05,98,100,88,79,365,4,0
950,3/22/2018 18:10,108,108,94,85,395,4,0
951,3/22/2018 18:15,99,100,88,79,366,4,0
952,3/22/2018 18:20,107,108,94,85,394,4,0
953,3/22/2018 18:25,107,108,95,86,396,4,0
954,3/22/2018 18:30,109,110,97,87,403,4,0
955,3/22/2018 18:35,100,102,90,81,373,4,0
956,3/22/2018 18:40,105,106,94,84,389,4,0
957,3/22/2018 18:45,97,99,87,78,361,4,0
958,3/22/2018 18:50,96,98,87,78,359,4,0
959,3/22/2018 18:55,96,98,87,78,359,4,0
960,3/22/2018 19:00,81,85,75,67,308,4,0
961,3/22/2018 19:05,101,103,91,81,376,4,0
962,3/22/2018 19:10,86,89,79,70,324,4,0
963,3/22/2018 19:15,86,89,79,70,324,4,0
964,3/22/2018 19:20,86,89,79,70,324,4,0
965,3/22/2018 19:25,91,94,83,74,342,4,0
966,3/22/2018 19:30,83,86,75,67,311,4,0
967,3/22/2018 19:35,71,75,67,60,273,4,0
968,3/22/2018 19:40,77,80,71,64,292,4,0
969,3/22/2018 19:45,73,77,67,60,277,4,0
970,3/22/2018 19:50,82,85,75,67,309,4,0
971,3/22/2018 19:55,88,90,79,71,328,4,0
972,3/22/2018 20:00,92,95,83,75,345,4,0
973,3/22/2018 20:05,77,80,71,64,292,4,0
974,3/22/2018 20:10,82,85,74,67,308,4,0
975,3/22/2018 20:15,89,92,81,73,335,4,0
976,3/22/2018 20:20,71,76,67,59,273,4,0
977,3/22/2018 20:25,71,75,67,60,273,4,0
978,3/22/2018 20:30,66,71,62,54,253,4,0
979,3/22/2018 20:35,75,79,69,62,285,4,0
980,3/22/2018 20:40,85,88,78,70,321,4,0
981,3/22/2018 20:45,74,78,68,61,281,4,0
982,3/22/2018 20:50,75,79,69,62,285,4,0
983,3/22/2018 20:55,67,72,63,56,258,4,0
984,3/22/2018 21:00,77,80,71,64,292,4,0
985,3/22/2018 21:05,73,77,68,61,279,4,0
986,3/22/2018 21:10,76,80,70,63,289,4,0
987,3/22/2018 21:15,72,77,68,59,276,4,0
988,3/22/2018 21:20,70,74,65,58,267,4,0
989,3/22/2018 21:25,73,77,67,60,277,4,0
990,3/22/2018 21:30,65,70,61,54,250,4,0
991,3/22/2018 21:35,72,76,67,61,276,4,0
992,3/22/2018 21:40,74,78,68,61,281,4,0
993,3/22/2018 21:45,58,63,55,49,225,4,0
994,3/22/2018 21:50,58,63,55,49,225,4,0
995,3/22/2018 21:55,67,71,62,56,256,4,0
996,3/22/2018 22:00,59,64,56,50,229,4,0
997,3/22/2018 22:05,70,74,65,58,267,4,0
998,3/22/2018 22:10,74,78,69,62,283,4,0
999,3/22/2018 22:15,68,72,63,56,259,4,0
1000,3/22/2018 22:20,58,63,55,49,225,4,0
1001,3/22/2018 22:25,63,68,59,53,243,4,0
1002,3/22/2018 22:30,51,57,51,46,205,4,0
1003,3/22/2018 22:35,59,64,57,51,231,4,0
1004,3/22/2018 22:40,57,63,54,48,222,4,0
1005,3/22/2018 22:45,61,66,58,51,236,4,0
1006,3/22/2018 22:50,56,62,55,49,222,4,0
1007,3/22/2018 22:55,64,69,60,53,246,4,0
1008,3/22/2018 23:00,43,51,46,41,181,4,0
1009,3/22/2018 23:05,60,65,57,50,232,4,0
1010,3/22/2018 23:10,41,49,44,37,171,4,0
1011,3/22/2018 23:15,52,58,50,45,205,4,0
1012,3/22/2018 23:20,43,50,43,38,174,4,0
1013,3/22/2018 23:25,48,55,47,42,192,4,0
1014,3/22/2018 23:30,38,46,39,34,157,4,0
1015,3/22/2018 23:35,35,43,37,32,147,4,0
1016,3/22/2018 23:40,42,49,42,37,170,4,0
1017,3/22/2018 23:45,43,50,43,38,174,4,0
1018,3/22/2018 23:50,39,46,40,35,160,4,0
1019,3/22/2018 23:55,44,51,46,41,182,4,0
1020,3/23/2018 0:00,40,48,42,38,168,4,0
1021,3/23/2018 0:05,35,43,38,34,150,4,0
1022,3/23/2018 0:10,43,50,44,39,176,4,0
1023,3/23/2018 0:15,40,48,42,37,167,4,0
1024,3/23/2018 0:20,42,49,43,39,173,4,0
1025,3/23/2018 0:25,36,45,40,36,157,4,0
1026,3/23/2018 0:30,29,40,35,30,134,4,0
1027,3/23/2018 0:35,39,48,42,37,166,4,0
1028,3/23/2018 0:40,30,41,36,31,138,4,0
1029,3/23/2018 0:45,35,44,39,34,152,4,0
1030,3/23/2018 0:50,32,42,38,34,146,4,0
1031,3/23/2018 0:55,34,44,39,33,150,4,0
1032,3/23/2018 1:00,33,43,38,32,146,4,0
1033,3/23/2018 1:05,29,38,34,30,131,4,0
1034,3/23/2018 1:10,27,37,33,28,125,4,0
1035,3/23/2018 1:15,32,41,36,31,140,4,0
1036,3/23/2018 1:20,24,35,31,26,116,4,0
1037,3/23/2018 1:25,21,32,28,23,104,4,0
1038,3/23/2018 1:30,27,36,32,28,123,4,0
1039,3/23/2018 1:35,23,34,30,25,112,4,0
1040,3/23/2018 1:40,24,35,31,25,115,4,0
1041,3/23/2018 1:45,30,39,34,29,132,4,0
1042,3/23/2018 1:50,22,34,30,24,110,4,0
1043,3/23/2018 1:55,26,37,32,28,123,4,0
1044,3/23/2018 2:00,26,35,31,27,119,4,0
1045,3/23/2018 2:05,24,35,32,26,117,4,0
1046,3/23/2018 2:10,27,36,32,28,123,4,0
1047,3/23/2018 2:15,26,36,32,26,120,4,0
1048,3/23/2018 2:20,22,33,29,24,108,4,0
1049,3/23/2018 2:25,20,31,29,24,104,4,0
1050,3/23/2018 2:30,29,39,34,27,129,4,0
1051,3/23/2018 2:35,27,36,32,29,124,4,0
1052,3/23/2018 2:40,24,34,30,26,114,4,0
1053,3/23/2018 2:45,35,43,38,33,149,4,0
1054,3/23/2018 2:50,26,35,31,25,117,4,0
1055,3/23/2018 2:55,24,34,30,26,114,4,0
1056,3/23/2018 3:00,28,37,32,27,124,4,0
1057,3/23/2018 3:05,28,37,33,28,126,4,0
1058,3/23/2018 3:10,28,37,32,28,125,4,0
1059,3/23/2018 3:15,29,37,33,29,128,4,0
1060,3/23/2018 3:20,28,38,34,29,129,4,0
1061,3/23/2018 3:25,29,38,35,29,131,4,0
1062,3/23/2018 3:30,28,39,34,29,130,4,0
1063,3/23/2018 3:35,35,43,38,33,149,4,0
1064,3/23/2018 3:40,39,46,41,36,162,4,0
1065,3/23/2018 3:45,35,44,39,34,152,4,0
1066,3/23/2018 3:50,38,46,41,36,161,4,0
1067,3/23/2018 3:55,36,44,39,34,153,4,0
1068,3/23/2018 4:00,33,43,38,33,147,4,0
1069,3/23/2018 4:05,37,46,41,36,160,4,0
1070,3/23/2018 4:10,37,46,40,36,159,4,0
1071,3/23/2018 4:15,42,50,43,37,172,4,0
1072,3/23/2018 4:20,44,51,45,40,180,4,0
1073,3/23/2018 4:25,49,55,49,43,196,4,0
1074,3/23/2018 4:30,56,63,56,50,225,4,0
1075,3/23/2018 4:35,51,58,51,46,206,4,0
1076,3/23/2018 4:40,67,72,63,56,258,4,0
1077,3/23/2018 4:45,76,80,70,64,290,4,0
1078,3/23/2018 4:50,79,82,72,65,298,4,0
1079,3/23/2018 4:55,64,69,61,54,248,4,0
1080,3/23/2018 5:00,63,69,60,54,246,4,0
1081,3/23/2018 5:05,71,76,66,59,272,4,0
1082,3/23/2018 5:10,83,87,76,68,314,4,0
1083,3/23/2018 5:15,72,77,67,60,276,4,0
1084,3/23/2018 5:20,86,88,77,70,321,4,0
1085,3/23/2018 5:25,96,97,85,77,355,4,0
1086,3/23/2018 5:30,109,109,96,87,401,4,0
1087,3/23/2018 5:35,131,128,111,101,471,4,0
1088,3/23/2018 5:40,124,123,108,98,453,4,0
1089,3/23/2018 5:45,129,127,112,101,469,4,0
1090,3/23/2018 5:50,125,123,108,98,454,4,0
1091,3/23/2018 5:55,125,123,107,98,453,4,0
1092,3/23/2018 6:00,112,112,98,89,411,4,0
1093,3/23/2018 6:05,109,108,95,86,398,4,0
1094,3/23/2018 6:10,116,116,102,92,426,4,0
1095,3/23/2018 6:15,115,115,101,91,422,4,0
1096,3/23/2018 6:20,134,132,114,104,484,4,0
1097,3/23/2018 6:25,126,124,109,99,458,4,0
1098,3/23/2018 6:30,122,121,106,96,445,4,0
1099,3/23/2018 6:35,130,129,113,103,475,4,0
1100,3/23/2018 6:40,137,135,120,109,501,4,0
1101,3/23/2018 6:45,141,137,121,111,510,4,0
1102,3/23/2018 6:50,136,133,116,106,491,4,0
1103,3/23/2018 6:55,125,124,110,101,460,4,0
1104,3/23/2018 7:00,119,118,104,94,435,4,0
1105,3/23/2018 7:05,133,132,117,107,489,4,0
1106,3/23/2018 7:10,134,133,118,108,493,4,0
1107,3/23/2018 7:15,130,129,115,105,479,4,0
1108,3/23/2018 7:20,137,133,117,106,493,4,0
1109,3/23/2018 7:25,140,137,120,109,506,4,0
1110,3/23/2018 7:30,134,132,116,107,489,4,0
1111,3/23/2018 7:35,141,139,121,110,511,4,0
1112,3/23/2018 7:40,126,124,108,98,456,4,0
1113,3/23/2018 7:45,138,134,117,107,496,4,0
1114,3/23/2018 7:50,131,127,111,101,470,4,0
1115,3/23/2018 7:55,128,125,110,100,463,4,0
1116,3/23/2018 8:00,128,125,110,100,463,4,0
1117,3/23/2018 8:05,115,114,100,91,420,4,0
1118,3/23/2018 8:10,121,121,107,98,447,4,0
1119,3/23/2018 8:15,138,135,118,107,498,4,0
1120,3/23/2018 8:20,122,121,108,98,449,4,0
1121,3/23/2018 8:25,111,111,99,89,410,4,0
1122,3/23/2018 8:30,112,112,100,90,414,4,0
1123,3/23/2018 8:35,121,119,103,94,437,4,0
1124,3/23/2018 8:40,116,116,102,92,426,4,0
1125,3/23/2018 8:45,116,115,102,93,426,4,0
1126,3/23/2018 8:50,115,114,100,91,420,4,0
1127,3/23/2018 8:55,119,118,104,95,436,4,0
1128,3/23/2018 9:00,109,109,96,87,401,4,0
1129,3/23/2018 9:05,106,106,93,84,389,4,0
1130,3/23/2018 9:10,107,106,93,85,391,4,0
1131,3/23/2018 9:15,103,103,91,82,379,4,0
1132,3/23/2018 9:20,109,109,96,86,400,4,0
1133,3/23/2018 9:25,113,112,98,89,412,4,0
1134,3/23/2018 9:30,119,118,104,94,435,4,0
1135,3/23/2018 9:35,113,113,99,90,415,4,0
1136,3/23/2018 9:40,104,104,92,83,383,4,0
1137,3/23/2018 9:45,113,112,99,89,413,4,0
1138,3/23/2018 9:50,107,107,94,85,393,4,0
1139,3/23/2018 9:55,110,109,95,87,401,4,0
1140,3/23/2018 10:00,107,107,94,85,393,4,0
1141,3/23/2018 10:05,110,110,96,88,404,4,0
1142,3/23/2018 10:10,101,102,90,81,374,4,0
1143,3/23/2018 10:15,120,118,104,94,436,4,0
1144,3/23/2018 10:20,109,108,95,86,398,4,0
1145,3/23/2018 10:25,111,110,97,88,406,4,0
1146,3/23/2018 10:30,111,110,96,87,404,4,0
1147,3/23/2018 10:35,113,113,99,90,415,4,0
1148,3/23/2018 10:40,108,108,95,86,397,4,0
1149,3/23/2018 10:45,109,108,94,86,397,4,0
1150,3/23/2018 10:50,117,115,100,91,423,4,0
1151,3/23/2018 10:55,114,114,100,90,418,4,0
1152,3/23/2018 11:00,106,107,95,85,393,4,0
1153,3/23/2018 11:05,112,112,98,89,411,4,0
1154,3/23/2018 11:10,118,116,101,92,427,4,0
1155,3/23/2018 11:15,100,101,89,81,371,4,0
1156,3/23/2018 11:20,101,102,89,81,373,4,0
1157,3/23/2018 11:25,93,95,84,75,347,4,0
1158,3/23/2018 11:30,109,108,94,86,397,4,0
1159,3/23/2018 11:35,110,110,97,87,404,4,0
1160,3/23/2018 11:40,117,117,102,92,428,4,0
1161,3/23/2018 11:45,109,108,94,86,397,4,0
1162,3/23/2018 11:50,105,105,92,83,385,4,0
1163,3/23/2018 11:55,117,116,102,92,427,4,0
1164,3/23/2018 12:00,110,110,97,87,404,4,0
1165,3/23/2018 12:05,118,116,101,92,427,4,0
1166,3/23/2018 12:10,110,110,96,87,403,4,0
1167,3/23/2018 12:15,107,107,94,85,393,4,0
1168,3/23/2018 12:20,110,110,96,87,403,4,0
1169,3/23/2018 12:25,110,109,95,87,401,4,0
1170,3/23/2018 12:30,129,126,109,100,464,4,0
1171,3/23/2018 12:35,119,118,103,94,434,4,0
1172,3/23/2018 12:40,115,115,101,91,422,4,0
1173,3/23/2018 12:45,120,118,103,94,435,4,0
1174,3/23/2018 12:50,111,111,97,88,407,4,0
1175,3/23/2018 12:55,112,112,98,89,411,4,0
1176,3/23/2018 13:00,104,105,91,83,383,4,0
1177,3/23/2018 13:05,110,110,96,87,403,4,0
1178,3/23/2018 13:10,108,108,95,86,397,4,0
1179,3/23/2018 13:15,116,116,101,92,425,4,0
1180,3/23/2018 13:20,118,117,103,94,432,4,0
1181,3/23/2018 13:25,119,117,102,93,431,4,0
1182,3/23/2018 13:30,123,121,105,96,445,4,0
1183,3/23/2018 13:35,120,119,103,94,436,4,0
1184,3/23/2018 13:40,111,111,97,88,407,4,0
1185,3/23/2018 13:45,123,121,106,97,447,4,0
1186,3/23/2018 13:50,110,110,96,87,403,4,0
1187,3/23/2018 13:55,114,113,99,90,416,4,0
1188,3/23/2018 14:00,115,113,99,90,417,4,0
1189,3/23/2018 14:05,117,116,101,92,426,4,0
1190,3/23/2018 14:10,119,117,102,93,431,4,0
1191,3/23/2018 14:15,122,121,106,96,445,4,0
1192,3/23/2018 14:20,114,113,99,90,416,4,0
1193,3/23/2018 14:25,119,118,104,94,435,4,0
1194,3/23/2018 14:30,108,107,94,85,394,4,0
1195,3/23/2018 14:35,120,118,103,93,434,4,0
1196,3/23/2018 14:40,119,117,103,94,433,4,0
1197,3/23/2018 14:45,132,130,113,103,478,4,0
1198,3/23/2018 14:50,121,119,103,94,437,4,0
1199,3/23/2018 14:55,109,109,95,86,399,4,0
1200,3/23/2018 15:00,109,108,95,86,398,4,0
1201,3/23/2018 15:05,105,106,93,84,388,4,0
1202,3/23/2018 15:10,118,116,101,92,427,4,0
1203,3/23/2018 15:15,117,117,102,92,428,4,0
1204,3/23/2018 15:20,125,122,106,97,450,4,0
1205,3/23/2018 15:25,112,112,98,89,411,4,0
1206,3/23/2018 15:30,110,110,96,87,403,4,0
1207,3/23/2018 15:35,122,120,104,95,441,4,0
1208,3/23/2018 15:40,121,120,105,95,441,4,0
1209,3/23/2018 15:45,123,122,107,97,449,4,0
1210,3/23/2018 15:50,119,118,104,94,435,4,0
1211,3/23/2018 15:55,124,121,106,96,447,4,0
1212,3/23/2018 16:00,122,121,106,96,445,4,0
1213,3/23/2018 16:05,127,125,110,99,461,4,0
1214,3/23/2018 16:10,124,122,107,97,450,4,0
1215,3/23/2018 16:15,128,125,109,99,461,4,0
1216,3/23/2018 16:20,126,124,109,99,458,4,0
1217,3/23/2018 16:25,131,128,112,102,473,4,0
1218,3/23/2018 16:30,118,116,102,93,429,4,0
1219,3/23/2018 16:35,129,127,112,101,469,4,0
1220,3/23/2018 16:40,129,126,110,100,465,4,0
1221,3/23/2018 16:45,118,116,102,92,428,4,0
1222,3/23/2018 16:50,110,110,96,87,403,4,0
1223,3/23/2018 16:55,122,121,106,96,445,4,0
1224,3/23/2018 17:00,114,113,98,90,415,4,0
1225,3/23/2018 17:05,130,128,112,102,472,4,0
1226,3/23/2018 17:10,117,115,100,91,423,4,0
1227,3/23/2018 17:15,136,132,116,105,489,4,0
1228,3/23/2018 17:20,121,119,104,94,438,4,0
1229,3/23/2018 17:25,116,114,100,91,421,4,0
1230,3/23/2018 17:30,120,118,102,93,433,4,0
1231,3/23/2018 17:35,124,122,107,97,450,4,0
1232,3/23/2018 17:40,107,107,94,85,393,4,0
1233,3/23/2018 17:45,111,110,97,88,406,4,0
1234,3/23/2018 17:50,110,110,96,87,403,4,0
1235,3/23/2018 17:55,111,111,96,88,406,4,0
1236,3/23/2018 18:00,119,117,102,93,431,4,0
1237,3/23/2018 18:05,98,99,87,78,362,4,0
1238,3/23/2018 18:10,116,115,100,91,422,4,0
1239,3/23/2018 18:15,106,106,93,84,389,4,0
1240,3/23/2018 18:20,102,103,91,82,378,4,0
1241,3/23/2018 18:25,115,114,100,91,420,4,0
1242,3/23/2018 18:30,111,111,97,88,407,4,0
1243,3/23/2018 18:35,112,112,98,89,411,4,0
1244,3/23/2018 18:40,111,111,97,88,407,4,0
1245,3/23/2018 18:45,115,114,101,91,421,4,0
1246,3/23/2018 18:50,110,110,96,87,403,4,0
1247,3/23/2018 18:55,111,111,97,88,407,4,0
1248,3/23/2018 19:00,116,116,102,92,426,4,0
1249,3/23/2018 19:05,112,112,98,89,411,4,0
1250,3/23/2018 19:10,111,111,97,88,407,4,0
1251,3/23/2018 19:15,114,113,98,90,415,4,0
1252,3/23/2018 19:20,107,107,93,85,392,4,0
1253,3/23/2018 19:25,118,117,103,93,431,4,0
1254,3/23/2018 19:30,112,111,98,89,410,4,0
1255,3/23/2018 19:35,113,113,99,90,415,4,0
1256,3/23/2018 19:40,109,108,95,86,398,4,0
1257,3/23/2018 19:45,102,102,90,81,375,4,0
1258,3/23/2018 19:50,105,106,93,85,389,4,0
1259,3/23/2018 19:55,102,103,90,82,377,4,0
1260,3/23/2018 20:00,94,96,84,76,350,4,0
1261,3/23/2018 20:05,99,100,88,79,366,4,0
1262,3/23/2018 20:10,101,102,89,81,373,4,0
1263,3/23/2018 20:15,104,104,92,83,383,4,0
1264,3/23/2018 20:20,98,100,88,79,365,4,0
1265,3/23/2018 20:25,101,103,90,82,376,4,0
1266,3/23/2018 20:30,105,105,92,84,386,4,0
1267,3/23/2018 20:35,92,94,83,75,344,4,0
1268,3/23/2018 20:40,109,109,95,86,399,4,0
1269,3/23/2018 20:45,86,88,77,70,321,4,0
1270,3/23/2018 20:50,86,89,78,70,323,4,0
1271,3/23/2018 20:55,83,86,75,68,312,4,0
1272,3/23/2018 21:00,91,93,82,73,339,4,0
1273,3/23/2018 21:05,84,87,76,68,315,4,0
1274,3/23/2018 21:10,84,87,76,69,316,4,0
