,5 Minutes,Lane 1 Flow (Veh/5 Minutes),Lane 2 Flow (Veh/5 Minutes),Lane 3 Flow (Veh/5 Minutes),Flow (Veh/5 Minutes),# Lane Points,% Observed
0,3/01/2018 0:00,39,46,33,118,3,100.0
1,3/01/2018 0:05,34,45,31,110,3,100.0
2,3/01/2018 0:10,36,47,43,126,3,100.0
3,3/01/2018 0:15,39,53,42,134,3,100.0
4,3/01/2018 0:20,38,49,32,119,3,100.0
5,3/01/2018 0:25,31,41,22,94,3,100.0
6,3/01/2018 0:30,42,43,31,116,3,100.0
7,3/01/2018 0:35,23,38,25,86,3,100.0
8,3/01/2018 0:40,31,50,24,105,3,100.0
9,3/01/2018 0:45,26,46,29,101,3,100.0
10,3/01/2018 0:50,25,29,18,72,3,100.0
11,3/01/2018 0:55,19,38,18,75,3,100.0
12,3/01/2018 1:00,22,28,23,73,3,100.0
13,3/01/2018 1:05,32,34,23,89,3,100.0
14,3/01/2018 1:10,19,30,25,74,3,100.0
15,3/01/2018 1:15,16,38,27,81,3,100.0
16,3/01/2018 1:20,14,25,17,56,3,100.0
17,3/01/2018 1:25,15,22,20,57,3,100.0
18,3/01/2018 1:30,16,27,18,61,3,100.0
19,3/01/2018 1:35,25,31,16,72,3,100.0
20,3/01/2018 1:40,11,19,14,44,3,100.0
21,3/01/2018 1:45,19,24,30,73,3,100.0
22,3/01/2018 1:50,9,15,10,34,3,100.0
23,3/01/2018 1:55,14,21,17,52,3,100.0
24,3/01/2018 2:00,10,19,17,46,3,100.0
25,3/01/2018 2:05,15,15,17,47,3,100.0
26,3/01/2018 2:10,11,20,20,51,3,100.0
27,3/01/2018 2:15,19,37,22,78,3,100.0
28,3/01/2018 2:20,12,14,18,44,3,100.0
29,3/01/2018 2:25,9,23,19,51,3,100.0
30,3/01/2018 2:30,15,19,11,45,3,100.0
31,3/01/2018 2:35,8,14,19,41,3,100.0
32,3/01/2018 2:40,13,21,12,46,3,100.0
33,3/01/2018 2:45,14,24,26,64,3,100.0
34,3/01/2018 2:50,11,15,11,37,3,100.0
35,3/01/2018 2:55,13,13,12,38,3,100.0
36,3/01/2018 3:00,14,13,14,41,3,100.0
37,3/01/2018 3:05,16,20,20,56,3,100.0
38,3/01/2018 3:10,10,11,13,34,3,100.0
39,3/01/2018 3:15,11,22,20,53,3,100.0
40,3/01/2018 3:20,11,16,11,38,3,100.0
41,3/01/2018 3:25,10,16,14,40,3,100.0
42,3/01/2018 3:30,9,16,15,40,3,100.0
43,3/01/2018 3:35,6,23,10,39,3,100.0
44,3/01/2018 3:40,21,23,16,60,3,100.0
45,3/01/2018 3:45,10,25,22,57,3,100.0
46,3/01/2018 3:50,17,19,18,54,3,100.0
47,3/01/2018 3:55,12,20,22,54,3,100.0
48,3/01/2018 4:00,13,20,19,52,3,100.0
49,3/01/2018 4:05,18,21,13,52,3,100.0
50,3/01/2018 4:10,25,26,19,70,3,100.0
51,3/01/2018 4:15,17,33,17,67,3,100.0
52,3/01/2018 4:20,27,30,31,88,3,100.0
53,3/01/2018 4:25,37,37,27,101,3,100.0
54,3/01/2018 4:30,37,39,25,101,3,100.0
55,3/01/2018 4:35,38,39,34,111,3,100.0
56,3/01/2018 4:40,37,42,35,114,3,100.0
57,3/01/2018 4:45,41,47,40,128,3,100.0
58,3/01/2018 4:50,44,56,34,134,3,100.0
59,3/01/2018 4:55,36,39,36,111,3,100.0
60,3/01/2018 5:00,33,47,35,115,3,100.0
61,3/01/2018 5:05,56,65,33,154,3,100.0
62,3/01/2018 5:10,71,59,41,171,3,100.0
63,3/01/2018 5:15,78,91,45,214,3,100.0
64,3/01/2018 5:20,91,77,55,223,3,100.0
65,3/01/2018 5:25,103,89,62,254,3,100.0
66,3/01/2018 5:30,111,96,61,268,3,100.0
67,3/01/2018 5:35,128,111,63,302,3,100.0
68,3/01/2018 5:40,133,115,67,315,3,100.0
69,3/01/2018 5:45,143,126,76,345,3,100.0
70,3/01/2018 5:50,154,127,80,361,3,100.0
71,3/01/2018 5:55,150,114,58,322,3,100.0
72,3/01/2018 6:00,159,122,74,355,3,100.0
73,3/01/2018 6:05,148,112,60,320,3,100.0
74,3/01/2018 6:10,161,146,82,389,3,100.0
75,3/01/2018 6:15,171,154,81,406,3,100.0
76,3/01/2018 6:20,158,137,84,379,3,100.0
77,3/01/2018 6:25,170,129,101,400,3,100.0
78,3/01/2018 6:30,170,126,94,390,3,100.0
79,3/01/2018 6:35,192,156,104,452,3,100.0
80,3/01/2018 6:40,181,143,117,441,3,100.0
81,3/01/2018 6:45,164,143,118,425,3,100.0
82,3/01/2018 6:50,181,140,107,428,3,100.0
83,3/01/2018 6:55,186,160,110,456,3,100.0
84,3/01/2018 7:00,201,174,102,477,3,100.0
85,3/01/2018 7:05,194,154,112,460,3,100.0
86,3/01/2018 7:10,192,168,109,469,3,100.0
87,3/01/2018 7:15,197,164,108,469,3,100.0
88,3/01/2018 7:20,174,167,122,463,3,100.0
89,3/01/2018 7:25,185,160,107,452,3,100.0
90,3/01/2018 7:30,194,159,117,470,3,100.0
91,3/01/2018 7:35,160,156,128,444,3,100.0
92,3/01/2018 7:40,153,159,139,451,3,100.0
93,3/01/2018 7:45,159,152,137,448,3,100.0
94,3/01/2018 7:50,156,158,138,452,3,100.0
95,3/01/2018 7:55,157,135,115,407,3,100.0
96,3/01/2018 8:00,185,178,148,511,3,100.0
97,3/01/2018 8:05,183,173,129,485,3,100.0
98,3/01/2018 8:10,197,165,123,485,3,100.0
99,3/01/2018 8:15,183,161,121,465,3,100.0
100,3/01/2018 8:20,182,176,138,496,3,100.0
101,3/01/2018 8:25,168,159,117,444,3,100.0
102,3/01/2018 8:30,169,151,117,437,3,100.0
103,3/01/2018 8:35,166,148,114,428,3,100.0
104,3/01/2018 8:40,171,152,128,451,3,100.0
105,3/01/2018 8:45,186,165,134,485,3,100.0
106,3/01/2018 8:50,204,189,139,532,3,100.0
107,3/01/2018 8:55,169,151,115,435,3,100.0
108,3/01/2018 9:00,189,169,107,465,3,100.0
109,3/01/2018 9:05,167,156,122,445,3,100.0
110,3/01/2018 9:10,173,143,107,423,3,100.0
111,3/01/2018 9:15,188,163,121,472,3,100.0
112,3/01/2018 9:20,175,153,103,431,3,100.0
113,3/01/2018 9:25,165,141,98,404,3,100.0
114,3/01/2018 9:30,193,148,114,455,3,100.0
115,3/01/2018 9:35,166,129,94,389,3,100.0
116,3/01/2018 9:40,158,148,102,408,3,100.0
117,3/01/2018 9:45,183,157,125,465,3,100.0
118,3/01/2018 9:50,157,140,81,378,3,100.0
119,3/01/2018 9:55,150,126,98,374,3,100.0
120,3/01/2018 10:00,171,149,98,418,3,100.0
121,3/01/2018 10:05,165,146,112,423,3,100.0
122,3/01/2018 10:10,186,152,104,442,3,100.0
123,3/01/2018 10:15,160,148,98,406,3,100.0
124,3/01/2018 10:20,168,157,104,429,3,100.0
125,3/01/2018 10:25,164,145,99,408,3,100.0
126,3/01/2018 10:30,168,166,107,441,3,100.0
127,3/01/2018 10:35,178,154,112,444,3,100.0
128,3/01/2018 10:40,182,148,104,434,3,100.0
129,3/01/2018 10:45,169,149,113,431,3,100.0
130,3/01/2018 10:50,167,152,92,411,3,100.0
131,3/01/2018 10:55,158,124,91,373,3,100.0
132,3/01/2018 11:00,169,157,108,434,3,100.0
133,3/01/2018 11:05,157,141,92,390,3,100.0
134,3/01/2018 11:10,181,150,102,433,3,100.0
135,3/01/2018 11:15,167,154,108,429,3,100.0
136,3/01/2018 11:20,166,157,107,430,3,100.0
137,3/01/2018 11:25,172,149,108,429,3,100.0
138,3/01/2018 11:30,184,166,132,482,3,100.0
139,3/01/2018 11:35,165,153,104,422,3,100.0
140,3/01/2018 11:40,174,149,111,434,3,100.0
141,3/01/2018 11:45,172,153,124,449,3,100.0
142,3/01/2018 11:50,164,159,111,434,3,100.0
143,3/01/2018 11:55,178,158,102,438,3,100.0
144,3/01/2018 12:00,161,156,115,432,3,100.0
145,3/01/2018 12:05,178,160,103,441,3,100.0
146,3/01/2018 12:10,179,156,113,448,3,100.0
147,3/01/2018 12:15,188,152,135,475,3,100.0
148,3/01/2018 12:20,178,163,120,461,3,100.0
149,3/01/2018 12:25,179,164,114,457,3,100.0
150,3/01/2018 12:30,170,167,107,444,3,100.0
151,3/01/2018 12:35,184,154,111,449,3,100.0
152,3/01/2018 12:40,176,152,119,447,3,100.0
153,3/01/2018 12:45,185,159,129,473,3,100.0
154,3/01/2018 12:50,180,163,130,473,3,100.0
155,3/01/2018 12:55,175,163,125,463,3,100.0
156,3/01/2018 13:00,182,155,120,457,3,100.0
157,3/01/2018 13:05,186,156,119,461,3,100.0
158,3/01/2018 13:10,174,153,116,443,3,100.0
159,3/01/2018 13:15,140,131,102,373,3,100.0
160,3/01/2018 13:20,154,125,113,392,3,100.0
161,3/01/2018 13:25,137,127,103,367,3,100.0
162,3/01/2018 13:30,142,129,103,374,3,100.0
163,3/01/2018 13:35,137,132,98,367,3,100.0
164,3/01/2018 13:40,134,142,107,383,3,100.0
165,3/01/2018 13:45,155,158,131,444,3,100.0
166,3/01/2018 13:50,159,142,120,421,3,100.0
167,3/01/2018 13:55,133,133,108,374,3,100.0
168,3/01/2018 14:00,167,152,122,441,3,100.0
169,3/01/2018 14:05,143,129,108,380,3,100.0
170,3/01/2018 14:10,152,139,132,423,3,100.0
171,3/01/2018 14:15,134,145,117,396,3,100.0
172,3/01/2018 14:20,139,135,115,389,3,100.0
173,3/01/2018 14:25,143,127,121,391,3,100.0
174,3/01/2018 14:30,150,141,121,412,3,100.0
175,3/01/2018 14:35,143,149,142,434,3,100.0
176,3/01/2018 14:40,164,156,148,468,3,100.0
177,3/01/2018 14:45,153,148,130,431,3,100.0
178,3/01/2018 14:50,163,157,134,454,3,100.0
179,3/01/2018 14:55,143,149,127,419,3,100.0
180,3/01/2018 15:00,162,142,147,451,3,100.0
181,3/01/2018 15:05,155,144,128,427,3,100.0
182,3/01/2018 15:10,151,152,135,438,3,100.0
183,3/01/2018 15:15,154,151,138,443,3,100.0
184,3/01/2018 15:20,152,145,130,427,3,100.0
185,3/01/2018 15:25,153,153,135,441,3,100.0
186,3/01/2018 15:30,166,152,144,462,3,100.0
187,3/01/2018 15:35,148,140,140,428,3,100.0
188,3/01/2018 15:40,158,138,141,437,3,100.0
189,3/01/2018 15:45,130,137,129,396,3,100.0
190,3/01/2018 15:50,165,172,151,488,3,100.0
191,3/01/2018 15:55,159,167,146,472,3,100.0
192,3/01/2018 16:00,138,129,141,408,3,100.0
193,3/01/2018 16:05,121,121,113,355,3,100.0
194,3/01/2018 16:10,143,143,134,420,3,100.0
195,3/01/2018 16:15,157,144,148,449,3,100.0
196,3/01/2018 16:20,142,130,125,397,3,100.0
197,3/01/2018 16:25,113,110,108,331,3,100.0
198,3/01/2018 16:30,160,139,144,443,3,100.0
199,3/01/2018 16:35,116,118,121,355,3,100.0
200,3/01/2018 16:40,141,141,132,414,3,100.0
201,3/01/2018 16:45,149,138,131,418,3,100.0
202,3/01/2018 16:50,148,144,134,426,3,100.0
203,3/01/2018 16:55,158,148,128,434,3,100.0
204,3/01/2018 17:00,141,156,143,440,3,100.0
205,3/01/2018 17:05,156,138,132,426,3,100.0
206,3/01/2018 17:10,124,121,117,362,3,100.0
207,3/01/2018 17:15,138,138,128,404,3,100.0
208,3/01/2018 17:20,134,128,130,392,3,100.0
209,3/01/2018 17:25,160,149,140,449,3,100.0
210,3/01/2018 17:30,158,159,147,464,3,100.0
211,3/01/2018 17:35,131,119,143,393,3,100.0
212,3/01/2018 17:40,153,132,134,419,3,100.0
213,3/01/2018 17:45,128,123,119,370,3,100.0
214,3/01/2018 17:50,154,150,134,438,3,100.0
215,3/01/2018 17:55,155,136,128,419,3,100.0
216,3/01/2018 18:00,134,138,120,392,3,100.0
217,3/01/2018 18:05,159,143,127,429,3,100.0
218,3/01/2018 18:10,153,142,131,426,3,100.0
219,3/01/2018 18:15,154,131,136,421,3,100.0
220,3/01/2018 18:20,152,143,137,432,3,100.0
221,3/01/2018 18:25,143,144,136,423,3,100.0
222,3/01/2018 18:30,150,142,118,410,3,100.0
223,3/01/2018 18:35,143,146,129,418,3,100.0
224,3/01/2018 18:40,150,139,134,423,3,100.0
225,3/01/2018 18:45,149,136,130,415,3,100.0
226,3/01/2018 18:50,138,141,132,411,3,100.0
227,3/01/2018 18:55,148,136,131,415,3,100.0
228,3/01/2018 19:00,142,136,121,399,3,100.0
229,3/01/2018 19:05,153,139,124,416,3,100.0
230,3/01/2018 19:10,140,150,120,410,3,100.0
231,3/01/2018 19:15,157,125,128,410,3,100.0
232,3/01/2018 19:20,139,139,129,407,3,100.0
233,3/01/2018 19:25,147,137,124,408,3,100.0
234,3/01/2018 19:30,150,135,131,416,3,100.0
235,3/01/2018 19:35,151,143,130,424,3,100.0
236,3/01/2018 19:40,142,132,130,404,3,100.0
237,3/01/2018 19:45,156,149,120,425,3,100.0
238,3/01/2018 19:50,158,147,137,442,3,100.0
239,3/01/2018 19:55,134,131,137,402,3,100.0
240,3/01/2018 20:00,153,151,137,441,3,100.0
241,3/01/2018 20:05,151,147,129,427,3,100.0
242,3/01/2018 20:10,152,141,132,425,3,100.0
243,3/01/2018 20:15,158,133,139,430,3,100.0
244,3/01/2018 20:20,152,142,131,425,3,0.0
245,3/01/2018 20:25,150,144,130,424,3,0.0
246,3/01/2018 20:30,155,144,117,416,3,0.0
247,3/01/2018 20:35,148,131,108,387,3,0.0
248,3/01/2018 20:40,155,150,123,428,3,0.0
249,3/01/2018 20:45,144,136,109,389,3,0.0
250,3/01/2018 20:50,158,138,112,408,3,100.0
251,3/01/2018 20:55,145,138,93,376,3,100.0
252,3/01/2018 21:00,150,126,93,369,3,100.0
253,3/01/2018 21:05,133,122,86,341,3,100.0
254,3/01/2018 21:10,128,126,83,337,3,100.0
255,3/01/2018 21:15,124,112,99,335,3,100.0
256,3/01/2018 21:20,131,137,105,373,3,100.0
257,3/01/2018 21:25,140,123,80,343,3,100.0
258,3/01/2018 21:30,138,124,91,353,3,0.0
259,3/01/2018 21:35,105,100,60,265,3,100.0
260,3/01/2018 21:40,107,112,76,295,3,100.0
261,3/01/2018 21:45,99,101,69,269,3,100.0
262,3/01/2018 21:50,125,113,80,318,3,100.0
263,3/01/2018 21:55,122,116,82,320,3,100.0
264,3/01/2018 22:00,89,96,77,262,3,100.0
265,3/01/2018 22:05,109,107,79,295,3,100.0
266,3/01/2018 22:10,104,96,69,269,3,100.0
267,3/01/2018 22:15,104,111,85,300,3,100.0
268,3/01/2018 22:20,113,107,73,293,3,100.0
269,3/01/2018 22:25,98,90,61,249,3,100.0
270,3/01/2018 22:30,82,96,64,242,3,100.0
271,3/01/2018 22:35,103,107,59,269,3,100.0
272,3/01/2018 22:40,102,99,68,269,3,100.0
273,3/01/2018 22:45,82,87,60,229,3,100.0
274,3/01/2018 22:50,96,74,61,231,3,100.0
275,3/01/2018 22:55,89,98,52,239,3,100.0
276,3/01/2018 23:00,78,82,64,224,3,100.0
277,3/01/2018 23:05,77,79,43,199,3,100.0
278,3/01/2018 23:10,78,72,49,199,3,100.0
279,3/01/2018 23:15,70,79,54,203,3,100.0
280,3/01/2018 23:20,56,73,50,179,3,100.0
281,3/01/2018 23:25,73,61,53,187,3,100.0
282,3/01/2018 23:30,57,69,43,169,3,100.0
283,3/01/2018 23:35,57,70,40,167,3,100.0
284,3/01/2018 23:40,51,72,41,164,3,100.0
285,3/01/2018 23:45,70,58,44,172,3,100.0
286,3/01/2018 23:50,46,71,38,155,3,100.0
287,3/01/2018 23:55,53,60,33,146,3,100.0
288,3/02/2018 0:00,42,52,31,125,3,100.0
289,3/02/2018 0:05,48,64,34,146,3,100.0
290,3/02/2018 0:10,46,41,45,132,3,100.0
291,3/02/2018 0:15,40,51,40,131,3,100.0
292,3/02/2018 0:20,43,46,38,127,3,100.0
293,3/02/2018 0:25,42,38,31,111,3,100.0
294,3/02/2018 0:30,43,46,39,128,3,100.0
295,3/02/2018 0:35,32,41,31,104,3,100.0
296,3/02/2018 0:40,29,54,31,114,3,100.0
297,3/02/2018 0:45,32,44,27,103,3,100.0
298,3/02/2018 0:50,32,40,30,102,3,100.0
299,3/02/2018 0:55,25,33,20,78,3,100.0
300,3/02/2018 1:00,32,39,30,101,3,100.0
301,3/02/2018 1:05,28,37,33,98,3,100.0
302,3/02/2018 1:10,25,35,22,82,3,100.0
303,3/02/2018 1:15,23,31,18,72,3,100.0
304,3/02/2018 1:20,28,29,17,74,3,100.0
305,3/02/2018 1:25,12,26,20,58,3,100.0
306,3/02/2018 1:30,15,29,25,69,3,100.0
307,3/02/2018 1:35,15,25,20,60,3,100.0
308,3/02/2018 1:40,16,23,23,62,3,100.0
309,3/02/2018 1:45,15,26,14,55,3,100.0
310,3/02/2018 1:50,16,20,11,47,3,100.0
311,3/02/2018 1:55,6,20,18,44,3,100.0
312,3/02/2018 2:00,14,18,14,46,3,100.0
313,3/02/2018 2:05,11,16,11,38,3,100.0
314,3/02/2018 2:10,17,18,11,46,3,100.0
315,3/02/2018 2:15,23,24,18,65,3,100.0
316,3/02/2018 2:20,14,26,15,55,3,100.0
317,3/02/2018 2:25,21,21,16,58,3,100.0
318,3/02/2018 2:30,16,20,15,51,3,100.0
319,3/02/2018 2:35,17,22,18,57,3,100.0
320,3/02/2018 2:40,11,12,12,35,3,100.0
321,3/02/2018 2:45,9,17,10,36,3,100.0
322,3/02/2018 2:50,10,17,13,40,3,100.0
323,3/02/2018 2:55,10,25,18,53,3,100.0
324,3/02/2018 3:00,8,17,18,43,3,100.0
325,3/02/2018 3:05,5,18,17,40,3,100.0
326,3/02/2018 3:10,10,13,15,38,3,100.0
327,3/02/2018 3:15,22,23,17,62,3,100.0
328,3/02/2018 3:20,12,19,14,45,3,100.0
329,3/02/2018 3:25,11,19,20,50,3,100.0
330,3/02/2018 3:30,11,16,13,40,3,100.0
331,3/02/2018 3:35,8,20,15,43,3,100.0
332,3/02/2018 3:40,11,23,20,54,3,100.0
333,3/02/2018 3:45,11,20,14,45,3,100.0
334,3/02/2018 3:50,13,19,17,49,3,100.0
335,3/02/2018 3:55,11,26,17,54,3,100.0
336,3/02/2018 4:00,14,29,13,56,3,100.0
337,3/02/2018 4:05,15,23,13,51,3,100.0
338,3/02/2018 4:10,16,20,18,54,3,100.0
339,3/02/2018 4:15,17,37,22,76,3,100.0
340,3/02/2018 4:20,25,32,29,86,3,100.0
341,3/02/2018 4:25,34,34,32,100,3,100.0
342,3/02/2018 4:30,25,36,20,81,3,100.0
343,3/02/2018 4:35,39,46,31,116,3,100.0
344,3/02/2018 4:40,36,43,28,107,3,100.0
345,3/02/2018 4:45,48,56,35,139,3,100.0
346,3/02/2018 4:50,33,46,28,107,3,100.0
347,3/02/2018 4:55,46,47,31,124,3,100.0
348,3/02/2018 5:00,44,51,29,124,3,100.0
349,3/02/2018 5:05,56,62,30,148,3,100.0
350,3/02/2018 5:10,62,60,38,160,3,100.0
351,3/02/2018 5:15,78,74,46,198,3,100.0
352,3/02/2018 5:20,71,81,57,209,3,100.0
353,3/02/2018 5:25,98,81,52,231,3,100.0
354,3/02/2018 5:30,99,78,53,230,3,100.0
355,3/02/2018 5:35,100,83,62,245,3,100.0
356,3/02/2018 5:40,130,119,70,319,3,100.0
357,3/02/2018 5:45,118,106,64,288,3,100.0
358,3/02/2018 5:50,120,101,72,293,3,100.0
359,3/02/2018 5:55,139,117,71,327,3,100.0
360,3/02/2018 6:00,138,115,66,319,3,100.0
361,3/02/2018 6:05,136,105,67,308,3,100.0
362,3/02/2018 6:10,141,115,78,334,3,100.0
363,3/02/2018 6:15,133,103,77,313,3,100.0
364,3/02/2018 6:20,137,118,73,328,3,100.0
365,3/02/2018 6:25,154,122,79,355,3,100.0
366,3/02/2018 6:30,141,117,82,340,3,100.0
367,3/02/2018 6:35,156,137,68,361,3,100.0
368,3/02/2018 6:40,152,133,90,375,3,100.0
369,3/02/2018 6:45,174,135,104,413,3,100.0
370,3/02/2018 6:50,162,143,114,419,3,100.0
371,3/02/2018 6:55,158,134,98,390,3,100.0
372,3/02/2018 7:00,153,141,94,388,3,100.0
373,3/02/2018 7:05,152,132,98,382,3,100.0
374,3/02/2018 7:10,161,152,97,410,3,100.0
375,3/02/2018 7:15,162,152,109,423,3,100.0
376,3/02/2018 7:20,159,150,111,420,3,100.0
377,3/02/2018 7:25,150,127,93,370,3,100.0
378,3/02/2018 7:30,151,132,111,394,3,100.0
379,3/02/2018 7:35,170,145,118,433,3,100.0
380,3/02/2018 7:40,148,130,102,380,3,100.0
381,3/02/2018 7:45,160,142,100,402,3,100.0
382,3/02/2018 7:50,145,117,104,366,3,100.0
383,3/02/2018 7:55,163,143,120,426,3,100.0
384,3/02/2018 8:00,168,148,101,417,3,100.0
385,3/02/2018 8:05,150,144,110,404,3,100.0
386,3/02/2018 8:10,159,127,115,401,3,100.0
387,3/02/2018 8:15,156,139,114,409,3,100.0
388,3/02/2018 8:20,162,127,110,399,3,100.0
389,3/02/2018 8:25,157,124,91,372,3,100.0
390,3/02/2018 8:30,146,123,105,374,3,100.0
391,3/02/2018 8:35,141,142,93,376,3,100.0
392,3/02/2018 8:40,154,142,105,401,3,100.0
393,3/02/2018 8:45,149,155,111,415,3,100.0
394,3/02/2018 8:50,144,137,118,399,3,100.0
395,3/02/2018 8:55,152,135,96,383,3,100.0
396,3/02/2018 9:00,151,131,95,377,3,100.0
397,3/02/2018 9:05,147,128,106,381,3,100.0
398,3/02/2018 9:10,142,138,109,389,3,100.0
399,3/02/2018 9:15,147,131,100,378,3,100.0
400,3/02/2018 9:20,151,123,92,366,3,100.0
401,3/02/2018 9:25,145,129,108,382,3,100.0
402,3/02/2018 9:30,148,130,99,377,3,100.0
403,3/02/2018 9:35,143,144,115,402,3,100.0
404,3/02/2018 9:40,142,132,120,394,3,100.0
405,3/02/2018 9:45,139,131,119,389,3,100.0
406,3/02/2018 9:50,168,145,117,430,3,100.0
407,3/02/2018 9:55,152,144,123,419,3,100.0
408,3/02/2018 10:00,132,122,109,363,3,100.0
409,3/02/2018 10:05,134,129,97,360,3,100.0
410,3/02/2018 10:10,140,131,91,362,3,100.0
411,3/02/2018 10:15,149,126,97,372,3,100.0
412,3/02/2018 10:20,136,132,81,349,3,100.0
413,3/02/2018 10:25,141,137,96,374,3,100.0
414,3/02/2018 10:30,102,106,95,303,3,100.0
415,3/02/2018 10:35,113,106,94,313,3,100.0
416,3/02/2018 10:40,136,130,109,375,3,100.0
417,3/02/2018 10:45,147,143,103,393,3,100.0
418,3/02/2018 10:50,117,112,82,311,3,100.0
419,3/02/2018 10:55,142,127,102,371,3,100.0
420,3/02/2018 11:00,132,135,93,360,3,100.0
421,3/02/2018 11:05,140,125,94,359,3,100.0
422,3/02/2018 11:10,149,129,102,380,3,100.0
423,3/02/2018 11:15,147,142,104,393,3,100.0
424,3/02/2018 11:20,145,134,111,390,3,100.0
425,3/02/2018 11:25,158,136,109,403,3,100.0
426,3/02/2018 11:30,159,140,106,405,3,100.0
427,3/02/2018 11:35,161,156,117,434,3,100.0
428,3/02/2018 11:40,171,136,120,427,3,100.0
429,3/02/2018 11:45,161,157,110,428,3,100.0
430,3/02/2018 11:50,162,153,118,433,3,100.0
431,3/02/2018 11:55,159,160,117,436,3,100.0
432,3/02/2018 12:00,162,152,121,435,3,100.0
433,3/02/2018 12:05,164,152,111,427,3,100.0
434,3/02/2018 12:10,152,151,114,417,3,100.0
435,3/02/2018 12:15,133,130,112,375,3,100.0
436,3/02/2018 12:20,152,137,101,390,3,100.0
437,3/02/2018 12:25,141,135,114,390,3,100.0
438,3/02/2018 12:30,159,139,119,417,3,100.0
439,3/02/2018 12:35,155,144,119,418,3,100.0
440,3/02/2018 12:40,146,134,115,395,3,100.0
441,3/02/2018 12:45,140,134,128,402,3,100.0
442,3/02/2018 12:50,157,138,124,419,3,100.0
443,3/02/2018 12:55,168,150,133,451,3,100.0
444,3/02/2018 13:00,146,139,133,418,3,100.0
445,3/02/2018 13:05,165,152,121,438,3,100.0
446,3/02/2018 13:10,149,145,120,414,3,100.0
447,3/02/2018 13:15,150,140,130,420,3,100.0
448,3/02/2018 13:20,166,157,123,446,3,100.0
449,3/02/2018 13:25,162,151,142,455,3,100.0
450,3/02/2018 13:30,175,151,126,452,3,100.0
451,3/02/2018 13:35,159,150,144,453,3,100.0
452,3/02/2018 13:40,168,172,136,476,3,100.0
453,3/02/2018 13:45,162,150,132,444,3,100.0
454,3/02/2018 13:50,165,148,126,439,3,100.0
455,3/02/2018 13:55,164,155,147,466,3,100.0
456,3/02/2018 14:00,169,167,141,477,3,100.0
457,3/02/2018 14:05,177,172,153,502,3,100.0
458,3/02/2018 14:10,132,133,110,375,3,100.0
459,3/02/2018 14:15,157,145,125,427,3,100.0
460,3/02/2018 14:20,173,171,147,491,3,100.0
461,3/02/2018 14:25,161,160,138,459,3,100.0
462,3/02/2018 14:30,156,143,137,436,3,100.0
463,3/02/2018 14:35,153,158,133,444,3,100.0
464,3/02/2018 14:40,165,151,143,459,3,100.0
465,3/02/2018 14:45,158,159,125,442,3,100.0
466,3/02/2018 14:50,168,168,152,488,3,100.0
467,3/02/2018 14:55,166,153,136,455,3,100.0
468,3/02/2018 15:00,167,165,148,480,3,100.0
469,3/02/2018 15:05,168,173,151,492,3,100.0
470,3/02/2018 15:10,171,176,140,487,3,100.0
471,3/02/2018 15:15,160,162,145,467,3,100.0
472,3/02/2018 15:20,163,171,137,471,3,100.0
473,3/02/2018 15:25,157,160,130,447,3,100.0
474,3/02/2018 15:30,166,167,144,477,3,100.0
475,3/02/2018 15:35,147,129,121,397,3,100.0
476,3/02/2018 15:40,156,157,137,450,3,100.0
477,3/02/2018 15:45,173,154,148,475,3,100.0
478,3/02/2018 15:50,155,132,128,415,3,100.0
479,3/02/2018 15:55,157,145,131,433,3,100.0
480,3/02/2018 16:00,147,144,124,415,3,100.0
481,3/02/2018 16:05,141,139,122,402,3,100.0
482,3/02/2018 16:10,149,136,137,422,3,100.0
483,3/02/2018 16:15,147,139,127,413,3,100.0
484,3/02/2018 16:20,135,135,121,391,3,100.0
485,3/02/2018 16:25,141,131,129,401,3,100.0
486,3/02/2018 16:30,144,138,129,411,3,100.0
487,3/02/2018 16:35,150,147,156,453,3,100.0
488,3/02/2018 16:40,147,137,139,423,3,100.0
489,3/02/2018 16:45,147,155,136,438,3,100.0
490,3/02/2018 16:50,123,129,118,370,3,100.0
491,3/02/2018 16:55,134,123,115,372,3,100.0
492,3/02/2018 17:00,131,123,114,368,3,100.0
493,3/02/2018 17:05,142,125,118,385,3,100.0
494,3/02/2018 17:10,142,133,119,394,3,100.0
495,3/02/2018 17:15,143,125,114,382,3,100.0
496,3/02/2018 17:20,130,123,115,368,3,100.0
497,3/02/2018 17:25,124,113,104,341,3,100.0
498,3/02/2018 17:30,129,114,111,354,3,100.0
499,3/02/2018 17:35,131,124,104,359,3,100.0
500,3/02/2018 17:40,140,130,116,386,3,100.0
501,3/02/2018 17:45,135,112,121,368,3,100.0
502,3/02/2018 17:50,140,128,121,389,3,100.0
503,3/02/2018 17:55,136,131,119,386,3,100.0
504,3/02/2018 18:00,130,124,110,364,3,100.0
505,3/02/2018 18:05,139,127,122,388,3,100.0
506,3/02/2018 18:10,139,135,111,385,3,100.0
507,3/02/2018 18:15,132,117,111,360,3,100.0
508,3/02/2018 18:20,134,117,116,367,3,100.0
509,3/02/2018 18:25,124,116,103,343,3,100.0
510,3/02/2018 18:30,138,128,121,387,3,100.0
511,3/02/2018 18:35,144,132,113,389,3,100.0
512,3/02/2018 18:40,141,141,117,399,3,100.0
513,3/02/2018 18:45,145,132,121,398,3,100.0
514,3/02/2018 18:50,145,136,113,394,3,100.0
515,3/02/2018 18:55,138,136,116,390,3,100.0
516,3/02/2018 19:00,136,125,121,382,3,100.0
517,3/02/2018 19:05,150,142,125,417,3,100.0
518,3/02/2018 19:10,140,120,117,377,3,100.0
519,3/02/2018 19:15,147,135,123,405,3,100.0
520,3/02/2018 19:20,146,135,121,402,3,100.0
521,3/02/2018 19:25,144,123,133,400,3,100.0
522,3/02/2018 19:30,138,129,120,387,3,100.0
523,3/02/2018 19:35,142,129,111,382,3,100.0
524,3/02/2018 19:40,121,120,112,353,3,100.0
525,3/02/2018 19:45,135,130,121,386,3,100.0
526,3/02/2018 19:50,144,137,127,408,3,100.0
527,3/02/2018 19:55,143,134,123,400,3,100.0
528,3/02/2018 20:00,141,133,128,402,3,100.0
529,3/02/2018 20:05,148,134,128,410,3,100.0
530,3/02/2018 20:10,142,137,122,401,3,100.0
531,3/02/2018 20:15,142,131,132,405,3,100.0
532,3/02/2018 20:20,150,146,130,426,3,100.0
533,3/02/2018 20:25,153,140,128,421,3,100.0
534,3/02/2018 20:30,162,143,126,431,3,100.0
535,3/02/2018 20:35,149,137,110,396,3,100.0
536,3/02/2018 20:40,159,144,92,395,3,100.0
537,3/02/2018 20:45,150,126,94,370,3,100.0
538,3/02/2018 20:50,144,132,90,366,3,100.0
539,3/02/2018 20:55,145,131,84,360,3,100.0
540,3/02/2018 21:00,131,114,92,337,3,100.0
541,3/02/2018 21:05,143,127,86,356,3,100.0
542,3/02/2018 21:10,134,114,81,329,3,100.0
543,3/02/2018 21:15,123,113,76,312,3,100.0
544,3/02/2018 21:20,133,111,83,327,3,100.0
545,3/02/2018 21:25,123,101,85,309,3,100.0
546,3/02/2018 21:30,122,116,87,325,3,100.0
547,3/02/2018 21:35,121,108,76,305,3,100.0
548,3/02/2018 21:40,138,131,92,361,3,100.0
549,3/02/2018 21:45,121,118,78,317,3,100.0
550,3/02/2018 21:50,118,106,69,293,3,100.0
551,3/02/2018 21:55,112,94,71,277,3,100.0
552,3/02/2018 22:00,127,119,87,333,3,100.0
553,3/02/2018 22:05,89,85,66,240,3,100.0
554,3/02/2018 22:10,105,99,78,282,3,100.0
555,3/02/2018 22:15,113,115,79,307,3,100.0
556,3/02/2018 22:20,95,99,78,272,3,100.0
557,3/02/2018 22:25,121,82,73,276,3,100.0
558,3/02/2018 22:30,89,94,71,254,3,100.0
559,3/02/2018 22:35,108,88,69,265,3,100.0
560,3/02/2018 22:40,108,99,77,284,3,100.0
561,3/02/2018 22:45,94,96,61,251,3,100.0
562,3/02/2018 22:50,80,82,48,210,3,100.0
563,3/02/2018 22:55,91,83,54,228,3,100.0
564,3/02/2018 23:00,75,79,67,221,3,100.0
565,3/02/2018 23:05,78,74,58,210,3,100.0
566,3/02/2018 23:10,74,72,54,200,3,100.0
567,3/02/2018 23:15,81,70,59,210,3,100.0
568,3/02/2018 23:20,86,80,54,220,3,100.0
569,3/02/2018 23:25,79,80,66,225,3,100.0
570,3/02/2018 23:30,61,71,51,183,3,100.0
571,3/02/2018 23:35,79,73,47,199,3,100.0
572,3/02/2018 23:40,66,79,48,193,3,100.0
573,3/02/2018 23:45,69,81,50,200,3,100.0
574,3/02/2018 23:50,64,72,50,186,3,100.0
575,3/02/2018 23:55,70,69,49,188,3,100.0
576,3/03/2018 0:00,69,69,44,182,3,100.0
577,3/03/2018 0:05,63,67,46,176,3,100.0
578,3/03/2018 0:10,53,68,48,169,3,100.0
579,3/03/2018 0:15,60,58,44,162,3,100.0
580,3/03/2018 0:20,47,59,37,143,3,100.0
581,3/03/2018 0:25,37,55,38,130,3,100.0
582,3/03/2018 0:30,46,54,39,139,3,100.0
583,3/03/2018 0:35,39,54,36,129,3,100.0
584,3/03/2018 0:40,42,42,36,120,3,100.0
585,3/03/2018 0:45,44,51,31,126,3,100.0
586,3/03/2018 0:50,43,41,33,117,3,100.0
587,3/03/2018 0:55,46,37,32,115,3,100.0
588,3/03/2018 1:00,32,46,25,103,3,100.0
589,3/03/2018 1:05,22,39,27,88,3,100.0
590,3/03/2018 1:10,32,40,24,96,3,100.0
591,3/03/2018 1:15,30,43,30,103,3,100.0
592,3/03/2018 1:20,34,35,22,91,3,100.0
593,3/03/2018 1:25,24,31,28,83,3,100.0
594,3/03/2018 1:30,19,32,18,69,3,100.0
595,3/03/2018 1:35,21,22,23,66,3,100.0
596,3/03/2018 1:40,27,37,17,81,3,100.0
597,3/03/2018 1:45,20,27,21,68,3,100.0
598,3/03/2018 1:50,28,28,26,82,3,100.0
599,3/03/2018 1:55,20,32,17,69,3,100.0
600,3/03/2018 2:00,22,28,18,68,3,100.0
601,3/03/2018 2:05,28,34,27,89,3,100.0
602,3/03/2018 2:10,15,18,19,52,3,100.0
603,3/03/2018 2:15,21,27,27,75,3,100.0
604,3/03/2018 2:20,18,25,21,64,3,100.0
605,3/03/2018 2:25,21,38,20,79,3,100.0
606,3/03/2018 2:30,22,32,26,80,3,100.0
607,3/03/2018 2:35,23,32,18,73,3,100.0
608,3/03/2018 2:40,17,24,18,59,3,100.0
609,3/03/2018 2:45,21,31,27,79,3,100.0
610,3/03/2018 2:50,18,27,16,61,3,100.0
611,3/03/2018 2:55,11,25,20,56,3,100.0
612,3/03/2018 3:00,13,21,14,48,3,100.0
613,3/03/2018 3:05,12,25,16,53,3,100.0
614,3/03/2018 3:10,11,27,11,49,3,100.0
615,3/03/2018 3:15,15,22,15,52,3,100.0
616,3/03/2018 3:20,20,20,15,55,3,100.0
617,3/03/2018 3:25,12,20,15,47,3,100.0
618,3/03/2018 3:30,13,21,18,52,3,100.0
619,3/03/2018 3:35,11,17,7,35,3,100.0
620,3/03/2018 3:40,8,24,13,45,3,100.0
621,3/03/2018 3:45,13,21,14,48,3,100.0
622,3/03/2018 3:50,16,13,11,40,3,100.0
623,3/03/2018 3:55,15,15,12,42,3,100.0
624,3/03/2018 4:00,8,23,16,47,3,100.0
625,3/03/2018 4:05,13,20,12,45,3,100.0
626,3/03/2018 4:10,19,15,19,53,3,100.0
627,3/03/2018 4:15,17,24,11,52,3,100.0
628,3/03/2018 4:20,12,24,19,55,3,100.0
629,3/03/2018 4:25,14,22,18,54,3,100.0
630,3/03/2018 4:30,26,31,20,77,3,100.0
631,3/03/2018 4:35,20,29,22,71,3,100.0
632,3/03/2018 4:40,17,33,12,62,3,100.0
633,3/03/2018 4:45,18,17,16,51,3,100.0
634,3/03/2018 4:50,21,24,12,57,3,100.0
635,3/03/2018 4:55,16,31,24,71,3,100.0
636,3/03/2018 5:00,21,25,23,69,3,100.0
637,3/03/2018 5:05,29,38,28,95,3,100.0
638,3/03/2018 5:10,36,28,31,95,3,100.0
639,3/03/2018 5:15,32,44,29,105,3,100.0
640,3/03/2018 5:20,44,48,30,122,3,100.0
641,3/03/2018 5:25,41,53,30,124,3,100.0
642,3/03/2018 5:30,32,43,36,111,3,100.0
643,3/03/2018 5:35,55,58,34,147,3,100.0
644,3/03/2018 5:40,53,67,31,151,3,100.0
645,3/03/2018 5:45,55,56,38,149,3,100.0
646,3/03/2018 5:50,54,51,43,148,3,100.0
647,3/03/2018 5:55,56,54,43,153,3,100.0
648,3/03/2018 6:00,64,58,35,157,3,100.0
649,3/03/2018 6:05,43,52,29,124,3,100.0
650,3/03/2018 6:10,56,63,40,159,3,100.0
651,3/03/2018 6:15,51,74,36,161,3,100.0
652,3/03/2018 6:20,65,80,48,193,3,100.0
653,3/03/2018 6:25,76,72,44,192,3,100.0
654,3/03/2018 6:30,65,87,51,203,3,100.0
655,3/03/2018 6:35,82,81,51,214,3,100.0
656,3/03/2018 6:40,72,90,42,204,3,100.0
657,3/03/2018 6:45,81,96,73,250,3,100.0
658,3/03/2018 6:50,93,99,62,254,3,100.0
659,3/03/2018 6:55,87,76,54,217,3,100.0
660,3/03/2018 7:00,86,88,59,233,3,100.0
661,3/03/2018 7:05,91,96,57,244,3,100.0
662,3/03/2018 7:10,94,94,63,251,3,100.0
663,3/03/2018 7:15,70,67,44,181,3,100.0
664,3/03/2018 7:20,109,94,76,279,3,100.0
665,3/03/2018 7:25,112,102,72,286,3,100.0
666,3/03/2018 7:30,112,118,80,310,3,100.0
667,3/03/2018 7:35,115,107,65,287,3,100.0
668,3/03/2018 7:40,105,114,87,306,3,100.0
669,3/03/2018 7:45,90,89,67,246,3,100.0
670,3/03/2018 7:50,98,104,71,273,3,100.0
671,3/03/2018 7:55,134,108,72,314,3,100.0
672,3/03/2018 8:00,121,115,78,314,3,100.0
673,3/03/2018 8:05,127,108,68,303,3,100.0
674,3/03/2018 8:10,112,117,75,304,3,100.0
675,3/03/2018 8:15,129,108,88,325,3,100.0
676,3/03/2018 8:20,110,106,78,294,3,100.0
677,3/03/2018 8:25,116,110,88,314,3,100.0
678,3/03/2018 8:30,134,132,80,346,3,100.0
679,3/03/2018 8:35,140,143,93,376,3,100.0
680,3/03/2018 8:40,133,113,78,324,3,100.0
681,3/03/2018 8:45,138,129,82,349,3,100.0
682,3/03/2018 8:50,124,120,71,315,3,100.0
683,3/03/2018 8:55,110,123,73,306,3,100.0
684,3/03/2018 9:00,127,121,79,327,3,100.0
685,3/03/2018 9:05,119,113,74,306,3,100.0
686,3/03/2018 9:10,114,123,79,316,3,100.0
687,3/03/2018 9:15,132,122,76,330,3,100.0
688,3/03/2018 9:20,145,138,101,384,3,100.0
689,3/03/2018 9:25,166,159,89,414,3,100.0
690,3/03/2018 9:30,171,139,97,407,3,100.0
691,3/03/2018 9:35,164,159,97,420,3,100.0
692,3/03/2018 9:40,173,157,115,445,3,100.0
693,3/03/2018 9:45,165,137,98,400,3,100.0
694,3/03/2018 9:50,166,152,100,418,3,100.0
695,3/03/2018 9:55,152,147,90,389,3,100.0
696,3/03/2018 10:00,168,146,102,416,3,100.0
697,3/03/2018 10:05,158,144,95,397,3,100.0
698,3/03/2018 10:10,163,161,102,426,3,100.0
699,3/03/2018 10:15,155,154,98,407,3,100.0
700,3/03/2018 10:20,188,164,124,476,3,100.0
701,3/03/2018 10:25,176,158,106,440,3,100.0
702,3/03/2018 10:30,192,165,115,472,3,100.0
703,3/03/2018 10:35,171,162,108,441,3,100.0
704,3/03/2018 10:40,177,160,113,450,3,100.0
705,3/03/2018 10:45,170,147,112,429,3,100.0
706,3/03/2018 10:50,185,155,115,455,3,100.0
707,3/03/2018 10:55,156,154,109,419,3,100.0
708,3/03/2018 11:00,167,147,107,421,3,100.0
709,3/03/2018 11:05,177,168,111,456,3,100.0
710,3/03/2018 11:10,166,147,110,423,3,100.0
711,3/03/2018 11:15,174,153,108,435,3,100.0
712,3/03/2018 11:20,157,150,108,415,3,100.0
713,3/03/2018 11:25,176,153,103,432,3,100.0
714,3/03/2018 11:30,169,146,106,421,3,100.0
715,3/03/2018 11:35,176,160,107,443,3,100.0
716,3/03/2018 11:40,158,160,107,425,3,100.0
717,3/03/2018 11:45,169,154,128,451,3,100.0
718,3/03/2018 11:50,166,149,110,425,3,100.0
719,3/03/2018 11:55,159,156,102,417,3,100.0
720,3/03/2018 12:00,164,160,112,436,3,100.0
721,3/03/2018 12:05,179,160,127,466,3,100.0
722,3/03/2018 12:10,180,152,137,469,3,100.0
723,3/03/2018 12:15,158,152,119,429,3,100.0
724,3/03/2018 12:20,152,140,88,380,3,100.0
725,3/03/2018 12:25,187,164,127,478,3,100.0
726,3/03/2018 12:30,156,162,114,432,3,100.0
727,3/03/2018 12:35,166,155,115,436,3,100.0
728,3/03/2018 12:40,180,158,126,464,3,100.0
729,3/03/2018 12:45,143,138,106,387,3,100.0
730,3/03/2018 12:50,126,126,93,345,3,100.0
731,3/03/2018 12:55,156,152,117,425,3,100.0
732,3/03/2018 13:00,180,165,115,460,3,100.0
733,3/03/2018 13:05,168,160,128,456,3,100.0
734,3/03/2018 13:10,183,155,116,454,3,100.0
735,3/03/2018 13:15,158,160,113,431,3,100.0
736,3/03/2018 13:20,185,166,132,483,3,100.0
737,3/03/2018 13:25,164,154,115,433,3,100.0
738,3/03/2018 13:30,174,146,105,425,3,100.0
739,3/03/2018 13:35,178,157,128,463,3,100.0
740,3/03/2018 13:40,172,153,127,452,3,100.0
741,3/03/2018 13:45,190,162,132,484,3,100.0
742,3/03/2018 13:50,169,165,115,449,3,100.0
743,3/03/2018 13:55,165,153,118,436,3,100.0
744,3/03/2018 14:00,174,158,115,447,3,100.0
745,3/03/2018 14:05,183,159,127,469,3,100.0
746,3/03/2018 14:10,165,157,111,433,3,100.0
747,3/03/2018 14:15,160,154,116,430,3,100.0
748,3/03/2018 14:20,164,160,131,455,3,100.0
749,3/03/2018 14:25,161,147,115,423,3,100.0
750,3/03/2018 14:30,172,158,124,454,3,100.0
751,3/03/2018 14:35,162,153,116,431,3,100.0
752,3/03/2018 14:40,172,174,136,482,3,100.0
753,3/03/2018 14:45,172,151,112,435,3,100.0
754,3/03/2018 14:50,153,146,124,423,3,100.0
755,3/03/2018 14:55,166,162,122,450,3,100.0
756,3/03/2018 15:00,175,168,132,475,3,100.0
757,3/03/2018 15:05,159,153,139,451,3,100.0
758,3/03/2018 15:10,177,160,137,474,3,100.0
759,3/03/2018 15:15,176,168,138,482,3,100.0
760,3/03/2018 15:20,159,161,121,441,3,100.0
761,3/03/2018 15:25,159,171,131,461,3,100.0
762,3/03/2018 15:30,160,166,134,460,3,100.0
763,3/03/2018 15:35,163,163,136,462,3,100.0
764,3/03/2018 15:40,165,150,137,452,3,100.0
765,3/03/2018 15:45,168,168,149,485,3,100.0
766,3/03/2018 15:50,163,151,131,445,3,100.0
767,3/03/2018 15:55,162,158,138,458,3,100.0
768,3/03/2018 16:00,161,140,133,434,3,100.0
769,3/03/2018 16:05,158,154,117,429,3,100.0
770,3/03/2018 16:10,155,168,124,447,3,100.0
771,3/03/2018 16:15,158,154,126,438,3,100.0
772,3/03/2018 16:20,180,159,145,484,3,100.0
773,3/03/2018 16:25,175,155,136,466,3,100.0
774,3/03/2018 16:30,141,157,108,406,3,100.0
775,3/03/2018 16:35,159,152,131,442,3,100.0
776,3/03/2018 16:40,152,161,112,425,3,100.0
777,3/03/2018 16:45,146,153,114,413,3,100.0
778,3/03/2018 16:50,159,160,118,437,3,100.0
779,3/03/2018 16:55,159,159,127,445,3,100.0
780,3/03/2018 17:00,163,169,134,466,3,100.0
781,3/03/2018 17:05,170,156,145,471,3,100.0
782,3/03/2018 17:10,157,156,130,443,3,100.0
783,3/03/2018 17:15,166,159,144,469,3,100.0
784,3/03/2018 17:20,172,147,130,449,3,100.0
785,3/03/2018 17:25,152,148,117,417,3,100.0
786,3/03/2018 17:30,152,143,130,425,3,100.0
787,3/03/2018 17:35,168,154,125,447,3,100.0
788,3/03/2018 17:40,159,154,114,427,3,100.0
789,3/03/2018 17:45,159,161,124,444,3,100.0
790,3/03/2018 17:50,172,157,115,444,3,100.0
791,3/03/2018 17:55,147,124,110,381,3,100.0
792,3/03/2018 18:00,151,144,102,397,3,100.0
793,3/03/2018 18:05,135,137,112,384,3,100.0
794,3/03/2018 18:10,152,141,122,415,3,100.0
795,3/03/2018 18:15,140,126,101,367,3,100.0
796,3/03/2018 18:20,156,160,111,427,3,100.0
797,3/03/2018 18:25,135,151,117,403,3,100.0
798,3/03/2018 18:30,139,141,98,378,3,100.0
799,3/03/2018 18:35,145,141,101,387,3,100.0
800,3/03/2018 18:40,138,139,93,370,3,100.0
801,3/03/2018 18:45,133,121,94,348,3,100.0
802,3/03/2018 18:50,126,129,108,363,3,100.0
803,3/03/2018 18:55,119,97,74,290,3,100.0
804,3/03/2018 19:00,126,119,79,324,3,100.0
805,3/03/2018 19:05,124,114,90,328,3,100.0
806,3/03/2018 19:10,144,138,93,375,3,100.0
807,3/03/2018 19:15,121,116,93,330,3,100.0
808,3/03/2018 19:20,128,112,85,325,3,100.0
809,3/03/2018 19:25,137,123,99,359,3,100.0
810,3/03/2018 19:30,129,118,83,330,3,100.0
811,3/03/2018 19:35,134,118,96,348,3,100.0
812,3/03/2018 19:40,105,102,77,284,3,100.0
813,3/03/2018 19:45,121,113,87,321,3,100.0
814,3/03/2018 19:50,124,107,82,313,3,100.0
815,3/03/2018 19:55,122,127,76,325,3,100.0
816,3/03/2018 20:00,110,119,74,303,3,100.0
817,3/03/2018 20:05,107,109,86,302,3,100.0
818,3/03/2018 20:10,118,113,91,322,3,100.0
819,3/03/2018 20:15,119,112,83,314,3,100.0
820,3/03/2018 20:20,116,106,78,300,3,100.0
821,3/03/2018 20:25,114,100,91,305,3,100.0
822,3/03/2018 20:30,108,100,74,282,3,100.0
823,3/03/2018 20:35,122,105,74,301,3,100.0
824,3/03/2018 20:40,118,98,94,310,3,100.0
825,3/03/2018 20:45,116,106,71,293,3,100.0
826,3/03/2018 20:50,99,106,73,278,3,100.0
827,3/03/2018 20:55,117,114,98,329,3,100.0
828,3/03/2018 21:00,104,102,69,275,3,100.0
829,3/03/2018 21:05,98,110,68,276,3,100.0
830,3/03/2018 21:10,96,92,85,273,3,100.0
831,3/03/2018 21:15,101,110,74,285,3,100.0
832,3/03/2018 21:20,114,121,83,318,3,100.0
833,3/03/2018 21:25,95,86,66,247,3,100.0
834,3/03/2018 21:30,106,100,70,276,3,100.0
835,3/03/2018 21:35,102,112,76,290,3,100.0
836,3/03/2018 21:40,122,98,83,303,3,100.0
837,3/03/2018 21:45,119,123,73,315,3,100.0
838,3/03/2018 21:50,107,106,76,289,3,100.0
839,3/03/2018 21:55,107,105,76,288,3,100.0
840,3/03/2018 22:00,111,107,77,295,3,100.0
841,3/03/2018 22:05,97,104,78,279,3,100.0
842,3/03/2018 22:10,104,111,84,299,3,100.0
843,3/03/2018 22:15,116,103,69,288,3,100.0
844,3/03/2018 22:20,100,92,70,262,3,100.0
845,3/03/2018 22:25,90,85,65,240,3,100.0
846,3/03/2018 22:30,97,100,62,259,3,100.0
847,3/03/2018 22:35,99,82,69,250,3,100.0
848,3/03/2018 22:40,93,88,62,243,3,100.0
849,3/03/2018 22:45,93,86,66,245,3,100.0
850,3/03/2018 22:50,86,106,69,261,3,100.0
851,3/03/2018 22:55,67,76,41,184,3,100.0
852,3/03/2018 23:00,71,78,74,223,3,100.0
853,3/03/2018 23:05,85,83,68,236,3,100.0
854,3/03/2018 23:10,70,73,64,207,3,100.0
855,3/03/2018 23:15,64,65,53,182,3,100.0
856,3/03/2018 23:20,68,63,47,178,3,100.0
857,3/03/2018 23:25,67,81,67,215,3,100.0
858,3/03/2018 23:30,73,79,47,199,3,100.0
859,3/03/2018 23:35,71,79,53,203,3,100.0
860,3/03/2018 23:40,68,63,46,177,3,100.0
861,3/03/2018 23:45,66,73,41,180,3,100.0
862,3/03/2018 23:50,76,77,54,207,3,100.0
863,3/03/2018 23:55,60,59,49,168,3,100.0
864,3/04/2018 0:00,56,82,50,188,3,100.0
865,3/04/2018 0:05,65,75,43,183,3,100.0
866,3/04/2018 0:10,42,57,43,142,3,100.0
867,3/04/2018 0:15,46,61,55,162,3,100.0
868,3/04/2018 0:20,52,54,47,153,3,100.0
869,3/04/2018 0:25,48,55,36,139,3,100.0
870,3/04/2018 0:30,44,57,40,141,3,100.0
871,3/04/2018 0:35,45,58,34,137,3,100.0
872,3/04/2018 0:40,55,40,29,124,3,100.0
873,3/04/2018 0:45,41,43,42,126,3,100.0
874,3/04/2018 0:50,42,47,37,126,3,100.0
875,3/04/2018 0:55,31,50,32,113,3,100.0
876,3/04/2018 1:00,28,40,34,102,3,100.0
877,3/04/2018 1:05,29,34,29,92,3,100.0
878,3/04/2018 1:10,30,37,27,94,3,100.0
879,3/04/2018 1:15,33,40,30,103,3,100.0
880,3/04/2018 1:20,36,39,28,103,3,100.0
881,3/04/2018 1:25,20,31,28,79,3,100.0
882,3/04/2018 1:30,26,29,22,77,3,100.0
883,3/04/2018 1:35,29,35,28,92,3,100.0
884,3/04/2018 1:40,23,40,21,84,3,100.0
885,3/04/2018 1:45,19,24,24,67,3,100.0
886,3/04/2018 1:50,17,21,21,59,3,100.0
887,3/04/2018 1:55,23,35,27,85,3,100.0
888,3/04/2018 2:00,17,21,30,68,3,100.0
889,3/04/2018 2:05,24,21,21,66,3,100.0
890,3/04/2018 2:10,20,31,20,71,3,100.0
891,3/04/2018 2:15,13,21,24,58,3,100.0
892,3/04/2018 2:20,19,28,23,70,3,100.0
893,3/04/2018 2:25,5,13,9,27,3,100.0
894,3/04/2018 2:30,22,35,19,76,3,100.0
895,3/04/2018 2:35,17,32,18,67,3,100.0
896,3/04/2018 2:40,19,22,20,61,3,100.0
897,3/04/2018 2:45,15,26,17,58,3,100.0
898,3/04/2018 2:50,14,29,21,64,3,100.0
899,3/04/2018 2:55,15,29,19,63,3,100.0
900,3/04/2018 3:00,13,20,11,44,3,100.0
901,3/04/2018 3:05,14,23,11,48,3,100.0
902,3/04/2018 3:10,15,20,14,49,3,100.0
903,3/04/2018 3:15,11,20,12,43,3,100.0
904,3/04/2018 3:20,12,22,15,49,3,100.0
905,3/04/2018 3:25,7,20,21,48,3,100.0
906,3/04/2018 3:30,11,18,12,41,3,100.0
907,3/04/2018 3:35,15,16,15,46,3,100.0
908,3/04/2018 3:40,9,16,11,36,3,100.0
909,3/04/2018 3:45,10,18,9,37,3,100.0
910,3/04/2018 3:50,10,23,17,50,3,100.0
911,3/04/2018 3:55,8,17,13,38,3,100.0
912,3/04/2018 4:00,7,10,7,24,3,100.0
913,3/04/2018 4:05,8,19,14,41,3,100.0
914,3/04/2018 4:10,12,15,15,42,3,100.0
915,3/04/2018 4:15,7,21,13,41,3,100.0
916,3/04/2018 4:20,14,21,14,49,3,100.0
917,3/04/2018 4:25,15,19,14,48,3,100.0
918,3/04/2018 4:30,3,15,14,32,3,100.0
919,3/04/2018 4:35,8,19,12,39,3,100.0
920,3/04/2018 4:40,11,23,13,47,3,100.0
921,3/04/2018 4:45,11,28,12,51,3,100.0
922,3/04/2018 4:50,7,22,21,50,3,100.0
923,3/04/2018 4:55,16,22,21,59,3,100.0
924,3/04/2018 5:00,10,23,16,49,3,100.0
925,3/04/2018 5:05,11,21,13,45,3,100.0
926,3/04/2018 5:10,20,29,20,69,3,100.0
927,3/04/2018 5:15,28,35,21,84,3,100.0
928,3/04/2018 5:20,23,31,23,77,3,100.0
929,3/04/2018 5:25,26,37,18,81,3,100.0
930,3/04/2018 5:30,17,34,26,77,3,100.0
931,3/04/2018 5:35,30,36,31,97,3,100.0
932,3/04/2018 5:40,24,51,28,103,3,100.0
933,3/04/2018 5:45,29,46,22,97,3,100.0
934,3/04/2018 5:50,24,41,28,93,3,100.0
935,3/04/2018 5:55,33,43,33,109,3,100.0
936,3/04/2018 6:00,25,46,32,103,3,100.0
937,3/04/2018 6:05,22,41,30,93,3,100.0
938,3/04/2018 6:10,41,49,35,125,3,100.0
939,3/04/2018 6:15,34,50,36,120,3,100.0
940,3/04/2018 6:20,30,50,33,113,3,100.0
941,3/04/2018 6:25,59,53,35,147,3,100.0
942,3/04/2018 6:30,49,48,45,142,3,100.0
943,3/04/2018 6:35,55,68,32,155,3,100.0
944,3/04/2018 6:40,48,69,44,161,3,100.0
945,3/04/2018 6:45,52,59,43,154,3,100.0
946,3/04/2018 6:50,57,52,35,144,3,100.0
947,3/04/2018 6:55,44,60,44,148,3,100.0
948,3/04/2018 7:00,41,54,39,134,3,100.0
949,3/04/2018 7:05,49,52,41,142,3,100.0
950,3/04/2018 7:10,67,64,43,174,3,100.0
951,3/04/2018 7:15,72,75,48,195,3,100.0
952,3/04/2018 7:20,71,78,45,194,3,100.0
953,3/04/2018 7:25,67,76,55,198,3,100.0
954,3/04/2018 7:30,60,70,50,180,3,100.0
955,3/04/2018 7:35,60,80,56,196,3,100.0
956,3/04/2018 7:40,67,79,61,207,3,100.0
957,3/04/2018 7:45,76,76,58,210,3,100.0
958,3/04/2018 7:50,78,80,59,217,3,100.0
959,3/04/2018 7:55,64,92,54,210,3,100.0
960,3/04/2018 8:00,71,80,63,214,3,100.0
961,3/04/2018 8:05,66,89,57,212,3,100.0
962,3/04/2018 8:10,76,84,49,209,3,100.0
963,3/04/2018 8:15,96,96,58,250,3,100.0
964,3/04/2018 8:20,99,102,61,262,3,100.0
965,3/04/2018 8:25,85,103,58,246,3,100.0
966,3/04/2018 8:30,87,94,66,247,3,100.0
967,3/04/2018 8:35,101,108,54,263,3,100.0
968,3/04/2018 8:40,81,114,58,253,3,100.0
969,3/04/2018 8:45,91,105,70,266,3,100.0
970,3/04/2018 8:50,106,94,60,260,3,100.0
971,3/04/2018 8:55,99,95,69,263,3,100.0
972,3/04/2018 9:00,106,100,66,272,3,100.0
973,3/04/2018 9:05,111,111,79,301,3,100.0
974,3/04/2018 9:10,95,95,72,262,3,100.0
975,3/04/2018 9:15,112,114,79,305,3,100.0
976,3/04/2018 9:20,113,123,84,320,3,100.0
977,3/04/2018 9:25,130,111,96,337,3,100.0
978,3/04/2018 9:30,111,109,106,326,3,100.0
979,3/04/2018 9:35,134,124,87,345,3,100.0
980,3/04/2018 9:40,127,108,88,323,3,100.0
981,3/04/2018 9:45,130,120,100,350,3,100.0
982,3/04/2018 9:50,143,142,91,376,3,100.0
983,3/04/2018 9:55,122,111,89,322,3,100.0
984,3/04/2018 10:00,127,118,77,322,3,100.0
985,3/04/2018 10:05,117,124,78,319,3,100.0
986,3/04/2018 10:10,138,134,101,373,3,100.0
987,3/04/2018 10:15,146,128,93,367,3,100.0
988,3/04/2018 10:20,162,143,104,409,3,100.0
989,3/04/2018 10:25,149,153,101,403,3,100.0
990,3/04/2018 10:30,162,158,103,423,3,100.0
991,3/04/2018 10:35,132,134,97,363,3,100.0
992,3/04/2018 10:40,167,146,96,409,3,100.0
993,3/04/2018 10:45,145,132,113,390,3,100.0
994,3/04/2018 10:50,162,149,120,431,3,100.0
995,3/04/2018 10:55,131,124,102,357,3,100.0
996,3/04/2018 11:00,132,132,93,357,3,100.0
997,3/04/2018 11:05,134,134,95,363,3,100.0
998,3/04/2018 11:10,176,153,128,457,3,100.0
999,3/04/2018 11:15,181,152,108,441,3,100.0
1000,3/04/2018 11:20,152,139,101,392,3,100.0
1001,3/04/2018 11:25,170,146,99,415,3,100.0
1002,3/04/2018 11:30,163,154,106,423,3,100.0
1003,3/04/2018 11:35,156,147,111,414,3,100.0
1004,3/04/2018 11:40,170,142,114,426,3,100.0
1005,3/04/2018 11:45,161,130,105,396,3,100.0
1006,3/04/2018 11:50,161,139,101,401,3,100.0
1007,3/04/2018 11:55,143,136,95,374,3,100.0
1008,3/04/2018 12:00,159,160,116,435,3,100.0
1009,3/04/2018 12:05,152,130,101,383,3,100.0
1010,3/04/2018 12:10,157,141,124,422,3,100.0
1011,3/04/2018 12:15,163,155,119,437,3,100.0
1012,3/04/2018 12:20,183,154,114,451,3,100.0
1013,3/04/2018 12:25,174,180,119,473,3,100.0
1014,3/04/2018 12:30,152,151,113,416,3,100.0
1015,3/04/2018 12:35,169,146,118,433,3,100.0
1016,3/04/2018 12:40,159,151,107,417,3,100.0
1017,3/04/2018 12:45,162,136,108,406,3,100.0
1018,3/04/2018 12:50,174,151,107,432,3,100.0
1019,3/04/2018 12:55,151,159,108,418,3,100.0
1020,3/04/2018 13:00,151,150,97,398,3,100.0
1021,3/04/2018 13:05,162,156,125,443,3,100.0
1022,3/04/2018 13:10,167,149,111,427,3,100.0
1023,3/04/2018 13:15,153,143,100,396,3,100.0
1024,3/04/2018 13:20,166,155,131,452,3,100.0
1025,3/04/2018 13:25,159,154,128,441,3,100.0
1026,3/04/2018 13:30,156,142,96,394,3,100.0
1027,3/04/2018 13:35,160,141,132,433,3,100.0
1028,3/04/2018 13:40,154,151,110,415,3,100.0
1029,3/04/2018 13:45,152,148,129,429,3,100.0
1030,3/04/2018 13:50,162,147,114,423,3,100.0
1031,3/04/2018 13:55,142,139,120,401,3,100.0
1032,3/04/2018 14:00,154,156,116,426,3,100.0
1033,3/04/2018 14:05,150,147,117,414,3,100.0
1034,3/04/2018 14:10,155,149,105,409,3,100.0
1035,3/04/2018 14:15,174,163,124,461,3,100.0
1036,3/04/2018 14:20,163,152,118,433,3,100.0
1037,3/04/2018 14:25,161,154,124,439,3,100.0
1038,3/04/2018 14:30,168,149,120,437,3,100.0
1039,3/04/2018 14:35,156,156,122,434,3,100.0
1040,3/04/2018 14:40,163,146,115,424,3,100.0
1041,3/04/2018 14:45,155,159,119,433,3,100.0
1042,3/04/2018 14:50,169,164,129,462,3,100.0
1043,3/04/2018 14:55,159,143,116,418,3,100.0
1044,3/04/2018 15:00,159,141,113,413,3,100.0
1045,3/04/2018 15:05,138,117,100,355,3,100.0
1046,3/04/2018 15:10,174,162,120,456,3,100.0
1047,3/04/2018 15:15,170,155,111,436,3,100.0
1048,3/04/2018 15:20,141,153,109,403,3,100.0
1049,3/04/2018 15:25,168,162,125,455,3,100.0
1050,3/04/2018 15:30,160,151,120,431,3,100.0
1051,3/04/2018 15:35,157,146,111,414,3,100.0
1052,3/04/2018 15:40,156,146,116,418,3,100.0
1053,3/04/2018 15:45,153,140,114,407,3,100.0
1054,3/04/2018 15:50,155,145,115,415,3,100.0
1055,3/04/2018 15:55,152,155,113,420,3,100.0
1056,3/04/2018 16:00,151,133,113,397,3,100.0
1057,3/04/2018 16:05,162,144,130,436,3,100.0
1058,3/04/2018 16:10,163,133,120,416,3,100.0
1059,3/04/2018 16:15,132,142,102,376,3,100.0
1060,3/04/2018 16:20,151,145,106,402,3,100.0
1061,3/04/2018 16:25,162,156,120,438,3,100.0
1062,3/04/2018 16:30,158,156,122,436,3,100.0
1063,3/04/2018 16:35,161,156,120,437,3,100.0
1064,3/04/2018 16:40,143,142,101,386,3,100.0
1065,3/04/2018 16:45,149,123,107,379,3,100.0
1066,3/04/2018 16:50,127,137,113,377,3,100.0
1067,3/04/2018 16:55,131,124,88,343,3,100.0
1068,3/04/2018 17:00,137,139,101,377,3,100.0
1069,3/04/2018 17:05,129,136,96,361,3,100.0
1070,3/04/2018 17:10,127,134,94,355,3,100.0
1071,3/04/2018 17:15,131,131,95,357,3,100.0
1072,3/04/2018 17:20,139,138,112,389,3,100.0
1073,3/04/2018 17:25,150,140,109,399,3,100.0
1074,3/04/2018 17:30,155,134,116,405,3,100.0
1075,3/04/2018 17:35,151,132,86,369,3,100.0
1076,3/04/2018 17:40,147,143,106,396,3,100.0
1077,3/04/2018 17:45,134,130,87,351,3,100.0
1078,3/04/2018 17:50,153,137,107,397,3,100.0
1079,3/04/2018 17:55,155,131,104,390,3,100.0
1080,3/04/2018 18:00,157,152,106,415,3,100.0
1081,3/04/2018 18:05,129,126,82,337,3,100.0
1082,3/04/2018 18:10,163,136,111,410,3,100.0
1083,3/04/2018 18:15,130,132,106,368,3,100.0
1084,3/04/2018 18:20,122,116,97,335,3,100.0
1085,3/04/2018 18:25,131,133,96,360,3,100.0
1086,3/04/2018 18:30,145,135,97,377,3,100.0
1087,3/04/2018 18:35,142,129,95,366,3,100.0
1088,3/04/2018 18:40,156,140,97,393,3,100.0
1089,3/04/2018 18:45,154,137,103,394,3,100.0
1090,3/04/2018 18:50,131,116,101,348,3,100.0
1091,3/04/2018 18:55,139,134,86,359,3,100.0
1092,3/04/2018 19:00,130,128,89,347,3,100.0
1093,3/04/2018 19:05,118,117,84,319,3,100.0
1094,3/04/2018 19:10,140,140,99,379,3,100.0
1095,3/04/2018 19:15,158,138,93,389,3,100.0
1096,3/04/2018 19:20,129,124,91,344,3,100.0
1097,3/04/2018 19:25,126,121,93,340,3,100.0
1098,3/04/2018 19:30,119,128,94,341,3,100.0
1099,3/04/2018 19:35,131,123,94,348,3,100.0
1100,3/04/2018 19:40,134,127,83,344,3,100.0
1101,3/04/2018 19:45,113,106,84,303,3,100.0
1102,3/04/2018 19:50,119,121,88,328,3,100.0
1103,3/04/2018 19:55,119,107,71,297,3,100.0
1104,3/04/2018 20:00,144,130,88,362,3,100.0
1105,3/04/2018 20:05,133,126,89,348,3,100.0
1106,3/04/2018 20:10,117,118,80,315,3,100.0
1107,3/04/2018 20:15,121,120,88,329,3,100.0
1108,3/04/2018 20:20,113,103,74,290,3,100.0
1109,3/04/2018 20:25,121,114,86,321,3,100.0
1110,3/04/2018 20:30,135,120,76,331,3,100.0
1111,3/04/2018 20:35,114,104,82,300,3,100.0
1112,3/04/2018 20:40,123,107,74,304,3,100.0
1113,3/04/2018 20:45,117,109,78,304,3,100.0
1114,3/04/2018 20:50,111,112,70,293,3,100.0
1115,3/04/2018 20:55,142,122,89,353,3,100.0
1116,3/04/2018 21:00,122,123,89,334,3,100.0
1117,3/04/2018 21:05,143,126,96,365,3,100.0
1118,3/04/2018 21:10,132,108,88,328,3,100.0
1119,3/04/2018 21:15,133,122,91,346,3,100.0
1120,3/04/2018 21:20,157,132,102,391,3,100.0
1121,3/04/2018 21:25,150,142,96,388,3,100.0
1122,3/04/2018 21:30,128,132,97,357,3,100.0
1123,3/04/2018 21:35,133,116,100,349,3,100.0
1124,3/04/2018 21:40,130,116,90,336,3,100.0
1125,3/04/2018 21:45,133,139,93,365,3,100.0
1126,3/04/2018 21:50,107,93,78,278,3,100.0
1127,3/04/2018 21:55,126,108,73,307,3,100.0
1128,3/04/2018 22:00,113,112,72,297,3,100.0
1129,3/04/2018 22:05,88,79,62,229,3,100.0
1130,3/04/2018 22:10,106,111,66,283,3,100.0
1131,3/04/2018 22:15,108,106,75,289,3,100.0
1132,3/04/2018 22:20,96,91,65,252,3,100.0
1133,3/04/2018 22:25,86,88,65,239,3,100.0
1134,3/04/2018 22:30,96,88,64,248,3,100.0
1135,3/04/2018 22:35,76,75,48,199,3,100.0
1136,3/04/2018 22:40,77,70,52,199,3,100.0
1137,3/04/2018 22:45,85,81,52,218,3,100.0
1138,3/04/2018 22:50,77,74,66,217,3,100.0
1139,3/04/2018 22:55,72,78,50,200,3,100.0
1140,3/04/2018 23:00,78,76,46,200,3,100.0
1141,3/04/2018 23:05,88,74,56,218,3,100.0
1142,3/04/2018 23:10,71,76,41,188,3,100.0
1143,3/04/2018 23:15,61,62,46,169,3,100.0
1144,3/04/2018 23:20,60,61,51,172,3,100.0
1145,3/04/2018 23:25,63,61,44,168,3,100.0
1146,3/04/2018 23:30,57,61,41,159,3,100.0
1147,3/04/2018 23:35,56,73,41,170,3,100.0
1148,3/04/2018 23:40,67,67,36,170,3,100.0
1149,3/04/2018 23:45,65,58,45,168,3,100.0
1150,3/04/2018 23:50,62,59,40,161,3,100.0
1151,3/04/2018 23:55,64,62,50,176,3,100.0
1152,3/05/2018 0:00,60,61,42,163,3,100.0
1153,3/05/2018 0:05,52,53,32,137,3,100.0
1154,3/05/2018 0:10,51,57,43,151,3,100.0
1155,3/05/2018 0:15,50,45,39,134,3,100.0
1156,3/05/2018 0:20,36,47,28,111,3,100.0
1157,3/05/2018 0:25,37,39,33,109,3,100.0
1158,3/05/2018 0:30,31,31,29,91,3,100.0
1159,3/05/2018 0:35,35,38,25,98,3,100.0
1160,3/05/2018 0:40,39,36,26,101,3,100.0
1161,3/05/2018 0:45,36,44,30,110,3,100.0
1162,3/05/2018 0:50,27,36,18,81,3,100.0
1163,3/05/2018 0:55,30,36,29,95,3,100.0
1164,3/05/2018 1:00,32,39,27,98,3,100.0
1165,3/05/2018 1:05,22,33,14,69,3,100.0
1166,3/05/2018 1:10,30,28,22,80,3,100.0
1167,3/05/2018 1:15,32,29,22,83,3,100.0
1168,3/05/2018 1:20,17,27,17,61,3,100.0
1169,3/05/2018 1:25,15,20,22,57,3,100.0
1170,3/05/2018 1:30,16,28,20,64,3,100.0
1171,3/05/2018 1:35,21,22,19,62,3,100.0
1172,3/05/2018 1:40,11,24,14,49,3,100.0
1173,3/05/2018 1:45,17,22,14,53,3,100.0
1174,3/05/2018 1:50,25,31,21,77,3,100.0
1175,3/05/2018 1:55,14,21,18,53,3,100.0
1176,3/05/2018 2:00,19,22,18,59,3,100.0
1177,3/05/2018 2:05,11,22,17,50,3,100.0
1178,3/05/2018 2:10,13,17,12,42,3,100.0
1179,3/05/2018 2:15,19,17,13,49,3,100.0
1180,3/05/2018 2:20,11,19,19,49,3,100.0
1181,3/05/2018 2:25,12,21,18,51,3,100.0
1182,3/05/2018 2:30,9,14,8,31,3,100.0
1183,3/05/2018 2:35,10,22,8,40,3,100.0
1184,3/05/2018 2:40,10,13,13,36,3,100.0
1185,3/05/2018 2:45,15,16,14,45,3,100.0
1186,3/05/2018 2:50,11,18,16,45,3,100.0
1187,3/05/2018 2:55,8,12,9,29,3,100.0
1188,3/05/2018 3:00,5,13,6,24,3,100.0
1189,3/05/2018 3:05,9,18,14,41,3,100.0
1190,3/05/2018 3:10,11,18,14,43,3,100.0
1191,3/05/2018 3:15,11,20,16,47,3,100.0
1192,3/05/2018 3:20,14,16,15,45,3,100.0
1193,3/05/2018 3:25,21,21,9,51,3,100.0
1194,3/05/2018 3:30,19,20,14,53,3,100.0
1195,3/05/2018 3:35,13,20,19,52,3,100.0
1196,3/05/2018 3:40,16,29,21,66,3,100.0
1197,3/05/2018 3:45,14,22,24,60,3,100.0
1198,3/05/2018 3:50,18,23,18,59,3,100.0
1199,3/05/2018 3:55,15,23,18,56,3,100.0
1200,3/05/2018 4:00,22,23,15,60,3,100.0
1201,3/05/2018 4:05,17,19,19,55,3,100.0
1202,3/05/2018 4:10,14,30,26,70,3,100.0
1203,3/05/2018 4:15,26,33,19,78,3,100.0
1204,3/05/2018 4:20,31,40,25,96,3,100.0
1205,3/05/2018 4:25,44,45,29,118,3,100.0
1206,3/05/2018 4:30,41,40,28,109,3,100.0
1207,3/05/2018 4:35,42,41,30,113,3,100.0
1208,3/05/2018 4:40,40,45,35,120,3,100.0
1209,3/05/2018 4:45,54,50,36,140,3,100.0
1210,3/05/2018 4:50,52,55,35,142,3,100.0
1211,3/05/2018 4:55,45,50,35,130,3,100.0
1212,3/05/2018 5:00,48,46,37,131,3,100.0
1213,3/05/2018 5:05,63,56,37,156,3,100.0
1214,3/05/2018 5:10,86,75,48,209,3,100.0
1215,3/05/2018 5:15,86,72,49,207,3,100.0
1216,3/05/2018 5:20,78,77,51,206,3,100.0
1217,3/05/2018 5:25,107,103,65,275,3,100.0
1218,3/05/2018 5:30,132,108,71,311,3,100.0
1219,3/05/2018 5:35,134,102,78,314,3,100.0
1220,3/05/2018 5:40,134,123,77,334,3,100.0
1221,3/05/2018 5:45,136,125,76,337,3,100.0
1222,3/05/2018 5:50,148,120,95,363,3,100.0
1223,3/05/2018 5:55,148,133,70,351,3,100.0
1224,3/05/2018 6:00,151,124,72,347,3,100.0
1225,3/05/2018 6:05,173,129,86,388,3,100.0
1226,3/05/2018 6:10,183,148,84,415,3,100.0
1227,3/05/2018 6:15,153,130,79,362,3,100.0
1228,3/05/2018 6:20,165,149,95,409,3,100.0
1229,3/05/2018 6:25,114,103,76,293,3,100.0
1230,3/05/2018 6:30,151,132,94,377,3,100.0
1231,3/05/2018 6:35,139,140,118,397,3,100.0
1232,3/05/2018 6:40,149,140,126,415,3,100.0
1233,3/05/2018 6:45,151,143,133,427,3,100.0
1234,3/05/2018 6:50,154,157,142,453,3,100.0
1235,3/05/2018 6:55,162,158,131,451,3,100.0
1236,3/05/2018 7:00,164,165,119,448,3,100.0
1237,3/05/2018 7:05,148,142,92,382,3,100.0
1238,3/05/2018 7:10,181,172,114,467,3,100.0
1239,3/05/2018 7:15,190,156,130,476,3,100.0
1240,3/05/2018 7:20,191,169,125,485,3,100.0
1241,3/05/2018 7:25,210,187,137,534,3,100.0
1242,3/05/2018 7:30,192,180,137,509,3,100.0
1243,3/05/2018 7:35,181,170,137,488,3,100.0
1244,3/05/2018 7:40,165,148,107,420,3,100.0
1245,3/05/2018 7:45,193,169,130,492,3,100.0
1246,3/05/2018 7:50,193,177,144,514,3,100.0
1247,3/05/2018 7:55,197,171,129,497,3,100.0
1248,3/05/2018 8:00,175,162,115,452,3,100.0
1249,3/05/2018 8:05,200,170,131,501,3,100.0
1250,3/05/2018 8:10,203,170,123,496,3,100.0
1251,3/05/2018 8:15,200,164,133,497,3,100.0
1252,3/05/2018 8:20,192,162,126,480,3,100.0
1253,3/05/2018 8:25,159,128,109,396,3,100.0
1254,3/05/2018 8:30,183,153,114,450,3,100.0
1255,3/05/2018 8:35,171,153,104,428,3,100.0
1256,3/05/2018 8:40,188,151,117,456,3,100.0
1257,3/05/2018 8:45,184,150,123,457,3,100.0
1258,3/05/2018 8:50,177,161,126,464,3,100.0
1259,3/05/2018 8:55,187,165,108,460,3,100.0
1260,3/05/2018 9:00,191,166,111,468,3,100.0
1261,3/05/2018 9:05,179,157,114,450,3,100.0
1262,3/05/2018 9:10,181,155,124,460,3,100.0
1263,3/05/2018 9:15,152,136,98,386,3,100.0
1264,3/05/2018 9:20,174,149,101,424,3,100.0
1265,3/05/2018 9:25,164,139,96,399,3,100.0
1266,3/05/2018 9:30,155,144,98,397,3,100.0
1267,3/05/2018 9:35,151,144,105,400,3,100.0
1268,3/05/2018 9:40,156,149,88,393,3,100.0
1269,3/05/2018 9:45,155,137,109,401,3,100.0
1270,3/05/2018 9:50,163,135,93,391,3,100.0
1271,3/05/2018 9:55,166,148,101,415,3,100.0
1272,3/05/2018 10:00,158,128,92,378,3,100.0
1273,3/05/2018 10:05,159,141,95,395,3,100.0
1274,3/05/2018 10:10,135,114,91,340,3,100.0
1275,3/05/2018 10:15,166,154,102,422,3,100.0
1276,3/05/2018 10:20,163,141,122,426,3,100.0
1277,3/05/2018 10:25,165,139,99,403,3,100.0
1278,3/05/2018 10:30,174,162,107,443,3,100.0
1279,3/05/2018 10:35,165,151,107,423,3,100.0
1280,3/05/2018 10:40,163,154,96,413,3,100.0
1281,3/05/2018 10:45,160,130,110,400,3,100.0
1282,3/05/2018 10:50,145,144,105,394,3,100.0
1283,3/05/2018 10:55,156,143,118,417,3,100.0
1284,3/05/2018 11:00,154,132,103,389,3,100.0
1285,3/05/2018 11:05,134,130,100,364,3,100.0
1286,3/05/2018 11:10,151,130,102,383,3,100.0
1287,3/05/2018 11:15,153,134,107,394,3,100.0
1288,3/05/2018 11:20,184,156,117,457,3,100.0
1289,3/05/2018 11:25,145,156,98,399,3,100.0
1290,3/05/2018 11:30,148,148,113,409,3,100.0
1291,3/05/2018 11:35,173,160,112,445,3,100.0
1292,3/05/2018 11:40,128,114,86,328,3,100.0
1293,3/05/2018 11:45,180,164,114,458,3,100.0
1294,3/05/2018 11:50,168,158,120,446,3,100.0
1295,3/05/2018 11:55,154,144,102,400,3,100.0
1296,3/05/2018 12:00,160,144,117,421,3,100.0
1297,3/05/2018 12:05,174,149,114,437,3,100.0
1298,3/05/2018 12:10,157,136,112,405,3,100.0
1299,3/05/2018 12:15,175,169,115,459,3,100.0
1300,3/05/2018 12:20,174,169,110,453,3,100.0
1301,3/05/2018 12:25,182,152,118,452,3,100.0
1302,3/05/2018 12:30,166,144,116,426,3,100.0
1303,3/05/2018 12:35,168,153,120,441,3,100.0
1304,3/05/2018 12:40,187,146,112,445,3,100.0
1305,3/05/2018 12:45,175,150,131,456,3,100.0
1306,3/05/2018 12:50,171,163,119,453,3,100.0
1307,3/05/2018 12:55,156,157,129,442,3,100.0
1308,3/05/2018 13:00,166,151,120,437,3,100.0
1309,3/05/2018 13:05,167,149,129,445,3,100.0
1310,3/05/2018 13:10,183,172,126,481,3,100.0
1311,3/05/2018 13:15,174,160,119,453,3,100.0
1312,3/05/2018 13:20,175,147,131,453,3,100.0
1313,3/05/2018 13:25,185,161,131,477,3,100.0
1314,3/05/2018 13:30,196,167,140,503,3,100.0
1315,3/05/2018 13:35,179,140,125,444,3,100.0
1316,3/05/2018 13:40,179,167,129,475,3,100.0
1317,3/05/2018 13:45,180,159,143,482,3,100.0
1318,3/05/2018 13:50,179,160,127,466,3,100.0
1319,3/05/2018 13:55,161,154,119,434,3,100.0
1320,3/05/2018 14:00,174,174,136,484,3,100.0
1321,3/05/2018 14:05,183,164,138,485,3,100.0
1322,3/05/2018 14:10,168,165,127,460,3,100.0
1323,3/05/2018 14:15,179,164,120,463,3,100.0
1324,3/05/2018 14:20,183,167,127,477,3,100.0
1325,3/05/2018 14:25,182,175,148,505,3,100.0
1326,3/05/2018 14:30,180,180,131,491,3,100.0
1327,3/05/2018 14:35,175,163,141,479,3,100.0
1328,3/05/2018 14:40,153,163,142,458,3,100.0
1329,3/05/2018 14:45,164,158,137,459,3,100.0
1330,3/05/2018 14:50,164,156,150,470,3,100.0
1331,3/05/2018 14:55,157,159,136,452,3,100.0
1332,3/05/2018 15:00,156,142,139,437,3,100.0
1333,3/05/2018 15:05,154,159,132,445,3,100.0
1334,3/05/2018 15:10,146,140,136,422,3,100.0
1335,3/05/2018 15:15,165,156,134,455,3,100.0
1336,3/05/2018 15:20,161,140,148,449,3,100.0
1337,3/05/2018 15:25,160,158,141,459,3,100.0
1338,3/05/2018 15:30,142,138,118,398,3,100.0
1339,3/05/2018 15:35,153,142,131,426,3,100.0
1340,3/05/2018 15:40,140,144,129,413,3,100.0
1341,3/05/2018 15:45,145,137,130,412,3,100.0
1342,3/05/2018 15:50,150,150,140,440,3,100.0
1343,3/05/2018 15:55,147,147,138,432,3,100.0
1344,3/05/2018 16:00,143,140,135,418,3,100.0
1345,3/05/2018 16:05,154,142,143,439,3,100.0
1346,3/05/2018 16:10,159,153,146,458,3,100.0
1347,3/05/2018 16:15,163,161,135,459,3,100.0
1348,3/05/2018 16:20,138,133,130,401,3,100.0
1349,3/05/2018 16:25,144,136,133,413,3,100.0
1350,3/05/2018 16:30,137,132,122,391,3,100.0
1351,3/05/2018 16:35,116,115,108,339,3,100.0
1352,3/05/2018 16:40,132,133,128,393,3,100.0
1353,3/05/2018 16:45,144,127,128,399,3,100.0
1354,3/05/2018 16:50,152,157,147,456,3,100.0
1355,3/05/2018 16:55,176,165,155,496,3,100.0
1356,3/05/2018 17:00,157,164,141,462,3,100.0
1357,3/05/2018 17:05,167,179,142,488,3,100.0
1358,3/05/2018 17:10,181,173,149,503,3,100.0
1359,3/05/2018 17:15,144,141,141,426,3,100.0
1360,3/05/2018 17:20,168,150,148,466,3,100.0
1361,3/05/2018 17:25,156,160,153,469,3,100.0
1362,3/05/2018 17:30,168,163,149,480,3,100.0
1363,3/05/2018 17:35,132,128,119,379,3,100.0
1364,3/05/2018 17:40,155,152,140,447,3,100.0
1365,3/05/2018 17:45,159,163,144,466,3,100.0
1366,3/05/2018 17:50,152,155,145,452,3,100.0
1367,3/05/2018 17:55,164,159,151,474,3,100.0
1368,3/05/2018 18:00,155,157,146,458,3,100.0
1369,3/05/2018 18:05,151,146,125,422,3,100.0
1370,3/05/2018 18:10,151,140,123,414,3,100.0
1371,3/05/2018 18:15,148,141,137,426,3,100.0
1372,3/05/2018 18:20,153,146,137,436,3,100.0
1373,3/05/2018 18:25,153,151,141,445,3,100.0
1374,3/05/2018 18:30,147,149,136,432,3,100.0
1375,3/05/2018 18:35,159,148,137,444,3,100.0
1376,3/05/2018 18:40,144,137,135,416,3,100.0
1377,3/05/2018 18:45,156,138,140,434,3,100.0
1378,3/05/2018 18:50,150,137,136,423,3,100.0
1379,3/05/2018 18:55,147,143,140,430,3,100.0
1380,3/05/2018 19:00,144,142,123,409,3,100.0
1381,3/05/2018 19:05,166,148,131,445,3,100.0
1382,3/05/2018 19:10,153,138,124,415,3,100.0
1383,3/05/2018 19:15,164,145,132,441,3,100.0
1384,3/05/2018 19:20,161,135,131,427,3,100.0
1385,3/05/2018 19:25,161,143,147,451,3,100.0
1386,3/05/2018 19:30,144,141,140,425,3,100.0
1387,3/05/2018 19:35,152,149,144,445,3,100.0
1388,3/05/2018 19:40,163,146,133,442,3,100.0
1389,3/05/2018 19:45,153,139,140,432,3,100.0
1390,3/05/2018 19:50,157,137,135,429,3,100.0
1391,3/05/2018 19:55,154,144,129,427,3,100.0
1392,3/05/2018 20:00,156,154,114,424,3,100.0
1393,3/05/2018 20:05,124,121,108,353,3,100.0
1394,3/05/2018 20:10,123,128,118,369,3,100.0
1395,3/05/2018 20:15,160,142,118,420,3,100.0
1396,3/05/2018 20:20,156,132,99,387,3,100.0
1397,3/05/2018 20:25,146,123,93,362,3,100.0
1398,3/05/2018 20:30,139,139,98,376,3,100.0
1399,3/05/2018 20:35,129,117,89,335,3,100.0
1400,3/05/2018 20:40,139,125,91,355,3,100.0
1401,3/05/2018 20:45,121,106,88,315,3,100.0
1402,3/05/2018 20:50,131,103,82,316,3,100.0
1403,3/05/2018 20:55,114,107,85,306,3,100.0
1404,3/05/2018 21:00,113,117,78,308,3,100.0
1405,3/05/2018 21:05,118,111,87,316,3,100.0
1406,3/05/2018 21:10,117,109,75,301,3,100.0
1407,3/05/2018 21:15,119,109,88,316,3,100.0
1408,3/05/2018 21:20,123,97,83,303,3,100.0
1409,3/05/2018 21:25,95,96,72,263,3,100.0
1410,3/05/2018 21:30,109,96,69,274,3,100.0
1411,3/05/2018 21:35,96,96,64,256,3,100.0
1412,3/05/2018 21:40,91,93,58,242,3,100.0
1413,3/05/2018 21:45,88,94,62,244,3,100.0
1414,3/05/2018 21:50,103,90,57,250,3,100.0
1415,3/05/2018 21:55,99,92,68,259,3,100.0
1416,3/05/2018 22:00,65,71,64,200,3,100.0
1417,3/05/2018 22:05,80,74,58,212,3,100.0
1418,3/05/2018 22:10,92,94,65,251,3,100.0
1419,3/05/2018 22:15,90,92,59,241,3,100.0
1420,3/05/2018 22:20,89,90,62,241,3,100.0
1421,3/05/2018 22:25,74,83,57,214,3,100.0
1422,3/05/2018 22:30,74,81,48,203,3,100.0
1423,3/05/2018 22:35,85,76,51,212,3,100.0
1424,3/05/2018 22:40,78,79,59,216,3,100.0
1425,3/05/2018 22:45,80,79,54,213,3,100.0
1426,3/05/2018 22:50,73,79,58,210,3,100.0
1427,3/05/2018 22:55,74,78,42,194,3,100.0
1428,3/05/2018 23:00,67,67,45,179,3,100.0
1429,3/05/2018 23:05,66,80,51,197,3,100.0
1430,3/05/2018 23:10,61,66,44,171,3,100.0
1431,3/05/2018 23:15,57,67,44,168,3,100.0
1432,3/05/2018 23:20,52,56,36,144,3,100.0
1433,3/05/2018 23:25,51,62,32,145,3,100.0
1434,3/05/2018 23:30,57,59,48,164,3,100.0
1435,3/05/2018 23:35,51,62,43,156,3,100.0
1436,3/05/2018 23:40,51,54,47,152,3,100.0
1437,3/05/2018 23:45,50,50,34,134,3,100.0
1438,3/05/2018 23:50,30,40,28,98,3,100.0
1439,3/05/2018 23:55,34,41,32,107,3,100.0
1440,3/06/2018 0:00,38,46,32,116,3,100.0
1441,3/06/2018 0:05,32,32,23,87,3,100.0
1442,3/06/2018 0:10,41,51,41,133,3,100.0
1443,3/06/2018 0:15,38,38,33,109,3,100.0
1444,3/06/2018 0:20,39,42,28,109,3,100.0
1445,3/06/2018 0:25,28,35,24,87,3,100.0
1446,3/06/2018 0:30,29,38,18,85,3,100.0
1447,3/06/2018 0:35,30,43,31,104,3,100.0
1448,3/06/2018 0:40,23,37,22,82,3,100.0
1449,3/06/2018 0:45,22,30,13,65,3,100.0
1450,3/06/2018 0:50,25,30,24,79,3,100.0
1451,3/06/2018 0:55,19,24,20,63,3,100.0
1452,3/06/2018 1:00,21,32,21,74,3,100.0
1453,3/06/2018 1:05,23,27,21,71,3,100.0
1454,3/06/2018 1:10,13,16,12,41,3,100.0
1455,3/06/2018 1:15,17,29,18,64,3,100.0
1456,3/06/2018 1:20,19,29,23,71,3,100.0
1457,3/06/2018 1:25,12,17,9,38,3,100.0
1458,3/06/2018 1:30,22,24,16,62,3,100.0
1459,3/06/2018 1:35,14,16,15,45,3,100.0
1460,3/06/2018 1:40,13,28,20,61,3,100.0
1461,3/06/2018 1:45,14,19,19,52,3,100.0
1462,3/06/2018 1:50,20,26,20,66,3,100.0
1463,3/06/2018 1:55,7,14,15,36,3,100.0
1464,3/06/2018 2:00,15,17,15,47,3,100.0
1465,3/06/2018 2:05,18,9,15,42,3,100.0
1466,3/06/2018 2:10,15,13,22,50,3,100.0
1467,3/06/2018 2:15,10,25,9,44,3,100.0
1468,3/06/2018 2:20,9,23,18,50,3,100.0
1469,3/06/2018 2:25,10,24,21,55,3,100.0
1470,3/06/2018 2:30,16,17,22,55,3,100.0
1471,3/06/2018 2:35,9,11,15,35,3,100.0
1472,3/06/2018 2:40,12,15,19,46,3,100.0
1473,3/06/2018 2:45,11,18,9,38,3,100.0
1474,3/06/2018 2:50,9,16,14,39,3,100.0
1475,3/06/2018 2:55,13,14,15,42,3,100.0
1476,3/06/2018 3:00,6,12,20,38,3,100.0
1477,3/06/2018 3:05,8,16,17,41,3,100.0
1478,3/06/2018 3:10,7,10,10,27,3,100.0
1479,3/06/2018 3:15,9,21,22,52,3,100.0
1480,3/06/2018 3:20,17,23,14,54,3,100.0
1481,3/06/2018 3:25,7,19,15,41,3,100.0
1482,3/06/2018 3:30,6,22,19,47,3,100.0
1483,3/06/2018 3:35,11,20,11,42,3,100.0
1484,3/06/2018 3:40,7,16,21,44,3,100.0
1485,3/06/2018 3:45,12,24,17,53,3,100.0
1486,3/06/2018 3:50,7,23,24,54,3,100.0
1487,3/06/2018 3:55,26,31,20,77,3,100.0
1488,3/06/2018 4:00,13,22,17,52,3,100.0
1489,3/06/2018 4:05,10,31,22,63,3,100.0
1490,3/06/2018 4:10,15,25,17,57,3,100.0
1491,3/06/2018 4:15,25,25,20,70,3,100.0
1492,3/06/2018 4:20,34,41,23,98,3,100.0
1493,3/06/2018 4:25,39,37,32,108,3,100.0
1494,3/06/2018 4:30,35,36,24,95,3,100.0
1495,3/06/2018 4:35,28,34,29,91,3,100.0
1496,3/06/2018 4:40,39,55,31,125,3,100.0
1497,3/06/2018 4:45,38,54,25,117,3,100.0
1498,3/06/2018 4:50,43,54,35,132,3,100.0
1499,3/06/2018 4:55,45,54,38,137,3,100.0
1500,3/06/2018 5:00,49,53,34,136,3,100.0
1501,3/06/2018 5:05,61,66,40,167,3,100.0
1502,3/06/2018 5:10,72,70,49,191,3,100.0
1503,3/06/2018 5:15,88,83,47,218,3,100.0
1504,3/06/2018 5:20,92,87,41,220,3,100.0
1505,3/06/2018 5:25,117,105,58,280,3,100.0
1506,3/06/2018 5:30,122,100,60,282,3,100.0
1507,3/06/2018 5:35,133,123,70,326,3,100.0
1508,3/06/2018 5:40,137,127,87,351,3,100.0
1509,3/06/2018 5:45,149,119,81,349,3,100.0
1510,3/06/2018 5:50,146,126,77,349,3,100.0
1511,3/06/2018 5:55,125,115,64,304,3,100.0
1512,3/06/2018 6:00,136,124,72,332,3,100.0
1513,3/06/2018 6:05,150,130,83,363,3,100.0
1514,3/06/2018 6:10,154,136,78,368,3,100.0
1515,3/06/2018 6:15,154,135,88,377,3,100.0
1516,3/06/2018 6:20,140,118,99,357,3,100.0
1517,3/06/2018 6:25,161,143,100,404,3,100.0
1518,3/06/2018 6:30,146,124,90,360,3,100.0
1519,3/06/2018 6:35,175,134,98,407,3,100.0
1520,3/06/2018 6:40,173,145,100,418,3,100.0
1521,3/06/2018 6:45,179,142,109,430,3,100.0
1522,3/06/2018 6:50,190,167,120,477,3,100.0
1523,3/06/2018 6:55,187,157,114,458,3,100.0
1524,3/06/2018 7:00,181,166,122,469,3,100.0
1525,3/06/2018 7:05,191,167,115,473,3,100.0
1526,3/06/2018 7:10,190,166,114,470,3,100.0
1527,3/06/2018 7:15,185,151,134,470,3,100.0
1528,3/06/2018 7:20,197,197,136,530,3,100.0
1529,3/06/2018 7:25,173,151,121,445,3,100.0
1530,3/06/2018 7:30,180,180,144,504,3,100.0
1531,3/06/2018 7:35,165,149,144,458,3,100.0
1532,3/06/2018 7:40,171,174,126,471,3,100.0
1533,3/06/2018 7:45,190,182,142,514,3,100.0
1534,3/06/2018 7:50,181,169,136,486,3,100.0
1535,3/06/2018 7:55,172,159,133,464,3,100.0
1536,3/06/2018 8:00,196,168,125,489,3,100.0
1537,3/06/2018 8:05,188,183,121,492,3,100.0
1538,3/06/2018 8:10,186,162,116,464,3,100.0
1539,3/06/2018 8:15,177,165,128,470,3,100.0
1540,3/06/2018 8:20,190,162,127,479,3,100.0
1541,3/06/2018 8:25,178,163,126,467,3,100.0
1542,3/06/2018 8:30,197,167,134,498,3,100.0
1543,3/06/2018 8:35,183,182,135,500,3,100.0
1544,3/06/2018 8:40,172,150,147,469,3,100.0
1545,3/06/2018 8:45,188,166,137,491,3,100.0
1546,3/06/2018 8:50,192,178,116,486,3,100.0
1547,3/06/2018 8:55,199,183,126,508,3,100.0
1548,3/06/2018 9:00,184,153,118,455,3,100.0
1549,3/06/2018 9:05,188,152,115,455,3,100.0
1550,3/06/2018 9:10,200,184,124,508,3,100.0
1551,3/06/2018 9:15,163,157,108,428,3,100.0
1552,3/06/2018 9:20,167,159,111,437,3,100.0
1553,3/06/2018 9:25,169,139,90,398,3,100.0
1554,3/06/2018 9:30,190,159,124,473,3,100.0
1555,3/06/2018 9:35,180,142,111,433,3,100.0
1556,3/06/2018 9:40,192,155,108,455,3,100.0
1557,3/06/2018 9:45,171,136,104,411,3,100.0
1558,3/06/2018 9:50,167,133,94,394,3,100.0
1559,3/06/2018 9:55,170,149,105,424,3,100.0
1560,3/06/2018 10:00,144,147,98,389,3,100.0
1561,3/06/2018 10:05,154,138,99,391,3,100.0
1562,3/06/2018 10:10,134,114,84,332,3,100.0
1563,3/06/2018 10:15,177,144,114,435,3,100.0
1564,3/06/2018 10:20,153,141,105,399,3,100.0
1565,3/06/2018 10:25,168,138,117,423,3,100.0
1566,3/06/2018 10:30,177,164,107,448,3,100.0
1567,3/06/2018 10:35,138,133,99,370,3,100.0
1568,3/06/2018 10:40,176,150,117,443,3,100.0
1569,3/06/2018 10:45,147,144,99,390,3,100.0
1570,3/06/2018 10:50,157,135,99,391,3,100.0
1571,3/06/2018 10:55,141,127,78,346,3,100.0
1572,3/06/2018 11:00,138,144,90,372,3,100.0
1573,3/06/2018 11:05,164,133,90,387,3,100.0
1574,3/06/2018 11:10,156,149,105,410,3,100.0
1575,3/06/2018 11:15,161,149,92,402,3,100.0
1576,3/06/2018 11:20,125,119,95,339,3,100.0
1577,3/06/2018 11:25,133,125,92,350,3,100.0
1578,3/06/2018 11:30,135,132,89,356,3,100.0
1579,3/06/2018 11:35,151,133,87,371,3,100.0
1580,3/06/2018 11:40,152,156,105,413,3,100.0
1581,3/06/2018 11:45,147,147,118,412,3,100.0
1582,3/06/2018 11:50,163,145,113,421,3,100.0
1583,3/06/2018 11:55,163,152,120,435,3,100.0
1584,3/06/2018 12:00,171,172,129,472,3,100.0
1585,3/06/2018 12:05,179,153,128,460,3,100.0
1586,3/06/2018 12:10,166,147,113,426,3,100.0
1587,3/06/2018 12:15,179,144,113,436,3,100.0
1588,3/06/2018 12:20,171,155,127,453,3,100.0
1589,3/06/2018 12:25,192,162,127,481,3,100.0
1590,3/06/2018 12:30,177,144,110,431,3,100.0
1591,3/06/2018 12:35,159,135,127,421,3,100.0
1592,3/06/2018 12:40,174,141,114,429,3,100.0
1593,3/06/2018 12:45,160,150,115,425,3,100.0
1594,3/06/2018 12:50,166,159,119,444,3,100.0
1595,3/06/2018 12:55,169,158,125,452,3,100.0
1596,3/06/2018 13:00,178,158,119,455,3,100.0
1597,3/06/2018 13:05,162,164,123,449,3,100.0
1598,3/06/2018 13:10,166,163,121,450,3,100.0
1599,3/06/2018 13:15,177,156,133,466,3,100.0
1600,3/06/2018 13:20,163,157,105,425,3,100.0
1601,3/06/2018 13:25,158,159,133,450,3,100.0
1602,3/06/2018 13:30,179,162,121,462,3,100.0
1603,3/06/2018 13:35,153,160,114,427,3,100.0
1604,3/06/2018 13:40,184,163,137,484,3,100.0
1605,3/06/2018 13:45,181,168,122,471,3,100.0
1606,3/06/2018 13:50,165,165,116,446,3,100.0
1607,3/06/2018 13:55,189,159,143,491,3,100.0
1608,3/06/2018 14:00,172,167,142,481,3,100.0
1609,3/06/2018 14:05,173,165,117,455,3,100.0
1610,3/06/2018 14:10,183,163,138,484,3,100.0
1611,3/06/2018 14:15,171,165,132,468,3,100.0
1612,3/06/2018 14:20,173,163,140,476,3,100.0
1613,3/06/2018 14:25,157,170,138,465,3,100.0
1614,3/06/2018 14:30,169,180,144,493,3,100.0
1615,3/06/2018 14:35,150,159,126,435,3,100.0
1616,3/06/2018 14:40,156,144,134,434,3,100.0
1617,3/06/2018 14:45,151,147,132,430,3,100.0
1618,3/06/2018 14:50,155,155,136,446,3,100.0
1619,3/06/2018 14:55,161,153,145,459,3,100.0
1620,3/06/2018 15:00,147,138,142,427,3,100.0
1621,3/06/2018 15:05,150,145,135,430,3,100.0
1622,3/06/2018 15:10,149,150,142,441,3,100.0
1623,3/06/2018 15:15,156,152,140,448,3,100.0
1624,3/06/2018 15:20,156,155,135,446,3,100.0
1625,3/06/2018 15:25,152,155,144,451,3,100.0
1626,3/06/2018 15:30,138,139,134,411,3,100.0
1627,3/06/2018 15:35,152,146,134,432,3,100.0
1628,3/06/2018 15:40,149,142,138,429,3,100.0
1629,3/06/2018 15:45,164,153,132,449,3,100.0
1630,3/06/2018 15:50,124,104,108,336,3,100.0
1631,3/06/2018 15:55,135,133,128,396,3,100.0
1632,3/06/2018 16:00,153,143,133,429,3,100.0
1633,3/06/2018 16:05,159,153,159,471,3,100.0
1634,3/06/2018 16:10,146,138,134,418,3,100.0
1635,3/06/2018 16:15,156,147,133,436,3,100.0
1636,3/06/2018 16:20,152,140,133,425,3,100.0
1637,3/06/2018 16:25,139,137,129,405,3,100.0
1638,3/06/2018 16:30,111,118,113,342,3,100.0
1639,3/06/2018 16:35,146,139,126,411,3,100.0
1640,3/06/2018 16:40,145,134,133,412,3,100.0
1641,3/06/2018 16:45,159,146,150,455,3,100.0
1642,3/06/2018 16:50,159,160,144,463,3,100.0
1643,3/06/2018 16:55,115,113,115,343,3,100.0
1644,3/06/2018 17:00,138,130,126,394,3,100.0
1645,3/06/2018 17:05,124,123,120,367,3,100.0
1646,3/06/2018 17:10,134,130,119,383,3,100.0
1647,3/06/2018 17:15,133,126,117,376,3,100.0
1648,3/06/2018 17:20,150,138,140,428,3,100.0
1649,3/06/2018 17:25,125,124,125,374,3,100.0
1650,3/06/2018 17:30,130,124,118,372,3,100.0
1651,3/06/2018 17:35,131,124,117,372,3,100.0
1652,3/06/2018 17:40,136,133,119,388,3,100.0
1653,3/06/2018 17:45,120,111,88,319,3,100.0
1654,3/06/2018 17:50,136,119,121,376,3,100.0
1655,3/06/2018 17:55,154,147,136,437,3,100.0
1656,3/06/2018 18:00,149,139,129,417,3,100.0
1657,3/06/2018 18:05,147,135,125,407,3,100.0
1658,3/06/2018 18:10,144,141,138,423,3,100.0
1659,3/06/2018 18:15,140,130,125,395,3,100.0
1660,3/06/2018 18:20,144,143,132,419,3,100.0
1661,3/06/2018 18:25,149,140,132,421,3,100.0
1662,3/06/2018 18:30,154,132,133,419,3,100.0
1663,3/06/2018 18:35,155,138,134,427,3,100.0
1664,3/06/2018 18:40,145,140,123,408,3,100.0
1665,3/06/2018 18:45,154,140,131,425,3,100.0
1666,3/06/2018 18:50,149,143,137,429,3,100.0
1667,3/06/2018 18:55,148,143,130,421,3,100.0
1668,3/06/2018 19:00,149,138,123,410,3,100.0
1669,3/06/2018 19:05,154,145,133,432,3,100.0
1670,3/06/2018 19:10,155,142,140,437,3,100.0
1671,3/06/2018 19:15,150,148,135,433,3,100.0
1672,3/06/2018 19:20,151,146,131,428,3,100.0
1673,3/06/2018 19:25,155,147,134,436,3,100.0
1674,3/06/2018 19:30,152,146,136,434,3,100.0
1675,3/06/2018 19:35,148,136,131,415,3,100.0
1676,3/06/2018 19:40,152,134,129,415,3,100.0
1677,3/06/2018 19:45,154,134,126,414,3,100.0
1678,3/06/2018 19:50,151,146,129,426,3,100.0
1679,3/06/2018 19:55,164,146,144,454,3,100.0
1680,3/06/2018 20:00,143,139,133,415,3,100.0
1681,3/06/2018 20:05,156,137,131,424,3,100.0
1682,3/06/2018 20:10,154,148,130,432,3,100.0
1683,3/06/2018 20:15,157,146,137,440,3,100.0
1684,3/06/2018 20:20,139,146,122,407,3,100.0
1685,3/06/2018 20:25,158,140,119,417,3,100.0
1686,3/06/2018 20:30,139,121,96,356,3,100.0
1687,3/06/2018 20:35,134,122,94,350,3,100.0
1688,3/06/2018 20:40,132,129,91,352,3,100.0
1689,3/06/2018 20:45,139,130,107,376,3,100.0
1690,3/06/2018 20:50,131,108,64,303,3,100.0
1691,3/06/2018 20:55,132,141,92,365,3,100.0
1692,3/06/2018 21:00,131,125,77,333,3,100.0
1693,3/06/2018 21:05,130,114,74,318,3,100.0
1694,3/06/2018 21:10,135,116,95,346,3,100.0
1695,3/06/2018 21:15,125,118,82,325,3,100.0
1696,3/06/2018 21:20,110,116,73,299,3,100.0
1697,3/06/2018 21:25,134,128,84,346,3,100.0
1698,3/06/2018 21:30,123,119,84,326,3,100.0
1699,3/06/2018 21:35,100,99,74,273,3,100.0
1700,3/06/2018 21:40,112,110,80,302,3,100.0
1701,3/06/2018 21:45,101,98,76,275,3,100.0
1702,3/06/2018 21:50,95,90,79,264,3,100.0
1703,3/06/2018 21:55,97,102,64,263,3,100.0
1704,3/06/2018 22:00,99,86,71,256,3,100.0
1705,3/06/2018 22:05,92,78,60,230,3,100.0
1706,3/06/2018 22:10,87,86,64,237,3,100.0
1707,3/06/2018 22:15,91,85,57,233,3,100.0
1708,3/06/2018 22:20,87,86,64,237,3,100.0
1709,3/06/2018 22:25,95,103,63,261,3,100.0
1710,3/06/2018 22:30,83,77,56,216,3,100.0
1711,3/06/2018 22:35,92,92,60,244,3,100.0
1712,3/06/2018 22:40,80,79,61,220,3,100.0
1713,3/06/2018 22:45,89,96,62,247,3,100.0
1714,3/06/2018 22:50,76,83,56,215,3,100.0
1715,3/06/2018 22:55,75,67,33,175,3,100.0
1716,3/06/2018 23:00,58,71,54,183,3,100.0
1717,3/06/2018 23:05,50,60,41,151,3,100.0
1718,3/06/2018 23:10,68,76,53,197,3,100.0
1719,3/06/2018 23:15,52,55,35,142,3,100.0
1720,3/06/2018 23:20,53,61,37,151,3,100.0
1721,3/06/2018 23:25,50,54,41,145,3,100.0
1722,3/06/2018 23:30,54,58,39,151,3,100.0
1723,3/06/2018 23:35,50,53,41,144,3,100.0
1724,3/06/2018 23:40,37,57,31,125,3,100.0
1725,3/06/2018 23:45,51,70,51,172,3,100.0
1726,3/06/2018 23:50,40,46,31,117,3,100.0
1727,3/06/2018 23:55,44,53,36,133,3,100.0
1728,3/07/2018 0:00,43,56,27,126,3,100.0
1729,3/07/2018 0:05,34,41,26,101,3,100.0
1730,3/07/2018 0:10,35,34,38,107,3,100.0
1731,3/07/2018 0:15,43,54,33,130,3,100.0
1732,3/07/2018 0:20,36,33,35,104,3,100.0
1733,3/07/2018 0:25,29,48,31,108,3,100.0
1734,3/07/2018 0:30,38,41,25,104,3,100.0
1735,3/07/2018 0:35,30,38,23,91,3,100.0
1736,3/07/2018 0:40,26,37,30,93,3,100.0
1737,3/07/2018 0:45,34,38,25,97,3,100.0
1738,3/07/2018 0:50,32,38,28,98,3,100.0
1739,3/07/2018 0:55,20,35,14,69,3,100.0
1740,3/07/2018 1:00,20,32,21,73,3,100.0
1741,3/07/2018 1:05,19,31,23,73,3,100.0
1742,3/07/2018 1:10,15,27,21,63,3,100.0
1743,3/07/2018 1:15,18,28,19,65,3,100.0
1744,3/07/2018 1:20,19,24,20,63,3,100.0
1745,3/07/2018 1:25,13,21,15,49,3,100.0
1746,3/07/2018 1:30,16,29,18,63,3,100.0
1747,3/07/2018 1:35,17,24,19,60,3,100.0
1748,3/07/2018 1:40,16,19,22,57,3,100.0
1749,3/07/2018 1:45,12,28,15,55,3,100.0
1750,3/07/2018 1:50,16,23,13,52,3,100.0
1751,3/07/2018 1:55,18,25,15,58,3,100.0
1752,3/07/2018 2:00,16,17,17,50,3,100.0
1753,3/07/2018 2:05,15,18,22,55,3,100.0
1754,3/07/2018 2:10,15,18,15,48,3,100.0
1755,3/07/2018 2:15,18,23,19,60,3,100.0
1756,3/07/2018 2:20,16,21,15,52,3,100.0
1757,3/07/2018 2:25,12,21,18,51,3,100.0
1758,3/07/2018 2:30,13,24,24,61,3,100.0
1759,3/07/2018 2:35,10,22,20,52,3,100.0
1760,3/07/2018 2:40,9,16,18,43,3,100.0
1761,3/07/2018 2:45,10,22,13,45,3,100.0
1762,3/07/2018 2:50,11,17,13,41,3,100.0
1763,3/07/2018 2:55,15,18,16,49,3,100.0
1764,3/07/2018 3:00,12,19,22,53,3,100.0
1765,3/07/2018 3:05,7,15,15,37,3,100.0
1766,3/07/2018 3:10,10,20,15,45,3,100.0
1767,3/07/2018 3:15,10,25,19,54,3,100.0
1768,3/07/2018 3:20,10,25,15,50,3,100.0
1769,3/07/2018 3:25,17,23,17,57,3,100.0
1770,3/07/2018 3:30,8,20,13,41,3,100.0
1771,3/07/2018 3:35,5,18,19,42,3,100.0
1772,3/07/2018 3:40,12,23,22,57,3,100.0
1773,3/07/2018 3:45,18,18,16,52,3,100.0
1774,3/07/2018 3:50,15,23,20,58,3,100.0
1775,3/07/2018 3:55,13,24,24,61,3,100.0
1776,3/07/2018 4:00,14,23,13,50,3,100.0
1777,3/07/2018 4:05,17,30,23,70,3,100.0
1778,3/07/2018 4:10,19,22,12,53,3,100.0
1779,3/07/2018 4:15,16,32,21,69,3,100.0
1780,3/07/2018 4:20,31,43,27,101,3,100.0
1781,3/07/2018 4:25,32,43,27,102,3,100.0
1782,3/07/2018 4:30,29,38,27,94,3,100.0
1783,3/07/2018 4:35,35,41,28,104,3,100.0
1784,3/07/2018 4:40,43,47,36,126,3,100.0
1785,3/07/2018 4:45,49,63,31,143,3,100.0
1786,3/07/2018 4:50,49,52,33,134,3,100.0
1787,3/07/2018 4:55,46,61,36,143,3,100.0
1788,3/07/2018 5:00,32,45,29,106,3,100.0
1789,3/07/2018 5:05,59,68,35,162,3,100.0
1790,3/07/2018 5:10,82,70,59,211,3,100.0
1791,3/07/2018 5:15,104,96,53,253,3,100.0
1792,3/07/2018 5:20,86,84,56,226,3,100.0
1793,3/07/2018 5:25,118,99,53,270,3,100.0
1794,3/07/2018 5:30,127,91,66,284,3,100.0
1795,3/07/2018 5:35,138,103,63,304,3,100.0
1796,3/07/2018 5:40,133,129,80,342,3,100.0
1797,3/07/2018 5:45,152,121,77,350,3,100.0
1798,3/07/2018 5:50,150,128,88,366,3,100.0
1799,3/07/2018 5:55,143,131,76,350,3,100.0
1800,3/07/2018 6:00,162,144,75,381,3,100.0
1801,3/07/2018 6:05,182,133,84,399,3,100.0
1802,3/07/2018 6:10,187,148,105,440,3,100.0
1803,3/07/2018 6:15,135,121,80,336,3,100.0
1804,3/07/2018 6:20,169,135,95,399,3,100.0
1805,3/07/2018 6:25,178,149,104,431,3,100.0
1806,3/07/2018 6:30,174,147,99,420,3,100.0
1807,3/07/2018 6:35,185,152,85,422,3,100.0
1808,3/07/2018 6:40,182,151,100,433,3,100.0
1809,3/07/2018 6:45,190,166,125,481,3,100.0
1810,3/07/2018 6:50,201,166,105,472,3,100.0
1811,3/07/2018 6:55,185,163,127,475,3,100.0
1812,3/07/2018 7:00,181,165,116,462,3,100.0
1813,3/07/2018 7:05,189,177,110,476,3,100.0
1814,3/07/2018 7:10,202,169,116,487,3,100.0
1815,3/07/2018 7:15,194,162,126,482,3,100.0
1816,3/07/2018 7:20,206,181,119,506,3,100.0
1817,3/07/2018 7:25,215,181,134,530,3,100.0
1818,3/07/2018 7:30,213,177,128,518,3,100.0
1819,3/07/2018 7:35,215,196,136,547,3,100.0
1820,3/07/2018 7:40,218,189,137,544,3,100.0
1821,3/07/2018 7:45,161,150,124,435,3,100.0
1822,3/07/2018 7:50,200,180,129,509,3,100.0
1823,3/07/2018 7:55,189,168,122,479,3,100.0
1824,3/07/2018 8:00,191,158,128,477,3,100.0
1825,3/07/2018 8:05,183,164,124,471,3,100.0
1826,3/07/2018 8:10,187,162,114,463,3,100.0
1827,3/07/2018 8:15,188,168,125,481,3,100.0
1828,3/07/2018 8:20,202,168,111,481,3,100.0
1829,3/07/2018 8:25,202,155,111,468,3,100.0
1830,3/07/2018 8:30,164,143,102,409,3,100.0
1831,3/07/2018 8:35,172,151,103,426,3,100.0
1832,3/07/2018 8:40,204,177,116,497,3,100.0
1833,3/07/2018 8:45,203,169,133,505,3,100.0
1834,3/07/2018 8:50,204,173,115,492,3,100.0
1835,3/07/2018 8:55,152,141,119,412,3,100.0
1836,3/07/2018 9:00,179,153,112,444,3,100.0
1837,3/07/2018 9:05,199,167,119,485,3,100.0
1838,3/07/2018 9:10,206,178,124,508,3,100.0
1839,3/07/2018 9:15,180,153,104,437,3,0.0
1840,3/07/2018 9:20,194,163,105,462,3,100.0
1841,3/07/2018 9:25,161,150,101,412,3,100.0
1842,3/07/2018 9:30,159,140,103,402,3,100.0
1843,3/07/2018 9:35,170,154,94,418,3,100.0
1844,3/07/2018 9:40,168,138,96,402,3,100.0
1845,3/07/2018 9:45,169,148,103,420,3,100.0
1846,3/07/2018 9:50,151,124,101,376,3,100.0
1847,3/07/2018 9:55,167,134,106,407,3,100.0
1848,3/07/2018 10:00,144,135,87,366,3,100.0
1849,3/07/2018 10:05,162,128,101,391,3,100.0
1850,3/07/2018 10:10,167,144,102,413,3,100.0
1851,3/07/2018 10:15,157,137,91,385,3,100.0
1852,3/07/2018 10:20,156,139,93,388,3,100.0
1853,3/07/2018 10:25,168,146,99,413,3,100.0
1854,3/07/2018 10:30,163,144,95,402,3,100.0
1855,3/07/2018 10:35,171,145,104,420,3,100.0
1856,3/07/2018 10:40,190,151,107,448,3,100.0
1857,3/07/2018 10:45,164,146,89,399,3,100.0
1858,3/07/2018 10:50,170,152,124,446,3,100.0
1859,3/07/2018 10:55,131,137,93,361,3,100.0
1860,3/07/2018 11:00,178,152,99,429,3,100.0
1861,3/07/2018 11:05,150,137,99,386,3,100.0
1862,3/07/2018 11:10,175,142,97,414,3,100.0
1863,3/07/2018 11:15,167,143,110,420,3,100.0
1864,3/07/2018 11:20,165,134,92,391,3,100.0
1865,3/07/2018 11:25,189,141,108,438,3,100.0
1866,3/07/2018 11:30,175,158,112,445,3,100.0
1867,3/07/2018 11:35,195,149,120,464,3,100.0
1868,3/07/2018 11:40,185,164,100,449,3,100.0
1869,3/07/2018 11:45,169,150,112,431,3,100.0
1870,3/07/2018 11:50,180,161,120,461,3,100.0
1871,3/07/2018 11:55,181,150,120,451,3,100.0
0,3/07/2018 0:00,43,56,27,126,3,100.0
1,3/07/2018 0:05,34,41,26,101,3,100.0
2,3/07/2018 0:10,35,34,38,107,3,100.0
3,3/07/2018 0:15,43,54,33,130,3,100.0
4,3/07/2018 0:20,36,33,35,104,3,100.0
5,3/07/2018 0:25,29,48,31,108,3,100.0
6,3/07/2018 0:30,38,41,25,104,3,100.0
7,3/07/2018 0:35,30,38,23,91,3,100.0
8,3/07/2018 0:40,26,37,30,93,3,100.0
9,3/07/2018 0:45,34,38,25,97,3,100.0
10,3/07/2018 0:50,32,38,28,98,3,100.0
11,3/07/2018 0:55,20,35,14,69,3,100.0
12,3/07/2018 1:00,20,32,21,73,3,100.0
13,3/07/2018 1:05,19,31,23,73,3,100.0
14,3/07/2018 1:10,15,27,21,63,3,100.0
15,3/07/2018 1:15,18,28,19,65,3,100.0
16,3/07/2018 1:20,19,24,20,63,3,100.0
17,3/07/2018 1:25,13,21,15,49,3,100.0
18,3/07/2018 1:30,16,29,18,63,3,100.0
19,3/07/2018 1:35,17,24,19,60,3,100.0
20,3/07/2018 1:40,16,19,22,57,3,100.0
21,3/07/2018 1:45,12,28,15,55,3,100.0
22,3/07/2018 1:50,16,23,13,52,3,100.0
23,3/07/2018 1:55,18,25,15,58,3,100.0
24,3/07/2018 2:00,16,17,17,50,3,100.0
25,3/07/2018 2:05,15,18,22,55,3,100.0
26,3/07/2018 2:10,15,18,15,48,3,100.0
27,3/07/2018 2:15,18,23,19,60,3,100.0
28,3/07/2018 2:20,16,21,15,52,3,100.0
29,3/07/2018 2:25,12,21,18,51,3,100.0
30,3/07/2018 2:30,13,24,24,61,3,100.0
31,3/07/2018 2:35,10,22,20,52,3,100.0
32,3/07/2018 2:40,9,16,18,43,3,100.0
33,3/07/2018 2:45,10,22,13,45,3,100.0
34,3/07/2018 2:50,11,17,13,41,3,100.0
35,3/07/2018 2:55,15,18,16,49,3,100.0
36,3/07/2018 3:00,12,19,22,53,3,100.0
37,3/07/2018 3:05,7,15,15,37,3,100.0
38,3/07/2018 3:10,10,20,15,45,3,100.0
39,3/07/2018 3:15,10,25,19,54,3,100.0
40,3/07/2018 3:20,10,25,15,50,3,100.0
41,3/07/2018 3:25,17,23,17,57,3,100.0
42,3/07/2018 3:30,8,20,13,41,3,100.0
43,3/07/2018 3:35,5,18,19,42,3,100.0
44,3/07/2018 3:40,12,23,22,57,3,100.0
45,3/07/2018 3:45,18,18,16,52,3,100.0
46,3/07/2018 3:50,15,23,20,58,3,100.0
47,3/07/2018 3:55,13,24,24,61,3,100.0
48,3/07/2018 4:00,14,23,13,50,3,100.0
49,3/07/2018 4:05,17,30,23,70,3,100.0
50,3/07/2018 4:10,19,22,12,53,3,100.0
51,3/07/2018 4:15,16,32,21,69,3,100.0
52,3/07/2018 4:20,31,43,27,101,3,100.0
53,3/07/2018 4:25,32,43,27,102,3,100.0
54,3/07/2018 4:30,29,38,27,94,3,100.0
55,3/07/2018 4:35,35,41,28,104,3,100.0
56,3/07/2018 4:40,43,47,36,126,3,100.0
57,3/07/2018 4:45,49,63,31,143,3,100.0
58,3/07/2018 4:50,49,52,33,134,3,100.0
59,3/07/2018 4:55,46,61,36,143,3,100.0
60,3/07/2018 5:00,32,45,29,106,3,100.0
61,3/07/2018 5:05,59,68,35,162,3,100.0
62,3/07/2018 5:10,82,70,59,211,3,100.0
63,3/07/2018 5:15,104,96,53,253,3,100.0
64,3/07/2018 5:20,86,84,56,226,3,100.0
65,3/07/2018 5:25,118,99,53,270,3,100.0
66,3/07/2018 5:30,127,91,66,284,3,100.0
67,3/07/2018 5:35,138,103,63,304,3,100.0
68,3/07/2018 5:40,133,129,80,342,3,100.0
69,3/07/2018 5:45,152,121,77,350,3,100.0
70,3/07/2018 5:50,150,128,88,366,3,100.0
71,3/07/2018 5:55,143,131,76,350,3,100.0
72,3/07/2018 6:00,162,144,75,381,3,100.0
73,3/07/2018 6:05,182,133,84,399,3,100.0
74,3/07/2018 6:10,187,148,105,440,3,100.0
75,3/07/2018 6:15,135,121,80,336,3,100.0
76,3/07/2018 6:20,169,135,95,399,3,100.0
77,3/07/2018 6:25,178,149,104,431,3,100.0
78,3/07/2018 6:30,174,147,99,420,3,100.0
79,3/07/2018 6:35,185,152,85,422,3,100.0
80,3/07/2018 6:40,182,151,100,433,3,100.0
81,3/07/2018 6:45,190,166,125,481,3,100.0
82,3/07/2018 6:50,201,166,105,472,3,100.0
83,3/07/2018 6:55,185,163,127,475,3,100.0
84,3/07/2018 7:00,181,165,116,462,3,100.0
85,3/07/2018 7:05,189,177,110,476,3,100.0
86,3/07/2018 7:10,202,169,116,487,3,100.0
87,3/07/2018 7:15,194,162,126,482,3,100.0
88,3/07/2018 7:20,206,181,119,506,3,100.0
89,3/07/2018 7:25,215,181,134,530,3,100.0
90,3/07/2018 7:30,213,177,128,518,3,100.0
91,3/07/2018 7:35,215,196,136,547,3,100.0
92,3/07/2018 7:40,218,189,137,544,3,100.0
93,3/07/2018 7:45,161,150,124,435,3,100.0
94,3/07/2018 7:50,200,180,129,509,3,100.0
95,3/07/2018 7:55,189,168,122,479,3,100.0
96,3/07/2018 8:00,191,158,128,477,3,100.0
97,3/07/2018 8:05,183,164,124,471,3,100.0
98,3/07/2018 8:10,187,162,114,463,3,100.0
99,3/07/2018 8:15,188,168,125,481,3,100.0
100,3/07/2018 8:20,202,168,111,481,3,100.0
101,3/07/2018 8:25,202,155,111,468,3,100.0
102,3/07/2018 8:30,164,143,102,409,3,100.0
103,3/07/2018 8:35,172,151,103,426,3,100.0
104,3/07/2018 8:40,204,177,116,497,3,100.0
105,3/07/2018 8:45,203,169,133,505,3,100.0
106,3/07/2018 8:50,204,173,115,492,3,100.0
107,3/07/2018 8:55,152,141,119,412,3,100.0
108,3/07/2018 9:00,179,153,112,444,3,100.0
109,3/07/2018 9:05,199,167,119,485,3,100.0
110,3/07/2018 9:10,206,178,124,508,3,100.0
111,3/07/2018 9:15,180,153,104,437,3,0.0
112,3/07/2018 9:20,194,163,105,462,3,100.0
113,3/07/2018 9:25,161,150,101,412,3,100.0
114,3/07/2018 9:30,159,140,103,402,3,100.0
115,3/07/2018 9:35,170,154,94,418,3,100.0
116,3/07/2018 9:40,168,138,96,402,3,100.0
117,3/07/2018 9:45,169,148,103,420,3,100.0
118,3/07/2018 9:50,151,124,101,376,3,100.0
119,3/07/2018 9:55,167,134,106,407,3,100.0
120,3/07/2018 10:00,144,135,87,366,3,100.0
121,3/07/2018 10:05,162,128,101,391,3,100.0
122,3/07/2018 10:10,167,144,102,413,3,100.0
123,3/07/2018 10:15,157,137,91,385,3,100.0
124,3/07/2018 10:20,156,139,93,388,3,100.0
125,3/07/2018 10:25,168,146,99,413,3,100.0
126,3/07/2018 10:30,163,144,95,402,3,100.0
127,3/07/2018 10:35,171,145,104,420,3,100.0
128,3/07/2018 10:40,190,151,107,448,3,100.0
129,3/07/2018 10:45,164,146,89,399,3,100.0
130,3/07/2018 10:50,170,152,124,446,3,100.0
131,3/07/2018 10:55,131,137,93,361,3,100.0
132,3/07/2018 11:00,178,152,99,429,3,100.0
133,3/07/2018 11:05,150,137,99,386,3,100.0
134,3/07/2018 11:10,175,142,97,414,3,100.0
135,3/07/2018 11:15,167,143,110,420,3,100.0
136,3/07/2018 11:20,165,134,92,391,3,100.0
137,3/07/2018 11:25,189,141,108,438,3,100.0
138,3/07/2018 11:30,175,158,112,445,3,100.0
139,3/07/2018 11:35,195,149,120,464,3,100.0
140,3/07/2018 11:40,185,164,100,449,3,100.0
141,3/07/2018 11:45,169,150,112,431,3,100.0
142,3/07/2018 11:50,180,161,120,461,3,100.0
143,3/07/2018 11:55,181,150,120,451,3,100.0
144,3/07/2018 12:00,173,144,99,416,3,100.0
145,3/07/2018 12:05,185,149,121,455,3,100.0
146,3/07/2018 12:10,166,150,112,428,3,100.0
147,3/07/2018 12:15,195,164,116,475,3,100.0
148,3/07/2018 12:20,167,139,94,400,3,100.0
149,3/07/2018 12:25,193,163,103,459,3,100.0
150,3/07/2018 12:30,194,140,108,442,3,100.0
151,3/07/2018 12:35,184,156,131,471,3,100.0
152,3/07/2018 12:40,180,151,103,434,3,100.0
153,3/07/2018 12:45,172,159,104,435,3,100.0
154,3/07/2018 12:50,176,169,121,466,3,100.0
155,3/07/2018 12:55,180,164,116,460,3,100.0
156,3/07/2018 13:00,175,156,120,451,3,100.0
157,3/07/2018 13:05,171,154,112,437,3,100.0
158,3/07/2018 13:10,166,160,116,442,3,100.0
159,3/07/2018 13:15,176,145,119,440,3,100.0
160,3/07/2018 13:20,172,164,135,471,3,100.0
161,3/07/2018 13:25,177,166,127,470,3,100.0
162,3/07/2018 13:30,170,157,128,455,3,100.0
163,3/07/2018 13:35,182,157,130,469,3,100.0
164,3/07/2018 13:40,186,181,144,511,3,100.0
165,3/07/2018 13:45,153,149,139,441,3,100.0
166,3/07/2018 13:50,170,174,139,483,3,100.0
167,3/07/2018 13:55,172,165,123,460,3,100.0
168,3/07/2018 14:00,173,168,122,463,3,100.0
169,3/07/2018 14:05,178,158,141,477,3,100.0
170,3/07/2018 14:10,169,158,151,478,3,100.0
171,3/07/2018 14:15,169,175,146,490,3,100.0
172,3/07/2018 14:20,169,162,143,474,3,100.0
173,3/07/2018 14:25,164,157,143,464,3,100.0
174,3/07/2018 14:30,171,154,133,458,3,100.0
175,3/07/2018 14:35,168,158,144,470,3,100.0
176,3/07/2018 14:40,172,169,153,494,3,100.0
177,3/07/2018 14:45,159,152,134,445,3,100.0
178,3/07/2018 14:50,168,161,143,472,3,100.0
179,3/07/2018 14:55,163,159,136,458,3,100.0
180,3/07/2018 15:00,162,159,143,464,3,100.0
181,3/07/2018 15:05,176,174,158,508,3,100.0
182,3/07/2018 15:10,162,155,140,457,3,100.0
183,3/07/2018 15:15,165,157,145,467,3,100.0
184,3/07/2018 15:20,168,161,135,464,3,100.0
185,3/07/2018 15:25,167,153,142,462,3,100.0
186,3/07/2018 15:30,176,166,143,485,3,100.0
187,3/07/2018 15:35,157,152,146,455,3,100.0
188,3/07/2018 15:40,167,167,157,491,3,100.0
189,3/07/2018 15:45,151,146,133,430,3,100.0
190,3/07/2018 15:50,164,151,137,452,3,100.0
191,3/07/2018 15:55,167,155,148,470,3,100.0
192,3/07/2018 16:00,161,145,141,447,3,100.0
193,3/07/2018 16:05,130,122,125,377,3,100.0
194,3/07/2018 16:10,162,151,144,457,3,100.0
195,3/07/2018 16:15,155,145,125,425,3,100.0
196,3/07/2018 16:20,169,164,150,483,3,100.0
197,3/07/2018 16:25,150,144,145,439,3,100.0
198,3/07/2018 16:30,169,169,152,490,3,100.0
199,3/07/2018 16:35,164,167,146,477,3,100.0
200,3/07/2018 16:40,131,133,121,385,3,100.0
201,3/07/2018 16:45,108,120,112,340,3,100.0
202,3/07/2018 16:50,150,155,138,443,3,100.0
203,3/07/2018 16:55,148,132,143,423,3,100.0
204,3/07/2018 17:00,147,135,127,409,3,100.0
205,3/07/2018 17:05,156,159,134,449,3,100.0
206,3/07/2018 17:10,128,128,118,374,3,100.0
207,3/07/2018 17:15,134,134,129,397,3,100.0
208,3/07/2018 17:20,150,142,141,433,3,100.0
209,3/07/2018 17:25,136,124,126,386,3,100.0
210,3/07/2018 17:30,140,142,135,417,3,100.0
211,3/07/2018 17:35,156,144,133,433,3,100.0
212,3/07/2018 17:40,127,122,117,366,3,100.0
213,3/07/2018 17:45,122,123,116,361,3,100.0
214,3/07/2018 17:50,130,135,122,387,3,100.0
215,3/07/2018 17:55,152,141,130,423,3,100.0
216,3/07/2018 18:00,149,135,124,408,3,100.0
217,3/07/2018 18:05,135,123,128,386,3,100.0
218,3/07/2018 18:10,138,133,122,393,3,100.0
219,3/07/2018 18:15,121,128,122,371,3,100.0
220,3/07/2018 18:20,140,138,123,401,3,100.0
221,3/07/2018 18:25,138,140,132,410,3,100.0
222,3/07/2018 18:30,160,140,134,434,3,100.0
223,3/07/2018 18:35,139,138,131,408,3,100.0
224,3/07/2018 18:40,149,136,120,405,3,100.0
225,3/07/2018 18:45,145,137,134,416,3,100.0
226,3/07/2018 18:50,148,140,135,423,3,100.0
227,3/07/2018 18:55,148,139,127,414,3,100.0
228,3/07/2018 19:00,151,147,128,426,3,100.0
229,3/07/2018 19:05,143,139,120,402,3,100.0
230,3/07/2018 19:10,155,142,133,430,3,100.0
231,3/07/2018 19:15,158,141,134,433,3,100.0
232,3/07/2018 19:20,144,133,115,392,3,100.0
233,3/07/2018 19:25,161,148,144,453,3,100.0
234,3/07/2018 19:30,152,149,136,437,3,100.0
235,3/07/2018 19:35,148,133,124,405,3,100.0
236,3/07/2018 19:40,157,143,136,436,3,100.0
237,3/07/2018 19:45,162,149,131,442,3,100.0
238,3/07/2018 19:50,149,141,138,428,3,100.0
239,3/07/2018 19:55,162,142,148,452,3,100.0
240,3/07/2018 20:00,145,142,138,425,3,100.0
241,3/07/2018 20:05,149,143,137,429,3,100.0
242,3/07/2018 20:10,157,154,119,430,3,100.0
243,3/07/2018 20:15,147,136,109,392,3,100.0
244,3/07/2018 20:20,141,149,111,401,3,100.0
245,3/07/2018 20:25,143,133,105,381,3,100.0
246,3/07/2018 20:30,128,126,96,350,3,100.0
247,3/07/2018 20:35,151,145,110,406,3,100.0
248,3/07/2018 20:40,131,120,92,343,3,100.0
249,3/07/2018 20:45,139,128,107,374,3,100.0
250,3/07/2018 20:50,144,135,98,377,3,100.0
251,3/07/2018 20:55,160,143,110,413,3,100.0
252,3/07/2018 21:00,151,134,111,396,3,100.0
253,3/07/2018 21:05,173,133,104,410,3,100.0
254,3/07/2018 21:10,153,142,100,395,3,100.0
255,3/07/2018 21:15,148,133,102,383,3,100.0
256,3/07/2018 21:20,111,108,76,295,3,100.0
257,3/07/2018 21:25,120,99,74,293,3,100.0
258,3/07/2018 21:30,124,117,94,335,3,100.0
259,3/07/2018 21:35,125,116,81,322,3,100.0
260,3/07/2018 21:40,108,103,67,278,3,100.0
261,3/07/2018 21:45,100,102,67,269,3,100.0
262,3/07/2018 21:50,119,111,75,305,3,100.0
263,3/07/2018 21:55,109,92,78,279,3,100.0
264,3/07/2018 22:00,82,84,58,224,3,100.0
265,3/07/2018 22:05,102,97,79,278,3,100.0
266,3/07/2018 22:10,119,109,74,302,3,100.0
267,3/07/2018 22:15,99,99,78,276,3,100.0
268,3/07/2018 22:20,129,103,78,310,3,100.0
269,3/07/2018 22:25,89,94,52,235,3,100.0
270,3/07/2018 22:30,111,97,67,275,3,100.0
271,3/07/2018 22:35,88,91,70,249,3,100.0
272,3/07/2018 22:40,96,94,68,258,3,100.0
273,3/07/2018 22:45,66,82,60,208,3,100.0
274,3/07/2018 22:50,94,86,49,229,3,100.0
275,3/07/2018 22:55,83,100,68,251,3,100.0
276,3/07/2018 23:00,55,75,55,185,3,100.0
277,3/07/2018 23:05,67,58,50,175,3,100.0
278,3/07/2018 23:10,69,69,47,185,3,100.0
279,3/07/2018 23:15,66,74,49,189,3,100.0
280,3/07/2018 23:20,58,56,39,153,3,100.0
281,3/07/2018 23:25,66,66,45,177,3,100.0
282,3/07/2018 23:30,57,60,33,150,3,100.0
283,3/07/2018 23:35,50,45,33,128,3,100.0
284,3/07/2018 23:40,54,53,29,136,3,100.0
285,3/07/2018 23:45,65,56,39,160,3,100.0
286,3/07/2018 23:50,47,53,44,144,3,100.0
287,3/07/2018 23:55,40,48,24,112,3,100.0
288,3/08/2018 0:00,54,42,32,128,3,100.0
289,3/08/2018 0:05,36,36,33,105,3,100.0
290,3/08/2018 0:10,41,42,40,123,3,100.0
291,3/08/2018 0:15,47,52,46,145,3,100.0
292,3/08/2018 0:20,45,48,29,122,3,100.0
293,3/08/2018 0:25,45,56,34,135,3,100.0
294,3/08/2018 0:30,39,44,33,116,3,100.0
295,3/08/2018 0:35,39,39,29,107,3,100.0
296,3/08/2018 0:40,36,44,25,105,3,100.0
297,3/08/2018 0:45,23,33,25,81,3,100.0
298,3/08/2018 0:50,30,30,22,82,3,100.0
299,3/08/2018 0:55,19,30,29,78,3,100.0
300,3/08/2018 1:00,22,27,16,65,3,100.0
301,3/08/2018 1:05,24,28,22,74,3,100.0
302,3/08/2018 1:10,11,24,22,57,3,100.0
303,3/08/2018 1:15,24,28,17,69,3,100.0
304,3/08/2018 1:20,15,22,17,54,3,100.0
305,3/08/2018 1:25,20,20,13,53,3,100.0
306,3/08/2018 1:30,18,20,15,53,3,100.0
307,3/08/2018 1:35,15,22,17,54,3,100.0
308,3/08/2018 1:40,13,23,14,50,3,100.0
309,3/08/2018 1:45,14,21,14,49,3,100.0
310,3/08/2018 1:50,14,23,12,49,3,100.0
311,3/08/2018 1:55,12,24,19,55,3,100.0
312,3/08/2018 2:00,11,23,20,54,3,100.0
313,3/08/2018 2:05,17,16,12,45,3,100.0
314,3/08/2018 2:10,16,17,15,48,3,100.0
315,3/08/2018 2:15,20,24,18,62,3,100.0
316,3/08/2018 2:20,14,27,18,59,3,100.0
317,3/08/2018 2:25,16,22,17,55,3,100.0
318,3/08/2018 2:30,11,28,20,59,3,100.0
319,3/08/2018 2:35,12,18,18,48,3,100.0
320,3/08/2018 2:40,12,17,14,43,3,100.0
321,3/08/2018 2:45,11,16,15,42,3,100.0
322,3/08/2018 2:50,9,26,16,51,3,100.0
323,3/08/2018 2:55,10,12,14,36,3,100.0
324,3/08/2018 3:00,7,12,14,33,3,100.0
325,3/08/2018 3:05,11,15,16,42,3,100.0
326,3/08/2018 3:10,7,14,14,35,3,100.0
327,3/08/2018 3:15,12,23,10,45,3,100.0
328,3/08/2018 3:20,14,22,9,45,3,100.0
329,3/08/2018 3:25,20,16,23,59,3,100.0
330,3/08/2018 3:30,15,18,23,56,3,100.0
331,3/08/2018 3:35,12,30,22,64,3,100.0
332,3/08/2018 3:40,12,24,18,54,3,100.0
333,3/08/2018 3:45,19,26,22,67,3,100.0
334,3/08/2018 3:50,16,32,19,67,3,100.0
335,3/08/2018 3:55,12,29,20,61,3,100.0
336,3/08/2018 4:00,6,17,21,44,3,100.0
337,3/08/2018 4:05,17,31,18,66,3,100.0
338,3/08/2018 4:10,24,33,20,77,3,100.0
339,3/08/2018 4:15,10,32,21,63,3,100.0
340,3/08/2018 4:20,27,43,22,92,3,100.0
341,3/08/2018 4:25,30,47,27,104,3,100.0
342,3/08/2018 4:30,41,48,27,116,3,100.0
343,3/08/2018 4:35,45,54,38,137,3,100.0
344,3/08/2018 4:40,43,47,36,126,3,100.0
345,3/08/2018 4:45,48,53,42,143,3,100.0
346,3/08/2018 4:50,41,52,35,128,3,100.0
347,3/08/2018 4:55,49,57,38,144,3,100.0
348,3/08/2018 5:00,37,52,32,121,3,100.0
349,3/08/2018 5:05,56,55,46,157,3,100.0
350,3/08/2018 5:10,75,71,54,200,3,100.0
351,3/08/2018 5:15,118,87,51,256,3,100.0
352,3/08/2018 5:20,117,84,58,259,3,100.0
353,3/08/2018 5:25,119,106,51,276,3,100.0
354,3/08/2018 5:30,135,111,61,307,3,100.0
355,3/08/2018 5:35,130,101,65,296,3,100.0
356,3/08/2018 5:40,141,123,78,342,3,100.0
357,3/08/2018 5:45,149,121,79,349,3,100.0
358,3/08/2018 5:50,131,136,77,344,3,100.0
359,3/08/2018 5:55,162,123,76,361,3,100.0
360,3/08/2018 6:00,158,129,85,372,3,100.0
361,3/08/2018 6:05,168,140,84,392,3,100.0
362,3/08/2018 6:10,160,124,83,367,3,100.0
363,3/08/2018 6:15,163,143,91,397,3,100.0
364,3/08/2018 6:20,170,141,108,419,3,100.0
365,3/08/2018 6:25,161,128,81,370,3,100.0
366,3/08/2018 6:30,177,129,93,399,3,100.0
367,3/08/2018 6:35,176,154,102,432,3,100.0
368,3/08/2018 6:40,192,166,108,466,3,100.0
369,3/08/2018 6:45,170,153,99,422,3,100.0
370,3/08/2018 6:50,183,150,112,445,3,100.0
371,3/08/2018 6:55,200,179,113,492,3,100.0
372,3/08/2018 7:00,194,173,105,472,3,100.0
373,3/08/2018 7:05,188,168,113,469,3,100.0
374,3/08/2018 7:10,205,172,120,497,3,100.0
375,3/08/2018 7:15,208,171,125,504,3,100.0
376,3/08/2018 7:20,181,171,134,486,3,100.0
377,3/08/2018 7:25,161,160,139,460,3,100.0
378,3/08/2018 7:30,164,148,150,462,3,100.0
379,3/08/2018 7:35,174,166,141,481,3,100.0
380,3/08/2018 7:40,176,177,156,509,3,100.0
381,3/08/2018 7:45,190,192,146,528,3,100.0
382,3/08/2018 7:50,206,183,131,520,3,100.0
383,3/08/2018 7:55,188,172,136,496,3,100.0
384,3/08/2018 8:00,175,163,116,454,3,100.0
385,3/08/2018 8:05,180,164,108,452,3,100.0
386,3/08/2018 8:10,189,179,115,483,3,100.0
387,3/08/2018 8:15,207,160,124,491,3,100.0
388,3/08/2018 8:20,183,167,120,470,3,100.0
389,3/08/2018 8:25,171,148,106,425,3,100.0
390,3/08/2018 8:30,164,154,114,432,3,100.0
391,3/08/2018 8:35,190,176,122,488,3,100.0
392,3/08/2018 8:40,201,163,129,493,3,100.0
393,3/08/2018 8:45,210,176,144,530,3,100.0
394,3/08/2018 8:50,183,159,113,455,3,100.0
395,3/08/2018 8:55,175,165,114,454,3,100.0
396,3/08/2018 9:00,183,164,115,462,3,100.0
397,3/08/2018 9:05,184,162,108,454,3,100.0
398,3/08/2018 9:10,198,157,98,453,3,100.0
399,3/08/2018 9:15,184,165,99,448,3,100.0
400,3/08/2018 9:20,182,163,99,444,3,100.0
401,3/08/2018 9:25,197,172,111,480,3,100.0
402,3/08/2018 9:30,185,154,115,454,3,100.0
403,3/08/2018 9:35,167,139,93,399,3,100.0
404,3/08/2018 9:40,173,154,96,423,3,100.0
405,3/08/2018 9:45,160,151,102,413,3,100.0
406,3/08/2018 9:50,170,155,104,429,3,100.0
407,3/08/2018 9:55,160,149,99,408,3,100.0
408,3/08/2018 10:00,156,140,99,395,3,100.0
409,3/08/2018 10:05,155,139,86,380,3,100.0
410,3/08/2018 10:10,166,147,91,404,3,100.0
411,3/08/2018 10:15,152,134,93,379,3,100.0
412,3/08/2018 10:20,177,153,105,435,3,100.0
413,3/08/2018 10:25,160,141,103,404,3,100.0
414,3/08/2018 10:30,157,142,92,391,3,100.0
415,3/08/2018 10:35,157,153,97,407,3,100.0
416,3/08/2018 10:40,163,136,101,400,3,100.0
417,3/08/2018 10:45,179,158,112,449,3,100.0
418,3/08/2018 10:50,167,146,87,400,3,100.0
419,3/08/2018 10:55,169,157,117,443,3,100.0
420,3/08/2018 11:00,184,163,106,453,3,100.0
421,3/08/2018 11:05,172,146,107,425,3,100.0
422,3/08/2018 11:10,174,157,114,445,3,100.0
423,3/08/2018 11:15,185,170,117,472,3,100.0
424,3/08/2018 11:20,171,155,109,435,3,100.0
425,3/08/2018 11:25,182,147,94,423,3,100.0
426,3/08/2018 11:30,175,150,113,438,3,100.0
427,3/08/2018 11:35,170,145,117,432,3,100.0
428,3/08/2018 11:40,163,154,123,440,3,100.0
429,3/08/2018 11:45,162,143,116,421,3,100.0
430,3/08/2018 11:50,181,153,109,443,3,100.0
431,3/08/2018 11:55,173,146,94,413,3,100.0
432,3/08/2018 12:00,173,148,106,427,3,100.0
433,3/08/2018 12:05,158,130,103,391,3,100.0
434,3/08/2018 12:10,166,137,101,404,3,100.0
435,3/08/2018 12:15,162,142,108,412,3,100.0
436,3/08/2018 12:20,149,133,106,388,3,100.0
437,3/08/2018 12:25,165,138,108,411,3,100.0
438,3/08/2018 12:30,151,127,118,396,3,100.0
439,3/08/2018 12:35,156,139,102,397,3,100.0
440,3/08/2018 12:40,164,145,118,427,3,100.0
441,3/08/2018 12:45,174,153,113,440,3,100.0
442,3/08/2018 12:50,169,159,118,446,3,100.0
443,3/08/2018 12:55,173,149,120,442,3,100.0
444,3/08/2018 13:00,171,136,104,411,3,100.0
445,3/08/2018 13:05,169,154,131,454,3,100.0
446,3/08/2018 13:10,167,152,117,436,3,100.0
447,3/08/2018 13:15,157,149,125,431,3,100.0
448,3/08/2018 13:20,158,151,125,434,3,100.0
449,3/08/2018 13:25,125,119,100,344,3,100.0
450,3/08/2018 13:30,121,120,104,345,3,100.0
451,3/08/2018 13:35,107,126,103,336,3,100.0
452,3/08/2018 13:40,113,107,92,312,3,100.0
453,3/08/2018 13:45,172,153,125,450,3,100.0
454,3/08/2018 13:50,179,173,143,495,3,100.0
455,3/08/2018 13:55,211,180,144,535,3,100.0
456,3/08/2018 14:00,165,158,126,449,3,100.0
457,3/08/2018 14:05,164,149,132,445,3,100.0
458,3/08/2018 14:10,169,164,124,457,3,100.0
459,3/08/2018 14:15,155,149,126,430,3,100.0
460,3/08/2018 14:20,172,165,139,476,3,100.0
461,3/08/2018 14:25,148,139,132,419,3,100.0
462,3/08/2018 14:30,153,161,124,438,3,100.0
463,3/08/2018 14:35,164,166,130,460,3,100.0
464,3/08/2018 14:40,168,160,141,469,3,100.0
465,3/08/2018 14:45,159,158,147,464,3,100.0
466,3/08/2018 14:50,148,143,137,428,3,100.0
467,3/08/2018 14:55,153,147,136,436,3,100.0
468,3/08/2018 15:00,160,154,149,463,3,100.0
469,3/08/2018 15:05,160,147,144,451,3,100.0
470,3/08/2018 15:10,168,158,141,467,3,100.0
471,3/08/2018 15:15,158,140,134,432,3,100.0
472,3/08/2018 15:20,160,167,142,469,3,100.0
473,3/08/2018 15:25,154,154,140,448,3,100.0
474,3/08/2018 15:30,152,144,132,428,3,100.0
475,3/08/2018 15:35,155,154,130,439,3,100.0
476,3/08/2018 15:40,149,134,125,408,3,100.0
477,3/08/2018 15:45,124,131,120,375,3,100.0
478,3/08/2018 15:50,128,133,126,387,3,100.0
479,3/08/2018 15:55,75,90,90,255,3,100.0
480,3/08/2018 16:00,89,101,101,291,3,100.0
481,3/08/2018 16:05,84,91,93,268,3,100.0
482,3/08/2018 16:10,88,97,104,289,3,100.0
483,3/08/2018 16:15,148,156,144,448,3,100.0
484,3/08/2018 16:20,165,155,140,460,3,100.0
485,3/08/2018 16:25,145,146,131,422,3,100.0
486,3/08/2018 16:30,139,129,133,401,3,100.0
487,3/08/2018 16:35,150,153,131,434,3,100.0
488,3/08/2018 16:40,157,150,153,460,3,100.0
489,3/08/2018 16:45,141,131,134,406,3,100.0
490,3/08/2018 16:50,151,142,144,437,3,100.0
491,3/08/2018 16:55,144,134,121,399,3,100.0
492,3/08/2018 17:00,139,141,143,423,3,100.0
493,3/08/2018 17:05,130,113,123,366,3,100.0
494,3/08/2018 17:10,132,144,120,396,3,100.0
495,3/08/2018 17:15,132,128,135,395,3,100.0
496,3/08/2018 17:20,137,135,130,402,3,100.0
497,3/08/2018 17:25,127,132,130,389,3,100.0
498,3/08/2018 17:30,132,130,139,401,3,100.0
499,3/08/2018 17:35,124,134,129,387,3,100.0
500,3/08/2018 17:40,138,136,140,414,3,100.0
501,3/08/2018 17:45,145,142,126,413,3,100.0
502,3/08/2018 17:50,154,141,129,424,3,100.0
503,3/08/2018 17:55,143,142,137,422,3,100.0
504,3/08/2018 18:00,145,128,133,406,3,100.0
505,3/08/2018 18:05,163,143,141,447,3,100.0
506,3/08/2018 18:10,156,140,132,428,3,100.0
507,3/08/2018 18:15,148,139,130,417,3,100.0
508,3/08/2018 18:20,154,139,128,421,3,100.0
509,3/08/2018 18:25,152,145,130,427,3,100.0
510,3/08/2018 18:30,161,134,131,426,3,100.0
511,3/08/2018 18:35,148,143,136,427,3,100.0
512,3/08/2018 18:40,148,144,131,423,3,100.0
513,3/08/2018 18:45,147,135,129,411,3,100.0
514,3/08/2018 18:50,143,141,126,410,3,100.0
515,3/08/2018 18:55,152,146,122,420,3,100.0
516,3/08/2018 19:00,162,142,131,435,3,100.0
517,3/08/2018 19:05,150,132,126,408,3,100.0
518,3/08/2018 19:10,144,138,135,417,3,100.0
519,3/08/2018 19:15,148,141,138,427,3,100.0
520,3/08/2018 19:20,151,145,137,433,3,100.0
521,3/08/2018 19:25,162,138,129,429,3,100.0
522,3/08/2018 19:30,138,150,123,411,3,100.0
523,3/08/2018 19:35,156,140,136,432,3,100.0
524,3/08/2018 19:40,157,152,136,445,3,100.0
525,3/08/2018 19:45,157,140,140,437,3,100.0
526,3/08/2018 19:50,147,144,128,419,3,100.0
527,3/08/2018 19:55,147,142,130,419,3,100.0
528,3/08/2018 20:00,140,124,118,382,3,100.0
529,3/08/2018 20:05,159,139,142,440,3,100.0
530,3/08/2018 20:10,142,124,122,388,3,100.0
531,3/08/2018 20:15,132,116,113,361,3,100.0
532,3/08/2018 20:20,155,152,148,455,3,100.0
533,3/08/2018 20:25,159,145,132,436,3,100.0
534,3/08/2018 20:30,146,139,126,411,3,100.0
535,3/08/2018 20:35,135,127,126,388,3,100.0
536,3/08/2018 20:40,131,124,130,385,3,100.0
537,3/08/2018 20:45,157,149,125,431,3,100.0
538,3/08/2018 20:50,166,157,111,434,3,100.0
539,3/08/2018 20:55,130,126,90,346,3,100.0
540,3/08/2018 21:00,136,137,93,366,3,100.0
541,3/08/2018 21:05,159,146,100,405,3,100.0
542,3/08/2018 21:10,142,125,101,368,3,100.0
543,3/08/2018 21:15,140,122,88,350,3,100.0
544,3/08/2018 21:20,166,147,92,405,3,100.0
545,3/08/2018 21:25,125,120,88,333,3,100.0
546,3/08/2018 21:30,160,132,103,395,3,100.0
547,3/08/2018 21:35,141,122,89,352,3,100.0
548,3/08/2018 21:40,128,116,87,331,3,100.0
549,3/08/2018 21:45,116,103,65,284,3,100.0
550,3/08/2018 21:50,123,103,72,298,3,100.0
551,3/08/2018 21:55,122,104,79,305,3,100.0
552,3/08/2018 22:00,106,101,79,286,3,100.0
553,3/08/2018 22:05,117,105,65,287,3,100.0
554,3/08/2018 22:10,118,101,70,289,3,100.0
555,3/08/2018 22:15,105,84,71,260,3,100.0
556,3/08/2018 22:20,97,100,64,261,3,100.0
557,3/08/2018 22:25,110,99,66,275,3,100.0
558,3/08/2018 22:30,100,97,76,273,3,100.0
559,3/08/2018 22:35,112,103,73,288,3,100.0
560,3/08/2018 22:40,98,107,65,270,3,100.0
561,3/08/2018 22:45,116,106,64,286,3,100.0
562,3/08/2018 22:50,101,120,65,286,3,100.0
563,3/08/2018 22:55,98,85,51,234,3,100.0
564,3/08/2018 23:00,76,91,67,234,3,100.0
565,3/08/2018 23:05,71,69,50,190,3,100.0
566,3/08/2018 23:10,64,80,50,194,3,100.0
567,3/08/2018 23:15,78,81,60,219,3,100.0
568,3/08/2018 23:20,77,66,48,191,3,100.0
569,3/08/2018 23:25,77,71,54,202,3,100.0
570,3/08/2018 23:30,51,65,40,156,3,100.0
571,3/08/2018 23:35,58,58,40,156,3,100.0
572,3/08/2018 23:40,54,64,32,150,3,100.0
573,3/08/2018 23:45,39,45,43,127,3,100.0
574,3/08/2018 23:50,47,58,45,150,3,100.0
575,3/08/2018 23:55,47,56,39,142,3,100.0
576,3/09/2018 0:00,47,51,19,117,3,100.0
577,3/09/2018 0:05,39,51,39,129,3,100.0
578,3/09/2018 0:10,47,64,38,149,3,100.0
579,3/09/2018 0:15,35,35,29,99,3,100.0
580,3/09/2018 0:20,47,51,31,129,3,100.0
581,3/09/2018 0:25,44,59,30,133,3,100.0
582,3/09/2018 0:30,33,43,28,104,3,100.0
583,3/09/2018 0:35,34,42,26,102,3,100.0
584,3/09/2018 0:40,35,49,33,117,3,100.0
585,3/09/2018 0:45,33,51,28,112,3,100.0
586,3/09/2018 0:50,29,32,24,85,3,100.0
587,3/09/2018 0:55,29,35,34,98,3,100.0
588,3/09/2018 1:00,25,41,29,95,3,100.0
589,3/09/2018 1:05,15,28,24,67,3,100.0
590,3/09/2018 1:10,15,23,18,56,3,100.0
591,3/09/2018 1:15,24,27,23,74,3,100.0
592,3/09/2018 1:20,23,25,27,75,3,100.0
593,3/09/2018 1:25,14,24,19,57,3,100.0
594,3/09/2018 1:30,11,22,15,48,3,100.0
595,3/09/2018 1:35,15,22,21,58,3,100.0
596,3/09/2018 1:40,15,24,24,63,3,100.0
597,3/09/2018 1:45,17,29,18,64,3,100.0
598,3/09/2018 1:50,19,24,21,64,3,100.0
599,3/09/2018 1:55,19,21,16,56,3,100.0
600,3/09/2018 2:00,13,27,19,59,3,100.0
601,3/09/2018 2:05,13,30,16,59,3,100.0
602,3/09/2018 2:10,13,29,16,58,3,100.0
603,3/09/2018 2:15,16,31,19,66,3,100.0
604,3/09/2018 2:20,10,19,22,51,3,100.0
605,3/09/2018 2:25,13,21,23,57,3,100.0
606,3/09/2018 2:30,19,24,22,65,3,100.0
607,3/09/2018 2:35,14,21,17,52,3,100.0
608,3/09/2018 2:40,16,24,12,52,3,100.0
609,3/09/2018 2:45,17,23,24,64,3,100.0
610,3/09/2018 2:50,10,21,16,47,3,100.0
611,3/09/2018 2:55,11,20,18,49,3,100.0
612,3/09/2018 3:00,10,23,18,51,3,100.0
613,3/09/2018 3:05,13,16,10,39,3,100.0
614,3/09/2018 3:10,6,16,12,34,3,100.0
615,3/09/2018 3:15,16,26,19,61,3,100.0
616,3/09/2018 3:20,11,17,14,42,3,100.0
617,3/09/2018 3:25,14,18,21,53,3,100.0
618,3/09/2018 3:30,12,18,11,41,3,100.0
619,3/09/2018 3:35,18,20,22,60,3,100.0
620,3/09/2018 3:40,23,29,18,70,3,100.0
621,3/09/2018 3:45,13,20,16,49,3,100.0
622,3/09/2018 3:50,21,30,21,72,3,100.0
623,3/09/2018 3:55,12,25,28,65,3,100.0
624,3/09/2018 4:00,17,26,12,55,3,100.0
625,3/09/2018 4:05,19,24,18,61,3,100.0
626,3/09/2018 4:10,20,33,22,75,3,100.0
627,3/09/2018 4:15,19,27,29,75,3,100.0
628,3/09/2018 4:20,26,38,29,93,3,100.0
629,3/09/2018 4:25,38,37,26,101,3,100.0
630,3/09/2018 4:30,45,49,28,122,3,100.0
631,3/09/2018 4:35,51,46,33,130,3,100.0
632,3/09/2018 4:40,40,47,26,113,3,100.0
633,3/09/2018 4:45,42,41,37,120,3,100.0
634,3/09/2018 4:50,47,59,33,139,3,100.0
635,3/09/2018 4:55,48,49,38,135,3,100.0
636,3/09/2018 5:00,48,46,46,140,3,100.0
637,3/09/2018 5:05,54,60,41,155,3,100.0
638,3/09/2018 5:10,58,63,46,167,3,100.0
639,3/09/2018 5:15,83,80,54,217,3,100.0
640,3/09/2018 5:20,93,111,59,263,3,100.0
641,3/09/2018 5:25,105,90,58,253,3,100.0
642,3/09/2018 5:30,113,99,53,265,3,100.0
643,3/09/2018 5:35,125,111,63,299,3,100.0
644,3/09/2018 5:40,138,123,77,338,3,100.0
645,3/09/2018 5:45,127,118,65,310,3,100.0
646,3/09/2018 5:50,129,147,82,358,3,100.0
647,3/09/2018 5:55,128,110,84,322,3,100.0
648,3/09/2018 6:00,134,108,57,299,3,100.0
649,3/09/2018 6:05,155,129,80,364,3,100.0
650,3/09/2018 6:10,167,125,83,375,3,100.0
651,3/09/2018 6:15,158,126,83,367,3,100.0
652,3/09/2018 6:20,164,126,91,381,3,100.0
653,3/09/2018 6:25,153,126,87,366,3,100.0
654,3/09/2018 6:30,165,161,86,412,3,100.0
655,3/09/2018 6:35,176,154,90,420,3,100.0
656,3/09/2018 6:40,176,166,114,456,3,100.0
657,3/09/2018 6:45,187,157,110,454,3,100.0
658,3/09/2018 6:50,160,140,111,411,3,100.0
659,3/09/2018 6:55,178,143,107,428,3,100.0
660,3/09/2018 7:00,194,157,113,464,3,100.0
661,3/09/2018 7:05,170,159,121,450,3,100.0
662,3/09/2018 7:10,184,148,114,446,3,100.0
663,3/09/2018 7:15,193,152,112,457,3,100.0
664,3/09/2018 7:20,181,168,111,460,3,100.0
665,3/09/2018 7:25,193,153,126,472,3,100.0
666,3/09/2018 7:30,194,178,124,496,3,100.0
667,3/09/2018 7:35,198,180,130,508,3,100.0
668,3/09/2018 7:40,191,191,127,509,3,100.0
669,3/09/2018 7:45,179,163,118,460,3,100.0
670,3/09/2018 7:50,194,161,126,481,3,100.0
671,3/09/2018 7:55,184,161,130,475,3,100.0
672,3/09/2018 8:00,184,172,114,470,3,100.0
673,3/09/2018 8:05,181,171,120,472,3,100.0
674,3/09/2018 8:10,182,160,120,462,3,100.0
675,3/09/2018 8:15,210,181,123,514,3,100.0
676,3/09/2018 8:20,181,190,130,501,3,100.0
677,3/09/2018 8:25,198,154,134,486,3,100.0
678,3/09/2018 8:30,188,169,135,492,3,100.0
679,3/09/2018 8:35,203,175,128,506,3,100.0
680,3/09/2018 8:40,182,156,101,439,3,100.0
681,3/09/2018 8:45,191,159,108,458,3,100.0
682,3/09/2018 8:50,189,177,109,475,3,100.0
683,3/09/2018 8:55,181,163,118,462,3,100.0
684,3/09/2018 9:00,185,154,123,462,3,100.0
685,3/09/2018 9:05,202,174,126,502,3,100.0
686,3/09/2018 9:10,177,165,105,447,3,100.0
687,3/09/2018 9:15,191,164,120,475,3,100.0
688,3/09/2018 9:20,189,179,116,484,3,100.0
689,3/09/2018 9:25,171,154,110,435,3,100.0
690,3/09/2018 9:30,192,177,109,478,3,100.0
691,3/09/2018 9:35,172,158,116,446,3,100.0
692,3/09/2018 9:40,190,158,109,457,3,100.0
693,3/09/2018 9:45,179,166,111,456,3,100.0
694,3/09/2018 9:50,175,151,126,452,3,100.0
695,3/09/2018 9:55,195,163,118,476,3,100.0
696,3/09/2018 10:00,158,144,113,415,3,100.0
697,3/09/2018 10:05,176,163,102,441,3,100.0
698,3/09/2018 10:10,176,156,102,434,3,100.0
699,3/09/2018 10:15,176,152,102,430,3,100.0
700,3/09/2018 10:20,160,152,108,420,3,100.0
701,3/09/2018 10:25,168,144,100,412,3,100.0
702,3/09/2018 10:30,189,170,107,466,3,100.0
703,3/09/2018 10:35,173,159,110,442,3,100.0
704,3/09/2018 10:40,180,165,105,450,3,100.0
705,3/09/2018 10:45,184,162,125,471,3,100.0
706,3/09/2018 10:50,190,159,119,468,3,100.0
707,3/09/2018 10:55,166,156,116,438,3,100.0
708,3/09/2018 11:00,175,162,127,464,3,100.0
709,3/09/2018 11:05,186,159,122,467,3,100.0
710,3/09/2018 11:10,180,160,118,458,3,100.0
711,3/09/2018 11:15,176,167,108,451,3,100.0
712,3/09/2018 11:20,177,158,121,456,3,100.0
713,3/09/2018 11:25,195,171,133,499,3,100.0
714,3/09/2018 11:30,189,172,119,480,3,100.0
715,3/09/2018 11:35,189,157,112,458,3,100.0
716,3/09/2018 11:40,172,134,121,427,3,100.0
717,3/09/2018 11:45,168,150,128,446,3,100.0
718,3/09/2018 11:50,174,147,133,454,3,100.0
719,3/09/2018 11:55,171,161,118,450,3,100.0
720,3/09/2018 12:00,179,143,132,454,3,100.0
721,3/09/2018 12:05,168,157,101,426,3,100.0
722,3/09/2018 12:10,177,162,120,459,3,100.0
723,3/09/2018 12:15,183,153,114,450,3,100.0
724,3/09/2018 12:20,173,152,127,452,3,100.0
725,3/09/2018 12:25,183,166,130,479,3,100.0
726,3/09/2018 12:30,176,161,110,447,3,100.0
727,3/09/2018 12:35,169,161,128,458,3,100.0
728,3/09/2018 12:40,183,164,142,489,3,100.0
729,3/09/2018 12:45,180,162,125,467,3,100.0
730,3/09/2018 12:50,182,160,127,469,3,100.0
731,3/09/2018 12:55,174,161,122,457,3,100.0
732,3/09/2018 13:00,161,159,110,430,3,100.0
733,3/09/2018 13:05,176,172,132,480,3,100.0
734,3/09/2018 13:10,172,153,110,435,3,100.0
735,3/09/2018 13:15,184,160,121,465,3,100.0
736,3/09/2018 13:20,166,158,128,452,3,100.0
737,3/09/2018 13:25,187,157,127,471,3,100.0
738,3/09/2018 13:30,153,143,122,418,3,100.0
739,3/09/2018 13:35,168,162,139,469,3,100.0
740,3/09/2018 13:40,162,158,132,452,3,100.0
741,3/09/2018 13:45,170,155,131,456,3,100.0
742,3/09/2018 13:50,171,166,151,488,3,100.0
743,3/09/2018 13:55,157,152,134,443,3,100.0
744,3/09/2018 14:00,173,170,156,499,3,100.0
745,3/09/2018 14:05,170,174,131,475,3,100.0
746,3/09/2018 14:10,176,164,144,484,3,100.0
747,3/09/2018 14:15,145,156,133,434,3,100.0
748,3/09/2018 14:20,163,158,134,455,3,100.0
749,3/09/2018 14:25,175,166,146,487,3,100.0
750,3/09/2018 14:30,160,156,132,448,3,100.0
751,3/09/2018 14:35,155,146,130,431,3,100.0
752,3/09/2018 14:40,153,144,135,432,3,100.0
753,3/09/2018 14:45,150,134,124,408,3,100.0
754,3/09/2018 14:50,108,118,103,329,3,100.0
755,3/09/2018 14:55,120,117,113,350,3,100.0
756,3/09/2018 15:00,128,126,116,370,3,100.0
757,3/09/2018 15:05,145,131,123,399,3,100.0
758,3/09/2018 15:10,144,151,125,420,3,100.0
759,3/09/2018 15:15,149,143,131,423,3,100.0
760,3/09/2018 15:20,159,139,131,429,3,100.0
761,3/09/2018 15:25,138,131,132,401,3,100.0
762,3/09/2018 15:30,148,134,127,409,3,100.0
763,3/09/2018 15:35,146,134,130,410,3,100.0
764,3/09/2018 15:40,141,147,127,415,3,100.0
765,3/09/2018 15:45,147,148,128,423,3,100.0
766,3/09/2018 15:50,136,124,135,395,3,100.0
767,3/09/2018 15:55,124,121,103,348,3,100.0
768,3/09/2018 16:00,133,130,129,392,3,100.0
769,3/09/2018 16:05,128,123,121,372,3,100.0
770,3/09/2018 16:10,145,133,128,406,3,100.0
771,3/09/2018 16:15,162,145,132,439,3,100.0
772,3/09/2018 16:20,170,160,131,461,3,100.0
773,3/09/2018 16:25,124,129,118,371,3,100.0
774,3/09/2018 16:30,138,138,138,414,3,100.0
775,3/09/2018 16:35,148,137,132,417,3,100.0
776,3/09/2018 16:40,136,133,133,402,3,100.0
777,3/09/2018 16:45,170,153,141,464,3,100.0
778,3/09/2018 16:50,151,141,130,422,3,100.0
779,3/09/2018 16:55,164,156,147,467,3,100.0
780,3/09/2018 17:00,171,167,143,481,3,100.0
781,3/09/2018 17:05,163,153,132,448,3,100.0
782,3/09/2018 17:10,114,115,109,338,3,100.0
783,3/09/2018 17:15,147,140,135,422,3,100.0
784,3/09/2018 17:20,147,138,139,424,3,100.0
785,3/09/2018 17:25,153,152,145,450,3,100.0
786,3/09/2018 17:30,135,128,137,400,3,100.0
787,3/09/2018 17:35,128,121,111,360,3,100.0
788,3/09/2018 17:40,136,130,129,395,3,100.0
789,3/09/2018 17:45,151,138,131,420,3,100.0
790,3/09/2018 17:50,150,145,136,431,3,100.0
791,3/09/2018 17:55,152,143,134,429,3,100.0
792,3/09/2018 18:00,151,136,131,418,3,100.0
793,3/09/2018 18:05,148,144,123,415,3,100.0
794,3/09/2018 18:10,145,143,129,417,3,100.0
795,3/09/2018 18:15,151,137,133,421,3,100.0
796,3/09/2018 18:20,147,141,126,414,3,100.0
797,3/09/2018 18:25,155,136,135,426,3,100.0
798,3/09/2018 18:30,153,139,134,426,3,100.0
799,3/09/2018 18:35,160,147,122,429,3,100.0
800,3/09/2018 18:40,152,137,129,418,3,100.0
801,3/09/2018 18:45,153,148,137,438,3,100.0
802,3/09/2018 18:50,149,133,127,409,3,100.0
803,3/09/2018 18:55,146,132,139,417,3,100.0
804,3/09/2018 19:00,144,140,127,411,3,100.0
805,3/09/2018 19:05,146,142,120,408,3,100.0
806,3/09/2018 19:10,150,147,146,443,3,100.0
807,3/09/2018 19:15,151,141,137,429,3,100.0
808,3/09/2018 19:20,138,129,120,387,3,100.0
809,3/09/2018 19:25,138,134,130,402,3,100.0
810,3/09/2018 19:30,146,134,130,410,3,100.0
811,3/09/2018 19:35,144,138,124,406,3,100.0
812,3/09/2018 19:40,159,139,129,427,3,100.0
813,3/09/2018 19:45,163,140,130,433,3,100.0
814,3/09/2018 19:50,132,127,119,378,3,100.0
815,3/09/2018 19:55,145,144,120,409,3,100.0
816,3/09/2018 20:00,165,159,121,445,3,100.0
817,3/09/2018 20:05,159,146,123,428,3,100.0
818,3/09/2018 20:10,163,162,127,452,3,100.0
819,3/09/2018 20:15,161,157,120,438,3,100.0
820,3/09/2018 20:20,164,155,136,455,3,100.0
821,3/09/2018 20:25,171,149,130,450,3,100.0
822,3/09/2018 20:30,149,146,113,408,3,100.0
823,3/09/2018 20:35,162,151,116,429,3,100.0
824,3/09/2018 20:40,164,146,115,425,3,100.0
825,3/09/2018 20:45,161,156,119,436,3,100.0
826,3/09/2018 20:50,158,141,105,404,3,100.0
827,3/09/2018 20:55,150,136,124,410,3,100.0
828,3/09/2018 21:00,153,155,127,435,3,100.0
829,3/09/2018 21:05,153,151,118,422,3,100.0
830,3/09/2018 21:10,164,135,101,400,3,100.0
831,3/09/2018 21:15,168,156,113,437,3,100.0
832,3/09/2018 21:20,151,133,93,377,3,100.0
833,3/09/2018 21:25,127,115,93,335,3,100.0
834,3/09/2018 21:30,130,118,92,340,3,100.0
835,3/09/2018 21:35,140,117,93,350,3,100.0
836,3/09/2018 21:40,125,128,74,327,3,100.0
837,3/09/2018 21:45,106,106,68,280,3,100.0
838,3/09/2018 21:50,112,110,84,306,3,100.0
839,3/09/2018 21:55,150,121,77,348,3,100.0
840,3/09/2018 22:00,105,91,70,266,3,100.0
841,3/09/2018 22:05,118,109,77,304,3,100.0
842,3/09/2018 22:10,132,114,87,333,3,100.0
843,3/09/2018 22:15,102,103,75,280,3,100.0
844,3/09/2018 22:20,118,108,81,307,3,100.0
845,3/09/2018 22:25,120,96,74,290,3,100.0
846,3/09/2018 22:30,117,105,75,297,3,100.0
847,3/09/2018 22:35,118,99,78,295,3,100.0
848,3/09/2018 22:40,107,98,64,269,3,100.0
849,3/09/2018 22:45,105,96,73,274,3,100.0
850,3/09/2018 22:50,104,102,71,277,3,100.0
851,3/09/2018 22:55,94,84,70,248,3,100.0
852,3/09/2018 23:00,94,95,69,258,3,100.0
853,3/09/2018 23:05,99,85,56,240,3,100.0
854,3/09/2018 23:10,81,76,58,215,3,100.0
855,3/09/2018 23:15,86,89,63,238,3,100.0
856,3/09/2018 23:20,73,86,62,221,3,100.0
857,3/09/2018 23:25,86,77,61,224,3,100.0
858,3/09/2018 23:30,86,71,64,221,3,100.0
859,3/09/2018 23:35,73,71,56,200,3,100.0
860,3/09/2018 23:40,79,82,46,207,3,100.0
861,3/09/2018 23:45,72,72,59,203,3,100.0
862,3/09/2018 23:50,68,76,47,191,3,100.0
863,3/09/2018 23:55,66,75,43,184,3,100.0
864,3/10/2018 0:00,59,61,50,170,3,100.0
865,3/10/2018 0:05,62,77,41,180,3,100.0
866,3/10/2018 0:10,60,69,60,189,3,100.0
867,3/10/2018 0:15,73,67,40,180,3,100.0
868,3/10/2018 0:20,54,56,46,156,3,100.0
869,3/10/2018 0:25,53,67,43,163,3,100.0
870,3/10/2018 0:30,61,56,39,156,3,100.0
871,3/10/2018 0:35,54,58,37,149,3,100.0
872,3/10/2018 0:40,47,57,40,144,3,100.0
873,3/10/2018 0:45,50,50,26,126,3,100.0
874,3/10/2018 0:50,49,47,35,131,3,100.0
875,3/10/2018 0:55,39,62,35,136,3,100.0
876,3/10/2018 1:00,41,55,33,129,3,100.0
877,3/10/2018 1:05,40,44,22,106,3,100.0
878,3/10/2018 1:10,24,35,27,86,3,100.0
879,3/10/2018 1:15,39,49,37,125,3,100.0
880,3/10/2018 1:20,42,41,31,114,3,100.0
881,3/10/2018 1:25,27,41,29,97,3,100.0
882,3/10/2018 1:30,31,31,30,92,3,100.0
883,3/10/2018 1:35,20,41,20,81,3,100.0
884,3/10/2018 1:40,37,39,30,106,3,100.0
885,3/10/2018 1:45,31,39,28,98,3,100.0
886,3/10/2018 1:50,18,36,23,77,3,100.0
887,3/10/2018 1:55,22,29,18,69,3,100.0
888,3/10/2018 2:00,16,29,21,66,3,100.0
889,3/10/2018 2:05,22,40,23,85,3,100.0
890,3/10/2018 2:10,25,40,27,92,3,100.0
891,3/10/2018 2:15,18,27,19,64,3,100.0
892,3/10/2018 2:20,29,28,28,85,3,100.0
893,3/10/2018 2:25,18,30,21,69,3,100.0
894,3/10/2018 2:30,17,27,20,64,3,100.0
895,3/10/2018 2:35,15,29,24,68,3,100.0
896,3/10/2018 2:40,22,30,17,69,3,100.0
897,3/10/2018 2:45,23,26,18,67,3,100.0
898,3/10/2018 2:50,19,30,23,72,3,100.0
899,3/10/2018 2:55,15,25,24,64,3,100.0
900,3/10/2018 3:00,14,15,10,39,3,100.0
901,3/10/2018 3:05,9,25,18,52,3,100.0
902,3/10/2018 3:10,27,24,30,81,3,100.0
903,3/10/2018 3:15,12,27,22,61,3,100.0
904,3/10/2018 3:20,14,25,12,51,3,100.0
905,3/10/2018 3:25,16,17,19,52,3,100.0
906,3/10/2018 3:30,14,19,15,48,3,100.0
907,3/10/2018 3:35,11,19,13,43,3,100.0
908,3/10/2018 3:40,12,20,17,49,3,100.0
909,3/10/2018 3:45,14,28,12,54,3,100.0
910,3/10/2018 3:50,11,15,16,42,3,100.0
911,3/10/2018 3:55,15,18,22,55,3,100.0
912,3/10/2018 4:00,16,20,17,53,3,100.0
913,3/10/2018 4:05,16,23,14,53,3,100.0
914,3/10/2018 4:10,17,29,19,65,3,100.0
915,3/10/2018 4:15,18,24,18,60,3,100.0
916,3/10/2018 4:20,26,33,22,81,3,100.0
917,3/10/2018 4:25,14,30,17,61,3,100.0
918,3/10/2018 4:30,21,31,15,67,3,100.0
919,3/10/2018 4:35,23,37,27,87,3,100.0
920,3/10/2018 4:40,18,28,17,63,3,100.0
921,3/10/2018 4:45,19,29,23,71,3,100.0
922,3/10/2018 4:50,30,34,26,90,3,100.0
923,3/10/2018 4:55,27,35,17,79,3,100.0
924,3/10/2018 5:00,24,33,29,86,3,100.0
925,3/10/2018 5:05,27,40,26,93,3,100.0
926,3/10/2018 5:10,39,47,36,122,3,100.0
927,3/10/2018 5:15,44,37,24,105,3,100.0
928,3/10/2018 5:20,39,47,33,119,3,100.0
929,3/10/2018 5:25,39,38,26,103,3,100.0
930,3/10/2018 5:30,45,50,32,127,3,100.0
931,3/10/2018 5:35,50,57,34,141,3,100.0
932,3/10/2018 5:40,66,74,42,182,3,100.0
933,3/10/2018 5:45,67,63,47,177,3,100.0
934,3/10/2018 5:50,57,56,33,146,3,100.0
935,3/10/2018 5:55,57,54,28,139,3,100.0
936,3/10/2018 6:00,58,69,34,161,3,100.0
937,3/10/2018 6:05,48,63,45,156,3,100.0
938,3/10/2018 6:10,64,69,36,169,3,100.0
939,3/10/2018 6:15,78,69,40,187,3,100.0
940,3/10/2018 6:20,70,70,41,181,3,100.0
941,3/10/2018 6:25,0,0,1,1,3,100.0
942,3/10/2018 6:30,0,1,3,4,3,100.0
943,3/10/2018 6:35,156,134,1,291,3,100.0
944,3/10/2018 6:40,161,140,0,301,3,100.0
945,3/10/2018 6:45,156,123,3,282,3,100.0
946,3/10/2018 6:50,140,121,1,262,3,100.0
947,3/10/2018 6:55,116,116,1,233,3,100.0
948,3/10/2018 7:00,126,126,0,252,3,100.0
949,3/10/2018 7:05,120,118,0,238,3,100.0
950,3/10/2018 7:10,136,141,0,277,3,100.0
951,3/10/2018 7:15,144,140,0,284,3,100.0
952,3/10/2018 7:20,159,138,2,299,3,100.0
953,3/10/2018 7:25,161,124,2,287,3,100.0
954,3/10/2018 7:30,152,125,1,278,3,100.0
955,3/10/2018 7:35,149,130,0,279,3,100.0
956,3/10/2018 7:40,150,119,0,269,3,100.0
957,3/10/2018 7:45,154,136,0,290,3,100.0
958,3/10/2018 7:50,153,133,0,286,3,100.0
959,3/10/2018 7:55,157,129,0,286,3,100.0
960,3/10/2018 8:00,158,132,0,290,3,100.0
961,3/10/2018 8:05,161,131,0,292,3,100.0
962,3/10/2018 8:10,151,133,0,284,3,100.0
963,3/10/2018 8:15,134,117,1,252,3,100.0
964,3/10/2018 8:20,133,114,77,324,3,66.7
965,3/10/2018 8:25,144,122,77,343,3,66.7
966,3/10/2018 8:30,138,119,77,334,3,66.7
967,3/10/2018 8:35,139,111,1,251,3,100.0
968,3/10/2018 8:40,132,101,0,233,3,100.0
969,3/10/2018 8:45,142,120,1,263,3,100.0
970,3/10/2018 8:50,148,123,0,271,3,100.0
971,3/10/2018 8:55,134,115,0,249,3,100.0
972,3/10/2018 9:00,151,124,0,275,3,100.0
973,3/10/2018 9:05,143,115,0,258,3,100.0
974,3/10/2018 9:10,147,122,3,272,3,100.0
975,3/10/2018 9:15,145,136,0,281,3,100.0
976,3/10/2018 9:20,139,133,0,272,3,100.0
977,3/10/2018 9:25,132,118,1,251,3,100.0
978,3/10/2018 9:30,133,129,0,262,3,100.0
979,3/10/2018 9:35,160,132,2,294,3,100.0
980,3/10/2018 9:40,148,132,0,280,3,100.0
981,3/10/2018 9:45,149,136,0,285,3,100.0
982,3/10/2018 9:50,149,129,0,278,3,100.0
983,3/10/2018 9:55,82,84,0,166,3,100.0
984,3/10/2018 10:00,135,86,78,299,3,100.0
985,3/10/2018 10:05,162,158,139,459,3,100.0
986,3/10/2018 10:10,149,137,111,397,3,100.0
987,3/10/2018 10:15,153,128,120,401,3,100.0
988,3/10/2018 10:20,170,150,130,450,3,100.0
989,3/10/2018 10:25,151,140,96,387,3,100.0
990,3/10/2018 10:30,150,132,101,383,3,100.0
991,3/10/2018 10:35,162,158,96,416,3,100.0
992,3/10/2018 10:40,142,132,102,376,3,100.0
993,3/10/2018 10:45,143,147,104,394,3,100.0
994,3/10/2018 10:50,163,155,98,416,3,100.0
995,3/10/2018 10:55,166,164,97,427,3,100.0
996,3/10/2018 11:00,162,143,104,409,3,100.0
997,3/10/2018 11:05,151,135,104,390,3,100.0
998,3/10/2018 11:10,153,159,116,428,3,100.0
999,3/10/2018 11:15,153,130,106,389,3,100.0
1000,3/10/2018 11:20,164,148,110,422,3,100.0
1001,3/10/2018 11:25,154,130,113,397,3,100.0
1002,3/10/2018 11:30,168,152,104,424,3,100.0
1003,3/10/2018 11:35,153,166,114,433,3,100.0
1004,3/10/2018 11:40,153,139,97,389,3,100.0
1005,3/10/2018 11:45,149,139,110,398,3,100.0
1006,3/10/2018 11:50,155,137,107,399,3,100.0
1007,3/10/2018 11:55,156,142,108,406,3,100.0
1008,3/10/2018 12:00,156,147,116,419,3,100.0
1009,3/10/2018 12:05,131,138,108,377,3,100.0
1010,3/10/2018 12:10,165,156,108,429,3,100.0
1011,3/10/2018 12:15,139,124,105,368,3,100.0
1012,3/10/2018 12:20,141,129,104,374,3,100.0
1013,3/10/2018 12:25,131,136,101,368,3,100.0
1014,3/10/2018 12:30,121,113,107,341,3,100.0
1015,3/10/2018 12:35,107,107,88,302,3,100.0
1016,3/10/2018 12:40,137,136,104,377,3,100.0
1017,3/10/2018 12:45,144,134,111,389,3,100.0
1018,3/10/2018 12:50,151,132,119,402,3,100.0
1019,3/10/2018 12:55,144,148,109,401,3,100.0
1020,3/10/2018 13:00,157,136,105,398,3,100.0
1021,3/10/2018 13:05,157,137,109,403,3,100.0
1022,3/10/2018 13:10,161,138,127,426,3,100.0
1023,3/10/2018 13:15,154,149,113,416,3,100.0
1024,3/10/2018 13:20,153,148,107,408,3,100.0
1025,3/10/2018 13:25,147,138,119,404,3,100.0
1026,3/10/2018 13:30,151,153,117,421,3,100.0
1027,3/10/2018 13:35,148,130,97,375,3,100.0
1028,3/10/2018 13:40,159,140,125,424,3,100.0
1029,3/10/2018 13:45,149,143,109,401,3,100.0
1030,3/10/2018 13:50,154,139,110,403,3,100.0
1031,3/10/2018 13:55,151,148,126,425,3,100.0
1032,3/10/2018 14:00,152,132,110,394,3,100.0
1033,3/10/2018 14:05,156,147,113,416,3,100.0
1034,3/10/2018 14:10,167,153,120,440,3,100.0
1035,3/10/2018 14:15,163,147,127,437,3,100.0
1036,3/10/2018 14:20,167,155,125,447,3,100.0
1037,3/10/2018 14:25,148,144,119,411,3,100.0
1038,3/10/2018 14:30,151,146,94,391,3,100.0
1039,3/10/2018 14:35,158,158,129,445,3,100.0
1040,3/10/2018 14:40,166,153,117,436,3,100.0
1041,3/10/2018 14:45,160,148,125,433,3,100.0
1042,3/10/2018 14:50,165,123,114,402,3,100.0
1043,3/10/2018 14:55,159,145,125,429,3,100.0
1044,3/10/2018 15:00,152,146,116,414,3,100.0
1045,3/10/2018 15:05,157,141,120,418,3,100.0
1046,3/10/2018 15:10,151,152,102,405,3,100.0
1047,3/10/2018 15:15,153,143,129,425,3,100.0
1048,3/10/2018 15:20,172,142,127,441,3,100.0
1049,3/10/2018 15:25,151,146,110,407,3,100.0
1050,3/10/2018 15:30,141,130,104,375,3,100.0
1051,3/10/2018 15:35,154,138,89,381,3,100.0
1052,3/10/2018 15:40,142,133,104,379,3,100.0
1053,3/10/2018 15:45,145,139,106,390,3,100.0
1054,3/10/2018 15:50,163,141,127,431,3,100.0
1055,3/10/2018 15:55,170,143,126,439,3,100.0
1056,3/10/2018 16:00,146,155,108,409,3,100.0
1057,3/10/2018 16:05,161,144,110,415,3,100.0
1058,3/10/2018 16:10,162,125,102,389,3,100.0
1059,3/10/2018 16:15,146,138,102,386,3,100.0
1060,3/10/2018 16:20,131,142,118,391,3,100.0
1061,3/10/2018 16:25,139,139,116,394,3,100.0
1062,3/10/2018 16:30,142,141,112,395,3,100.0
1063,3/10/2018 16:35,140,129,120,389,3,100.0
1064,3/10/2018 16:40,150,133,112,395,3,100.0
1065,3/10/2018 16:45,135,129,111,375,3,100.0
1066,3/10/2018 16:50,145,136,108,389,3,100.0
1067,3/10/2018 16:55,135,126,104,365,3,100.0
1068,3/10/2018 17:00,140,135,116,391,3,100.0
1069,3/10/2018 17:05,133,137,110,380,3,100.0
1070,3/10/2018 17:10,147,137,117,401,3,100.0
1071,3/10/2018 17:15,147,131,111,389,3,100.0
1072,3/10/2018 17:20,138,134,111,383,3,100.0
1073,3/10/2018 17:25,153,139,122,414,3,100.0
1074,3/10/2018 17:30,135,144,125,404,3,100.0
1075,3/10/2018 17:35,137,125,110,372,3,100.0
1076,3/10/2018 17:40,150,140,123,413,3,100.0
1077,3/10/2018 17:45,144,153,109,406,3,100.0
1078,3/10/2018 17:50,147,129,116,392,3,100.0
1079,3/10/2018 17:55,146,128,114,388,3,100.0
1080,3/10/2018 18:00,133,120,118,371,3,100.0
1081,3/10/2018 18:05,143,133,114,390,3,100.0
1082,3/10/2018 18:10,148,134,106,388,3,100.0
1083,3/10/2018 18:15,134,137,103,374,3,100.0
1084,3/10/2018 18:20,139,123,106,368,3,100.0
1085,3/10/2018 18:25,130,135,111,376,3,100.0
1086,3/10/2018 18:30,150,145,117,412,3,100.0
1087,3/10/2018 18:35,130,119,107,356,3,100.0
1088,3/10/2018 18:40,150,139,117,406,3,100.0
1089,3/10/2018 18:45,134,139,110,383,3,100.0
1090,3/10/2018 18:50,144,130,117,391,3,100.0
1091,3/10/2018 18:55,128,123,84,335,3,100.0
1092,3/10/2018 19:00,128,124,94,346,3,100.0
1093,3/10/2018 19:05,143,128,99,370,3,100.0
1094,3/10/2018 19:10,135,123,83,341,3,100.0
1095,3/10/2018 19:15,133,116,89,338,3,100.0
1096,3/10/2018 19:20,117,116,88,321,3,100.0
1097,3/10/2018 19:25,123,119,79,321,3,100.0
1098,3/10/2018 19:30,125,110,82,317,3,100.0
1099,3/10/2018 19:35,99,109,87,295,3,100.0
1100,3/10/2018 19:40,94,90,58,242,3,100.0
1101,3/10/2018 19:45,110,105,64,279,3,100.0
1102,3/10/2018 19:50,59,70,53,182,3,100.0
1103,3/10/2018 19:55,15,32,29,76,3,100.0
1104,3/10/2018 20:00,14,34,23,71,3,100.0
1105,3/10/2018 20:05,93,83,64,240,3,100.0
1106,3/10/2018 20:10,150,142,113,405,3,100.0
1107,3/10/2018 20:15,151,133,119,403,3,100.0
1108,3/10/2018 20:20,137,125,113,375,3,100.0
1109,3/10/2018 20:25,127,125,110,362,3,100.0
1110,3/10/2018 20:30,118,108,93,319,3,100.0
1111,3/10/2018 20:35,59,68,52,179,3,100.0
1112,3/10/2018 20:40,131,117,82,330,3,100.0
1113,3/10/2018 20:45,90,91,62,243,3,100.0
1114,3/10/2018 20:50,101,80,60,241,3,100.0
1115,3/10/2018 20:55,99,92,69,260,3,100.0
1116,3/10/2018 21:00,99,101,80,280,3,100.0
1117,3/10/2018 21:05,103,101,66,270,3,100.0
1118,3/10/2018 21:10,109,110,77,296,3,100.0
1119,3/10/2018 21:15,94,106,63,263,3,100.0
1120,3/10/2018 21:20,110,98,78,286,3,100.0
1121,3/10/2018 21:25,108,98,69,275,3,100.0
1122,3/10/2018 21:30,111,103,76,290,3,100.0
1123,3/10/2018 21:35,101,108,71,280,3,100.0
1124,3/10/2018 21:40,89,91,64,244,3,100.0
1125,3/10/2018 21:45,99,98,73,270,3,100.0
1126,3/10/2018 21:50,114,107,62,283,3,100.0
1127,3/10/2018 21:55,82,79,47,208,3,100.0
1128,3/10/2018 22:00,87,94,65,246,3,100.0
1129,3/10/2018 22:05,101,103,68,272,3,100.0
1130,3/10/2018 22:10,105,94,68,267,3,100.0
1131,3/10/2018 22:15,94,90,68,252,3,100.0
1132,3/10/2018 22:20,112,99,69,280,3,100.0
1133,3/10/2018 22:25,79,78,66,223,3,100.0
1134,3/10/2018 22:30,97,83,78,258,3,100.0
1135,3/10/2018 22:35,85,91,62,238,3,100.0
1136,3/10/2018 22:40,98,93,74,265,3,100.0
1137,3/10/2018 22:45,91,87,56,234,3,100.0
1138,3/10/2018 22:50,96,107,65,268,3,100.0
1139,3/10/2018 22:55,93,95,65,253,3,100.0
1140,3/10/2018 23:00,74,83,44,201,3,100.0
1141,3/10/2018 23:05,66,79,46,191,3,100.0
1142,3/10/2018 23:10,89,96,50,235,3,100.0
1143,3/10/2018 23:15,64,83,63,210,3,100.0
1144,3/10/2018 23:20,74,77,48,199,3,100.0
1145,3/10/2018 23:25,73,76,42,191,3,100.0
1146,3/10/2018 23:30,79,95,46,220,3,100.0
1147,3/10/2018 23:35,90,98,64,252,3,100.0
1148,3/10/2018 23:40,87,87,60,234,3,100.0
1149,3/10/2018 23:45,10,33,18,61,3,100.0
1150,3/10/2018 23:50,15,23,13,51,3,100.0
1151,3/10/2018 23:55,18,17,20,55,3,100.0
1152,3/11/2018 0:00,136,123,101,360,3,100.0
1153,3/11/2018 0:05,69,85,43,197,3,100.0
1154,3/11/2018 0:10,61,57,34,152,3,100.0
1155,3/11/2018 0:15,55,53,36,144,3,100.0
1156,3/11/2018 0:20,52,59,35,146,3,100.0
1157,3/11/2018 0:25,48,59,37,144,3,100.0
1158,3/11/2018 0:30,47,52,35,134,3,100.0
1159,3/11/2018 0:35,52,63,46,161,3,100.0
1160,3/11/2018 0:40,50,53,37,140,3,100.0
1161,3/11/2018 0:45,53,67,28,148,3,100.0
1162,3/11/2018 0:50,49,49,31,129,3,100.0
1163,3/11/2018 0:55,32,39,32,103,3,100.0
1164,3/11/2018 1:00,31,43,35,109,3,100.0
1165,3/11/2018 1:05,29,40,28,97,3,100.0
1166,3/11/2018 1:10,29,33,29,91,3,100.0
1167,3/11/2018 1:15,30,43,22,95,3,100.0
1168,3/11/2018 1:20,32,31,24,87,3,100.0
1169,3/11/2018 1:25,33,44,35,112,3,100.0
1170,3/11/2018 1:30,32,34,37,103,3,100.0
1171,3/11/2018 1:35,26,33,15,74,3,100.0
1172,3/11/2018 1:40,24,30,23,77,3,100.0
1173,3/11/2018 1:45,24,46,26,96,3,100.0
1174,3/11/2018 1:50,17,27,25,69,3,100.0
1175,3/11/2018 1:55,18,26,13,57,3,100.0
1176,3/11/2018 3:00,20,31,19,70,3,100.0
1177,3/11/2018 3:05,22,27,20,69,3,100.0
1178,3/11/2018 3:10,16,29,15,60,3,100.0
1179,3/11/2018 3:15,25,21,22,68,3,100.0
1180,3/11/2018 3:20,17,26,15,58,3,100.0
1181,3/11/2018 3:25,18,20,20,58,3,100.0
1182,3/11/2018 3:30,26,26,20,72,3,100.0
1183,3/11/2018 3:35,21,32,21,74,3,100.0
1184,3/11/2018 3:40,14,26,23,63,3,100.0
1185,3/11/2018 3:45,17,25,18,60,3,100.0
1186,3/11/2018 3:50,20,29,23,72,3,100.0
1187,3/11/2018 3:55,20,31,22,73,3,100.0
1188,3/11/2018 4:00,24,30,24,78,3,100.0
1189,3/11/2018 4:05,8,20,15,43,3,0.0
1190,3/11/2018 4:10,20,30,50,100,3,100.0
1191,3/11/2018 4:15,15,21,18,54,3,100.0
1192,3/11/2018 4:20,13,29,19,61,3,100.0
1193,3/11/2018 4:25,14,30,16,60,3,100.0
1194,3/11/2018 4:30,13,35,20,68,3,100.0
1195,3/11/2018 4:35,20,29,18,67,3,100.0
1196,3/11/2018 4:40,11,30,13,54,3,100.0
1197,3/11/2018 4:45,14,30,13,57,3,100.0
1198,3/11/2018 4:50,21,32,19,72,3,100.0
1199,3/11/2018 4:55,13,24,17,54,3,100.0
1200,3/11/2018 5:00,19,27,14,60,3,100.0
1201,3/11/2018 5:05,18,22,16,56,3,100.0
1202,3/11/2018 5:10,16,26,26,68,3,100.0
1203,3/11/2018 5:15,13,29,21,63,3,100.0
1204,3/11/2018 5:20,20,27,15,62,3,100.0
1205,3/11/2018 5:25,22,36,27,85,3,100.0
1206,3/11/2018 5:30,27,39,19,85,3,100.0
1207,3/11/2018 5:35,17,37,22,76,3,100.0
1208,3/11/2018 5:40,33,51,19,103,3,100.0
1209,3/11/2018 5:45,38,49,29,116,3,100.0
1210,3/11/2018 5:50,33,46,23,102,3,100.0
1211,3/11/2018 5:55,33,43,34,110,3,100.0
1212,3/11/2018 6:00,24,40,21,85,3,100.0
1213,3/11/2018 6:05,40,58,44,142,3,100.0
1214,3/11/2018 6:10,49,61,39,149,3,100.0
1215,3/11/2018 6:15,48,58,29,135,3,100.0
1216,3/11/2018 6:20,60,66,46,172,3,100.0
1217,3/11/2018 6:25,51,63,35,149,3,100.0
1218,3/11/2018 6:30,58,54,39,151,3,100.0
1219,3/11/2018 6:35,58,79,41,178,3,100.0
1220,3/11/2018 6:40,63,69,44,176,3,100.0
1221,3/11/2018 6:45,58,62,35,155,3,100.0
1222,3/11/2018 6:50,89,77,46,212,3,100.0
1223,3/11/2018 6:55,56,57,39,152,3,100.0
1224,3/11/2018 7:00,56,69,43,168,3,100.0
1225,3/11/2018 7:05,62,73,47,182,3,100.0
1226,3/11/2018 7:10,66,69,51,186,3,100.0
1227,3/11/2018 7:15,49,69,36,154,3,100.0
1228,3/11/2018 7:20,58,76,40,174,3,100.0
1229,3/11/2018 7:25,66,59,57,182,3,100.0
1230,3/11/2018 7:30,64,69,43,176,3,100.0
1231,3/11/2018 7:35,67,73,56,196,3,100.0
1232,3/11/2018 7:40,61,78,47,186,3,100.0
1233,3/11/2018 7:45,58,69,56,183,3,100.0
1234,3/11/2018 7:50,59,76,46,181,3,100.0
1235,3/11/2018 7:55,70,84,48,202,3,100.0
1236,3/11/2018 8:00,72,76,44,192,3,100.0
1237,3/11/2018 8:05,64,77,40,181,3,100.0
1238,3/11/2018 8:10,77,79,47,203,3,100.0
1239,3/11/2018 8:15,85,80,57,222,3,100.0
1240,3/11/2018 8:20,81,79,53,213,3,100.0
1241,3/11/2018 8:25,87,102,54,243,3,100.0
1242,3/11/2018 8:30,63,86,54,203,3,100.0
1243,3/11/2018 8:35,84,89,46,219,3,100.0
1244,3/11/2018 8:40,82,85,51,218,3,100.0
1245,3/11/2018 8:45,90,80,53,223,3,100.0
1246,3/11/2018 8:50,90,86,55,231,3,100.0
1247,3/11/2018 8:55,69,82,61,212,3,100.0
1248,3/11/2018 9:00,81,85,54,220,3,100.0
1249,3/11/2018 9:05,83,90,46,219,3,100.0
1250,3/11/2018 9:10,84,82,53,219,3,100.0
1251,3/11/2018 9:15,93,84,67,244,3,100.0
1252,3/11/2018 9:20,100,105,76,281,3,100.0
1253,3/11/2018 9:25,100,107,54,261,3,100.0
1254,3/11/2018 9:30,84,101,67,252,3,100.0
1255,3/11/2018 9:35,99,94,66,259,3,100.0
1256,3/11/2018 9:40,114,102,84,300,3,100.0
1257,3/11/2018 9:45,114,109,78,301,3,100.0
1258,3/11/2018 9:50,107,112,80,299,3,100.0
1259,3/11/2018 9:55,109,112,73,294,3,100.0
1260,3/11/2018 10:00,100,100,74,274,3,100.0
1261,3/11/2018 10:05,118,121,85,324,3,100.0
1262,3/11/2018 10:10,116,126,80,322,3,100.0
1263,3/11/2018 10:15,135,121,77,333,3,100.0
1264,3/11/2018 10:20,131,117,81,329,3,100.0
1265,3/11/2018 10:25,123,111,76,310,3,100.0
1266,3/11/2018 10:30,156,132,80,368,3,100.0
1267,3/11/2018 10:35,134,134,90,358,3,100.0
1268,3/11/2018 10:40,142,126,84,352,3,100.0
1269,3/11/2018 10:45,145,134,93,372,3,100.0
1270,3/11/2018 10:50,161,134,91,386,3,100.0
1271,3/11/2018 10:55,144,128,92,364,3,100.0
1272,3/11/2018 11:00,117,118,82,317,3,100.0
1273,3/11/2018 11:05,128,117,91,336,3,100.0
1274,3/11/2018 11:10,147,129,88,364,3,100.0
1275,3/11/2018 11:15,134,133,92,359,3,100.0
1276,3/11/2018 11:20,131,124,106,361,3,100.0
1277,3/11/2018 11:25,138,140,86,364,3,100.0
1278,3/11/2018 11:30,145,143,97,385,3,100.0
1279,3/11/2018 11:35,153,139,90,382,3,100.0
1280,3/11/2018 11:40,156,148,100,404,3,100.0
1281,3/11/2018 11:45,148,133,90,371,3,100.0
1282,3/11/2018 11:50,151,141,115,407,3,100.0
1283,3/11/2018 11:55,148,137,99,384,3,100.0
1284,3/11/2018 12:00,138,133,96,367,3,100.0
1285,3/11/2018 12:05,149,140,93,382,3,100.0
1286,3/11/2018 12:10,156,147,112,415,3,100.0
1287,3/11/2018 12:15,145,139,106,390,3,100.0
1288,3/11/2018 12:20,153,140,98,391,3,100.0
1289,3/11/2018 12:25,149,135,93,377,3,100.0
1290,3/11/2018 12:30,147,140,111,398,3,100.0
1291,3/11/2018 12:35,149,147,92,388,3,100.0
1292,3/11/2018 12:40,144,140,108,392,3,100.0
1293,3/11/2018 12:45,155,133,94,382,3,100.0
1294,3/11/2018 12:50,160,138,114,412,3,100.0
1295,3/11/2018 12:55,164,159,112,435,3,100.0
1296,3/11/2018 13:00,155,132,98,385,3,100.0
1297,3/11/2018 13:05,161,144,94,399,3,100.0
1298,3/11/2018 13:10,148,136,99,383,3,100.0
1299,3/11/2018 13:15,169,146,102,417,3,100.0
1300,3/11/2018 13:20,148,147,97,392,3,100.0
1301,3/11/2018 13:25,151,141,102,394,3,100.0
1302,3/11/2018 13:30,150,153,102,405,3,100.0
1303,3/11/2018 13:35,163,162,117,442,3,100.0
1304,3/11/2018 13:40,180,140,110,430,3,100.0
1305,3/11/2018 13:45,140,119,95,354,3,100.0
1306,3/11/2018 13:50,159,126,116,401,3,100.0
1307,3/11/2018 13:55,173,146,112,431,3,100.0
1308,3/11/2018 14:00,151,137,100,388,3,100.0
1309,3/11/2018 14:05,145,128,112,385,3,100.0
1310,3/11/2018 14:10,162,154,112,428,3,100.0
1311,3/11/2018 14:15,142,149,96,387,3,100.0
1312,3/11/2018 14:20,160,143,115,418,3,100.0
1313,3/11/2018 14:25,178,159,124,461,3,100.0
1314,3/11/2018 14:30,138,132,119,389,3,100.0
1315,3/11/2018 14:35,166,162,118,446,3,100.0
1316,3/11/2018 14:40,140,140,102,382,3,100.0
1317,3/11/2018 14:45,150,165,117,432,3,100.0
1318,3/11/2018 14:50,152,165,119,436,3,100.0
1319,3/11/2018 14:55,142,132,106,380,3,100.0
1320,3/11/2018 15:00,152,124,104,380,3,100.0
1321,3/11/2018 15:05,145,143,102,390,3,100.0
1322,3/11/2018 15:10,167,162,121,450,3,100.0
1323,3/11/2018 15:15,147,148,106,401,3,100.0
1324,3/11/2018 15:20,167,163,112,442,3,100.0
1325,3/11/2018 15:25,159,155,115,429,3,100.0
1326,3/11/2018 15:30,153,145,120,418,3,100.0
1327,3/11/2018 15:35,152,144,112,408,3,100.0
1328,3/11/2018 15:40,156,151,96,403,3,100.0
1329,3/11/2018 15:45,155,148,114,417,3,100.0
1330,3/11/2018 15:50,143,125,98,366,3,100.0
1331,3/11/2018 15:55,144,130,120,394,3,100.0
1332,3/11/2018 16:00,158,141,108,407,3,100.0
1333,3/11/2018 16:05,167,152,116,435,3,100.0
1334,3/11/2018 16:10,169,159,119,447,3,100.0
1335,3/11/2018 16:15,164,152,95,411,3,100.0
1336,3/11/2018 16:20,170,157,110,437,3,100.0
1337,3/11/2018 16:25,177,160,118,455,3,100.0
1338,3/11/2018 16:30,157,148,114,419,3,100.0
1339,3/11/2018 16:35,171,151,122,444,3,100.0
1340,3/11/2018 16:40,153,137,114,404,3,100.0
1341,3/11/2018 16:45,168,143,107,418,3,100.0
1342,3/11/2018 16:50,159,152,111,422,3,100.0
1343,3/11/2018 16:55,134,130,96,360,3,100.0
1344,3/11/2018 17:00,144,140,95,379,3,100.0
1345,3/11/2018 17:05,147,145,112,404,3,100.0
1346,3/11/2018 17:10,164,129,101,394,3,100.0
1347,3/11/2018 17:15,160,134,112,406,3,100.0
1348,3/11/2018 17:20,143,121,119,383,3,100.0
1349,3/11/2018 17:25,153,152,105,410,3,100.0
1350,3/11/2018 17:30,171,149,120,440,3,100.0
1351,3/11/2018 17:35,147,126,104,377,3,100.0
1352,3/11/2018 17:40,159,147,113,419,3,100.0
1353,3/11/2018 17:45,151,150,106,407,3,100.0
1354,3/11/2018 17:50,161,138,108,407,3,100.0
1355,3/11/2018 17:55,135,127,103,365,3,100.0
1356,3/11/2018 18:00,124,138,98,360,3,100.0
1357,3/11/2018 18:05,144,137,107,388,3,100.0
1358,3/11/2018 18:10,136,134,106,376,3,100.0
1359,3/11/2018 18:15,149,127,106,382,3,100.0
1360,3/11/2018 18:20,138,143,105,386,3,100.0
1361,3/11/2018 18:25,152,132,117,401,3,100.0
1362,3/11/2018 18:30,161,127,95,383,3,100.0
1363,3/11/2018 18:35,155,130,95,380,3,100.0
1364,3/11/2018 18:40,151,142,94,387,3,100.0
1365,3/11/2018 18:45,134,125,98,357,3,100.0
1366,3/11/2018 18:50,138,132,94,364,3,100.0
1367,3/11/2018 18:55,152,134,93,379,3,100.0
1368,3/11/2018 19:00,140,134,91,365,3,100.0
1369,3/11/2018 19:05,115,114,77,306,3,100.0
1370,3/11/2018 19:10,129,130,106,365,3,100.0
1371,3/11/2018 19:15,160,134,101,395,3,100.0
1372,3/11/2018 19:20,141,130,97,368,3,100.0
1373,3/11/2018 19:25,140,110,81,331,3,100.0
1374,3/11/2018 19:30,139,105,85,329,3,100.0
1375,3/11/2018 19:35,134,138,88,360,3,100.0
1376,3/11/2018 19:40,138,120,86,344,3,100.0
1377,3/11/2018 19:45,120,122,91,333,3,100.0
1378,3/11/2018 19:50,122,121,89,332,3,100.0
1379,3/11/2018 19:55,149,131,93,373,3,100.0
1380,3/11/2018 20:00,153,128,93,374,3,100.0
1381,3/11/2018 20:05,139,122,92,353,3,100.0
1382,3/11/2018 20:10,139,122,92,353,3,100.0
1383,3/11/2018 20:15,132,112,81,325,3,100.0
1384,3/11/2018 20:20,135,116,94,345,3,100.0
1385,3/11/2018 20:25,142,126,87,355,3,100.0
1386,3/11/2018 20:30,129,123,94,346,3,100.0
1387,3/11/2018 20:35,127,123,84,334,3,100.0
1388,3/11/2018 20:40,138,134,114,386,3,100.0
1389,3/11/2018 20:45,147,126,91,364,3,100.0
1390,3/11/2018 20:50,138,129,87,354,3,100.0
1391,3/11/2018 20:55,142,125,94,361,3,100.0
1392,3/11/2018 21:00,133,125,84,342,3,100.0
1393,3/11/2018 21:05,137,120,92,349,3,100.0
1394,3/11/2018 21:10,138,133,89,360,3,100.0
1395,3/11/2018 21:15,151,128,89,368,3,100.0
1396,3/11/2018 21:20,126,124,86,336,3,100.0
1397,3/11/2018 21:25,125,129,86,340,3,100.0
1398,3/11/2018 21:30,128,107,83,318,3,100.0
1399,3/11/2018 21:35,126,123,77,326,3,100.0
1400,3/11/2018 21:40,126,115,75,316,3,100.0
1401,3/11/2018 21:45,131,127,92,350,3,100.0
1402,3/11/2018 21:50,134,125,97,356,3,100.0
1403,3/11/2018 21:55,121,121,80,322,3,100.0
1404,3/11/2018 22:00,113,103,77,293,3,100.0
1405,3/11/2018 22:05,100,105,76,281,3,100.0
1406,3/11/2018 22:10,115,92,57,264,3,100.0
1407,3/11/2018 22:15,111,87,63,261,3,100.0
1408,3/11/2018 22:20,96,88,75,259,3,100.0
1409,3/11/2018 22:25,112,88,67,267,3,100.0
1410,3/11/2018 22:30,99,82,63,244,3,100.0
1411,3/11/2018 22:35,92,88,66,246,3,100.0
1412,3/11/2018 22:40,98,79,57,234,3,100.0
1413,3/11/2018 22:45,96,97,65,258,3,100.0
1414,3/11/2018 22:50,92,84,54,230,3,100.0
1415,3/11/2018 22:55,91,79,52,222,3,100.0
1416,3/11/2018 23:00,77,75,61,213,3,100.0
1417,3/11/2018 23:05,78,83,65,226,3,100.0
1418,3/11/2018 23:10,72,67,45,184,3,100.0
1419,3/11/2018 23:15,67,73,44,184,3,100.0
1420,3/11/2018 23:20,63,77,49,189,3,100.0
1421,3/11/2018 23:25,76,69,40,185,3,100.0
1422,3/11/2018 23:30,59,59,28,146,3,100.0
1423,3/11/2018 23:35,65,65,44,174,3,100.0
1424,3/11/2018 23:40,52,70,35,157,3,100.0
1425,3/11/2018 23:45,50,57,30,137,3,100.0
1426,3/11/2018 23:50,58,65,41,164,3,100.0
1427,3/11/2018 23:55,58,60,38,156,3,100.0
1428,3/12/2018 0:00,47,55,28,130,3,100.0
1429,3/12/2018 0:05,46,48,41,135,3,100.0
1430,3/12/2018 0:10,38,45,33,116,3,100.0
1431,3/12/2018 0:15,40,36,29,105,3,100.0
1432,3/12/2018 0:20,44,43,33,120,3,100.0
1433,3/12/2018 0:25,34,45,39,118,3,100.0
1434,3/12/2018 0:30,27,35,25,87,3,100.0
1435,3/12/2018 0:35,36,48,25,109,3,100.0
1436,3/12/2018 0:40,36,34,28,98,3,100.0
1437,3/12/2018 0:45,35,38,25,98,3,100.0
1438,3/12/2018 0:50,34,38,30,102,3,100.0
1439,3/12/2018 0:55,31,32,23,86,3,100.0
1440,3/12/2018 1:00,32,31,25,88,3,100.0
1441,3/12/2018 1:05,31,37,21,89,3,100.0
1442,3/12/2018 1:10,16,30,19,65,3,100.0
1443,3/12/2018 1:15,33,40,16,89,3,100.0
1444,3/12/2018 1:20,19,34,16,69,3,100.0
1445,3/12/2018 1:25,21,31,19,71,3,100.0
1446,3/12/2018 1:30,27,30,13,70,3,100.0
1447,3/12/2018 1:35,17,27,15,59,3,100.0
1448,3/12/2018 1:40,13,13,16,42,3,100.0
1449,3/12/2018 1:45,17,26,16,59,3,100.0
1450,3/12/2018 1:50,10,15,15,40,3,100.0
1451,3/12/2018 1:55,12,23,16,51,3,100.0
1452,3/12/2018 2:00,16,21,11,48,3,100.0
1453,3/12/2018 2:05,9,19,11,39,3,100.0
1454,3/12/2018 2:10,12,22,16,50,3,100.0
1455,3/12/2018 2:15,9,20,10,39,3,100.0
1456,3/12/2018 2:20,9,17,11,37,3,100.0
1457,3/12/2018 2:25,8,14,13,35,3,100.0
1458,3/12/2018 2:30,10,13,9,32,3,100.0
1459,3/12/2018 2:35,9,17,11,37,3,100.0
1460,3/12/2018 2:40,10,16,12,38,3,100.0
1461,3/12/2018 2:45,11,19,11,41,3,100.0
1462,3/12/2018 2:50,7,14,16,37,3,100.0
1463,3/12/2018 2:55,2,12,11,25,3,100.0
1464,3/12/2018 3:00,9,13,9,31,3,100.0
1465,3/12/2018 3:05,12,14,13,39,3,100.0
1466,3/12/2018 3:10,11,11,12,34,3,100.0
1467,3/12/2018 3:15,10,14,14,38,3,100.0
1468,3/12/2018 3:20,8,16,10,34,3,100.0
1469,3/12/2018 3:25,18,26,19,63,3,100.0
1470,3/12/2018 3:30,12,20,19,51,3,100.0
1471,3/12/2018 3:35,15,20,18,53,3,100.0
1472,3/12/2018 3:40,11,21,13,45,3,100.0
1473,3/12/2018 3:45,16,15,15,46,3,100.0
1474,3/12/2018 3:50,14,21,19,54,3,100.0
1475,3/12/2018 3:55,16,19,14,49,3,100.0
1476,3/12/2018 4:00,13,22,20,55,3,100.0
1477,3/12/2018 4:05,28,24,18,70,3,100.0
1478,3/12/2018 4:10,24,25,27,76,3,100.0
1479,3/12/2018 4:15,24,26,20,70,3,100.0
1480,3/12/2018 4:20,31,33,24,88,3,100.0
1481,3/12/2018 4:25,44,49,27,120,3,100.0
1482,3/12/2018 4:30,28,36,18,82,3,100.0
1483,3/12/2018 4:35,44,33,33,110,3,100.0
1484,3/12/2018 4:40,39,42,26,107,3,100.0
1485,3/12/2018 4:45,46,53,33,132,3,100.0
1486,3/12/2018 4:50,51,51,31,133,3,100.0
1487,3/12/2018 4:55,52,45,40,137,3,100.0
1488,3/12/2018 5:00,53,50,34,137,3,100.0
1489,3/12/2018 5:05,61,51,40,152,3,100.0
1490,3/12/2018 5:10,79,77,54,210,3,100.0
1491,3/12/2018 5:15,83,73,43,199,3,100.0
1492,3/12/2018 5:20,91,86,51,228,3,100.0
1493,3/12/2018 5:25,124,90,66,280,3,100.0
1494,3/12/2018 5:30,113,107,49,269,3,100.0
1495,3/12/2018 5:35,128,99,64,291,3,100.0
1496,3/12/2018 5:40,128,111,81,320,3,100.0
1497,3/12/2018 5:45,149,120,73,342,3,100.0
1498,3/12/2018 5:50,151,124,83,358,3,100.0
1499,3/12/2018 5:55,159,123,89,371,3,100.0
1500,3/12/2018 6:00,153,121,76,350,3,100.0
1501,3/12/2018 6:05,144,120,82,346,3,100.0
1502,3/12/2018 6:10,157,127,88,372,3,100.0
1503,3/12/2018 6:15,154,123,80,357,3,100.0
1504,3/12/2018 6:20,166,136,86,388,3,100.0
1505,3/12/2018 6:25,167,136,94,397,3,100.0
1506,3/12/2018 6:30,164,126,90,380,3,100.0
1507,3/12/2018 6:35,160,132,91,383,3,100.0
1508,3/12/2018 6:40,162,154,93,409,3,100.0
1509,3/12/2018 6:45,181,162,117,460,3,100.0
1510,3/12/2018 6:50,183,160,97,440,3,100.0
1511,3/12/2018 6:55,173,138,104,415,3,100.0
1512,3/12/2018 7:00,177,149,92,418,3,100.0
1513,3/12/2018 7:05,173,145,103,421,3,100.0
1514,3/12/2018 7:10,192,161,123,476,3,100.0
1515,3/12/2018 7:15,192,165,123,480,3,100.0
1516,3/12/2018 7:20,208,178,131,517,3,100.0
1517,3/12/2018 7:25,193,160,111,464,3,100.0
1518,3/12/2018 7:30,174,155,129,458,3,100.0
1519,3/12/2018 7:35,167,157,135,459,3,100.0
1520,3/12/2018 7:40,188,177,148,513,3,100.0
1521,3/12/2018 7:45,168,173,148,489,3,100.0
1522,3/12/2018 7:50,187,171,148,506,3,100.0
1523,3/12/2018 7:55,208,182,162,552,3,100.0
1524,3/12/2018 8:00,182,167,124,473,3,100.0
1525,3/12/2018 8:05,177,167,118,462,3,100.0
1526,3/12/2018 8:10,161,156,108,425,3,100.0
1527,3/12/2018 8:15,185,176,120,481,3,100.0
1528,3/12/2018 8:20,201,171,116,488,3,100.0
1529,3/12/2018 8:25,189,146,114,449,3,100.0
1530,3/12/2018 8:30,197,147,111,455,3,100.0
1531,3/12/2018 8:35,182,153,114,449,3,100.0
1532,3/12/2018 8:40,184,156,112,452,3,100.0
1533,3/12/2018 8:45,156,143,97,396,3,100.0
1534,3/12/2018 8:50,186,153,122,461,3,100.0
1535,3/12/2018 8:55,180,152,110,442,3,100.0
1536,3/12/2018 9:00,189,175,119,483,3,100.0
1537,3/12/2018 9:05,178,158,133,469,3,100.0
1538,3/12/2018 9:10,188,165,118,471,3,100.0
1539,3/12/2018 9:15,170,141,100,411,3,100.0
1540,3/12/2018 9:20,169,154,112,435,3,100.0
1541,3/12/2018 9:25,127,117,89,333,3,100.0
1542,3/12/2018 9:30,149,130,93,372,3,100.0
1543,3/12/2018 9:35,138,122,89,349,3,100.0
1544,3/12/2018 9:40,153,146,104,403,3,100.0
1545,3/12/2018 9:45,117,124,78,319,3,100.0
1546,3/12/2018 9:50,167,131,87,385,3,100.0
1547,3/12/2018 9:55,154,130,104,388,3,100.0
1548,3/12/2018 10:00,169,137,104,410,3,100.0
1549,3/12/2018 10:05,170,150,110,430,3,100.0
1550,3/12/2018 10:10,171,135,97,403,3,100.0
1551,3/12/2018 10:15,155,144,90,389,3,100.0
1552,3/12/2018 10:20,127,114,74,315,3,100.0
1553,3/12/2018 10:25,171,139,114,424,3,100.0
1554,3/12/2018 10:30,158,150,101,409,3,100.0
1555,3/12/2018 10:35,163,155,107,425,3,100.0
1556,3/12/2018 10:40,152,136,112,400,3,100.0
1557,3/12/2018 10:45,150,141,106,397,3,100.0
1558,3/12/2018 10:50,159,143,99,401,3,100.0
1559,3/12/2018 10:55,152,145,98,395,3,100.0
1560,3/12/2018 11:00,166,133,94,393,3,100.0
1561,3/12/2018 11:05,167,162,110,439,3,100.0
1562,3/12/2018 11:10,181,153,113,447,3,100.0
1563,3/12/2018 11:15,154,154,110,418,3,100.0
1564,3/12/2018 11:20,174,149,120,443,3,100.0
1565,3/12/2018 11:25,160,153,116,429,3,100.0
1566,3/12/2018 11:30,173,144,105,422,3,100.0
1567,3/12/2018 11:35,172,161,115,448,3,100.0
1568,3/12/2018 11:40,180,143,120,443,3,100.0
1569,3/12/2018 11:45,170,153,115,438,3,100.0
1570,3/12/2018 11:50,179,169,123,471,3,100.0
1571,3/12/2018 11:55,161,138,99,398,3,100.0
1572,3/12/2018 12:00,170,159,119,448,3,100.0
1573,3/12/2018 12:05,177,162,137,476,3,100.0
1574,3/12/2018 12:10,188,154,127,469,3,100.0
1575,3/12/2018 12:15,157,144,109,410,3,100.0
1576,3/12/2018 12:20,173,166,128,467,3,100.0
1577,3/12/2018 12:25,169,155,112,436,3,100.0
1578,3/12/2018 12:30,188,158,119,465,3,100.0
1579,3/12/2018 12:35,178,156,114,448,3,100.0
1580,3/12/2018 12:40,166,148,127,441,3,100.0
1581,3/12/2018 12:45,180,166,125,471,3,100.0
1582,3/12/2018 12:50,183,162,123,468,3,100.0
1583,3/12/2018 12:55,177,161,112,450,3,100.0
1584,3/12/2018 13:00,184,151,114,449,3,100.0
1585,3/12/2018 13:05,181,150,133,464,3,100.0
1586,3/12/2018 13:10,199,181,133,513,3,100.0
1587,3/12/2018 13:15,179,154,111,444,3,100.0
1588,3/12/2018 13:20,164,155,119,438,3,100.0
1589,3/12/2018 13:25,172,138,134,444,3,100.0
1590,3/12/2018 13:30,156,146,115,417,3,100.0
1591,3/12/2018 13:35,169,148,119,436,3,100.0
1592,3/12/2018 13:40,167,145,140,452,3,100.0
1593,3/12/2018 13:45,177,157,129,463,3,100.0
1594,3/12/2018 13:50,169,159,139,467,3,100.0
1595,3/12/2018 13:55,174,171,151,496,3,100.0
1596,3/12/2018 14:00,174,155,138,467,3,100.0
1597,3/12/2018 14:05,171,178,151,500,3,100.0
1598,3/12/2018 14:10,175,167,130,472,3,100.0
1599,3/12/2018 14:15,192,161,140,493,3,100.0
1600,3/12/2018 14:20,178,179,140,497,3,100.0
1601,3/12/2018 14:25,188,177,143,508,3,100.0
1602,3/12/2018 14:30,182,179,134,495,3,100.0
1603,3/12/2018 14:35,165,169,145,479,3,100.0
1604,3/12/2018 14:40,180,177,126,483,3,100.0
1605,3/12/2018 14:45,151,152,137,440,3,100.0
1606,3/12/2018 14:50,164,165,140,469,3,100.0
1607,3/12/2018 14:55,158,161,143,462,3,100.0
1608,3/12/2018 15:00,154,151,129,434,3,100.0
1609,3/12/2018 15:05,164,173,148,485,3,100.0
1610,3/12/2018 15:10,156,150,134,440,3,100.0
1611,3/12/2018 15:15,151,139,144,434,3,100.0
1612,3/12/2018 15:20,161,152,138,451,3,100.0
1613,3/12/2018 15:25,145,135,121,401,3,100.0
1614,3/12/2018 15:30,162,152,142,456,3,100.0
1615,3/12/2018 15:35,160,142,134,436,3,100.0
1616,3/12/2018 15:40,154,165,149,468,3,100.0
1617,3/12/2018 15:45,162,169,145,476,3,100.0
1618,3/12/2018 15:50,164,163,148,475,3,100.0
1619,3/12/2018 15:55,167,157,151,475,3,100.0
1620,3/12/2018 16:00,159,155,147,461,3,100.0
1621,3/12/2018 16:05,163,163,144,470,3,100.0
1622,3/12/2018 16:10,170,172,157,499,3,100.0
1623,3/12/2018 16:15,178,165,167,510,3,100.0
1624,3/12/2018 16:20,147,144,144,435,3,100.0
1625,3/12/2018 16:25,162,167,136,465,3,100.0
1626,3/12/2018 16:30,171,177,146,494,3,100.0
1627,3/12/2018 16:35,159,148,153,460,3,100.0
1628,3/12/2018 16:40,169,154,146,469,3,100.0
1629,3/12/2018 16:45,137,148,141,426,3,100.0
1630,3/12/2018 16:50,150,134,146,430,3,100.0
1631,3/12/2018 16:55,132,127,125,384,3,100.0
1632,3/12/2018 17:00,160,145,134,439,3,100.0
1633,3/12/2018 17:05,165,174,154,493,3,100.0
1634,3/12/2018 17:10,159,171,148,478,3,100.0
1635,3/12/2018 17:15,175,165,162,502,3,100.0
1636,3/12/2018 17:20,178,168,150,496,3,100.0
1637,3/12/2018 17:25,160,150,142,452,3,0.0
1638,3/12/2018 17:30,162,162,141,465,3,0.0
1639,3/12/2018 17:35,154,149,128,431,3,0.0
1640,3/12/2018 17:40,158,146,137,441,3,0.0
1641,3/12/2018 17:45,160,152,142,454,3,0.0
1642,3/12/2018 17:50,157,178,140,475,3,100.0
1643,3/12/2018 17:55,164,164,147,475,3,100.0
1644,3/12/2018 18:00,154,158,155,467,3,100.0
1645,3/12/2018 18:05,162,160,135,457,3,100.0
1646,3/12/2018 18:10,166,172,144,482,3,100.0
1647,3/12/2018 18:15,159,158,131,448,3,100.0
1648,3/12/2018 18:20,168,155,163,486,3,100.0
1649,3/12/2018 18:25,172,161,153,486,3,100.0
1650,3/12/2018 18:30,164,147,133,444,3,100.0
1651,3/12/2018 18:35,177,183,151,511,3,100.0
1652,3/12/2018 18:40,168,160,136,464,3,100.0
1653,3/12/2018 18:45,171,166,141,478,3,100.0
1654,3/12/2018 18:50,167,164,148,479,3,100.0
1655,3/12/2018 18:55,157,150,125,432,3,100.0
1656,3/12/2018 19:00,159,157,119,435,3,100.0
1657,3/12/2018 19:05,149,133,105,387,3,100.0
1658,3/12/2018 19:10,147,130,108,385,3,100.0
1659,3/12/2018 19:15,145,144,105,394,3,100.0
1660,3/12/2018 19:20,140,134,103,377,3,100.0
1661,3/12/2018 19:25,129,141,99,369,3,100.0
1662,3/12/2018 19:30,118,127,110,355,3,100.0
1663,3/12/2018 19:35,139,139,116,394,3,100.0
1664,3/12/2018 19:40,142,126,122,390,3,100.0
1665,3/12/2018 19:45,143,132,104,379,3,100.0
1666,3/12/2018 19:50,154,153,120,427,3,100.0
1667,3/12/2018 19:55,139,144,109,392,3,100.0
1668,3/12/2018 20:00,131,127,90,348,3,100.0
1669,3/12/2018 20:05,132,123,100,355,3,100.0
1670,3/12/2018 20:10,143,135,99,377,3,100.0
1671,3/12/2018 20:15,162,153,114,429,3,100.0
1672,3/12/2018 20:20,141,116,97,354,3,100.0
1673,3/12/2018 20:25,155,124,94,373,3,100.0
1674,3/12/2018 20:30,154,140,107,401,3,100.0
1675,3/12/2018 20:35,142,124,93,359,3,100.0
1676,3/12/2018 20:40,130,135,104,369,3,100.0
1677,3/12/2018 20:45,135,113,95,343,3,100.0
1678,3/12/2018 20:50,102,107,84,293,3,100.0
1679,3/12/2018 20:55,103,102,79,284,3,100.0
1680,3/12/2018 21:00,108,102,72,282,3,100.0
1681,3/12/2018 21:05,124,106,97,327,3,100.0
1682,3/12/2018 21:10,111,107,73,291,3,100.0
1683,3/12/2018 21:15,108,101,67,276,3,100.0
1684,3/12/2018 21:20,109,109,86,304,3,100.0
1685,3/12/2018 21:25,107,101,89,297,3,100.0
1686,3/12/2018 21:30,106,101,81,288,3,100.0
1687,3/12/2018 21:35,98,102,68,268,3,100.0
1688,3/12/2018 21:40,95,91,65,251,3,100.0
1689,3/12/2018 21:45,89,80,66,235,3,100.0
1690,3/12/2018 21:50,103,87,65,255,3,100.0
1691,3/12/2018 21:55,80,79,53,212,3,100.0
1692,3/12/2018 22:00,87,94,58,239,3,100.0
1693,3/12/2018 22:05,71,80,58,209,3,100.0
1694,3/12/2018 22:10,93,85,65,243,3,100.0
1695,3/12/2018 22:15,83,86,68,237,3,100.0
1696,3/12/2018 22:20,105,104,70,279,3,100.0
1697,3/12/2018 22:25,75,87,59,221,3,100.0
1698,3/12/2018 22:30,74,92,58,224,3,100.0
1699,3/12/2018 22:35,67,82,53,202,3,100.0
1700,3/12/2018 22:40,83,79,59,221,3,100.0
1701,3/12/2018 22:45,72,81,54,207,3,100.0
1702,3/12/2018 22:50,72,88,52,212,3,100.0
1703,3/12/2018 22:55,50,70,45,165,3,100.0
1704,3/12/2018 23:00,76,71,37,184,3,100.0
1705,3/12/2018 23:05,68,62,41,171,3,100.0
1706,3/12/2018 23:10,50,65,46,161,3,100.0
1707,3/12/2018 23:15,61,73,60,194,3,100.0
1708,3/12/2018 23:20,43,56,36,135,3,100.0
1709,3/12/2018 23:25,53,54,36,143,3,100.0
1710,3/12/2018 23:30,54,58,28,140,3,100.0
1711,3/12/2018 23:35,47,61,44,152,3,100.0
1712,3/12/2018 23:40,54,60,45,159,3,100.0
1713,3/12/2018 23:45,56,60,41,157,3,100.0
1714,3/12/2018 23:50,40,56,26,122,3,100.0
1715,3/12/2018 23:55,47,56,34,137,3,100.0
1716,3/13/2018 0:00,48,55,33,136,3,100.0
1717,3/13/2018 0:05,32,43,16,91,3,100.0
1718,3/13/2018 0:10,43,51,39,133,3,100.0
1719,3/13/2018 0:15,36,46,38,120,3,100.0
1720,3/13/2018 0:20,41,40,37,118,3,100.0
1721,3/13/2018 0:25,31,40,28,99,3,100.0
1722,3/13/2018 0:30,41,32,18,91,3,100.0
1723,3/13/2018 0:35,29,47,26,102,3,100.0
1724,3/13/2018 0:40,33,41,24,98,3,100.0
1725,3/13/2018 0:45,27,38,27,92,3,100.0
1726,3/13/2018 0:50,29,42,23,94,3,100.0
1727,3/13/2018 0:55,23,28,14,65,3,100.0
1728,3/13/2018 1:00,26,35,19,80,3,100.0
1729,3/13/2018 1:05,21,33,23,77,3,100.0
1730,3/13/2018 1:10,29,29,22,80,3,100.0
1731,3/13/2018 1:15,23,26,18,67,3,100.0
1732,3/13/2018 1:20,28,25,25,78,3,100.0
1733,3/13/2018 1:25,18,26,16,60,3,100.0
1734,3/13/2018 1:30,17,30,20,67,3,100.0
1735,3/13/2018 1:35,19,24,16,59,3,100.0
1736,3/13/2018 1:40,14,29,21,64,3,100.0
1737,3/13/2018 1:45,21,35,23,79,3,100.0
1738,3/13/2018 1:50,16,20,21,57,3,100.0
1739,3/13/2018 1:55,12,19,13,44,3,100.0
1740,3/13/2018 2:00,11,19,13,43,3,100.0
1741,3/13/2018 2:05,14,11,17,42,3,100.0
1742,3/13/2018 2:10,10,21,15,46,3,100.0
1743,3/13/2018 2:15,14,18,18,50,3,100.0
1744,3/13/2018 2:20,14,19,18,51,3,100.0
1745,3/13/2018 2:25,12,26,14,52,3,100.0
1746,3/13/2018 2:30,14,21,16,51,3,100.0
1747,3/13/2018 2:35,7,23,17,47,3,100.0
1748,3/13/2018 2:40,16,25,17,58,3,100.0
1749,3/13/2018 2:45,7,15,11,33,3,100.0
1750,3/13/2018 2:50,12,14,18,44,3,100.0
1751,3/13/2018 2:55,13,10,12,35,3,100.0
1752,3/13/2018 3:00,7,15,18,40,3,100.0
1753,3/13/2018 3:05,8,16,17,41,3,100.0
1754,3/13/2018 3:10,12,18,14,44,3,100.0
1755,3/13/2018 3:15,8,12,11,31,3,100.0
1756,3/13/2018 3:20,12,20,13,45,3,100.0
1757,3/13/2018 3:25,13,18,16,47,3,100.0
1758,3/13/2018 3:30,15,23,18,56,3,100.0
1759,3/13/2018 3:35,13,25,15,53,3,100.0
1760,3/13/2018 3:40,20,18,29,67,3,100.0
1761,3/13/2018 3:45,21,24,20,65,3,100.0
1762,3/13/2018 3:50,13,19,13,45,3,100.0
1763,3/13/2018 3:55,12,27,21,60,3,100.0
1764,3/13/2018 4:00,17,24,18,59,3,100.0
1765,3/13/2018 4:05,14,26,16,56,3,100.0
1766,3/13/2018 4:10,16,19,18,53,3,100.0
1767,3/13/2018 4:15,21,30,16,67,3,100.0
1768,3/13/2018 4:20,39,42,22,103,3,100.0
1769,3/13/2018 4:25,31,35,27,93,3,100.0
1770,3/13/2018 4:30,38,39,28,105,3,100.0
1771,3/13/2018 4:35,39,50,27,116,3,100.0
1772,3/13/2018 4:40,30,42,27,99,3,100.0
1773,3/13/2018 4:45,42,56,32,130,3,100.0
1774,3/13/2018 4:50,46,61,35,142,3,100.0
1775,3/13/2018 4:55,41,59,31,131,3,100.0
1776,3/13/2018 5:00,51,58,43,152,3,100.0
1777,3/13/2018 5:05,54,46,32,132,3,100.0
1778,3/13/2018 5:10,80,78,60,218,3,100.0
1779,3/13/2018 5:15,77,83,50,210,3,100.0
1780,3/13/2018 5:20,100,87,57,244,3,100.0
1781,3/13/2018 5:25,106,99,55,260,3,100.0
1782,3/13/2018 5:30,102,102,48,252,3,100.0
1783,3/13/2018 5:35,137,120,60,317,3,100.0
1784,3/13/2018 5:40,137,124,56,317,3,100.0
1785,3/13/2018 5:45,150,131,81,362,3,100.0
1786,3/13/2018 5:50,142,121,76,339,3,100.0
1787,3/13/2018 5:55,168,126,86,380,3,100.0
1788,3/13/2018 6:00,146,117,71,334,3,100.0
1789,3/13/2018 6:05,176,137,86,399,3,100.0
1790,3/13/2018 6:10,150,121,93,364,3,100.0
1791,3/13/2018 6:15,163,137,99,399,3,100.0
1792,3/13/2018 6:20,165,133,92,390,3,100.0
1793,3/13/2018 6:25,160,131,94,385,3,100.0
1794,3/13/2018 6:30,168,148,97,413,3,100.0
1795,3/13/2018 6:35,172,136,94,402,3,100.0
1796,3/13/2018 6:40,154,141,83,378,3,100.0
1797,3/13/2018 6:45,163,137,93,393,3,100.0
1798,3/13/2018 6:50,197,156,109,462,3,100.0
1799,3/13/2018 6:55,180,152,110,442,3,100.0
1800,3/13/2018 7:00,162,149,107,418,3,100.0
1801,3/13/2018 7:05,161,138,120,419,3,100.0
1802,3/13/2018 7:10,193,172,114,479,3,100.0
1803,3/13/2018 7:15,201,155,110,466,3,100.0
1804,3/13/2018 7:20,173,154,117,444,3,100.0
1805,3/13/2018 7:25,177,165,126,468,3,100.0
1806,3/13/2018 7:30,171,151,115,437,3,100.0
1807,3/13/2018 7:35,207,184,142,533,3,100.0
1808,3/13/2018 7:40,205,183,137,525,3,100.0
1809,3/13/2018 7:45,197,176,138,511,3,100.0
1810,3/13/2018 7:50,190,179,140,509,3,100.0
1811,3/13/2018 7:55,198,173,135,506,3,100.0
1812,3/13/2018 8:00,188,166,119,473,3,100.0
1813,3/13/2018 8:05,164,166,118,448,3,100.0
1814,3/13/2018 8:10,157,145,99,401,3,100.0
1815,3/13/2018 8:15,163,141,103,407,3,100.0
1816,3/13/2018 8:20,191,181,126,498,3,100.0
1817,3/13/2018 8:25,172,164,119,455,3,100.0
1818,3/13/2018 8:30,211,177,132,520,3,100.0
1819,3/13/2018 8:35,195,168,131,494,3,100.0
1820,3/13/2018 8:40,195,185,134,514,3,100.0
1821,3/13/2018 8:45,192,165,125,482,3,100.0
1822,3/13/2018 8:50,184,171,130,485,3,100.0
1823,3/13/2018 8:55,177,156,109,442,3,100.0
1824,3/13/2018 9:00,197,176,125,498,3,100.0
1825,3/13/2018 9:05,167,165,108,440,3,100.0
1826,3/13/2018 9:10,165,147,102,414,3,100.0
1827,3/13/2018 9:15,179,157,118,454,3,100.0
1828,3/13/2018 9:20,179,153,107,439,3,100.0
1829,3/13/2018 9:25,188,155,104,447,3,100.0
1830,3/13/2018 9:30,166,142,104,412,3,100.0
1831,3/13/2018 9:35,170,156,108,434,3,100.0
1832,3/13/2018 9:40,162,155,100,417,3,100.0
1833,3/13/2018 9:45,153,139,94,386,3,100.0
1834,3/13/2018 9:50,160,138,93,391,3,100.0
1835,3/13/2018 9:55,185,155,104,444,3,100.0
1836,3/13/2018 10:00,152,139,87,378,3,100.0
1837,3/13/2018 10:05,144,128,85,357,3,100.0
1838,3/13/2018 10:10,170,142,107,419,3,100.0
1839,3/13/2018 10:15,153,138,101,392,3,100.0
1840,3/13/2018 10:20,178,142,97,417,3,100.0
1841,3/13/2018 10:25,162,139,96,397,3,100.0
1842,3/13/2018 10:30,162,124,93,379,3,100.0
1843,3/13/2018 10:35,172,151,103,426,3,100.0
1844,3/13/2018 10:40,190,166,119,475,3,100.0
1845,3/13/2018 10:45,171,150,107,428,3,100.0
1846,3/13/2018 10:50,157,128,92,377,3,100.0
1847,3/13/2018 10:55,180,151,112,443,3,100.0
1848,3/13/2018 11:00,167,143,95,405,3,100.0
1849,3/13/2018 11:05,153,138,87,378,3,100.0
1850,3/13/2018 11:10,166,143,108,417,3,100.0
1851,3/13/2018 11:15,177,142,108,427,3,100.0
1852,3/13/2018 11:20,154,130,104,388,3,100.0
1853,3/13/2018 11:25,165,146,106,417,3,100.0
1854,3/13/2018 11:30,152,139,101,392,3,100.0
1855,3/13/2018 11:35,123,117,91,331,3,100.0
1856,3/13/2018 11:40,142,135,86,363,3,100.0
1857,3/13/2018 11:45,90,101,88,279,3,100.0
1858,3/13/2018 11:50,171,158,125,454,3,100.0
1859,3/13/2018 11:55,181,164,118,463,3,100.0
0,3/13/2018 0:00,48,55,33,136,3,100.0
1,3/13/2018 0:05,32,43,16,91,3,100.0
2,3/13/2018 0:10,43,51,39,133,3,100.0
3,3/13/2018 0:15,36,46,38,120,3,100.0
4,3/13/2018 0:20,41,40,37,118,3,100.0
5,3/13/2018 0:25,31,40,28,99,3,100.0
6,3/13/2018 0:30,41,32,18,91,3,100.0
7,3/13/2018 0:35,29,47,26,102,3,100.0
8,3/13/2018 0:40,33,41,24,98,3,100.0
9,3/13/2018 0:45,27,38,27,92,3,100.0
10,3/13/2018 0:50,29,42,23,94,3,100.0
11,3/13/2018 0:55,23,28,14,65,3,100.0
12,3/13/2018 1:00,26,35,19,80,3,100.0
13,3/13/2018 1:05,21,33,23,77,3,100.0
14,3/13/2018 1:10,29,29,22,80,3,100.0
15,3/13/2018 1:15,23,26,18,67,3,100.0
16,3/13/2018 1:20,28,25,25,78,3,100.0
17,3/13/2018 1:25,18,26,16,60,3,100.0
18,3/13/2018 1:30,17,30,20,67,3,100.0
19,3/13/2018 1:35,19,24,16,59,3,100.0
20,3/13/2018 1:40,14,29,21,64,3,100.0
21,3/13/2018 1:45,21,35,23,79,3,100.0
22,3/13/2018 1:50,16,20,21,57,3,100.0
23,3/13/2018 1:55,12,19,13,44,3,100.0
24,3/13/2018 2:00,11,19,13,43,3,100.0
25,3/13/2018 2:05,14,11,17,42,3,100.0
26,3/13/2018 2:10,10,21,15,46,3,100.0
27,3/13/2018 2:15,14,18,18,50,3,100.0
28,3/13/2018 2:20,14,19,18,51,3,100.0
29,3/13/2018 2:25,12,26,14,52,3,100.0
30,3/13/2018 2:30,14,21,16,51,3,100.0
31,3/13/2018 2:35,7,23,17,47,3,100.0
32,3/13/2018 2:40,16,25,17,58,3,100.0
33,3/13/2018 2:45,7,15,11,33,3,100.0
34,3/13/2018 2:50,12,14,18,44,3,100.0
35,3/13/2018 2:55,13,10,12,35,3,100.0
36,3/13/2018 3:00,7,15,18,40,3,100.0
37,3/13/2018 3:05,8,16,17,41,3,100.0
38,3/13/2018 3:10,12,18,14,44,3,100.0
39,3/13/2018 3:15,8,12,11,31,3,100.0
40,3/13/2018 3:20,12,20,13,45,3,100.0
41,3/13/2018 3:25,13,18,16,47,3,100.0
42,3/13/2018 3:30,15,23,18,56,3,100.0
43,3/13/2018 3:35,13,25,15,53,3,100.0
44,3/13/2018 3:40,20,18,29,67,3,100.0
45,3/13/2018 3:45,21,24,20,65,3,100.0
46,3/13/2018 3:50,13,19,13,45,3,100.0
47,3/13/2018 3:55,12,27,21,60,3,100.0
48,3/13/2018 4:00,17,24,18,59,3,100.0
49,3/13/2018 4:05,14,26,16,56,3,100.0
50,3/13/2018 4:10,16,19,18,53,3,100.0
51,3/13/2018 4:15,21,30,16,67,3,100.0
52,3/13/2018 4:20,39,42,22,103,3,100.0
53,3/13/2018 4:25,31,35,27,93,3,100.0
54,3/13/2018 4:30,38,39,28,105,3,100.0
55,3/13/2018 4:35,39,50,27,116,3,100.0
56,3/13/2018 4:40,30,42,27,99,3,100.0
57,3/13/2018 4:45,42,56,32,130,3,100.0
58,3/13/2018 4:50,46,61,35,142,3,100.0
59,3/13/2018 4:55,41,59,31,131,3,100.0
60,3/13/2018 5:00,51,58,43,152,3,100.0
61,3/13/2018 5:05,54,46,32,132,3,100.0
62,3/13/2018 5:10,80,78,60,218,3,100.0
63,3/13/2018 5:15,77,83,50,210,3,100.0
64,3/13/2018 5:20,100,87,57,244,3,100.0
65,3/13/2018 5:25,106,99,55,260,3,100.0
66,3/13/2018 5:30,102,102,48,252,3,100.0
67,3/13/2018 5:35,137,120,60,317,3,100.0
68,3/13/2018 5:40,137,124,56,317,3,100.0
69,3/13/2018 5:45,150,131,81,362,3,100.0
70,3/13/2018 5:50,142,121,76,339,3,100.0
71,3/13/2018 5:55,168,126,86,380,3,100.0
72,3/13/2018 6:00,146,117,71,334,3,100.0
73,3/13/2018 6:05,176,137,86,399,3,100.0
74,3/13/2018 6:10,150,121,93,364,3,100.0
75,3/13/2018 6:15,163,137,99,399,3,100.0
76,3/13/2018 6:20,165,133,92,390,3,100.0
77,3/13/2018 6:25,160,131,94,385,3,100.0
78,3/13/2018 6:30,168,148,97,413,3,100.0
79,3/13/2018 6:35,172,136,94,402,3,100.0
80,3/13/2018 6:40,154,141,83,378,3,100.0
81,3/13/2018 6:45,163,137,93,393,3,100.0
82,3/13/2018 6:50,197,156,109,462,3,100.0
83,3/13/2018 6:55,180,152,110,442,3,100.0
84,3/13/2018 7:00,162,149,107,418,3,100.0
85,3/13/2018 7:05,161,138,120,419,3,100.0
86,3/13/2018 7:10,193,172,114,479,3,100.0
87,3/13/2018 7:15,201,155,110,466,3,100.0
88,3/13/2018 7:20,173,154,117,444,3,100.0
89,3/13/2018 7:25,177,165,126,468,3,100.0
90,3/13/2018 7:30,171,151,115,437,3,100.0
91,3/13/2018 7:35,207,184,142,533,3,100.0
92,3/13/2018 7:40,205,183,137,525,3,100.0
93,3/13/2018 7:45,197,176,138,511,3,100.0
94,3/13/2018 7:50,190,179,140,509,3,100.0
95,3/13/2018 7:55,198,173,135,506,3,100.0
96,3/13/2018 8:00,188,166,119,473,3,100.0
97,3/13/2018 8:05,164,166,118,448,3,100.0
98,3/13/2018 8:10,157,145,99,401,3,100.0
99,3/13/2018 8:15,163,141,103,407,3,100.0
100,3/13/2018 8:20,191,181,126,498,3,100.0
101,3/13/2018 8:25,172,164,119,455,3,100.0
102,3/13/2018 8:30,211,177,132,520,3,100.0
103,3/13/2018 8:35,195,168,131,494,3,100.0
104,3/13/2018 8:40,195,185,134,514,3,100.0
105,3/13/2018 8:45,192,165,125,482,3,100.0
106,3/13/2018 8:50,184,171,130,485,3,100.0
107,3/13/2018 8:55,177,156,109,442,3,100.0
108,3/13/2018 9:00,197,176,125,498,3,100.0
109,3/13/2018 9:05,167,165,108,440,3,100.0
110,3/13/2018 9:10,165,147,102,414,3,100.0
111,3/13/2018 9:15,179,157,118,454,3,100.0
112,3/13/2018 9:20,179,153,107,439,3,100.0
113,3/13/2018 9:25,188,155,104,447,3,100.0
114,3/13/2018 9:30,166,142,104,412,3,100.0
115,3/13/2018 9:35,170,156,108,434,3,100.0
116,3/13/2018 9:40,162,155,100,417,3,100.0
117,3/13/2018 9:45,153,139,94,386,3,100.0
118,3/13/2018 9:50,160,138,93,391,3,100.0
119,3/13/2018 9:55,185,155,104,444,3,100.0
120,3/13/2018 10:00,152,139,87,378,3,100.0
121,3/13/2018 10:05,144,128,85,357,3,100.0
122,3/13/2018 10:10,170,142,107,419,3,100.0
123,3/13/2018 10:15,153,138,101,392,3,100.0
124,3/13/2018 10:20,178,142,97,417,3,100.0
125,3/13/2018 10:25,162,139,96,397,3,100.0
126,3/13/2018 10:30,162,124,93,379,3,100.0
127,3/13/2018 10:35,172,151,103,426,3,100.0
128,3/13/2018 10:40,190,166,119,475,3,100.0
129,3/13/2018 10:45,171,150,107,428,3,100.0
130,3/13/2018 10:50,157,128,92,377,3,100.0
131,3/13/2018 10:55,180,151,112,443,3,100.0
132,3/13/2018 11:00,167,143,95,405,3,100.0
133,3/13/2018 11:05,153,138,87,378,3,100.0
134,3/13/2018 11:10,166,143,108,417,3,100.0
135,3/13/2018 11:15,177,142,108,427,3,100.0
136,3/13/2018 11:20,154,130,104,388,3,100.0
137,3/13/2018 11:25,165,146,106,417,3,100.0
138,3/13/2018 11:30,152,139,101,392,3,100.0
139,3/13/2018 11:35,123,117,91,331,3,100.0
140,3/13/2018 11:40,142,135,86,363,3,100.0
141,3/13/2018 11:45,90,101,88,279,3,100.0
142,3/13/2018 11:50,171,158,125,454,3,100.0
143,3/13/2018 11:55,181,164,118,463,3,100.0
144,3/13/2018 12:00,189,164,124,477,3,100.0
145,3/13/2018 12:05,182,162,131,475,3,100.0
146,3/13/2018 12:10,160,151,114,425,3,100.0
147,3/13/2018 12:15,162,130,91,383,3,100.0
148,3/13/2018 12:20,173,156,108,437,3,100.0
149,3/13/2018 12:25,184,155,111,450,3,100.0
150,3/13/2018 12:30,170,151,122,443,3,100.0
151,3/13/2018 12:35,187,159,116,462,3,100.0
152,3/13/2018 12:40,185,159,118,462,3,100.0
153,3/13/2018 12:45,180,165,130,475,3,100.0
154,3/13/2018 12:50,184,157,119,460,3,100.0
155,3/13/2018 12:55,168,151,96,415,3,100.0
156,3/13/2018 13:00,176,157,123,456,3,100.0
157,3/13/2018 13:05,184,153,104,441,3,100.0
158,3/13/2018 13:10,168,159,115,442,3,100.0
159,3/13/2018 13:15,177,138,116,431,3,100.0
160,3/13/2018 13:20,164,153,112,429,3,100.0
161,3/13/2018 13:25,186,171,113,470,3,100.0
162,3/13/2018 13:30,173,162,109,444,3,100.0
163,3/13/2018 13:35,196,168,120,484,3,100.0
164,3/13/2018 13:40,184,149,130,463,3,100.0
165,3/13/2018 13:45,170,181,124,475,3,100.0
166,3/13/2018 13:50,169,169,122,460,3,100.0
167,3/13/2018 13:55,178,172,128,478,3,100.0
168,3/13/2018 14:00,189,166,142,497,3,100.0
169,3/13/2018 14:05,172,167,123,462,3,100.0
170,3/13/2018 14:10,184,172,139,495,3,100.0
171,3/13/2018 14:15,184,182,121,487,3,100.0
172,3/13/2018 14:20,182,173,148,503,3,100.0
173,3/13/2018 14:25,172,176,141,489,3,100.0
174,3/13/2018 14:30,168,163,139,470,3,100.0
175,3/13/2018 14:35,170,177,120,467,3,100.0
176,3/13/2018 14:40,166,148,127,441,3,100.0
177,3/13/2018 14:45,180,158,131,469,3,100.0
178,3/13/2018 14:50,187,171,142,500,3,100.0
179,3/13/2018 14:55,173,170,158,501,3,100.0
180,3/13/2018 15:00,183,164,149,496,3,100.0
181,3/13/2018 15:05,175,182,148,505,3,100.0
182,3/13/2018 15:10,164,158,138,460,3,100.0
183,3/13/2018 15:15,164,157,134,455,3,100.0
184,3/13/2018 15:20,165,152,140,457,3,100.0
185,3/13/2018 15:25,148,146,134,428,3,100.0
186,3/13/2018 15:30,144,136,115,395,3,100.0
187,3/13/2018 15:35,146,141,131,418,3,100.0
188,3/13/2018 15:40,146,139,133,418,3,100.0
189,3/13/2018 15:45,162,147,121,430,3,100.0
190,3/13/2018 15:50,126,124,110,360,3,100.0
191,3/13/2018 15:55,149,136,123,408,3,100.0
192,3/13/2018 16:00,149,134,138,421,3,100.0
193,3/13/2018 16:05,147,136,125,408,3,100.0
194,3/13/2018 16:10,142,142,133,417,3,100.0
195,3/13/2018 16:15,140,130,137,407,3,100.0
196,3/13/2018 16:20,151,136,136,423,3,100.0
197,3/13/2018 16:25,152,134,130,416,3,100.0
198,3/13/2018 16:30,129,127,122,378,3,100.0
199,3/13/2018 16:35,130,117,116,363,3,100.0
200,3/13/2018 16:40,142,137,128,407,3,100.0
201,3/13/2018 16:45,127,130,120,377,3,100.0
202,3/13/2018 16:50,153,150,139,442,3,100.0
203,3/13/2018 16:55,124,131,115,370,3,100.0
204,3/13/2018 17:00,118,125,107,350,3,100.0
205,3/13/2018 17:05,107,98,77,282,3,100.0
206,3/13/2018 17:10,101,82,82,265,3,100.0
207,3/13/2018 17:15,86,78,79,243,3,100.0
208,3/13/2018 17:20,70,53,53,176,3,100.0
209,3/13/2018 17:25,106,95,84,285,3,100.0
210,3/13/2018 17:30,116,107,101,324,3,100.0
211,3/13/2018 17:35,94,84,80,258,3,100.0
212,3/13/2018 17:40,85,78,79,242,3,100.0
213,3/13/2018 17:45,101,96,80,277,3,100.0
214,3/13/2018 17:50,107,96,85,288,3,100.0
215,3/13/2018 17:55,131,125,114,370,3,100.0
216,3/13/2018 18:00,126,125,126,377,3,100.0
217,3/13/2018 18:05,137,145,123,405,3,100.0
218,3/13/2018 18:10,135,130,113,378,3,100.0
219,3/13/2018 18:15,134,137,134,405,3,100.0
220,3/13/2018 18:20,145,132,130,407,3,100.0
221,3/13/2018 18:25,166,148,126,440,3,100.0
222,3/13/2018 18:30,151,137,133,421,3,100.0
223,3/13/2018 18:35,155,151,156,462,3,100.0
224,3/13/2018 18:40,166,169,151,486,3,100.0
225,3/13/2018 18:45,160,155,137,452,3,100.0
226,3/13/2018 18:50,161,153,145,459,3,100.0
227,3/13/2018 18:55,160,138,133,431,3,100.0
228,3/13/2018 19:00,157,152,141,450,3,100.0
229,3/13/2018 19:05,148,153,141,442,3,100.0
230,3/13/2018 19:10,158,144,129,431,3,100.0
231,3/13/2018 19:15,150,139,135,424,3,100.0
232,3/13/2018 19:20,159,149,141,449,3,100.0
233,3/13/2018 19:25,157,154,136,447,3,100.0
234,3/13/2018 19:30,151,138,126,415,3,100.0
235,3/13/2018 19:35,150,131,123,404,3,100.0
236,3/13/2018 19:40,152,151,137,440,3,100.0
237,3/13/2018 19:45,156,149,142,447,3,100.0
238,3/13/2018 19:50,141,145,130,416,3,100.0
239,3/13/2018 19:55,152,152,133,437,3,100.0
240,3/13/2018 20:00,155,141,132,428,3,100.0
241,3/13/2018 20:05,151,149,124,424,3,100.0
242,3/13/2018 20:10,153,140,111,404,3,100.0
243,3/13/2018 20:15,112,108,81,301,3,100.0
244,3/13/2018 20:20,134,111,86,331,3,100.0
245,3/13/2018 20:25,128,103,93,324,3,100.0
246,3/13/2018 20:30,113,101,93,307,3,100.0
247,3/13/2018 20:35,119,116,95,330,3,100.0
248,3/13/2018 20:40,109,112,88,309,3,100.0
249,3/13/2018 20:45,119,118,91,328,3,100.0
250,3/13/2018 20:50,141,119,91,351,3,100.0
251,3/13/2018 20:55,133,100,78,311,3,100.0
252,3/13/2018 21:00,111,108,69,288,3,100.0
253,3/13/2018 21:05,117,110,78,305,3,100.0
254,3/13/2018 21:10,112,114,80,306,3,100.0
255,3/13/2018 21:15,130,104,74,308,3,100.0
256,3/13/2018 21:20,107,106,85,298,3,100.0
257,3/13/2018 21:25,106,92,69,267,3,100.0
258,3/13/2018 21:30,108,94,75,277,3,100.0
259,3/13/2018 21:35,124,106,70,300,3,100.0
260,3/13/2018 21:40,124,101,71,296,3,100.0
261,3/13/2018 21:45,100,95,65,260,3,100.0
262,3/13/2018 21:50,96,99,65,260,3,100.0
263,3/13/2018 21:55,88,85,65,238,3,100.0
264,3/13/2018 22:00,79,79,54,212,3,100.0
265,3/13/2018 22:05,104,93,73,270,3,100.0
266,3/13/2018 22:10,87,90,64,241,3,100.0
267,3/13/2018 22:15,102,98,58,258,3,100.0
268,3/13/2018 22:20,88,97,70,255,3,100.0
269,3/13/2018 22:25,85,88,53,226,3,100.0
270,3/13/2018 22:30,92,87,60,239,3,100.0
271,3/13/2018 22:35,89,92,62,243,3,100.0
272,3/13/2018 22:40,80,91,63,234,3,100.0
273,3/13/2018 22:45,94,93,56,243,3,100.0
274,3/13/2018 22:50,62,77,50,189,3,100.0
275,3/13/2018 22:55,74,63,42,179,3,100.0
276,3/13/2018 23:00,74,76,54,204,3,100.0
277,3/13/2018 23:05,71,66,47,184,3,100.0
278,3/13/2018 23:10,67,62,50,179,3,100.0
279,3/13/2018 23:15,64,68,51,183,3,100.0
280,3/13/2018 23:20,69,63,45,177,3,100.0
281,3/13/2018 23:25,56,57,45,158,3,100.0
282,3/13/2018 23:30,44,60,36,140,3,100.0
283,3/13/2018 23:35,46,54,46,146,3,100.0
284,3/13/2018 23:40,49,60,42,151,3,100.0
285,3/13/2018 23:45,52,70,48,170,3,100.0
286,3/13/2018 23:50,54,54,39,147,3,100.0
287,3/13/2018 23:55,50,60,34,144,3,100.0
288,3/14/2018 0:00,45,41,35,121,3,100.0
289,3/14/2018 0:05,45,47,39,131,3,100.0
290,3/14/2018 0:10,20,34,40,94,3,100.0
291,3/14/2018 0:15,31,36,26,93,3,100.0
292,3/14/2018 0:20,62,66,49,177,3,100.0
293,3/14/2018 0:25,29,32,21,82,3,100.0
294,3/14/2018 0:30,21,33,27,81,3,100.0
295,3/14/2018 0:35,22,23,26,71,3,100.0
296,3/14/2018 0:40,48,47,41,136,3,100.0
297,3/14/2018 0:45,29,33,20,82,3,100.0
298,3/14/2018 0:50,14,38,26,78,3,100.0
299,3/14/2018 0:55,27,35,19,81,3,100.0
300,3/14/2018 1:00,29,32,19,80,3,100.0
301,3/14/2018 1:05,24,28,22,74,3,100.0
302,3/14/2018 1:10,21,27,10,58,3,100.0
303,3/14/2018 1:15,22,29,22,73,3,100.0
304,3/14/2018 1:20,16,23,23,62,3,100.0
305,3/14/2018 1:25,11,21,20,52,3,100.0
306,3/14/2018 1:30,17,30,22,69,3,100.0
307,3/14/2018 1:35,19,29,25,73,3,100.0
308,3/14/2018 1:40,22,31,20,73,3,100.0
309,3/14/2018 1:45,17,20,15,52,3,100.0
310,3/14/2018 1:50,10,34,18,62,3,100.0
311,3/14/2018 1:55,13,19,8,40,3,100.0
312,3/14/2018 2:00,13,17,10,40,3,100.0
313,3/14/2018 2:05,18,22,12,52,3,100.0
314,3/14/2018 2:10,20,22,13,55,3,100.0
315,3/14/2018 2:15,7,22,15,44,3,100.0
316,3/14/2018 2:20,13,24,22,59,3,100.0
317,3/14/2018 2:25,13,21,13,47,3,100.0
318,3/14/2018 2:30,19,23,16,58,3,100.0
319,3/14/2018 2:35,13,22,15,50,3,100.0
320,3/14/2018 2:40,12,21,18,51,3,100.0
321,3/14/2018 2:45,19,29,13,61,3,100.0
322,3/14/2018 2:50,13,19,22,54,3,100.0
323,3/14/2018 2:55,11,18,11,40,3,100.0
324,3/14/2018 3:00,6,15,14,35,3,100.0
325,3/14/2018 3:05,10,16,15,41,3,100.0
326,3/14/2018 3:10,10,15,16,41,3,100.0
327,3/14/2018 3:15,15,17,16,48,3,100.0
328,3/14/2018 3:20,11,11,10,32,3,100.0
329,3/14/2018 3:25,12,23,11,46,3,100.0
330,3/14/2018 3:30,10,20,14,44,3,100.0
331,3/14/2018 3:35,12,23,17,52,3,100.0
332,3/14/2018 3:40,8,19,12,39,3,100.0
333,3/14/2018 3:45,14,23,20,57,3,100.0
334,3/14/2018 3:50,10,21,18,49,3,100.0
335,3/14/2018 3:55,18,25,20,63,3,100.0
336,3/14/2018 4:00,19,25,16,60,3,100.0
337,3/14/2018 4:05,19,20,13,52,3,100.0
338,3/14/2018 4:10,24,34,22,80,3,100.0
339,3/14/2018 4:15,25,32,19,76,3,100.0
340,3/14/2018 4:20,17,27,23,67,3,100.0
341,3/14/2018 4:25,32,38,29,99,3,100.0
342,3/14/2018 4:30,39,42,25,106,3,100.0
343,3/14/2018 4:35,36,43,30,109,3,100.0
344,3/14/2018 4:40,43,46,30,119,3,100.0
345,3/14/2018 4:45,42,48,38,128,3,100.0
346,3/14/2018 4:50,41,54,27,122,3,100.0
347,3/14/2018 4:55,50,44,37,131,3,100.0
348,3/14/2018 5:00,47,56,37,140,3,100.0
349,3/14/2018 5:05,64,58,42,164,3,100.0
350,3/14/2018 5:10,74,70,53,197,3,100.0
351,3/14/2018 5:15,86,80,49,215,3,100.0
352,3/14/2018 5:20,86,77,48,211,3,100.0
353,3/14/2018 5:25,124,107,58,289,3,100.0
354,3/14/2018 5:30,120,102,63,285,3,100.0
355,3/14/2018 5:35,112,97,60,269,3,100.0
356,3/14/2018 5:40,146,125,87,358,3,100.0
357,3/14/2018 5:45,137,125,73,335,3,100.0
358,3/14/2018 5:50,123,107,66,296,3,100.0
359,3/14/2018 5:55,141,104,64,309,3,100.0
360,3/14/2018 6:00,149,114,70,333,3,100.0
361,3/14/2018 6:05,151,128,83,362,3,100.0
362,3/14/2018 6:10,162,143,92,397,3,100.0
363,3/14/2018 6:15,151,135,79,365,3,100.0
364,3/14/2018 6:20,167,137,91,395,3,100.0
365,3/14/2018 6:25,156,143,100,399,3,100.0
366,3/14/2018 6:30,138,136,76,350,3,100.0
367,3/14/2018 6:35,159,134,103,396,3,100.0
368,3/14/2018 6:40,177,130,92,399,3,100.0
369,3/14/2018 6:45,204,132,136,472,3,100.0
370,3/14/2018 6:50,202,156,102,460,3,100.0
371,3/14/2018 6:55,189,161,121,471,3,100.0
372,3/14/2018 7:00,171,140,99,410,3,100.0
373,3/14/2018 7:05,197,163,114,474,3,100.0
374,3/14/2018 7:10,194,168,110,472,3,100.0
375,3/14/2018 7:15,177,171,112,460,3,100.0
376,3/14/2018 7:20,187,162,119,468,3,100.0
377,3/14/2018 7:25,142,139,115,396,3,100.0
378,3/14/2018 7:30,148,148,139,435,3,100.0
379,3/14/2018 7:35,156,158,149,463,3,100.0
380,3/14/2018 7:40,162,160,141,463,3,100.0
381,3/14/2018 7:45,160,154,141,455,3,100.0
382,3/14/2018 7:50,170,166,139,475,3,100.0
383,3/14/2018 7:55,162,161,120,443,3,100.0
384,3/14/2018 8:00,205,183,143,531,3,100.0
385,3/14/2018 8:05,180,166,132,478,3,100.0
386,3/14/2018 8:10,173,168,123,464,3,100.0
387,3/14/2018 8:15,161,160,139,460,3,100.0
388,3/14/2018 8:20,151,143,113,407,3,100.0
389,3/14/2018 8:25,172,163,142,477,3,100.0
390,3/14/2018 8:30,167,174,135,476,3,100.0
391,3/14/2018 8:35,197,164,136,497,3,100.0
392,3/14/2018 8:40,162,156,146,464,3,100.0
393,3/14/2018 8:45,174,161,139,474,3,100.0
394,3/14/2018 8:50,171,157,115,443,3,100.0
395,3/14/2018 8:55,202,173,130,505,3,100.0
396,3/14/2018 9:00,196,178,132,506,3,100.0
397,3/14/2018 9:05,173,142,114,429,3,100.0
398,3/14/2018 9:10,174,157,108,439,3,100.0
399,3/14/2018 9:15,160,137,91,388,3,100.0
400,3/14/2018 9:20,188,155,102,445,3,100.0
401,3/14/2018 9:25,182,165,107,454,3,100.0
402,3/14/2018 9:30,169,146,113,428,3,100.0
403,3/14/2018 9:35,164,133,94,391,3,100.0
404,3/14/2018 9:40,172,138,95,405,3,100.0
405,3/14/2018 9:45,179,163,108,450,3,100.0
406,3/14/2018 9:50,153,123,86,362,3,100.0
407,3/14/2018 9:55,165,156,93,414,3,100.0
408,3/14/2018 10:00,170,146,103,419,3,100.0
409,3/14/2018 10:05,126,119,81,326,3,100.0
410,3/14/2018 10:10,155,135,87,377,3,100.0
411,3/14/2018 10:15,164,130,104,398,3,100.0
412,3/14/2018 10:20,181,144,113,438,3,100.0
413,3/14/2018 10:25,178,144,103,425,3,100.0
414,3/14/2018 10:30,154,131,102,387,3,100.0
415,3/14/2018 10:35,185,174,109,468,3,100.0
416,3/14/2018 10:40,170,143,123,436,3,100.0
417,3/14/2018 10:45,175,146,107,428,3,100.0
418,3/14/2018 10:50,165,160,107,432,3,100.0
419,3/14/2018 10:55,166,142,106,414,3,100.0
420,3/14/2018 11:00,167,142,104,413,3,100.0
421,3/14/2018 11:05,185,152,113,450,3,100.0
422,3/14/2018 11:10,160,148,98,406,3,100.0
423,3/14/2018 11:15,142,125,92,359,3,100.0
424,3/14/2018 11:20,164,149,107,420,3,100.0
425,3/14/2018 11:25,179,165,106,450,3,100.0
426,3/14/2018 11:30,186,163,125,474,3,100.0
427,3/14/2018 11:35,152,142,104,398,3,100.0
428,3/14/2018 11:40,185,164,124,473,3,100.0
429,3/14/2018 11:45,164,142,104,410,3,100.0
430,3/14/2018 11:50,184,160,144,488,3,100.0
431,3/14/2018 11:55,176,152,107,435,3,100.0
432,3/14/2018 12:00,181,152,123,456,3,100.0
433,3/14/2018 12:05,192,165,139,496,3,100.0
434,3/14/2018 12:10,178,163,123,464,3,100.0
435,3/14/2018 12:15,182,158,117,457,3,100.0
436,3/14/2018 12:20,196,169,125,490,3,100.0
437,3/14/2018 12:25,182,159,114,455,3,100.0
438,3/14/2018 12:30,168,159,114,441,3,100.0
439,3/14/2018 12:35,166,141,130,437,3,100.0
440,3/14/2018 12:40,177,163,126,466,3,100.0
441,3/14/2018 12:45,159,165,130,454,3,100.0
442,3/14/2018 12:50,175,160,122,457,3,100.0
443,3/14/2018 12:55,154,147,119,420,3,100.0
444,3/14/2018 13:00,169,159,123,451,3,100.0
445,3/14/2018 13:05,181,161,122,464,3,100.0
446,3/14/2018 13:10,171,158,118,447,3,100.0
447,3/14/2018 13:15,162,165,129,456,3,100.0
448,3/14/2018 13:20,189,171,136,496,3,100.0
449,3/14/2018 13:25,177,169,122,468,3,100.0
450,3/14/2018 13:30,173,165,119,457,3,100.0
451,3/14/2018 13:35,172,168,133,473,3,100.0
452,3/14/2018 13:40,180,172,122,474,3,100.0
453,3/14/2018 13:45,167,157,134,458,3,100.0
454,3/14/2018 13:50,179,188,138,505,3,100.0
455,3/14/2018 13:55,172,182,141,495,3,100.0
456,3/14/2018 14:00,193,165,137,495,3,100.0
457,3/14/2018 14:05,178,160,121,459,3,100.0
458,3/14/2018 14:10,168,174,128,470,3,100.0
459,3/14/2018 14:15,183,168,137,488,3,100.0
460,3/14/2018 14:20,173,181,141,495,3,100.0
461,3/14/2018 14:25,185,176,138,499,3,100.0
462,3/14/2018 14:30,174,167,124,465,3,100.0
463,3/14/2018 14:35,174,151,130,455,3,100.0
464,3/14/2018 14:40,183,164,139,486,3,100.0
465,3/14/2018 14:45,166,174,152,492,3,100.0
466,3/14/2018 14:50,176,181,150,507,3,100.0
467,3/14/2018 14:55,164,177,144,485,3,100.0
468,3/14/2018 15:00,163,149,136,448,3,100.0
469,3/14/2018 15:05,169,163,146,478,3,100.0
470,3/14/2018 15:10,174,156,136,466,3,100.0
471,3/14/2018 15:15,169,161,154,484,3,100.0
472,3/14/2018 15:20,159,160,138,457,3,100.0
473,3/14/2018 15:25,164,157,151,472,3,100.0
474,3/14/2018 15:30,184,189,141,514,3,100.0
475,3/14/2018 15:35,135,139,138,412,3,100.0
476,3/14/2018 15:40,155,146,131,432,3,100.0
477,3/14/2018 15:45,156,155,149,460,3,100.0
478,3/14/2018 15:50,89,93,91,273,3,100.0
479,3/14/2018 15:55,151,145,150,446,3,100.0
480,3/14/2018 16:00,154,164,154,472,3,100.0
481,3/14/2018 16:05,148,164,132,444,3,100.0
482,3/14/2018 16:10,151,148,156,455,3,100.0
483,3/14/2018 16:15,148,141,141,430,3,100.0
484,3/14/2018 16:20,146,143,131,420,3,100.0
485,3/14/2018 16:25,132,137,123,392,3,100.0
486,3/14/2018 16:30,117,124,115,356,3,100.0
487,3/14/2018 16:35,127,120,117,364,3,100.0
488,3/14/2018 16:40,142,143,142,427,3,100.0
489,3/14/2018 16:45,153,146,149,448,3,100.0
490,3/14/2018 16:50,146,145,132,423,3,100.0
491,3/14/2018 16:55,121,114,116,351,3,100.0
492,3/14/2018 17:00,152,144,146,442,3,100.0
493,3/14/2018 17:05,161,153,151,465,3,100.0
494,3/14/2018 17:10,137,131,129,397,3,100.0
495,3/14/2018 17:15,157,166,154,477,3,100.0
496,3/14/2018 17:20,130,132,128,390,3,100.0
497,3/14/2018 17:25,106,106,100,312,3,100.0
498,3/14/2018 17:30,148,131,129,408,3,100.0
499,3/14/2018 17:35,114,118,116,348,3,100.0
500,3/14/2018 17:40,138,159,136,433,3,100.0
501,3/14/2018 17:45,144,147,139,430,3,100.0
502,3/14/2018 17:50,154,139,129,422,3,100.0
503,3/14/2018 17:55,163,152,152,467,3,100.0
504,3/14/2018 18:00,166,151,137,454,3,100.0
505,3/14/2018 18:05,159,160,140,459,3,100.0
506,3/14/2018 18:10,163,164,154,481,3,100.0
507,3/14/2018 18:15,165,155,155,475,3,100.0
508,3/14/2018 18:20,157,165,138,460,3,100.0
509,3/14/2018 18:25,154,156,153,463,3,100.0
510,3/14/2018 18:30,159,154,151,464,3,100.0
511,3/14/2018 18:35,163,149,138,450,3,100.0
512,3/14/2018 18:40,169,154,157,480,3,100.0
513,3/14/2018 18:45,167,155,149,471,3,100.0
514,3/14/2018 18:50,162,151,141,454,3,100.0
515,3/14/2018 18:55,159,156,144,459,3,100.0
516,3/14/2018 19:00,151,153,144,448,3,100.0
517,3/14/2018 19:05,170,163,148,481,3,100.0
518,3/14/2018 19:10,165,161,147,473,3,100.0
519,3/14/2018 19:15,157,159,133,449,3,100.0
520,3/14/2018 19:20,157,154,136,447,3,100.0
521,3/14/2018 19:25,157,163,127,447,3,100.0
522,3/14/2018 19:30,164,142,119,425,3,100.0
523,3/14/2018 19:35,159,143,130,432,3,100.0
524,3/14/2018 19:40,168,149,133,450,3,100.0
525,3/14/2018 19:45,147,152,118,417,3,100.0
526,3/14/2018 19:50,155,165,134,454,3,100.0
527,3/14/2018 19:55,164,143,119,426,3,100.0
528,3/14/2018 20:00,157,149,126,432,3,100.0
529,3/14/2018 20:05,150,141,103,394,3,100.0
530,3/14/2018 20:10,154,158,124,436,3,100.0
531,3/14/2018 20:15,131,136,116,383,3,100.0
532,3/14/2018 20:20,156,145,118,419,3,100.0
533,3/14/2018 20:25,125,118,100,343,3,100.0
534,3/14/2018 20:30,162,150,116,428,3,100.0
535,3/14/2018 20:35,158,120,124,402,3,100.0
536,3/14/2018 20:40,149,129,93,371,3,100.0
537,3/14/2018 20:45,160,118,95,373,3,100.0
538,3/14/2018 20:50,137,123,98,358,3,100.0
539,3/14/2018 20:55,135,121,99,355,3,100.0
540,3/14/2018 21:00,137,136,99,372,3,100.0
541,3/14/2018 21:05,127,123,86,336,3,100.0
542,3/14/2018 21:10,124,110,96,330,3,100.0
543,3/14/2018 21:15,145,128,95,368,3,100.0
544,3/14/2018 21:20,131,106,86,323,3,100.0
545,3/14/2018 21:25,133,119,85,337,3,100.0
546,3/14/2018 21:30,110,110,83,303,3,100.0
547,3/14/2018 21:35,119,121,87,327,3,100.0
548,3/14/2018 21:40,125,113,81,319,3,100.0
549,3/14/2018 21:45,91,87,64,242,3,100.0
550,3/14/2018 21:50,101,89,70,260,3,100.0
551,3/14/2018 21:55,110,106,74,290,3,100.0
552,3/14/2018 22:00,88,93,68,249,3,100.0
553,3/14/2018 22:05,108,102,67,277,3,100.0
554,3/14/2018 22:10,104,93,69,266,3,100.0
555,3/14/2018 22:15,109,98,71,278,3,100.0
556,3/14/2018 22:20,107,104,58,269,3,100.0
557,3/14/2018 22:25,96,93,57,246,3,100.0
558,3/14/2018 22:30,104,76,64,244,3,100.0
559,3/14/2018 22:35,88,94,67,249,3,100.0
560,3/14/2018 22:40,84,84,57,225,3,100.0
561,3/14/2018 22:45,56,81,48,185,3,100.0
562,3/14/2018 22:50,81,89,61,231,3,100.0
563,3/14/2018 22:55,77,77,57,211,3,100.0
564,3/14/2018 23:00,71,76,46,193,3,100.0
565,3/14/2018 23:05,66,70,56,192,3,100.0
566,3/14/2018 23:10,80,85,46,211,3,100.0
567,3/14/2018 23:15,76,82,58,216,3,100.0
568,3/14/2018 23:20,67,66,61,194,3,100.0
569,3/14/2018 23:25,73,69,53,195,3,100.0
570,3/14/2018 23:30,72,76,47,195,3,100.0
571,3/14/2018 23:35,52,69,49,170,3,100.0
572,3/14/2018 23:40,54,59,54,167,3,100.0
573,3/14/2018 23:45,40,44,29,113,3,100.0
574,3/14/2018 23:50,69,66,46,181,3,100.0
575,3/14/2018 23:55,51,54,47,152,3,100.0
576,3/15/2018 0:00,46,60,41,147,3,100.0
577,3/15/2018 0:05,40,54,47,141,3,100.0
578,3/15/2018 0:10,41,49,32,122,3,100.0
579,3/15/2018 0:15,35,50,35,120,3,100.0
580,3/15/2018 0:20,44,49,39,132,3,100.0
581,3/15/2018 0:25,30,39,26,95,3,100.0
582,3/15/2018 0:30,39,43,28,110,3,100.0
583,3/15/2018 0:35,46,43,25,114,3,100.0
584,3/15/2018 0:40,23,33,32,88,3,100.0
585,3/15/2018 0:45,41,42,29,112,3,100.0
586,3/15/2018 0:50,19,38,21,78,3,100.0
587,3/15/2018 0:55,21,33,14,68,3,100.0
588,3/15/2018 1:00,27,32,21,80,3,100.0
589,3/15/2018 1:05,32,29,27,88,3,100.0
590,3/15/2018 1:10,23,35,26,84,3,100.0
591,3/15/2018 1:15,22,33,23,78,3,100.0
592,3/15/2018 1:20,21,29,24,74,3,100.0
593,3/15/2018 1:25,16,33,12,61,3,100.0
594,3/15/2018 1:30,13,34,22,69,3,100.0
595,3/15/2018 1:35,12,37,14,63,3,100.0
596,3/15/2018 1:40,23,24,13,60,3,100.0
597,3/15/2018 1:45,12,31,16,59,3,100.0
598,3/15/2018 1:50,17,22,15,54,3,100.0
599,3/15/2018 1:55,12,22,10,44,3,100.0
600,3/15/2018 2:00,13,24,10,47,3,100.0
601,3/15/2018 2:05,16,23,16,55,3,100.0
602,3/15/2018 2:10,14,19,10,43,3,100.0
603,3/15/2018 2:15,15,19,20,54,3,100.0
604,3/15/2018 2:20,6,28,12,46,3,100.0
605,3/15/2018 2:25,17,14,13,44,3,100.0
606,3/15/2018 2:30,11,24,13,48,3,100.0
607,3/15/2018 2:35,19,18,11,48,3,100.0
608,3/15/2018 2:40,13,19,11,43,3,100.0
609,3/15/2018 2:45,18,27,19,64,3,100.0
610,3/15/2018 2:50,11,17,20,48,3,100.0
611,3/15/2018 2:55,8,14,19,41,3,100.0
612,3/15/2018 3:00,13,16,15,44,3,100.0
613,3/15/2018 3:05,13,20,14,47,3,100.0
614,3/15/2018 3:10,5,15,10,30,3,100.0
615,3/15/2018 3:15,7,18,8,33,3,100.0
616,3/15/2018 3:20,10,18,10,38,3,100.0
617,3/15/2018 3:25,6,15,14,35,3,100.0
618,3/15/2018 3:30,13,24,14,51,3,100.0
619,3/15/2018 3:35,12,24,13,49,3,100.0
620,3/15/2018 3:40,17,29,20,66,3,100.0
621,3/15/2018 3:45,11,17,17,45,3,100.0
622,3/15/2018 3:50,13,27,14,54,3,100.0
623,3/15/2018 3:55,18,28,19,65,3,100.0
624,3/15/2018 4:00,12,26,10,48,3,100.0
625,3/15/2018 4:05,14,26,20,60,3,0.0
626,3/15/2018 4:10,10,23,20,53,3,100.0
627,3/15/2018 4:15,16,32,24,72,3,100.0
628,3/15/2018 4:20,26,37,21,84,3,100.0
629,3/15/2018 4:25,32,36,24,92,3,100.0
630,3/15/2018 4:30,42,46,22,110,3,100.0
631,3/15/2018 4:35,32,46,24,102,3,100.0
632,3/15/2018 4:40,43,45,24,112,3,100.0
633,3/15/2018 4:45,43,45,31,119,3,100.0
634,3/15/2018 4:50,40,52,36,128,3,100.0
635,3/15/2018 4:55,38,46,31,115,3,100.0
636,3/15/2018 5:00,53,54,34,141,3,100.0
637,3/15/2018 5:05,66,59,36,161,3,100.0
638,3/15/2018 5:10,82,80,54,216,3,100.0
639,3/15/2018 5:15,80,68,46,194,3,100.0
640,3/15/2018 5:20,92,88,47,227,3,100.0
641,3/15/2018 5:25,115,98,52,265,3,100.0
642,3/15/2018 5:30,125,99,66,290,3,100.0
643,3/15/2018 5:35,135,107,64,306,3,100.0
644,3/15/2018 5:40,133,112,75,320,3,100.0
645,3/15/2018 5:45,142,119,64,325,3,100.0
646,3/15/2018 5:50,162,127,69,358,3,100.0
647,3/15/2018 5:55,145,128,69,342,3,100.0
648,3/15/2018 6:00,162,140,80,382,3,100.0
649,3/15/2018 6:05,161,135,68,364,3,100.0
650,3/15/2018 6:10,147,115,83,345,3,100.0
651,3/15/2018 6:15,157,134,92,383,3,100.0
652,3/15/2018 6:20,166,141,96,403,3,100.0
653,3/15/2018 6:25,175,150,93,418,3,100.0
654,3/15/2018 6:30,171,144,89,404,3,100.0
655,3/15/2018 6:35,175,139,91,405,3,100.0
656,3/15/2018 6:40,169,157,110,436,3,100.0
657,3/15/2018 6:45,176,160,110,446,3,100.0
658,3/15/2018 6:50,171,144,106,421,3,100.0
659,3/15/2018 6:55,179,155,122,456,3,100.0
660,3/15/2018 7:00,194,170,124,488,3,100.0
661,3/15/2018 7:05,186,161,125,472,3,100.0
662,3/15/2018 7:10,182,163,126,471,3,100.0
663,3/15/2018 7:15,162,136,127,425,3,100.0
664,3/15/2018 7:20,139,143,117,399,3,100.0
665,3/15/2018 7:25,147,143,122,412,3,100.0
666,3/15/2018 7:30,154,154,135,443,3,100.0
667,3/15/2018 7:35,147,139,138,424,3,100.0
668,3/15/2018 7:40,157,151,132,440,3,100.0
669,3/15/2018 7:45,175,160,144,479,3,100.0
670,3/15/2018 7:50,173,166,132,471,3,100.0
671,3/15/2018 7:55,179,183,143,505,3,100.0
672,3/15/2018 8:00,159,150,139,448,3,100.0
673,3/15/2018 8:05,186,157,136,479,3,100.0
674,3/15/2018 8:10,183,174,133,490,3,100.0
675,3/15/2018 8:15,191,181,148,520,3,100.0
676,3/15/2018 8:20,190,165,132,487,3,100.0
677,3/15/2018 8:25,189,164,144,497,3,100.0
678,3/15/2018 8:30,190,158,146,494,3,100.0
679,3/15/2018 8:35,174,168,125,467,3,100.0
680,3/15/2018 8:40,183,163,128,474,3,100.0
681,3/15/2018 8:45,175,172,138,485,3,100.0
682,3/15/2018 8:50,183,173,130,486,3,100.0
683,3/15/2018 8:55,175,162,134,471,3,100.0
684,3/15/2018 9:00,172,150,130,452,3,100.0
685,3/15/2018 9:05,183,161,120,464,3,100.0
686,3/15/2018 9:10,190,156,123,469,3,100.0
687,3/15/2018 9:15,149,146,114,409,3,100.0
688,3/15/2018 9:20,191,166,104,461,3,100.0
689,3/15/2018 9:25,179,143,108,430,3,100.0
690,3/15/2018 9:30,188,162,127,477,3,100.0
691,3/15/2018 9:35,196,168,120,484,3,100.0
692,3/15/2018 9:40,173,142,112,427,3,100.0
693,3/15/2018 9:45,190,146,122,458,3,100.0
694,3/15/2018 9:50,144,137,86,367,3,100.0
695,3/15/2018 9:55,169,137,116,422,3,100.0
696,3/15/2018 10:00,165,154,107,426,3,100.0
697,3/15/2018 10:05,144,134,98,376,3,100.0
698,3/15/2018 10:10,170,135,103,408,3,100.0
699,3/15/2018 10:15,165,149,98,412,3,100.0
700,3/15/2018 10:20,175,158,100,433,3,100.0
701,3/15/2018 10:25,189,156,117,462,3,100.0
702,3/15/2018 10:30,177,155,108,440,3,100.0
703,3/15/2018 10:35,167,140,98,405,3,100.0
704,3/15/2018 10:40,169,162,113,444,3,100.0
705,3/15/2018 10:45,157,147,111,415,3,100.0
706,3/15/2018 10:50,181,143,116,440,3,100.0
707,3/15/2018 10:55,177,154,108,439,3,100.0
708,3/15/2018 11:00,182,147,102,431,3,100.0
709,3/15/2018 11:05,162,148,115,425,3,100.0
710,3/15/2018 11:10,189,153,114,456,3,100.0
711,3/15/2018 11:15,157,146,106,409,3,100.0
712,3/15/2018 11:20,157,154,99,410,3,100.0
713,3/15/2018 11:25,185,159,121,465,3,100.0
714,3/15/2018 11:30,164,154,111,429,3,100.0
715,3/15/2018 11:35,178,150,114,442,3,100.0
716,3/15/2018 11:40,177,149,124,450,3,100.0
717,3/15/2018 11:45,186,161,120,467,3,100.0
718,3/15/2018 11:50,179,161,123,463,3,100.0
719,3/15/2018 11:55,178,141,114,433,3,100.0
720,3/15/2018 12:00,182,167,137,486,3,100.0
721,3/15/2018 12:05,159,154,110,423,3,100.0
722,3/15/2018 12:10,170,154,113,437,3,100.0
723,3/15/2018 12:15,177,160,119,456,3,100.0
724,3/15/2018 12:20,170,149,119,438,3,100.0
725,3/15/2018 12:25,187,150,113,450,3,100.0
726,3/15/2018 12:30,184,147,117,448,3,100.0
727,3/15/2018 12:35,174,153,111,438,3,100.0
728,3/15/2018 12:40,157,148,99,404,3,100.0
729,3/15/2018 12:45,176,156,131,463,3,100.0
730,3/15/2018 12:50,201,160,130,491,3,100.0
731,3/15/2018 12:55,184,169,133,486,3,100.0
732,3/15/2018 13:00,187,160,124,471,3,100.0
733,3/15/2018 13:05,170,146,110,426,3,100.0
734,3/15/2018 13:10,173,131,119,423,3,100.0
735,3/15/2018 13:15,175,181,122,478,3,100.0
736,3/15/2018 13:20,128,133,95,356,3,100.0
737,3/15/2018 13:25,193,167,139,499,3,100.0
738,3/15/2018 13:30,179,172,123,474,3,100.0
739,3/15/2018 13:35,186,168,143,497,3,100.0
740,3/15/2018 13:40,180,171,132,483,3,100.0
741,3/15/2018 13:45,174,155,140,469,3,100.0
742,3/15/2018 13:50,183,182,150,515,3,100.0
743,3/15/2018 13:55,185,168,130,483,3,100.0
744,3/15/2018 14:00,173,164,126,463,3,100.0
745,3/15/2018 14:05,174,170,133,477,3,100.0
746,3/15/2018 14:10,174,173,130,477,3,100.0
747,3/15/2018 14:15,153,154,135,442,3,100.0
748,3/15/2018 14:20,155,152,142,449,3,100.0
749,3/15/2018 14:25,159,148,135,442,3,100.0
750,3/15/2018 14:30,163,148,139,450,3,100.0
751,3/15/2018 14:35,154,148,129,431,3,100.0
752,3/15/2018 14:40,150,143,128,421,3,100.0
753,3/15/2018 14:45,163,150,131,444,3,100.0
754,3/15/2018 14:50,173,152,146,471,3,100.0
755,3/15/2018 14:55,166,150,140,456,3,100.0
756,3/15/2018 15:00,157,154,141,452,3,100.0
757,3/15/2018 15:05,152,154,132,438,3,100.0
758,3/15/2018 15:10,170,153,149,472,3,100.0
759,3/15/2018 15:15,171,161,151,483,3,100.0
760,3/15/2018 15:20,161,152,138,451,3,100.0
761,3/15/2018 15:25,174,165,144,483,3,100.0
762,3/15/2018 15:30,162,144,133,439,3,100.0
763,3/15/2018 15:35,158,159,143,460,3,100.0
764,3/15/2018 15:40,155,146,133,434,3,100.0
765,3/15/2018 15:45,140,133,136,409,3,100.0
766,3/15/2018 15:50,120,124,116,360,3,100.0
767,3/15/2018 15:55,158,140,137,435,3,100.0
768,3/15/2018 16:00,146,129,127,402,3,100.0
769,3/15/2018 16:05,129,129,128,386,3,100.0
770,3/15/2018 16:10,122,116,109,347,3,100.0
771,3/15/2018 16:15,129,140,132,401,3,100.0
772,3/15/2018 16:20,133,129,126,388,3,100.0
773,3/15/2018 16:25,128,141,124,393,3,100.0
774,3/15/2018 16:30,111,111,121,343,3,100.0
775,3/15/2018 16:35,143,145,127,415,3,100.0
776,3/15/2018 16:40,161,146,145,452,3,100.0
777,3/15/2018 16:45,134,124,131,389,3,100.0
778,3/15/2018 16:50,147,148,139,434,3,100.0
779,3/15/2018 16:55,154,150,136,440,3,100.0
780,3/15/2018 17:00,154,147,151,452,3,100.0
781,3/15/2018 17:05,133,136,127,396,3,100.0
782,3/15/2018 17:10,135,124,118,377,3,100.0
783,3/15/2018 17:15,139,133,137,409,3,100.0
784,3/15/2018 17:20,144,138,146,428,3,100.0
785,3/15/2018 17:25,145,145,143,433,3,100.0
786,3/15/2018 17:30,153,145,145,443,3,100.0
787,3/15/2018 17:35,160,142,142,444,3,100.0
788,3/15/2018 17:40,138,136,150,424,3,100.0
789,3/15/2018 17:45,154,143,132,429,3,100.0
790,3/15/2018 17:50,150,143,134,427,3,100.0
791,3/15/2018 17:55,140,138,117,395,3,100.0
792,3/15/2018 18:00,146,157,138,441,3,100.0
793,3/15/2018 18:05,153,152,137,442,3,100.0
794,3/15/2018 18:10,153,152,143,448,3,100.0
795,3/15/2018 18:15,155,158,149,462,3,100.0
796,3/15/2018 18:20,156,160,144,460,3,100.0
797,3/15/2018 18:25,147,144,134,425,3,100.0
798,3/15/2018 18:30,147,148,137,432,3,100.0
799,3/15/2018 18:35,162,159,145,466,3,100.0
800,3/15/2018 18:40,159,146,144,449,3,100.0
801,3/15/2018 18:45,152,151,139,442,3,100.0
802,3/15/2018 18:50,157,160,158,475,3,100.0
803,3/15/2018 18:55,163,167,144,474,3,100.0
804,3/15/2018 19:00,164,162,140,466,3,100.0
805,3/15/2018 19:05,171,160,147,478,3,100.0
806,3/15/2018 19:10,167,174,139,480,3,100.0
807,3/15/2018 19:15,158,151,135,444,3,100.0
808,3/15/2018 19:20,159,159,144,462,3,100.0
809,3/15/2018 19:25,167,161,135,463,3,100.0
810,3/15/2018 19:30,146,155,130,431,3,100.0
811,3/15/2018 19:35,166,159,129,454,3,100.0
812,3/15/2018 19:40,147,160,132,439,3,100.0
813,3/15/2018 19:45,153,146,139,438,3,100.0
814,3/15/2018 19:50,161,149,124,434,3,100.0
815,3/15/2018 19:55,147,128,105,380,3,100.0
816,3/15/2018 20:00,163,148,124,435,3,100.0
817,3/15/2018 20:05,164,148,123,435,3,100.0
818,3/15/2018 20:10,159,150,111,420,3,100.0
819,3/15/2018 20:15,155,151,112,418,3,100.0
820,3/15/2018 20:20,146,159,133,438,3,100.0
821,3/15/2018 20:25,170,150,135,455,3,100.0
822,3/15/2018 20:30,149,154,122,425,3,100.0
823,3/15/2018 20:35,167,138,121,426,3,100.0
824,3/15/2018 20:40,163,162,116,441,3,100.0
825,3/15/2018 20:45,149,144,120,413,3,100.0
826,3/15/2018 20:50,151,135,108,394,3,100.0
827,3/15/2018 20:55,142,123,108,373,3,100.0
828,3/15/2018 21:00,140,130,92,362,3,100.0
829,3/15/2018 21:05,150,129,91,370,3,100.0
830,3/15/2018 21:10,156,133,102,391,3,100.0
831,3/15/2018 21:15,129,118,93,340,3,100.0
832,3/15/2018 21:20,144,143,106,393,3,100.0
833,3/15/2018 21:25,152,127,106,385,3,100.0
834,3/15/2018 21:30,147,108,107,362,3,100.0
835,3/15/2018 21:35,155,131,103,389,3,100.0
836,3/15/2018 21:40,128,108,91,327,3,100.0
837,3/15/2018 21:45,111,107,73,291,3,100.0
838,3/15/2018 21:50,125,107,91,323,3,100.0
839,3/15/2018 21:55,100,104,61,265,3,100.0
840,3/15/2018 22:00,110,114,83,307,3,100.0
841,3/15/2018 22:05,112,108,72,292,3,100.0
842,3/15/2018 22:10,109,104,68,281,3,100.0
843,3/15/2018 22:15,121,99,81,301,3,100.0
844,3/15/2018 22:20,91,108,71,270,3,100.0
845,3/15/2018 22:25,87,91,69,247,3,100.0
846,3/15/2018 22:30,125,97,79,301,3,100.0
847,3/15/2018 22:35,117,109,74,300,3,100.0
848,3/15/2018 22:40,105,85,68,258,3,100.0
849,3/15/2018 22:45,113,116,67,296,3,100.0
850,3/15/2018 22:50,91,88,67,246,3,100.0
851,3/15/2018 22:55,83,81,59,223,3,100.0
852,3/15/2018 23:00,82,77,50,209,3,100.0
853,3/15/2018 23:05,78,69,47,194,3,100.0
854,3/15/2018 23:10,74,83,49,206,3,100.0
855,3/15/2018 23:15,80,78,54,212,3,100.0
856,3/15/2018 23:20,78,81,48,207,3,100.0
857,3/15/2018 23:25,76,73,56,205,3,100.0
858,3/15/2018 23:30,74,79,57,210,3,100.0
859,3/15/2018 23:35,81,74,44,199,3,100.0
860,3/15/2018 23:40,60,71,47,178,3,100.0
861,3/15/2018 23:45,62,75,40,177,3,100.0
862,3/15/2018 23:50,43,50,35,128,3,100.0
863,3/15/2018 23:55,64,56,40,160,3,100.0
864,3/16/2018 0:00,50,62,34,146,3,100.0
865,3/16/2018 0:05,54,54,38,146,3,100.0
866,3/16/2018 0:10,48,70,45,163,3,100.0
867,3/16/2018 0:15,47,42,42,131,3,100.0
868,3/16/2018 0:20,50,47,28,125,3,100.0
869,3/16/2018 0:25,39,41,29,109,3,100.0
870,3/16/2018 0:30,42,46,34,122,3,100.0
871,3/16/2018 0:35,46,57,36,139,3,100.0
872,3/16/2018 0:40,37,51,33,121,3,100.0
873,3/16/2018 0:45,42,46,32,120,3,100.0
874,3/16/2018 0:50,38,41,35,114,3,100.0
875,3/16/2018 0:55,33,45,26,104,3,100.0
876,3/16/2018 1:00,26,26,29,81,3,100.0
877,3/16/2018 1:05,31,33,36,100,3,100.0
878,3/16/2018 1:10,27,36,21,84,3,100.0
879,3/16/2018 1:15,17,30,22,69,3,100.0
880,3/16/2018 1:20,30,28,26,84,3,100.0
881,3/16/2018 1:25,20,29,16,65,3,100.0
882,3/16/2018 1:30,27,38,16,81,3,100.0
883,3/16/2018 1:35,29,31,24,84,3,100.0
884,3/16/2018 1:40,18,28,18,64,3,100.0
885,3/16/2018 1:45,29,30,16,75,3,100.0
886,3/16/2018 1:50,19,23,21,63,3,100.0
887,3/16/2018 1:55,16,24,19,59,3,100.0
888,3/16/2018 2:00,23,25,24,72,3,100.0
889,3/16/2018 2:05,20,30,18,68,3,100.0
890,3/16/2018 2:10,22,25,22,69,3,100.0
891,3/16/2018 2:15,15,26,18,59,3,100.0
892,3/16/2018 2:20,17,27,17,61,3,100.0
893,3/16/2018 2:25,23,28,23,74,3,100.0
894,3/16/2018 2:30,20,28,15,63,3,100.0
895,3/16/2018 2:35,20,25,19,64,3,100.0
896,3/16/2018 2:40,16,25,13,54,3,100.0
897,3/16/2018 2:45,18,21,21,60,3,100.0
898,3/16/2018 2:50,12,24,17,53,3,100.0
899,3/16/2018 2:55,9,21,13,43,3,100.0
900,3/16/2018 3:00,10,20,19,49,3,100.0
901,3/16/2018 3:05,8,18,16,42,3,100.0
902,3/16/2018 3:10,11,21,13,45,3,100.0
903,3/16/2018 3:15,14,25,20,59,3,100.0
904,3/16/2018 3:20,14,24,16,54,3,100.0
905,3/16/2018 3:25,12,23,17,52,3,100.0
906,3/16/2018 3:30,16,25,19,60,3,100.0
907,3/16/2018 3:35,22,21,11,54,3,100.0
908,3/16/2018 3:40,15,25,15,55,3,100.0
909,3/16/2018 3:45,14,30,17,61,3,100.0
910,3/16/2018 3:50,20,33,19,72,3,100.0
911,3/16/2018 3:55,16,30,18,64,3,100.0
912,3/16/2018 4:00,10,28,13,51,3,100.0
913,3/16/2018 4:05,15,21,15,51,3,100.0
914,3/16/2018 4:10,23,32,22,77,3,100.0
915,3/16/2018 4:15,23,35,28,86,3,100.0
916,3/16/2018 4:20,21,30,24,75,3,100.0
917,3/16/2018 4:25,41,39,22,102,3,100.0
918,3/16/2018 4:30,37,45,37,119,3,100.0
919,3/16/2018 4:35,39,36,30,105,3,100.0
920,3/16/2018 4:40,45,41,31,117,3,100.0
921,3/16/2018 4:45,38,46,30,114,3,100.0
922,3/16/2018 4:50,48,54,37,139,3,100.0
923,3/16/2018 4:55,44,51,28,123,3,100.0
924,3/16/2018 5:00,36,46,38,120,3,100.0
925,3/16/2018 5:05,56,57,45,158,3,100.0
926,3/16/2018 5:10,72,65,42,179,3,100.0
927,3/16/2018 5:15,77,80,46,203,3,100.0
928,3/16/2018 5:20,93,84,60,237,3,100.0
929,3/16/2018 5:25,95,87,56,238,3,100.0
930,3/16/2018 5:30,115,107,48,270,3,100.0
931,3/16/2018 5:35,112,98,69,279,3,100.0
932,3/16/2018 5:40,101,105,55,261,3,100.0
933,3/16/2018 5:45,129,101,65,295,3,100.0
934,3/16/2018 5:50,138,121,64,323,3,100.0
935,3/16/2018 5:55,133,113,69,315,3,100.0
936,3/16/2018 6:00,148,128,79,355,3,100.0
937,3/16/2018 6:05,135,111,78,324,3,100.0
938,3/16/2018 6:10,137,126,81,344,3,100.0
939,3/16/2018 6:15,138,126,89,353,3,100.0
940,3/16/2018 6:20,150,142,81,373,3,100.0
941,3/16/2018 6:25,147,108,76,331,3,100.0
942,3/16/2018 6:30,146,126,106,378,3,100.0
943,3/16/2018 6:35,151,124,99,374,3,100.0
944,3/16/2018 6:40,169,150,96,415,3,100.0
945,3/16/2018 6:45,111,110,96,317,3,0.0
946,3/16/2018 6:50,152,129,93,374,3,100.0
947,3/16/2018 6:55,182,162,102,446,3,100.0
948,3/16/2018 7:00,161,142,104,407,3,100.0
949,3/16/2018 7:05,165,157,103,425,3,100.0
950,3/16/2018 7:10,171,162,101,434,3,100.0
951,3/16/2018 7:15,179,145,113,437,3,100.0
952,3/16/2018 7:20,156,142,103,401,3,100.0
953,3/16/2018 7:25,193,151,126,470,3,100.0
954,3/16/2018 7:30,172,169,110,451,3,100.0
955,3/16/2018 7:35,173,161,123,457,3,100.0
956,3/16/2018 7:40,180,156,113,449,3,100.0
957,3/16/2018 7:45,178,164,130,472,3,100.0
958,3/16/2018 7:50,171,144,114,429,3,100.0
959,3/16/2018 7:55,190,175,116,481,3,100.0
960,3/16/2018 8:00,160,154,118,432,3,100.0
961,3/16/2018 8:05,193,176,126,495,3,100.0
962,3/16/2018 8:10,170,156,103,429,3,100.0
963,3/16/2018 8:15,183,167,114,464,3,100.0
964,3/16/2018 8:20,175,169,125,469,3,100.0
965,3/16/2018 8:25,166,164,134,464,3,100.0
966,3/16/2018 8:30,188,166,118,472,3,100.0
967,3/16/2018 8:35,175,155,107,437,3,100.0
968,3/16/2018 8:40,144,139,100,383,3,100.0
969,3/16/2018 8:45,181,162,112,455,3,100.0
970,3/16/2018 8:50,198,154,135,487,3,100.0
971,3/16/2018 8:55,185,160,115,460,3,100.0
972,3/16/2018 9:00,154,144,97,395,3,100.0
973,3/16/2018 9:05,168,148,106,422,3,100.0
974,3/16/2018 9:10,149,143,96,388,3,100.0
975,3/16/2018 9:15,184,149,92,425,3,100.0
976,3/16/2018 9:20,160,140,100,400,3,100.0
977,3/16/2018 9:25,165,150,96,411,3,100.0
978,3/16/2018 9:30,152,157,103,412,3,100.0
979,3/16/2018 9:35,194,166,130,490,3,100.0
980,3/16/2018 9:40,161,149,96,406,3,100.0
981,3/16/2018 9:45,178,137,108,423,3,100.0
982,3/16/2018 9:50,148,135,96,379,3,100.0
983,3/16/2018 9:55,161,137,89,387,3,100.0
984,3/16/2018 10:00,166,128,93,387,3,100.0
985,3/16/2018 10:05,149,143,87,379,3,100.0
986,3/16/2018 10:10,156,162,107,425,3,100.0
987,3/16/2018 10:15,173,157,98,428,3,100.0
988,3/16/2018 10:20,170,160,119,449,3,100.0
989,3/16/2018 10:25,167,151,89,407,3,100.0
990,3/16/2018 10:30,191,151,122,464,3,100.0
991,3/16/2018 10:35,158,156,94,408,3,100.0
992,3/16/2018 10:40,174,143,96,413,3,100.0
993,3/16/2018 10:45,174,161,107,442,3,100.0
994,3/16/2018 10:50,175,144,112,431,3,100.0
995,3/16/2018 10:55,153,134,111,398,3,100.0
996,3/16/2018 11:00,188,165,118,471,3,100.0
997,3/16/2018 11:05,190,160,118,468,3,100.0
998,3/16/2018 11:10,194,163,116,473,3,100.0
999,3/16/2018 11:15,178,154,126,458,3,100.0
1000,3/16/2018 11:20,204,164,132,500,3,100.0
1001,3/16/2018 11:25,190,158,104,452,3,100.0
1002,3/16/2018 11:30,199,177,112,488,3,100.0
1003,3/16/2018 11:35,184,159,110,453,3,100.0
1004,3/16/2018 11:40,196,175,117,488,3,100.0
1005,3/16/2018 11:45,190,168,108,466,3,100.0
1006,3/16/2018 11:50,192,155,123,470,3,100.0
1007,3/16/2018 11:55,173,160,111,444,3,100.0
1008,3/16/2018 12:00,180,161,139,480,3,100.0
1009,3/16/2018 12:05,189,172,109,470,3,100.0
1010,3/16/2018 12:10,156,151,104,411,3,100.0
1011,3/16/2018 12:15,108,116,104,328,3,100.0
1012,3/16/2018 12:20,121,128,110,359,3,100.0
1013,3/16/2018 12:25,162,151,142,455,3,100.0
1014,3/16/2018 12:30,176,159,144,479,3,100.0
1015,3/16/2018 12:35,162,152,127,441,3,100.0
1016,3/16/2018 12:40,177,152,116,445,3,100.0
1017,3/16/2018 12:45,164,160,138,462,3,100.0
1018,3/16/2018 12:50,168,181,112,461,3,100.0
1019,3/16/2018 12:55,186,148,125,459,3,100.0
1020,3/16/2018 13:00,183,162,132,477,3,100.0
1021,3/16/2018 13:05,182,172,142,496,3,100.0
1022,3/16/2018 13:10,181,159,126,466,3,100.0
1023,3/16/2018 13:15,119,116,114,349,3,100.0
1024,3/16/2018 13:20,136,116,99,351,3,100.0
1025,3/16/2018 13:25,142,148,132,422,3,100.0
1026,3/16/2018 13:30,114,120,110,344,3,100.0
1027,3/16/2018 13:35,112,111,100,323,3,100.0
1028,3/16/2018 13:40,158,151,128,437,3,100.0
1029,3/16/2018 13:45,163,158,134,455,3,100.0
1030,3/16/2018 13:50,164,158,145,467,3,100.0
1031,3/16/2018 13:55,171,165,139,475,3,100.0
1032,3/16/2018 14:00,164,146,141,451,3,100.0
1033,3/16/2018 14:05,166,175,139,480,3,100.0
1034,3/16/2018 14:10,180,173,136,489,3,100.0
1035,3/16/2018 14:15,162,173,141,476,3,100.0
1036,3/16/2018 14:20,142,141,137,420,3,100.0
1037,3/16/2018 14:25,169,164,153,486,3,100.0
1038,3/16/2018 14:30,144,143,124,411,3,100.0
1039,3/16/2018 14:35,161,153,144,458,3,100.0
1040,3/16/2018 14:40,161,172,141,474,3,100.0
1041,3/16/2018 14:45,170,160,154,484,3,100.0
1042,3/16/2018 14:50,139,145,123,407,3,100.0
1043,3/16/2018 14:55,177,171,161,509,3,100.0
1044,3/16/2018 15:00,121,130,106,357,3,100.0
1045,3/16/2018 15:05,162,162,149,473,3,100.0
1046,3/16/2018 15:10,173,159,137,469,3,100.0
1047,3/16/2018 15:15,167,163,150,480,3,100.0
1048,3/16/2018 15:20,142,147,133,422,3,100.0
1049,3/16/2018 15:25,163,148,130,441,3,100.0
1050,3/16/2018 15:30,157,148,127,432,3,100.0
1051,3/16/2018 15:35,146,152,128,426,3,100.0
1052,3/16/2018 15:40,142,131,131,404,3,100.0
1053,3/16/2018 15:45,134,138,125,397,3,100.0
1054,3/16/2018 15:50,133,137,131,401,3,100.0
1055,3/16/2018 15:55,154,139,136,429,3,100.0
1056,3/16/2018 16:00,137,135,136,408,3,100.0
1057,3/16/2018 16:05,135,128,129,392,3,100.0
1058,3/16/2018 16:10,145,151,139,435,3,100.0
1059,3/16/2018 16:15,164,152,134,450,3,100.0
1060,3/16/2018 16:20,131,137,134,402,3,100.0
1061,3/16/2018 16:25,154,169,144,467,3,100.0
1062,3/16/2018 16:30,137,137,140,414,3,100.0
1063,3/16/2018 16:35,132,128,135,395,3,100.0
1064,3/16/2018 16:40,163,154,148,465,3,100.0
1065,3/16/2018 16:45,151,132,112,395,3,100.0
1066,3/16/2018 16:50,143,132,122,397,3,100.0
1067,3/16/2018 16:55,127,137,116,380,3,100.0
1068,3/16/2018 17:00,153,160,148,461,3,100.0
1069,3/16/2018 17:05,130,130,111,371,3,100.0
1070,3/16/2018 17:10,145,145,124,414,3,100.0
1071,3/16/2018 17:15,157,146,130,433,3,100.0
1072,3/16/2018 17:20,130,132,141,403,3,100.0
1073,3/16/2018 17:25,147,145,139,431,3,100.0
1074,3/16/2018 17:30,133,132,120,385,3,100.0
1075,3/16/2018 17:35,151,150,128,429,3,100.0
1076,3/16/2018 17:40,135,131,131,397,3,100.0
1077,3/16/2018 17:45,172,152,147,471,3,100.0
1078,3/16/2018 17:50,173,151,147,471,3,100.0
1079,3/16/2018 17:55,161,151,143,455,3,100.0
1080,3/16/2018 18:00,158,173,144,475,3,100.0
1081,3/16/2018 18:05,163,158,150,471,3,100.0
1082,3/16/2018 18:10,176,168,151,495,3,100.0
1083,3/16/2018 18:15,169,152,138,459,3,100.0
1084,3/16/2018 18:20,169,165,146,480,3,100.0
1085,3/16/2018 18:25,158,148,135,441,3,100.0
1086,3/16/2018 18:30,145,141,137,423,3,100.0
1087,3/16/2018 18:35,157,149,152,458,3,100.0
1088,3/16/2018 18:40,166,162,151,479,3,100.0
1089,3/16/2018 18:45,160,152,136,448,3,100.0
1090,3/16/2018 18:50,169,163,150,482,3,100.0
1091,3/16/2018 18:55,166,170,146,482,3,100.0
1092,3/16/2018 19:00,169,157,138,464,3,100.0
1093,3/16/2018 19:05,168,143,126,437,3,100.0
1094,3/16/2018 19:10,162,153,144,459,3,100.0
1095,3/16/2018 19:15,162,153,135,450,3,100.0
1096,3/16/2018 19:20,178,148,134,460,3,100.0
1097,3/16/2018 19:25,151,138,104,393,3,100.0
1098,3/16/2018 19:30,150,148,105,403,3,100.0
1099,3/16/2018 19:35,155,150,125,430,3,100.0
1100,3/16/2018 19:40,164,133,116,413,3,100.0
1101,3/16/2018 19:45,154,144,121,419,3,100.0
1102,3/16/2018 19:50,152,132,109,393,3,100.0
1103,3/16/2018 19:55,157,143,102,402,3,100.0
1104,3/16/2018 20:00,126,128,86,340,3,100.0
1105,3/16/2018 20:05,130,132,100,362,3,100.0
1106,3/16/2018 20:10,136,126,107,369,3,100.0
1107,3/16/2018 20:15,140,130,96,366,3,100.0
1108,3/16/2018 20:20,154,132,110,396,3,100.0
1109,3/16/2018 20:25,138,125,99,362,3,100.0
1110,3/16/2018 20:30,155,131,108,394,3,100.0
1111,3/16/2018 20:35,146,119,89,354,3,100.0
1112,3/16/2018 20:40,141,121,103,365,3,100.0
1113,3/16/2018 20:45,166,141,117,424,3,100.0
1114,3/16/2018 20:50,146,133,102,381,3,100.0
1115,3/16/2018 20:55,151,137,99,387,3,100.0
1116,3/16/2018 21:00,146,129,96,371,3,100.0
1117,3/16/2018 21:05,135,123,92,350,3,100.0
1118,3/16/2018 21:10,127,124,84,335,3,100.0
1119,3/16/2018 21:15,132,136,105,373,3,100.0
1120,3/16/2018 21:20,135,115,90,340,3,100.0
1121,3/16/2018 21:25,139,129,96,364,3,100.0
1122,3/16/2018 21:30,124,122,89,335,3,100.0
1123,3/16/2018 21:35,105,92,89,286,3,100.0
1124,3/16/2018 21:40,112,110,74,296,3,100.0
1125,3/16/2018 21:45,109,105,78,292,3,100.0
1126,3/16/2018 21:50,124,110,88,322,3,100.0
1127,3/16/2018 21:55,142,114,84,340,3,100.0
1128,3/16/2018 22:00,111,108,69,288,3,100.0
1129,3/16/2018 22:05,129,112,99,340,3,100.0
1130,3/16/2018 22:10,132,128,88,348,3,100.0
1131,3/16/2018 22:15,118,104,81,303,3,100.0
1132,3/16/2018 22:20,116,107,76,299,3,100.0
1133,3/16/2018 22:25,138,109,95,342,3,100.0
1134,3/16/2018 22:30,133,93,82,308,3,100.0
1135,3/16/2018 22:35,130,120,75,325,3,100.0
1136,3/16/2018 22:40,125,131,100,356,3,100.0
1137,3/16/2018 22:45,107,135,97,339,3,100.0
1138,3/16/2018 22:50,125,118,81,324,3,100.0
1139,3/16/2018 22:55,107,90,62,259,3,100.0
1140,3/16/2018 23:00,118,107,75,300,3,100.0
1141,3/16/2018 23:05,110,107,59,276,3,100.0
1142,3/16/2018 23:10,98,100,75,273,3,100.0
1143,3/16/2018 23:15,86,78,47,211,3,100.0
1144,3/16/2018 23:20,119,106,67,292,3,100.0
1145,3/16/2018 23:25,96,102,60,258,3,100.0
1146,3/16/2018 23:30,90,86,70,246,3,100.0
1147,3/16/2018 23:35,105,104,59,268,3,100.0
1148,3/16/2018 23:40,58,62,44,164,3,100.0
1149,3/16/2018 23:45,73,73,48,194,3,100.0
1150,3/16/2018 23:50,68,74,45,187,3,100.0
1151,3/16/2018 23:55,69,77,42,188,3,100.0
1152,3/17/2018 0:00,54,71,43,168,3,100.0
1153,3/17/2018 0:05,56,57,37,150,3,100.0
1154,3/17/2018 0:10,54,78,49,181,3,100.0
1155,3/17/2018 0:15,59,71,46,176,3,100.0
1156,3/17/2018 0:20,47,50,37,134,3,100.0
1157,3/17/2018 0:25,52,60,39,151,3,100.0
1158,3/17/2018 0:30,57,49,37,143,3,100.0
1159,3/17/2018 0:35,54,61,29,144,3,100.0
1160,3/17/2018 0:40,45,58,33,136,3,100.0
1161,3/17/2018 0:45,48,49,40,137,3,100.0
1162,3/17/2018 0:50,31,35,30,96,3,100.0
1163,3/17/2018 0:55,35,47,23,105,3,100.0
1164,3/17/2018 1:00,33,51,36,120,3,100.0
1165,3/17/2018 1:05,39,50,31,120,3,100.0
1166,3/17/2018 1:10,45,52,34,131,3,100.0
1167,3/17/2018 1:15,30,44,18,92,3,100.0
1168,3/17/2018 1:20,30,50,27,107,3,100.0
1169,3/17/2018 1:25,25,36,25,86,3,100.0
1170,3/17/2018 1:30,39,47,35,121,3,100.0
1171,3/17/2018 1:35,26,34,32,92,3,100.0
1172,3/17/2018 1:40,32,34,21,87,3,100.0
1173,3/17/2018 1:45,31,33,23,87,3,100.0
1174,3/17/2018 1:50,26,27,24,77,3,100.0
1175,3/17/2018 1:55,26,30,23,79,3,100.0
1176,3/17/2018 2:00,28,38,26,92,3,100.0
1177,3/17/2018 2:05,21,24,21,66,3,100.0
1178,3/17/2018 2:10,20,28,26,74,3,100.0
1179,3/17/2018 2:15,19,32,16,67,3,100.0
1180,3/17/2018 2:20,26,26,20,72,3,100.0
1181,3/17/2018 2:25,19,32,21,72,3,100.0
1182,3/17/2018 2:30,20,24,13,57,3,100.0
1183,3/17/2018 2:35,19,30,15,64,3,100.0
1184,3/17/2018 2:40,21,26,31,78,3,100.0
1185,3/17/2018 2:45,16,28,16,60,3,100.0
1186,3/17/2018 2:50,23,20,18,61,3,100.0
1187,3/17/2018 2:55,15,20,17,52,3,100.0
1188,3/17/2018 3:00,12,23,13,48,3,100.0
1189,3/17/2018 3:05,14,23,13,50,3,100.0
1190,3/17/2018 3:10,17,19,22,58,3,100.0
1191,3/17/2018 3:15,18,24,14,56,3,100.0
1192,3/17/2018 3:20,12,23,16,51,3,100.0
1193,3/17/2018 3:25,18,20,15,53,3,100.0
1194,3/17/2018 3:30,19,22,18,59,3,100.0
1195,3/17/2018 3:35,9,19,18,46,3,100.0
1196,3/17/2018 3:40,10,22,15,47,3,100.0
1197,3/17/2018 3:45,7,21,11,39,3,100.0
1198,3/17/2018 3:50,8,13,16,37,3,100.0
1199,3/17/2018 3:55,10,18,20,48,3,100.0
1200,3/17/2018 4:00,11,20,13,44,3,100.0
1201,3/17/2018 4:05,11,21,14,46,3,100.0
1202,3/17/2018 4:10,20,24,19,63,3,100.0
1203,3/17/2018 4:15,19,23,17,59,3,100.0
1204,3/17/2018 4:20,15,24,16,55,3,100.0
1205,3/17/2018 4:25,17,25,14,56,3,100.0
1206,3/17/2018 4:30,24,26,16,66,3,100.0
1207,3/17/2018 4:35,21,32,24,77,3,100.0
1208,3/17/2018 4:40,14,30,29,73,3,100.0
1209,3/17/2018 4:45,20,30,24,74,3,100.0
1210,3/17/2018 4:50,27,33,23,83,3,100.0
1211,3/17/2018 4:55,20,28,18,66,3,100.0
1212,3/17/2018 5:00,26,35,30,91,3,100.0
1213,3/17/2018 5:05,26,35,30,91,3,100.0
1214,3/17/2018 5:10,28,43,24,95,3,100.0
1215,3/17/2018 5:15,37,51,27,115,3,100.0
1216,3/17/2018 5:20,50,52,33,135,3,100.0
1217,3/17/2018 5:25,41,50,27,118,3,100.0
1218,3/17/2018 5:30,51,54,21,126,3,100.0
1219,3/17/2018 5:35,38,54,43,135,3,100.0
1220,3/17/2018 5:40,54,60,38,152,3,100.0
1221,3/17/2018 5:45,46,57,40,143,3,100.0
1222,3/17/2018 5:50,40,55,38,133,3,100.0
1223,3/17/2018 5:55,51,53,32,136,3,100.0
1224,3/17/2018 6:00,51,61,38,150,3,100.0
1225,3/17/2018 6:05,38,58,37,133,3,100.0
1226,3/17/2018 6:10,67,72,39,178,3,100.0
1227,3/17/2018 6:15,73,74,46,193,3,100.0
1228,3/17/2018 6:20,73,66,56,195,3,100.0
1229,3/17/2018 6:25,74,81,44,199,3,100.0
1230,3/17/2018 6:30,75,73,34,182,3,100.0
1231,3/17/2018 6:35,95,89,52,236,3,100.0
1232,3/17/2018 6:40,91,85,50,226,3,100.0
1233,3/17/2018 6:45,94,79,54,227,3,100.0
1234,3/17/2018 6:50,103,94,68,265,3,100.0
1235,3/17/2018 6:55,91,95,69,255,3,100.0
1236,3/17/2018 7:00,83,87,62,232,3,100.0
1237,3/17/2018 7:05,85,101,69,255,3,100.0
1238,3/17/2018 7:10,89,85,68,242,3,100.0
1239,3/17/2018 7:15,104,114,62,280,3,100.0
1240,3/17/2018 7:20,118,131,73,322,3,100.0
1241,3/17/2018 7:25,112,101,65,278,3,100.0
1242,3/17/2018 7:30,129,105,82,316,3,100.0
1243,3/17/2018 7:35,123,116,77,316,3,100.0
1244,3/17/2018 7:40,114,111,72,297,3,100.0
1245,3/17/2018 7:45,145,129,76,350,3,100.0
1246,3/17/2018 7:50,116,118,84,318,3,100.0
1247,3/17/2018 7:55,143,135,95,373,3,100.0
1248,3/17/2018 8:00,122,127,75,324,3,100.0
1249,3/17/2018 8:05,120,108,83,311,3,100.0
1250,3/17/2018 8:10,140,117,75,332,3,100.0
1251,3/17/2018 8:15,143,118,83,344,3,100.0
1252,3/17/2018 8:20,142,128,89,359,3,100.0
1253,3/17/2018 8:25,136,126,82,344,3,100.0
1254,3/17/2018 8:30,130,119,84,333,3,100.0
1255,3/17/2018 8:35,68,77,65,210,3,100.0
1256,3/17/2018 8:40,160,139,91,390,3,100.0
1257,3/17/2018 8:45,147,128,107,382,3,100.0
1258,3/17/2018 8:50,142,119,92,353,3,100.0
1259,3/17/2018 8:55,129,123,91,343,3,100.0
1260,3/17/2018 9:00,139,131,82,352,3,100.0
1261,3/17/2018 9:05,179,144,102,425,3,100.0
1262,3/17/2018 9:10,140,137,86,363,3,100.0
1263,3/17/2018 9:15,145,142,93,380,3,100.0
1264,3/17/2018 9:20,137,115,88,340,3,100.0
1265,3/17/2018 9:25,177,155,92,424,3,100.0
1266,3/17/2018 9:30,162,142,102,406,3,100.0
1267,3/17/2018 9:35,161,155,96,412,3,100.0
1268,3/17/2018 9:40,151,136,101,388,3,100.0
1269,3/17/2018 9:45,169,160,92,421,3,100.0
1270,3/17/2018 9:50,168,147,98,413,3,100.0
1271,3/17/2018 9:55,153,155,95,403,3,100.0
1272,3/17/2018 10:00,167,143,101,411,3,100.0
1273,3/17/2018 10:05,151,128,110,389,3,100.0
1274,3/17/2018 10:10,161,141,105,407,3,100.0
1275,3/17/2018 10:15,175,148,103,426,3,100.0
1276,3/17/2018 10:20,161,162,114,437,3,100.0
1277,3/17/2018 10:25,172,130,102,404,3,100.0
1278,3/17/2018 10:30,183,158,113,454,3,100.0
1279,3/17/2018 10:35,182,163,103,448,3,100.0
1280,3/17/2018 10:40,167,165,121,453,3,100.0
1281,3/17/2018 10:45,174,141,108,423,3,100.0
1282,3/17/2018 10:50,188,165,120,473,3,100.0
1283,3/17/2018 10:55,173,151,115,439,3,100.0
1284,3/17/2018 11:00,180,161,110,451,3,100.0
1285,3/17/2018 11:05,143,133,93,369,3,100.0
1286,3/17/2018 11:10,181,153,117,451,3,100.0
1287,3/17/2018 11:15,179,161,110,450,3,100.0
1288,3/17/2018 11:20,174,163,118,455,3,100.0
1289,3/17/2018 11:25,166,167,128,461,3,100.0
1290,3/17/2018 11:30,185,161,127,473,3,100.0
1291,3/17/2018 11:35,184,161,117,462,3,100.0
1292,3/17/2018 11:40,167,176,124,467,3,100.0
1293,3/17/2018 11:45,163,157,115,435,3,100.0
1294,3/17/2018 11:50,193,164,129,486,3,100.0
1295,3/17/2018 11:55,175,149,104,428,3,100.0
1296,3/17/2018 12:00,168,157,114,439,3,100.0
1297,3/17/2018 12:05,162,168,138,468,3,100.0
1298,3/17/2018 12:10,164,148,112,424,3,100.0
1299,3/17/2018 12:15,188,164,131,483,3,100.0
1300,3/17/2018 12:20,171,167,122,460,3,100.0
1301,3/17/2018 12:25,172,158,127,457,3,100.0
1302,3/17/2018 12:30,163,151,123,437,3,100.0
1303,3/17/2018 12:35,183,168,120,471,3,100.0
1304,3/17/2018 12:40,146,142,109,397,3,100.0
1305,3/17/2018 12:45,174,171,124,469,3,100.0
1306,3/17/2018 12:50,162,152,132,446,3,100.0
1307,3/17/2018 12:55,178,167,140,485,3,100.0
1308,3/17/2018 13:00,186,164,126,476,3,100.0
1309,3/17/2018 13:05,172,153,117,442,3,100.0
1310,3/17/2018 13:10,182,159,124,465,3,100.0
1311,3/17/2018 13:15,180,158,106,444,3,100.0
1312,3/17/2018 13:20,163,161,120,444,3,100.0
1313,3/17/2018 13:25,165,152,125,442,3,100.0
1314,3/17/2018 13:30,174,150,119,443,3,100.0
1315,3/17/2018 13:35,191,176,150,517,3,100.0
1316,3/17/2018 13:40,162,141,134,437,3,100.0
1317,3/17/2018 13:45,173,166,125,464,3,100.0
1318,3/17/2018 13:50,167,159,123,449,3,100.0
1319,3/17/2018 13:55,158,153,114,425,3,100.0
1320,3/17/2018 14:00,159,156,124,439,3,100.0
1321,3/17/2018 14:05,176,152,118,446,3,100.0
1322,3/17/2018 14:10,150,158,110,418,3,100.0
1323,3/17/2018 14:15,172,160,120,452,3,100.0
1324,3/17/2018 14:20,146,131,129,406,3,100.0
1325,3/17/2018 14:25,144,127,129,400,3,100.0
1326,3/17/2018 14:30,163,166,144,473,3,100.0
1327,3/17/2018 14:35,163,168,138,469,3,100.0
1328,3/17/2018 14:40,169,168,131,468,3,100.0
1329,3/17/2018 14:45,146,145,131,422,3,100.0
1330,3/17/2018 14:50,143,142,126,411,3,100.0
1331,3/17/2018 14:55,133,129,131,393,3,100.0
1332,3/17/2018 15:00,159,153,130,442,3,100.0
1333,3/17/2018 15:05,157,151,134,442,3,100.0
1334,3/17/2018 15:10,154,145,137,436,3,100.0
1335,3/17/2018 15:15,170,155,142,467,3,100.0
1336,3/17/2018 15:20,168,171,144,483,3,100.0
1337,3/17/2018 15:25,166,163,155,484,3,100.0
1338,3/17/2018 15:30,165,158,133,456,3,100.0
1339,3/17/2018 15:35,186,160,152,498,3,100.0
1340,3/17/2018 15:40,147,172,134,453,3,100.0
1341,3/17/2018 15:45,159,157,129,445,3,100.0
1342,3/17/2018 15:50,168,164,139,471,3,100.0
1343,3/17/2018 15:55,162,178,138,478,3,100.0
1344,3/17/2018 16:00,159,149,123,431,3,100.0
1345,3/17/2018 16:05,177,160,120,457,3,100.0
1346,3/17/2018 16:10,158,163,139,460,3,100.0
1347,3/17/2018 16:15,166,155,131,452,3,100.0
1348,3/17/2018 16:20,165,154,121,440,3,100.0
1349,3/17/2018 16:25,162,163,113,438,3,100.0
1350,3/17/2018 16:30,164,169,114,447,3,100.0
1351,3/17/2018 16:35,164,142,131,437,3,100.0
1352,3/17/2018 16:40,159,154,110,423,3,100.0
1353,3/17/2018 16:45,155,154,126,435,3,100.0
1354,3/17/2018 16:50,151,155,122,428,3,100.0
1355,3/17/2018 16:55,155,148,131,434,3,100.0
1356,3/17/2018 17:00,150,138,132,420,3,100.0
1357,3/17/2018 17:05,132,124,114,370,3,100.0
1358,3/17/2018 17:10,149,144,144,437,3,100.0
1359,3/17/2018 17:15,182,159,139,480,3,100.0
1360,3/17/2018 17:20,157,158,128,443,3,100.0
1361,3/17/2018 17:25,157,163,121,441,3,100.0
1362,3/17/2018 17:30,159,155,116,430,3,100.0
1363,3/17/2018 17:35,162,152,128,442,3,100.0
1364,3/17/2018 17:40,172,146,128,446,3,100.0
1365,3/17/2018 17:45,166,164,133,463,3,100.0
1366,3/17/2018 17:50,162,137,117,416,3,100.0
1367,3/17/2018 17:55,157,160,122,439,3,100.0
1368,3/17/2018 18:00,160,155,121,436,3,100.0
1369,3/17/2018 18:05,159,153,121,433,3,100.0
1370,3/17/2018 18:10,162,150,133,445,3,100.0
1371,3/17/2018 18:15,173,164,130,467,3,100.0
1372,3/17/2018 18:20,163,158,127,448,3,100.0
1373,3/17/2018 18:25,160,159,119,438,3,100.0
1374,3/17/2018 18:30,163,154,113,430,3,100.0
1375,3/17/2018 18:35,185,155,113,453,3,100.0
1376,3/17/2018 18:40,147,149,110,406,3,100.0
1377,3/17/2018 18:45,146,142,112,400,3,100.0
1378,3/17/2018 18:50,136,131,111,378,3,100.0
1379,3/17/2018 18:55,155,152,107,414,3,100.0
1380,3/17/2018 19:00,136,139,112,387,3,100.0
1381,3/17/2018 19:05,173,160,116,449,3,100.0
1382,3/17/2018 19:10,153,139,114,406,3,100.0
1383,3/17/2018 19:15,159,145,102,406,3,100.0
1384,3/17/2018 19:20,136,128,90,354,3,100.0
1385,3/17/2018 19:25,142,125,106,373,3,100.0
1386,3/17/2018 19:30,140,138,102,380,3,100.0
1387,3/17/2018 19:35,134,108,97,339,3,100.0
1388,3/17/2018 19:40,129,130,91,350,3,100.0
1389,3/17/2018 19:45,137,109,96,342,3,100.0
1390,3/17/2018 19:50,124,140,93,357,3,100.0
1391,3/17/2018 19:55,135,119,85,339,3,100.0
1392,3/17/2018 20:00,125,123,91,339,3,100.0
1393,3/17/2018 20:05,131,122,94,347,3,100.0
1394,3/17/2018 20:10,122,125,95,342,3,100.0
1395,3/17/2018 20:15,98,101,77,276,3,100.0
1396,3/17/2018 20:20,106,108,97,311,3,100.0
1397,3/17/2018 20:25,124,106,109,339,3,100.0
1398,3/17/2018 20:30,117,119,110,346,3,100.0
1399,3/17/2018 20:35,137,116,97,350,3,100.0
1400,3/17/2018 20:40,108,102,87,297,3,100.0
1401,3/17/2018 20:45,104,119,78,301,3,100.0
1402,3/17/2018 20:50,127,118,78,323,3,100.0
1403,3/17/2018 20:55,103,98,81,282,3,100.0
1404,3/17/2018 21:00,118,113,91,322,3,100.0
1405,3/17/2018 21:05,111,99,79,289,3,100.0
1406,3/17/2018 21:10,114,105,74,293,3,100.0
1407,3/17/2018 21:15,104,111,85,300,3,100.0
1408,3/17/2018 21:20,109,103,82,294,3,100.0
1409,3/17/2018 21:25,96,87,63,246,3,100.0
1410,3/17/2018 21:30,97,113,84,294,3,100.0
1411,3/17/2018 21:35,119,105,87,311,3,100.0
1412,3/17/2018 21:40,104,108,75,287,3,100.0
1413,3/17/2018 21:45,108,95,67,270,3,100.0
1414,3/17/2018 21:50,116,96,80,292,3,100.0
1415,3/17/2018 21:55,109,108,83,300,3,100.0
1416,3/17/2018 22:00,106,102,78,286,3,100.0
1417,3/17/2018 22:05,90,91,64,245,3,100.0
1418,3/17/2018 22:10,100,104,61,265,3,100.0
1419,3/17/2018 22:15,109,117,79,305,3,100.0
1420,3/17/2018 22:20,102,108,68,278,3,100.0
1421,3/17/2018 22:25,108,96,72,276,3,100.0
1422,3/17/2018 22:30,114,98,59,271,3,100.0
1423,3/17/2018 22:35,110,109,68,287,3,100.0
1424,3/17/2018 22:40,109,91,70,270,3,100.0
1425,3/17/2018 22:45,94,92,66,252,3,100.0
1426,3/17/2018 22:50,86,90,73,249,3,100.0
1427,3/17/2018 22:55,103,98,56,257,3,100.0
1428,3/17/2018 23:00,87,93,59,239,3,100.0
1429,3/17/2018 23:05,80,84,55,219,3,100.0
1430,3/17/2018 23:10,75,89,68,232,3,100.0
1431,3/17/2018 23:15,83,74,52,209,3,100.0
1432,3/17/2018 23:20,70,77,55,202,3,100.0
1433,3/17/2018 23:25,83,84,56,223,3,100.0
1434,3/17/2018 23:30,74,77,55,206,3,100.0
1435,3/17/2018 23:35,80,71,53,204,3,100.0
1436,3/17/2018 23:40,60,75,50,185,3,100.0
1437,3/17/2018 23:45,52,61,52,165,3,100.0
1438,3/17/2018 23:50,62,58,48,168,3,100.0
1439,3/17/2018 23:55,50,63,51,164,3,100.0
1440,3/18/2018 0:00,58,64,61,183,3,100.0
1441,3/18/2018 0:05,60,55,41,156,3,100.0
1442,3/18/2018 0:10,45,43,38,126,3,100.0
1443,3/18/2018 0:15,47,48,43,138,3,100.0
1444,3/18/2018 0:20,52,64,48,164,3,100.0
1445,3/18/2018 0:25,49,56,38,143,3,100.0
1446,3/18/2018 0:30,49,57,42,148,3,100.0
1447,3/18/2018 0:35,46,52,33,131,3,100.0
1448,3/18/2018 0:40,45,52,34,131,3,100.0
1449,3/18/2018 0:45,48,54,34,136,3,100.0
1450,3/18/2018 0:50,44,43,36,123,3,100.0
1451,3/18/2018 0:55,35,43,26,104,3,100.0
1452,3/18/2018 1:00,32,50,42,124,3,100.0
1453,3/18/2018 1:05,34,46,34,114,3,100.0
1454,3/18/2018 1:10,27,40,29,96,3,100.0
1455,3/18/2018 1:15,34,43,32,109,3,100.0
1456,3/18/2018 1:20,25,36,32,93,3,100.0
1457,3/18/2018 1:25,31,35,16,82,3,100.0
1458,3/18/2018 1:30,31,36,30,97,3,100.0
1459,3/18/2018 1:35,29,44,24,97,3,100.0
1460,3/18/2018 1:40,26,43,31,100,3,100.0
1461,3/18/2018 1:45,28,36,18,82,3,100.0
1462,3/18/2018 1:50,30,36,30,96,3,100.0
1463,3/18/2018 1:55,23,35,19,77,3,100.0
1464,3/18/2018 2:00,20,28,21,69,3,100.0
1465,3/18/2018 2:05,17,24,20,61,3,100.0
1466,3/18/2018 2:10,17,24,18,59,3,100.0
1467,3/18/2018 2:15,29,26,26,81,3,100.0
1468,3/18/2018 2:20,24,24,19,67,3,100.0
1469,3/18/2018 2:25,16,33,29,78,3,100.0
1470,3/18/2018 2:30,13,22,18,53,3,100.0
1471,3/18/2018 2:35,20,28,21,69,3,100.0
1472,3/18/2018 2:40,12,26,16,54,3,100.0
1473,3/18/2018 2:45,14,29,16,59,3,100.0
1474,3/18/2018 2:50,14,25,25,64,3,100.0
1475,3/18/2018 2:55,15,28,19,62,3,100.0
1476,3/18/2018 3:00,9,27,17,53,3,100.0
1477,3/18/2018 3:05,13,17,16,46,3,100.0
1478,3/18/2018 3:10,12,23,13,48,3,100.0
1479,3/18/2018 3:15,8,22,5,35,3,100.0
1480,3/18/2018 3:20,10,20,18,48,3,100.0
1481,3/18/2018 3:25,6,19,14,39,3,100.0
1482,3/18/2018 3:30,19,22,18,59,3,100.0
1483,3/18/2018 3:35,12,17,16,45,3,100.0
1484,3/18/2018 3:40,9,17,14,40,3,100.0
1485,3/18/2018 3:45,13,23,15,51,3,100.0
1486,3/18/2018 3:50,8,23,14,45,3,100.0
1487,3/18/2018 3:55,7,15,16,38,3,100.0
1488,3/18/2018 4:00,9,15,17,41,3,100.0
1489,3/18/2018 4:05,9,18,16,43,3,100.0
1490,3/18/2018 4:10,13,23,14,50,3,100.0
1491,3/18/2018 4:15,13,20,19,52,3,100.0
1492,3/18/2018 4:20,11,19,22,52,3,100.0
1493,3/18/2018 4:25,9,25,12,46,3,100.0
1494,3/18/2018 4:30,12,23,16,51,3,100.0
1495,3/18/2018 4:35,13,27,20,60,3,100.0
1496,3/18/2018 4:40,17,24,12,53,3,100.0
1497,3/18/2018 4:45,20,22,24,66,3,100.0
1498,3/18/2018 4:50,18,33,19,70,3,100.0
1499,3/18/2018 4:55,18,26,22,66,3,100.0
1500,3/18/2018 5:00,18,33,20,71,3,100.0
1501,3/18/2018 5:05,19,34,36,89,3,100.0
1502,3/18/2018 5:10,13,25,20,58,3,100.0
1503,3/18/2018 5:15,12,26,18,56,3,100.0
1504,3/18/2018 5:20,27,34,20,81,3,100.0
1505,3/18/2018 5:25,36,33,22,91,3,100.0
1506,3/18/2018 5:30,25,37,24,86,3,100.0
1507,3/18/2018 5:35,28,36,29,93,3,100.0
1508,3/18/2018 5:40,25,39,28,92,3,100.0
1509,3/18/2018 5:45,38,46,33,117,3,100.0
1510,3/18/2018 5:50,23,40,32,95,3,100.0
1511,3/18/2018 5:55,28,48,29,105,3,100.0
1512,3/18/2018 6:00,32,39,25,96,3,100.0
1513,3/18/2018 6:05,33,50,34,117,3,100.0
1514,3/18/2018 6:10,32,46,38,116,3,100.0
1515,3/18/2018 6:15,37,52,31,120,3,100.0
1516,3/18/2018 6:20,45,54,44,143,3,100.0
1517,3/18/2018 6:25,49,47,42,138,3,100.0
1518,3/18/2018 6:30,62,60,47,169,3,100.0
1519,3/18/2018 6:35,45,60,44,149,3,100.0
1520,3/18/2018 6:40,56,79,50,185,3,100.0
1521,3/18/2018 6:45,50,68,45,163,3,100.0
1522,3/18/2018 6:50,50,66,50,166,3,100.0
1523,3/18/2018 6:55,61,62,43,166,3,100.0
1524,3/18/2018 7:00,57,62,43,162,3,100.0
1525,3/18/2018 7:05,60,70,56,186,3,100.0
1526,3/18/2018 7:10,55,58,39,152,3,100.0
1527,3/18/2018 7:15,74,70,57,201,3,100.0
1528,3/18/2018 7:20,67,71,36,174,3,100.0
1529,3/18/2018 7:25,64,79,44,187,3,100.0
1530,3/18/2018 7:30,74,89,48,211,3,100.0
1531,3/18/2018 7:35,68,78,53,199,3,100.0
1532,3/18/2018 7:40,70,77,53,200,3,100.0
1533,3/18/2018 7:45,70,74,53,197,3,100.0
1534,3/18/2018 7:50,70,81,51,202,3,100.0
1535,3/18/2018 7:55,79,85,53,217,3,100.0
1536,3/18/2018 8:00,61,76,41,178,3,100.0
1537,3/18/2018 8:05,85,82,56,223,3,100.0
1538,3/18/2018 8:10,78,73,56,207,3,100.0
1539,3/18/2018 8:15,81,79,56,216,3,100.0
1540,3/18/2018 8:20,99,95,66,260,3,100.0
1541,3/18/2018 8:25,78,85,50,213,3,100.0
1542,3/18/2018 8:30,78,88,60,226,3,100.0
1543,3/18/2018 8:35,96,101,60,257,3,100.0
1544,3/18/2018 8:40,79,89,47,215,3,100.0
1545,3/18/2018 8:45,79,92,66,237,3,100.0
1546,3/18/2018 8:50,99,111,79,289,3,100.0
1547,3/18/2018 8:55,98,100,72,270,3,100.0
1548,3/18/2018 9:00,91,94,66,251,3,100.0
1549,3/18/2018 9:05,103,103,70,276,3,100.0
1550,3/18/2018 9:10,100,108,78,286,3,100.0
1551,3/18/2018 9:15,123,114,79,316,3,100.0
1552,3/18/2018 9:20,104,94,70,268,3,100.0
1553,3/18/2018 9:25,121,109,77,307,3,100.0
1554,3/18/2018 9:30,107,113,69,289,3,100.0
1555,3/18/2018 9:35,148,137,105,390,3,100.0
1556,3/18/2018 9:40,158,119,87,364,3,100.0
1557,3/18/2018 9:45,124,122,90,336,3,100.0
1558,3/18/2018 9:50,120,118,89,327,3,100.0
1559,3/18/2018 9:55,148,143,88,379,3,100.0
1560,3/18/2018 10:00,126,131,80,337,3,100.0
1561,3/18/2018 10:05,131,116,82,329,3,100.0
1562,3/18/2018 10:10,147,130,90,367,3,100.0
1563,3/18/2018 10:15,118,118,77,313,3,100.0
1564,3/18/2018 10:20,119,127,91,337,3,100.0
1565,3/18/2018 10:25,154,134,106,394,3,100.0
1566,3/18/2018 10:30,156,144,104,404,3,100.0
1567,3/18/2018 10:35,148,148,104,400,3,100.0
1568,3/18/2018 10:40,151,156,94,401,3,100.0
1569,3/18/2018 10:45,131,140,99,370,3,100.0
1570,3/18/2018 10:50,171,136,104,411,3,100.0
1571,3/18/2018 10:55,158,154,104,416,3,100.0
1572,3/18/2018 11:00,151,140,97,388,3,100.0
1573,3/18/2018 11:05,143,136,80,359,3,100.0
1574,3/18/2018 11:10,191,157,122,470,3,100.0
1575,3/18/2018 11:15,153,136,103,392,3,100.0
1576,3/18/2018 11:20,165,157,111,433,3,100.0
1577,3/18/2018 11:25,175,153,93,421,3,100.0
1578,3/18/2018 11:30,136,147,114,397,3,100.0
1579,3/18/2018 11:35,168,152,103,423,3,100.0
1580,3/18/2018 11:40,161,154,112,427,3,100.0
1581,3/18/2018 11:45,153,132,97,382,3,100.0
1582,3/18/2018 11:50,176,156,122,454,3,100.0
1583,3/18/2018 11:55,166,152,107,425,3,100.0
1584,3/18/2018 12:00,153,136,101,390,3,100.0
1585,3/18/2018 12:05,151,146,111,408,3,100.0
1586,3/18/2018 12:10,178,154,117,449,3,100.0
1587,3/18/2018 12:15,166,132,106,404,3,100.0
1588,3/18/2018 12:20,167,158,137,462,3,100.0
1589,3/18/2018 12:25,162,150,107,419,3,100.0
1590,3/18/2018 12:30,199,149,117,465,3,100.0
1591,3/18/2018 12:35,166,151,100,417,3,100.0
1592,3/18/2018 12:40,170,160,129,459,3,100.0
1593,3/18/2018 12:45,169,152,105,426,3,100.0
1594,3/18/2018 12:50,183,151,135,469,3,100.0
1595,3/18/2018 12:55,158,148,121,427,3,100.0
1596,3/18/2018 13:00,172,151,130,453,3,100.0
1597,3/18/2018 13:05,172,164,110,446,3,100.0
1598,3/18/2018 13:10,142,133,101,376,3,100.0
1599,3/18/2018 13:15,170,146,122,438,3,100.0
1600,3/18/2018 13:20,144,152,100,396,3,100.0
1601,3/18/2018 13:25,157,143,119,419,3,100.0
1602,3/18/2018 13:30,155,142,100,397,3,100.0
1603,3/18/2018 13:35,153,157,124,434,3,100.0
1604,3/18/2018 13:40,174,155,115,444,3,100.0
1605,3/18/2018 13:45,170,147,126,443,3,100.0
1606,3/18/2018 13:50,154,135,105,394,3,100.0
1607,3/18/2018 13:55,162,141,108,411,3,100.0
1608,3/18/2018 14:00,144,132,103,379,3,100.0
1609,3/18/2018 14:05,160,155,117,432,3,100.0
1610,3/18/2018 14:10,143,130,110,383,3,100.0
1611,3/18/2018 14:15,170,130,116,416,3,100.0
1612,3/18/2018 14:20,150,157,105,412,3,100.0
1613,3/18/2018 14:25,163,154,111,428,3,100.0
1614,3/18/2018 14:30,149,149,107,405,3,100.0
1615,3/18/2018 14:35,167,162,119,448,3,100.0
1616,3/18/2018 14:40,163,151,128,442,3,100.0
1617,3/18/2018 14:45,181,165,133,479,3,100.0
1618,3/18/2018 14:50,161,159,110,430,3,100.0
1619,3/18/2018 14:55,159,160,111,430,3,100.0
1620,3/18/2018 15:00,164,152,105,421,3,100.0
1621,3/18/2018 15:05,157,154,124,435,3,100.0
1622,3/18/2018 15:10,152,157,111,420,3,100.0
1623,3/18/2018 15:15,160,132,123,415,3,100.0
1624,3/18/2018 15:20,170,148,125,443,3,100.0
1625,3/18/2018 15:25,177,157,126,460,3,100.0
1626,3/18/2018 15:30,173,155,111,439,3,100.0
1627,3/18/2018 15:35,133,150,104,387,3,100.0
1628,3/18/2018 15:40,170,161,123,454,3,100.0
1629,3/18/2018 15:45,169,155,112,436,3,100.0
1630,3/18/2018 15:50,158,155,131,444,3,100.0
1631,3/18/2018 15:55,160,146,119,425,3,100.0
1632,3/18/2018 16:00,155,146,118,419,3,100.0
1633,3/18/2018 16:05,160,148,115,423,3,100.0
1634,3/18/2018 16:10,172,153,123,448,3,100.0
1635,3/18/2018 16:15,156,146,124,426,3,100.0
1636,3/18/2018 16:20,161,155,118,434,3,100.0
1637,3/18/2018 16:25,150,137,105,392,3,100.0
1638,3/18/2018 16:30,164,163,123,450,3,100.0
1639,3/18/2018 16:35,149,146,107,402,3,100.0
1640,3/18/2018 16:40,167,149,117,433,3,100.0
1641,3/18/2018 16:45,166,151,106,423,3,100.0
1642,3/18/2018 16:50,151,143,117,411,3,100.0
1643,3/18/2018 16:55,175,152,109,436,3,100.0
1644,3/18/2018 17:00,152,140,98,390,3,100.0
1645,3/18/2018 17:05,164,156,123,443,3,100.0
1646,3/18/2018 17:10,165,153,119,437,3,100.0
1647,3/18/2018 17:15,156,144,114,414,3,100.0
1648,3/18/2018 17:20,160,159,117,436,3,100.0
1649,3/18/2018 17:25,162,146,127,435,3,100.0
1650,3/18/2018 17:30,178,155,110,443,3,100.0
1651,3/18/2018 17:35,168,160,118,446,3,100.0
1652,3/18/2018 17:40,168,147,116,431,3,100.0
1653,3/18/2018 17:45,162,172,128,462,3,100.0
1654,3/18/2018 17:50,155,150,113,418,3,100.0
1655,3/18/2018 17:55,137,135,105,377,3,100.0
1656,3/18/2018 18:00,151,141,104,396,3,100.0
1657,3/18/2018 18:05,160,140,89,389,3,100.0
1658,3/18/2018 18:10,150,139,110,399,3,100.0
1659,3/18/2018 18:15,154,145,109,408,3,100.0
1660,3/18/2018 18:20,151,139,115,405,3,100.0
1661,3/18/2018 18:25,163,128,112,403,3,100.0
1662,3/18/2018 18:30,155,122,111,388,3,100.0
1663,3/18/2018 18:35,168,135,94,397,3,100.0
1664,3/18/2018 18:40,145,135,122,402,3,100.0
1665,3/18/2018 18:45,141,141,102,384,3,100.0
1666,3/18/2018 18:50,155,131,104,390,3,100.0
1667,3/18/2018 18:55,143,147,106,396,3,100.0
1668,3/18/2018 19:00,153,135,100,388,3,100.0
1669,3/18/2018 19:05,126,125,95,346,3,100.0
1670,3/18/2018 19:10,102,103,72,277,3,100.0
1671,3/18/2018 19:15,132,131,95,358,3,100.0
1672,3/18/2018 19:20,124,117,91,332,3,100.0
1673,3/18/2018 19:25,145,131,91,367,3,100.0
1674,3/18/2018 19:30,145,128,92,365,3,100.0
1675,3/18/2018 19:35,126,129,90,345,3,100.0
1676,3/18/2018 19:40,134,109,91,334,3,100.0
1677,3/18/2018 19:45,109,115,81,305,3,100.0
1678,3/18/2018 19:50,126,111,84,321,3,100.0
1679,3/18/2018 19:55,120,110,83,313,3,100.0
1680,3/18/2018 20:00,127,114,103,344,3,100.0
1681,3/18/2018 20:05,145,126,90,361,3,100.0
1682,3/18/2018 20:10,110,105,84,299,3,100.0
1683,3/18/2018 20:15,127,105,94,326,3,100.0
1684,3/18/2018 20:20,127,115,90,332,3,100.0
1685,3/18/2018 20:25,132,124,99,355,3,100.0
1686,3/18/2018 20:30,123,112,88,323,3,100.0
1687,3/18/2018 20:35,141,121,82,344,3,100.0
1688,3/18/2018 20:40,130,100,96,326,3,100.0
1689,3/18/2018 20:45,129,124,79,332,3,100.0
1690,3/18/2018 20:50,109,107,69,285,3,100.0
1691,3/18/2018 20:55,127,123,87,337,3,100.0
1692,3/18/2018 21:00,132,103,85,320,3,100.0
1693,3/18/2018 21:05,143,128,95,366,3,100.0
1694,3/18/2018 21:10,127,116,70,313,3,100.0
1695,3/18/2018 21:15,115,111,90,316,3,100.0
1696,3/18/2018 21:20,145,130,89,364,3,100.0
1697,3/18/2018 21:25,113,103,85,301,3,100.0
1698,3/18/2018 21:30,110,107,77,294,3,100.0
1699,3/18/2018 21:35,104,96,76,276,3,100.0
1700,3/18/2018 21:40,111,104,59,274,3,100.0
1701,3/18/2018 21:45,119,111,67,297,3,100.0
1702,3/18/2018 21:50,117,105,72,294,3,100.0
1703,3/18/2018 21:55,126,103,68,297,3,100.0
1704,3/18/2018 22:00,96,79,78,253,3,100.0
1705,3/18/2018 22:05,115,91,70,276,3,100.0
1706,3/18/2018 22:10,99,98,68,265,3,100.0
1707,3/18/2018 22:15,100,98,62,260,3,100.0
1708,3/18/2018 22:20,98,96,68,262,3,100.0
1709,3/18/2018 22:25,95,97,55,247,3,100.0
1710,3/18/2018 22:30,103,102,62,267,3,100.0
1711,3/18/2018 22:35,93,82,59,234,3,100.0
1712,3/18/2018 22:40,85,86,60,231,3,100.0
1713,3/18/2018 22:45,88,75,54,217,3,100.0
1714,3/18/2018 22:50,87,87,56,230,3,100.0
1715,3/18/2018 22:55,74,75,48,197,3,100.0
1716,3/18/2018 23:00,80,72,47,199,3,100.0
1717,3/18/2018 23:05,68,72,46,186,3,100.0
1718,3/18/2018 23:10,80,74,49,203,3,100.0
1719,3/18/2018 23:15,58,63,53,174,3,100.0
1720,3/18/2018 23:20,67,66,35,168,3,100.0
1721,3/18/2018 23:25,51,54,44,149,3,100.0
1722,3/18/2018 23:30,63,62,41,166,3,100.0
1723,3/18/2018 23:35,67,74,34,175,3,100.0
1724,3/18/2018 23:40,66,65,51,182,3,100.0
1725,3/18/2018 23:45,64,60,43,167,3,100.0
1726,3/18/2018 23:50,55,66,40,161,3,100.0
1727,3/18/2018 23:55,51,53,25,129,3,100.0
1728,3/19/2018 0:00,60,57,39,156,3,100.0
1729,3/19/2018 0:05,39,49,30,118,3,100.0
1730,3/19/2018 0:10,33,47,29,109,3,100.0
1731,3/19/2018 0:15,37,44,22,103,3,100.0
1732,3/19/2018 0:20,34,43,28,105,3,100.0
1733,3/19/2018 0:25,38,44,28,110,3,100.0
1734,3/19/2018 0:30,33,44,28,105,3,100.0
1735,3/19/2018 0:35,35,50,28,113,3,100.0
1736,3/19/2018 0:40,20,47,23,90,3,100.0
1737,3/19/2018 0:45,26,37,26,89,3,100.0
1738,3/19/2018 0:50,33,34,20,87,3,100.0
1739,3/19/2018 0:55,31,36,29,96,3,100.0
1740,3/19/2018 1:00,35,37,22,94,3,100.0
1741,3/19/2018 1:05,23,25,21,69,3,100.0
1742,3/19/2018 1:10,22,29,20,71,3,100.0
1743,3/19/2018 1:15,23,41,15,79,3,100.0
1744,3/19/2018 1:20,26,30,18,74,3,100.0
1745,3/19/2018 1:25,12,19,20,51,3,100.0
1746,3/19/2018 1:30,15,27,23,65,3,100.0
1747,3/19/2018 1:35,18,25,21,64,3,100.0
1748,3/19/2018 1:40,15,22,11,48,3,100.0
1749,3/19/2018 1:45,15,20,12,47,3,100.0
1750,3/19/2018 1:50,18,26,11,55,3,100.0
1751,3/19/2018 1:55,15,19,14,48,3,100.0
1752,3/19/2018 2:00,21,21,20,62,3,100.0
1753,3/19/2018 2:05,13,16,11,40,3,100.0
1754,3/19/2018 2:10,4,12,10,26,3,100.0
1755,3/19/2018 2:15,13,23,9,45,3,100.0
1756,3/19/2018 2:20,10,20,10,40,3,100.0
1757,3/19/2018 2:25,9,12,8,29,3,100.0
1758,3/19/2018 2:30,9,13,18,40,3,100.0
1759,3/19/2018 2:35,13,19,9,41,3,100.0
1760,3/19/2018 2:40,16,24,16,56,3,100.0
1761,3/19/2018 2:45,16,21,11,48,3,100.0
1762,3/19/2018 2:50,13,16,8,37,3,100.0
1763,3/19/2018 2:55,2,12,8,22,3,100.0
1764,3/19/2018 3:00,7,15,10,32,3,100.0
1765,3/19/2018 3:05,8,15,12,35,3,100.0
1766,3/19/2018 3:10,8,11,7,26,3,100.0
1767,3/19/2018 3:15,13,14,10,37,3,100.0
1768,3/19/2018 3:20,8,18,9,35,3,100.0
1769,3/19/2018 3:25,13,20,13,46,3,100.0
1770,3/19/2018 3:30,8,16,13,37,3,100.0
1771,3/19/2018 3:35,17,21,16,54,3,100.0
1772,3/19/2018 3:40,14,24,15,53,3,100.0
1773,3/19/2018 3:45,12,20,13,45,3,100.0
1774,3/19/2018 3:50,16,26,18,60,3,100.0
1775,3/19/2018 3:55,18,13,12,43,3,100.0
1776,3/19/2018 4:00,26,29,24,79,3,100.0
1777,3/19/2018 4:05,13,32,24,69,3,100.0
1778,3/19/2018 4:10,20,24,20,64,3,100.0
1779,3/19/2018 4:15,26,33,23,82,3,100.0
1780,3/19/2018 4:20,27,33,17,77,3,100.0
1781,3/19/2018 4:25,35,31,21,87,3,100.0
1782,3/19/2018 4:30,47,44,25,116,3,100.0
1783,3/19/2018 4:35,38,44,32,114,3,100.0
1784,3/19/2018 4:40,38,49,25,112,3,100.0
1785,3/19/2018 4:45,39,52,26,117,3,100.0
1786,3/19/2018 4:50,34,33,28,95,3,100.0
1787,3/19/2018 4:55,49,61,30,140,3,100.0
1788,3/19/2018 5:00,47,49,28,124,3,100.0
1789,3/19/2018 5:05,66,71,41,178,3,100.0
1790,3/19/2018 5:10,77,69,47,193,3,100.0
1791,3/19/2018 5:15,80,73,52,205,3,100.0
1792,3/19/2018 5:20,100,89,55,244,3,100.0
1793,3/19/2018 5:25,113,95,61,269,3,100.0
1794,3/19/2018 5:30,149,98,59,306,3,100.0
1795,3/19/2018 5:35,125,112,60,297,3,100.0
1796,3/19/2018 5:40,148,120,86,354,3,100.0
1797,3/19/2018 5:45,137,111,67,315,3,100.0
1798,3/19/2018 5:50,150,128,83,361,3,100.0
1799,3/19/2018 5:55,167,134,87,388,3,100.0
1800,3/19/2018 6:00,157,110,75,342,3,100.0
1801,3/19/2018 6:05,136,115,76,327,3,100.0
1802,3/19/2018 6:10,150,130,74,354,3,100.0
1803,3/19/2018 6:15,159,139,95,393,3,100.0
1804,3/19/2018 6:20,139,120,87,346,3,100.0
1805,3/19/2018 6:25,166,118,91,375,3,100.0
1806,3/19/2018 6:30,160,138,101,399,3,100.0
1807,3/19/2018 6:35,163,141,97,401,3,100.0
1808,3/19/2018 6:40,160,141,101,402,3,100.0
1809,3/19/2018 6:45,176,151,111,438,3,100.0
1810,3/19/2018 6:50,177,140,96,413,3,100.0
1811,3/19/2018 6:55,174,142,102,418,3,100.0
1812,3/19/2018 7:00,171,149,108,428,3,100.0
1813,3/19/2018 7:05,163,137,103,403,3,100.0
1814,3/19/2018 7:10,155,143,114,412,3,100.0
1815,3/19/2018 7:15,143,141,122,406,3,100.0
1816,3/19/2018 7:20,152,151,124,427,3,100.0
1817,3/19/2018 7:25,160,157,131,448,3,100.0
1818,3/19/2018 7:30,138,124,122,384,3,100.0
1819,3/19/2018 7:35,161,158,140,459,3,100.0
1820,3/19/2018 7:40,166,162,143,471,3,100.0
1821,3/19/2018 7:45,167,167,140,474,3,100.0
1822,3/19/2018 7:50,145,158,125,428,3,100.0
1823,3/19/2018 7:55,149,167,148,464,3,100.0
1824,3/19/2018 8:00,137,145,132,414,3,100.0
1825,3/19/2018 8:05,114,112,120,346,3,100.0
1826,3/19/2018 8:10,129,121,106,356,3,100.0
1827,3/19/2018 8:15,124,127,110,361,3,100.0
1828,3/19/2018 8:20,120,117,112,349,3,100.0
1829,3/19/2018 8:25,124,128,113,365,3,100.0
1830,3/19/2018 8:30,148,138,125,411,3,100.0
1831,3/19/2018 8:35,166,162,148,476,3,100.0
1832,3/19/2018 8:40,162,162,144,468,3,100.0
1833,3/19/2018 8:45,159,155,129,443,3,100.0
1834,3/19/2018 8:50,173,147,111,431,3,100.0
1835,3/19/2018 8:55,172,163,124,459,3,100.0
1836,3/19/2018 9:00,191,155,126,472,3,100.0
1837,3/19/2018 9:05,160,148,108,416,3,100.0
1838,3/19/2018 9:10,154,130,101,385,3,100.0
1839,3/19/2018 9:15,163,146,103,412,3,100.0
1840,3/19/2018 9:20,171,160,103,434,3,100.0
1841,3/19/2018 9:25,162,136,107,405,3,100.0
1842,3/19/2018 9:30,183,147,113,443,3,100.0
1843,3/19/2018 9:35,170,143,96,409,3,100.0
1844,3/19/2018 9:40,168,146,110,424,3,100.0
1845,3/19/2018 9:45,161,139,89,389,3,100.0
1846,3/19/2018 9:50,144,134,98,376,3,100.0
1847,3/19/2018 9:55,155,136,93,384,3,100.0
1848,3/19/2018 10:00,152,127,99,378,3,100.0
1849,3/19/2018 10:05,131,131,84,346,3,100.0
1850,3/19/2018 10:10,163,137,102,402,3,100.0
1851,3/19/2018 10:15,143,143,100,386,3,100.0
1852,3/19/2018 10:20,177,136,80,393,3,100.0
1853,3/19/2018 10:25,145,135,99,379,3,100.0
1854,3/19/2018 10:30,155,135,95,385,3,100.0
1855,3/19/2018 10:35,166,139,97,402,3,100.0
1856,3/19/2018 10:40,158,139,89,386,3,100.0
1857,3/19/2018 10:45,158,151,110,419,3,100.0
1858,3/19/2018 10:50,164,137,104,405,3,100.0
1859,3/19/2018 10:55,155,138,99,392,3,100.0
1860,3/19/2018 11:00,173,134,95,402,3,100.0
1861,3/19/2018 11:05,149,137,87,373,3,100.0
1862,3/19/2018 11:10,159,152,102,413,3,100.0
1863,3/19/2018 11:15,163,139,94,396,3,100.0
1864,3/19/2018 11:20,140,128,93,361,3,100.0
1865,3/19/2018 11:25,190,164,119,473,3,100.0
1866,3/19/2018 11:30,192,160,114,466,3,100.0
1867,3/19/2018 11:35,158,141,100,399,3,100.0
1868,3/19/2018 11:40,171,154,109,434,3,100.0
1869,3/19/2018 11:45,157,139,107,403,3,100.0
1870,3/19/2018 11:50,160,149,106,415,3,100.0
1871,3/19/2018 11:55,174,151,116,441,3,100.0
0,3/19/2018 0:00,60,57,39,156,3,100.0
1,3/19/2018 0:05,39,49,30,118,3,100.0
2,3/19/2018 0:10,33,47,29,109,3,100.0
3,3/19/2018 0:15,37,44,22,103,3,100.0
4,3/19/2018 0:20,34,43,28,105,3,100.0
5,3/19/2018 0:25,38,44,28,110,3,100.0
6,3/19/2018 0:30,33,44,28,105,3,100.0
7,3/19/2018 0:35,35,50,28,113,3,100.0
8,3/19/2018 0:40,20,47,23,90,3,100.0
9,3/19/2018 0:45,26,37,26,89,3,100.0
10,3/19/2018 0:50,33,34,20,87,3,100.0
11,3/19/2018 0:55,31,36,29,96,3,100.0
12,3/19/2018 1:00,35,37,22,94,3,100.0
13,3/19/2018 1:05,23,25,21,69,3,100.0
14,3/19/2018 1:10,22,29,20,71,3,100.0
15,3/19/2018 1:15,23,41,15,79,3,100.0
16,3/19/2018 1:20,26,30,18,74,3,100.0
17,3/19/2018 1:25,12,19,20,51,3,100.0
18,3/19/2018 1:30,15,27,23,65,3,100.0
19,3/19/2018 1:35,18,25,21,64,3,100.0
20,3/19/2018 1:40,15,22,11,48,3,100.0
21,3/19/2018 1:45,15,20,12,47,3,100.0
22,3/19/2018 1:50,18,26,11,55,3,100.0
23,3/19/2018 1:55,15,19,14,48,3,100.0
24,3/19/2018 2:00,21,21,20,62,3,100.0
25,3/19/2018 2:05,13,16,11,40,3,100.0
26,3/19/2018 2:10,4,12,10,26,3,100.0
27,3/19/2018 2:15,13,23,9,45,3,100.0
28,3/19/2018 2:20,10,20,10,40,3,100.0
29,3/19/2018 2:25,9,12,8,29,3,100.0
30,3/19/2018 2:30,9,13,18,40,3,100.0
31,3/19/2018 2:35,13,19,9,41,3,100.0
32,3/19/2018 2:40,16,24,16,56,3,100.0
33,3/19/2018 2:45,16,21,11,48,3,100.0
34,3/19/2018 2:50,13,16,8,37,3,100.0
35,3/19/2018 2:55,2,12,8,22,3,100.0
36,3/19/2018 3:00,7,15,10,32,3,100.0
37,3/19/2018 3:05,8,15,12,35,3,100.0
38,3/19/2018 3:10,8,11,7,26,3,100.0
39,3/19/2018 3:15,13,14,10,37,3,100.0
40,3/19/2018 3:20,8,18,9,35,3,100.0
41,3/19/2018 3:25,13,20,13,46,3,100.0
42,3/19/2018 3:30,8,16,13,37,3,100.0
43,3/19/2018 3:35,17,21,16,54,3,100.0
44,3/19/2018 3:40,14,24,15,53,3,100.0
45,3/19/2018 3:45,12,20,13,45,3,100.0
46,3/19/2018 3:50,16,26,18,60,3,100.0
47,3/19/2018 3:55,18,13,12,43,3,100.0
48,3/19/2018 4:00,26,29,24,79,3,100.0
49,3/19/2018 4:05,13,32,24,69,3,100.0
50,3/19/2018 4:10,20,24,20,64,3,100.0
51,3/19/2018 4:15,26,33,23,82,3,100.0
52,3/19/2018 4:20,27,33,17,77,3,100.0
53,3/19/2018 4:25,35,31,21,87,3,100.0
54,3/19/2018 4:30,47,44,25,116,3,100.0
55,3/19/2018 4:35,38,44,32,114,3,100.0
56,3/19/2018 4:40,38,49,25,112,3,100.0
57,3/19/2018 4:45,39,52,26,117,3,100.0
58,3/19/2018 4:50,34,33,28,95,3,100.0
59,3/19/2018 4:55,49,61,30,140,3,100.0
60,3/19/2018 5:00,47,49,28,124,3,100.0
61,3/19/2018 5:05,66,71,41,178,3,100.0
62,3/19/2018 5:10,77,69,47,193,3,100.0
63,3/19/2018 5:15,80,73,52,205,3,100.0
64,3/19/2018 5:20,100,89,55,244,3,100.0
65,3/19/2018 5:25,113,95,61,269,3,100.0
66,3/19/2018 5:30,149,98,59,306,3,100.0
67,3/19/2018 5:35,125,112,60,297,3,100.0
68,3/19/2018 5:40,148,120,86,354,3,100.0
69,3/19/2018 5:45,137,111,67,315,3,100.0
70,3/19/2018 5:50,150,128,83,361,3,100.0
71,3/19/2018 5:55,167,134,87,388,3,100.0
72,3/19/2018 6:00,157,110,75,342,3,100.0
73,3/19/2018 6:05,136,115,76,327,3,100.0
74,3/19/2018 6:10,150,130,74,354,3,100.0
75,3/19/2018 6:15,159,139,95,393,3,100.0
76,3/19/2018 6:20,139,120,87,346,3,100.0
77,3/19/2018 6:25,166,118,91,375,3,100.0
78,3/19/2018 6:30,160,138,101,399,3,100.0
79,3/19/2018 6:35,163,141,97,401,3,100.0
80,3/19/2018 6:40,160,141,101,402,3,100.0
81,3/19/2018 6:45,176,151,111,438,3,100.0
82,3/19/2018 6:50,177,140,96,413,3,100.0
83,3/19/2018 6:55,174,142,102,418,3,100.0
84,3/19/2018 7:00,171,149,108,428,3,100.0
85,3/19/2018 7:05,163,137,103,403,3,100.0
86,3/19/2018 7:10,155,143,114,412,3,100.0
87,3/19/2018 7:15,143,141,122,406,3,100.0
88,3/19/2018 7:20,152,151,124,427,3,100.0
89,3/19/2018 7:25,160,157,131,448,3,100.0
90,3/19/2018 7:30,138,124,122,384,3,100.0
91,3/19/2018 7:35,161,158,140,459,3,100.0
92,3/19/2018 7:40,166,162,143,471,3,100.0
93,3/19/2018 7:45,167,167,140,474,3,100.0
94,3/19/2018 7:50,145,158,125,428,3,100.0
95,3/19/2018 7:55,149,167,148,464,3,100.0
96,3/19/2018 8:00,137,145,132,414,3,100.0
97,3/19/2018 8:05,114,112,120,346,3,100.0
98,3/19/2018 8:10,129,121,106,356,3,100.0
99,3/19/2018 8:15,124,127,110,361,3,100.0
100,3/19/2018 8:20,120,117,112,349,3,100.0
101,3/19/2018 8:25,124,128,113,365,3,100.0
102,3/19/2018 8:30,148,138,125,411,3,100.0
103,3/19/2018 8:35,166,162,148,476,3,100.0
104,3/19/2018 8:40,162,162,144,468,3,100.0
105,3/19/2018 8:45,159,155,129,443,3,100.0
106,3/19/2018 8:50,173,147,111,431,3,100.0
107,3/19/2018 8:55,172,163,124,459,3,100.0
108,3/19/2018 9:00,191,155,126,472,3,100.0
109,3/19/2018 9:05,160,148,108,416,3,100.0
110,3/19/2018 9:10,154,130,101,385,3,100.0
111,3/19/2018 9:15,163,146,103,412,3,100.0
112,3/19/2018 9:20,171,160,103,434,3,100.0
113,3/19/2018 9:25,162,136,107,405,3,100.0
114,3/19/2018 9:30,183,147,113,443,3,100.0
115,3/19/2018 9:35,170,143,96,409,3,100.0
116,3/19/2018 9:40,168,146,110,424,3,100.0
117,3/19/2018 9:45,161,139,89,389,3,100.0
118,3/19/2018 9:50,144,134,98,376,3,100.0
119,3/19/2018 9:55,155,136,93,384,3,100.0
120,3/19/2018 10:00,152,127,99,378,3,100.0
121,3/19/2018 10:05,131,131,84,346,3,100.0
122,3/19/2018 10:10,163,137,102,402,3,100.0
123,3/19/2018 10:15,143,143,100,386,3,100.0
124,3/19/2018 10:20,177,136,80,393,3,100.0
125,3/19/2018 10:25,145,135,99,379,3,100.0
126,3/19/2018 10:30,155,135,95,385,3,100.0
127,3/19/2018 10:35,166,139,97,402,3,100.0
128,3/19/2018 10:40,158,139,89,386,3,100.0
129,3/19/2018 10:45,158,151,110,419,3,100.0
130,3/19/2018 10:50,164,137,104,405,3,100.0
131,3/19/2018 10:55,155,138,99,392,3,100.0
132,3/19/2018 11:00,173,134,95,402,3,100.0
133,3/19/2018 11:05,149,137,87,373,3,100.0
134,3/19/2018 11:10,159,152,102,413,3,100.0
135,3/19/2018 11:15,163,139,94,396,3,100.0
136,3/19/2018 11:20,140,128,93,361,3,100.0
137,3/19/2018 11:25,190,164,119,473,3,100.0
138,3/19/2018 11:30,192,160,114,466,3,100.0
139,3/19/2018 11:35,158,141,100,399,3,100.0
140,3/19/2018 11:40,171,154,109,434,3,100.0
141,3/19/2018 11:45,157,139,107,403,3,100.0
142,3/19/2018 11:50,160,149,106,415,3,100.0
143,3/19/2018 11:55,174,151,116,441,3,100.0
144,3/19/2018 12:00,172,150,109,431,3,100.0
145,3/19/2018 12:05,181,148,131,460,3,100.0
146,3/19/2018 12:10,169,142,111,422,3,100.0
147,3/19/2018 12:15,170,151,117,438,3,100.0
148,3/19/2018 12:20,190,161,130,481,3,100.0
149,3/19/2018 12:25,173,162,129,464,3,100.0
150,3/19/2018 12:30,164,168,123,455,3,100.0
151,3/19/2018 12:35,164,150,110,424,3,100.0
152,3/19/2018 12:40,193,162,127,482,3,100.0
153,3/19/2018 12:45,168,150,121,439,3,100.0
154,3/19/2018 12:50,162,151,108,421,3,100.0
155,3/19/2018 12:55,174,160,109,443,3,100.0
156,3/19/2018 13:00,184,155,116,455,3,100.0
157,3/19/2018 13:05,173,152,118,443,3,100.0
158,3/19/2018 13:10,175,133,109,417,3,100.0
159,3/19/2018 13:15,174,162,110,446,3,100.0
160,3/19/2018 13:20,195,170,111,476,3,100.0
161,3/19/2018 13:25,153,140,110,403,3,100.0
162,3/19/2018 13:30,173,164,127,464,3,100.0
163,3/19/2018 13:35,163,156,135,454,3,100.0
164,3/19/2018 13:40,176,173,115,464,3,100.0
165,3/19/2018 13:45,161,145,115,421,3,100.0
166,3/19/2018 13:50,174,158,132,464,3,100.0
167,3/19/2018 13:55,174,156,129,459,3,100.0
168,3/19/2018 14:00,180,180,112,472,3,100.0
169,3/19/2018 14:05,137,135,102,374,3,100.0
170,3/19/2018 14:10,171,168,136,475,3,100.0
171,3/19/2018 14:15,169,161,134,464,3,100.0
172,3/19/2018 14:20,175,168,142,485,3,100.0
173,3/19/2018 14:25,185,163,151,499,3,100.0
174,3/19/2018 14:30,185,163,141,489,3,100.0
175,3/19/2018 14:35,180,178,151,509,3,100.0
176,3/19/2018 14:40,173,173,145,491,3,100.0
177,3/19/2018 14:45,176,174,133,483,3,100.0
178,3/19/2018 14:50,184,173,162,519,3,100.0
179,3/19/2018 14:55,157,152,136,445,3,100.0
180,3/19/2018 15:00,159,137,123,419,3,100.0
181,3/19/2018 15:05,152,143,137,432,3,100.0
182,3/19/2018 15:10,154,149,142,445,3,100.0
183,3/19/2018 15:15,129,119,117,365,3,100.0
184,3/19/2018 15:20,124,130,121,375,3,100.0
185,3/19/2018 15:25,156,148,140,444,3,100.0
186,3/19/2018 15:30,142,137,129,408,3,100.0
187,3/19/2018 15:35,147,138,125,410,3,100.0
188,3/19/2018 15:40,147,140,134,421,3,100.0
189,3/19/2018 15:45,148,145,136,429,3,100.0
190,3/19/2018 15:50,146,145,145,436,3,100.0
191,3/19/2018 15:55,149,145,139,433,3,100.0
192,3/19/2018 16:00,145,142,144,431,3,100.0
193,3/19/2018 16:05,167,159,148,474,3,100.0
194,3/19/2018 16:10,163,159,147,469,3,100.0
195,3/19/2018 16:15,166,161,163,490,3,100.0
196,3/19/2018 16:20,131,132,133,396,3,100.0
197,3/19/2018 16:25,145,155,152,452,3,100.0
198,3/19/2018 16:30,141,146,134,421,3,100.0
199,3/19/2018 16:35,160,156,152,468,3,100.0
200,3/19/2018 16:40,160,148,146,454,3,100.0
201,3/19/2018 16:45,160,143,149,452,3,100.0
202,3/19/2018 16:50,160,154,134,448,3,100.0
203,3/19/2018 16:55,150,164,134,448,3,100.0
204,3/19/2018 17:00,146,136,145,427,3,100.0
205,3/19/2018 17:05,163,162,159,484,3,100.0
206,3/19/2018 17:10,163,158,148,469,3,100.0
207,3/19/2018 17:15,166,152,145,463,3,100.0
208,3/19/2018 17:20,154,151,145,450,3,100.0
209,3/19/2018 17:25,171,171,159,501,3,100.0
210,3/19/2018 17:30,150,143,145,438,3,100.0
211,3/19/2018 17:35,170,157,152,479,3,100.0
212,3/19/2018 17:40,155,157,144,456,3,100.0
213,3/19/2018 17:45,165,172,149,486,3,100.0
214,3/19/2018 17:50,172,160,164,496,3,100.0
215,3/19/2018 17:55,163,173,157,493,3,100.0
216,3/19/2018 18:00,152,156,135,443,3,100.0
217,3/19/2018 18:05,170,175,152,497,3,100.0
218,3/19/2018 18:10,164,175,171,510,3,100.0
219,3/19/2018 18:15,186,182,145,513,3,100.0
220,3/19/2018 18:20,173,180,157,510,3,100.0
221,3/19/2018 18:25,169,180,150,499,3,100.0
222,3/19/2018 18:30,165,160,138,463,3,100.0
223,3/19/2018 18:35,162,145,125,432,3,100.0
224,3/19/2018 18:40,169,166,161,496,3,100.0
225,3/19/2018 18:45,158,152,141,451,3,100.0
226,3/19/2018 18:50,164,163,134,461,3,100.0
227,3/19/2018 18:55,160,163,141,464,3,100.0
228,3/19/2018 19:00,170,154,135,459,3,100.0
229,3/19/2018 19:05,162,162,135,459,3,100.0
230,3/19/2018 19:10,155,169,141,465,3,100.0
231,3/19/2018 19:15,167,139,141,447,3,100.0
232,3/19/2018 19:20,162,132,134,428,3,100.0
233,3/19/2018 19:25,160,153,120,433,3,100.0
234,3/19/2018 19:30,155,150,132,437,3,100.0
235,3/19/2018 19:35,154,149,129,432,3,100.0
236,3/19/2018 19:40,158,150,134,442,3,100.0
237,3/19/2018 19:45,153,154,122,429,3,100.0
238,3/19/2018 19:50,151,147,126,424,3,100.0
239,3/19/2018 19:55,148,141,110,399,3,100.0
240,3/19/2018 20:00,163,154,135,452,3,100.0
241,3/19/2018 20:05,159,145,111,415,3,100.0
242,3/19/2018 20:10,156,139,107,402,3,100.0
243,3/19/2018 20:15,150,148,109,407,3,100.0
244,3/19/2018 20:20,142,132,104,378,3,100.0
245,3/19/2018 20:25,152,130,92,374,3,100.0
246,3/19/2018 20:30,152,132,110,394,3,100.0
247,3/19/2018 20:35,116,104,81,301,3,100.0
248,3/19/2018 20:40,141,121,98,360,3,100.0
249,3/19/2018 20:45,129,111,103,343,3,100.0
250,3/19/2018 20:50,125,121,77,323,3,100.0
251,3/19/2018 20:55,136,129,87,352,3,100.0
252,3/19/2018 21:00,133,117,93,343,3,100.0
253,3/19/2018 21:05,121,96,81,298,3,100.0
254,3/19/2018 21:10,133,117,95,345,3,100.0
255,3/19/2018 21:15,123,115,74,312,3,100.0
256,3/19/2018 21:20,112,114,98,324,3,100.0
257,3/19/2018 21:25,130,112,77,319,3,100.0
258,3/19/2018 21:30,101,110,81,292,3,100.0
259,3/19/2018 21:35,105,81,65,251,3,100.0
260,3/19/2018 21:40,107,88,70,265,3,100.0
261,3/19/2018 21:45,102,102,78,282,3,100.0
262,3/19/2018 21:50,95,81,64,240,3,100.0
263,3/19/2018 21:55,93,93,67,253,3,100.0
264,3/19/2018 22:00,79,80,57,216,3,100.0
265,3/19/2018 22:05,92,83,69,244,3,100.0
266,3/19/2018 22:10,80,77,63,220,3,100.0
267,3/19/2018 22:15,99,100,70,269,3,100.0
268,3/19/2018 22:20,89,90,63,242,3,100.0
269,3/19/2018 22:25,84,80,60,224,3,100.0
270,3/19/2018 22:30,74,79,48,201,3,100.0
271,3/19/2018 22:35,76,75,54,205,3,100.0
272,3/19/2018 22:40,91,90,54,235,3,100.0
273,3/19/2018 22:45,77,79,57,213,3,100.0
274,3/19/2018 22:50,75,81,43,199,3,100.0
275,3/19/2018 22:55,52,73,39,164,3,100.0
276,3/19/2018 23:00,79,80,52,211,3,100.0
277,3/19/2018 23:05,72,69,52,193,3,100.0
278,3/19/2018 23:10,48,47,36,131,3,100.0
279,3/19/2018 23:15,54,69,45,168,3,100.0
280,3/19/2018 23:20,58,60,38,156,3,100.0
281,3/19/2018 23:25,59,66,40,165,3,100.0
282,3/19/2018 23:30,61,64,44,169,3,100.0
283,3/19/2018 23:35,47,57,32,136,3,100.0
284,3/19/2018 23:40,43,44,31,118,3,100.0
285,3/19/2018 23:45,46,61,40,147,3,100.0
286,3/19/2018 23:50,53,57,33,143,3,100.0
287,3/19/2018 23:55,43,49,34,126,3,100.0
288,3/20/2018 0:00,41,45,32,118,3,100.0
289,3/20/2018 0:05,35,42,26,103,3,100.0
290,3/20/2018 0:10,42,48,39,129,3,100.0
291,3/20/2018 0:15,42,32,37,111,3,100.0
292,3/20/2018 0:20,40,41,27,108,3,100.0
293,3/20/2018 0:25,34,43,30,107,3,100.0
294,3/20/2018 0:30,34,38,28,100,3,100.0
295,3/20/2018 0:35,36,36,35,107,3,100.0
296,3/20/2018 0:40,30,35,30,95,3,100.0
297,3/20/2018 0:45,33,47,25,105,3,100.0
298,3/20/2018 0:50,22,30,16,68,3,100.0
299,3/20/2018 0:55,24,37,22,83,3,100.0
300,3/20/2018 1:00,24,30,14,68,3,100.0
301,3/20/2018 1:05,17,27,16,60,3,100.0
302,3/20/2018 1:10,21,26,26,73,3,100.0
303,3/20/2018 1:15,11,29,13,53,3,100.0
304,3/20/2018 1:20,27,28,13,68,3,100.0
305,3/20/2018 1:25,11,20,15,46,3,100.0
306,3/20/2018 1:30,19,31,19,69,3,100.0
307,3/20/2018 1:35,15,25,15,55,3,100.0
308,3/20/2018 1:40,12,28,21,61,3,100.0
309,3/20/2018 1:45,14,27,15,56,3,100.0
310,3/20/2018 1:50,17,26,21,64,3,100.0
311,3/20/2018 1:55,13,29,17,59,3,100.0
312,3/20/2018 2:00,13,18,23,54,3,100.0
313,3/20/2018 2:05,15,19,15,49,3,100.0
314,3/20/2018 2:10,10,22,19,51,3,100.0
315,3/20/2018 2:15,10,22,12,44,3,100.0
316,3/20/2018 2:20,12,21,16,49,3,100.0
317,3/20/2018 2:25,18,21,16,55,3,100.0
318,3/20/2018 2:30,20,23,17,60,3,100.0
319,3/20/2018 2:35,16,34,14,64,3,100.0
320,3/20/2018 2:40,12,25,16,53,3,100.0
321,3/20/2018 2:45,13,17,16,46,3,100.0
322,3/20/2018 2:50,8,21,20,49,3,100.0
323,3/20/2018 2:55,4,16,16,36,3,100.0
324,3/20/2018 3:00,9,20,10,39,3,100.0
325,3/20/2018 3:05,8,13,14,35,3,100.0
326,3/20/2018 3:10,9,16,16,41,3,100.0
327,3/20/2018 3:15,8,23,12,43,3,100.0
328,3/20/2018 3:20,7,23,14,44,3,100.0
329,3/20/2018 3:25,14,21,14,49,3,100.0
330,3/20/2018 3:30,8,16,12,36,3,100.0
331,3/20/2018 3:35,10,31,18,59,3,100.0
332,3/20/2018 3:40,14,30,14,58,3,100.0
333,3/20/2018 3:45,14,24,21,59,3,100.0
334,3/20/2018 3:50,19,25,22,66,3,100.0
335,3/20/2018 3:55,16,20,19,55,3,100.0
336,3/20/2018 4:00,22,25,19,66,3,100.0
337,3/20/2018 4:05,9,19,14,42,3,100.0
338,3/20/2018 4:10,16,30,20,66,3,100.0
339,3/20/2018 4:15,23,32,21,76,3,100.0
340,3/20/2018 4:20,27,31,27,85,3,100.0
341,3/20/2018 4:25,31,30,21,82,3,100.0
342,3/20/2018 4:30,30,44,20,94,3,100.0
343,3/20/2018 4:35,43,50,26,119,3,100.0
344,3/20/2018 4:40,35,44,29,108,3,100.0
345,3/20/2018 4:45,39,48,36,123,3,100.0
346,3/20/2018 4:50,53,51,36,140,3,100.0
347,3/20/2018 4:55,35,47,33,115,3,100.0
348,3/20/2018 5:00,53,62,40,155,3,100.0
349,3/20/2018 5:05,58,60,40,158,3,100.0
350,3/20/2018 5:10,73,73,48,194,3,100.0
351,3/20/2018 5:15,87,70,44,201,3,100.0
352,3/20/2018 5:20,97,84,50,231,3,100.0
353,3/20/2018 5:25,116,102,59,277,3,100.0
354,3/20/2018 5:30,123,94,56,273,3,100.0
355,3/20/2018 5:35,120,110,60,290,3,100.0
356,3/20/2018 5:40,147,114,79,340,3,100.0
357,3/20/2018 5:45,146,118,75,339,3,100.0
358,3/20/2018 5:50,155,119,79,353,3,100.0
359,3/20/2018 5:55,143,121,64,328,3,100.0
360,3/20/2018 6:00,138,120,69,327,3,100.0
361,3/20/2018 6:05,140,122,73,335,3,100.0
362,3/20/2018 6:10,143,116,71,330,3,100.0
363,3/20/2018 6:15,132,123,73,328,3,100.0
364,3/20/2018 6:20,148,142,83,373,3,100.0
365,3/20/2018 6:25,182,160,101,443,3,100.0
366,3/20/2018 6:30,165,147,102,414,3,100.0
367,3/20/2018 6:35,174,166,96,436,3,100.0
368,3/20/2018 6:40,191,164,107,462,3,100.0
369,3/20/2018 6:45,188,157,127,472,3,100.0
370,3/20/2018 6:50,186,157,117,460,3,100.0
371,3/20/2018 6:55,179,165,111,455,3,100.0
372,3/20/2018 7:00,173,156,130,459,3,100.0
373,3/20/2018 7:05,180,170,125,475,3,100.0
374,3/20/2018 7:10,186,149,121,456,3,100.0
375,3/20/2018 7:15,179,153,136,468,3,100.0
376,3/20/2018 7:20,168,158,115,441,3,100.0
377,3/20/2018 7:25,170,159,133,462,3,100.0
378,3/20/2018 7:30,206,177,157,540,3,100.0
379,3/20/2018 7:35,190,178,124,492,3,100.0
380,3/20/2018 7:40,194,159,136,489,3,100.0
381,3/20/2018 7:45,192,186,143,521,3,100.0
382,3/20/2018 7:50,180,160,131,471,3,100.0
383,3/20/2018 7:55,192,170,139,501,3,100.0
384,3/20/2018 8:00,198,154,113,465,3,100.0
385,3/20/2018 8:05,199,178,121,498,3,100.0
386,3/20/2018 8:10,179,171,126,476,3,100.0
387,3/20/2018 8:15,167,164,101,432,3,100.0
388,3/20/2018 8:20,166,148,109,423,3,100.0
389,3/20/2018 8:25,149,144,120,413,3,100.0
390,3/20/2018 8:30,123,130,130,383,3,100.0
391,3/20/2018 8:35,82,94,100,276,3,100.0
392,3/20/2018 8:40,115,119,111,345,3,100.0
393,3/20/2018 8:45,128,130,128,386,3,100.0
394,3/20/2018 8:50,133,136,124,393,3,100.0
395,3/20/2018 8:55,161,148,137,446,3,100.0
396,3/20/2018 9:00,169,170,137,476,3,100.0
397,3/20/2018 9:05,162,145,114,421,3,100.0
398,3/20/2018 9:10,164,136,97,397,3,100.0
399,3/20/2018 9:15,182,140,97,419,3,100.0
400,3/20/2018 9:20,176,145,111,432,3,100.0
401,3/20/2018 9:25,177,133,109,419,3,100.0
402,3/20/2018 9:30,160,143,90,393,3,100.0
403,3/20/2018 9:35,158,141,110,409,3,100.0
404,3/20/2018 9:40,173,139,92,404,3,100.0
405,3/20/2018 9:45,171,143,113,427,3,100.0
406,3/20/2018 9:50,142,125,76,343,3,100.0
407,3/20/2018 9:55,165,132,98,395,3,100.0
408,3/20/2018 10:00,152,131,89,372,3,100.0
409,3/20/2018 10:05,130,113,74,317,3,100.0
410,3/20/2018 10:10,153,130,98,381,3,100.0
411,3/20/2018 10:15,163,165,94,422,3,100.0
412,3/20/2018 10:20,178,154,119,451,3,100.0
413,3/20/2018 10:25,192,156,110,458,3,100.0
414,3/20/2018 10:30,182,151,116,449,3,100.0
415,3/20/2018 10:35,177,150,111,438,3,100.0
416,3/20/2018 10:40,200,177,114,491,3,100.0
417,3/20/2018 10:45,157,134,97,388,3,100.0
418,3/20/2018 10:50,170,148,117,435,3,100.0
419,3/20/2018 10:55,173,147,106,426,3,100.0
420,3/20/2018 11:00,176,149,120,445,3,100.0
421,3/20/2018 11:05,160,145,97,402,3,100.0
422,3/20/2018 11:10,166,149,95,410,3,100.0
423,3/20/2018 11:15,176,156,112,444,3,100.0
424,3/20/2018 11:20,154,133,87,374,3,100.0
425,3/20/2018 11:25,142,135,101,378,3,100.0
426,3/20/2018 11:30,180,161,126,467,3,100.0
427,3/20/2018 11:35,172,163,114,449,3,100.0
428,3/20/2018 11:40,168,175,129,472,3,100.0
429,3/20/2018 11:45,170,153,105,428,3,100.0
430,3/20/2018 11:50,174,154,115,443,3,100.0
431,3/20/2018 11:55,170,167,123,460,3,100.0
432,3/20/2018 12:00,139,141,107,387,3,100.0
433,3/20/2018 12:05,137,130,92,359,3,100.0
434,3/20/2018 12:10,155,137,100,392,3,100.0
435,3/20/2018 12:15,149,118,100,367,3,100.0
436,3/20/2018 12:20,109,106,79,294,3,100.0
437,3/20/2018 12:25,155,158,130,443,3,100.0
438,3/20/2018 12:30,175,155,114,444,3,100.0
439,3/20/2018 12:35,164,156,110,430,3,100.0
440,3/20/2018 12:40,174,168,126,468,3,100.0
441,3/20/2018 12:45,167,160,147,474,3,100.0
442,3/20/2018 12:50,176,171,132,479,3,100.0
443,3/20/2018 12:55,183,174,127,484,3,100.0
444,3/20/2018 13:00,162,165,119,446,3,100.0
445,3/20/2018 13:05,172,167,123,462,3,100.0
446,3/20/2018 13:10,177,171,120,468,3,100.0
447,3/20/2018 13:15,179,155,127,461,3,100.0
448,3/20/2018 13:20,158,149,104,411,3,100.0
449,3/20/2018 13:25,174,162,129,465,3,100.0
450,3/20/2018 13:30,179,165,132,476,3,100.0
451,3/20/2018 13:35,167,158,118,443,3,100.0
452,3/20/2018 13:40,149,153,133,435,3,100.0
453,3/20/2018 13:45,145,139,128,412,3,100.0
454,3/20/2018 13:50,174,162,136,472,3,100.0
455,3/20/2018 13:55,144,140,110,394,3,100.0
456,3/20/2018 14:00,149,131,119,399,3,100.0
457,3/20/2018 14:05,176,180,153,509,3,100.0
458,3/20/2018 14:10,168,167,140,475,3,100.0
459,3/20/2018 14:15,169,159,141,469,3,100.0
460,3/20/2018 14:20,170,158,147,475,3,100.0
461,3/20/2018 14:25,155,149,140,444,3,100.0
462,3/20/2018 14:30,176,163,151,490,3,100.0
463,3/20/2018 14:35,175,170,147,492,3,100.0
464,3/20/2018 14:40,176,171,137,484,3,100.0
465,3/20/2018 14:45,185,173,165,523,3,100.0
466,3/20/2018 14:50,166,176,151,493,3,100.0
467,3/20/2018 14:55,140,140,132,412,3,100.0
468,3/20/2018 15:00,183,168,149,500,3,100.0
469,3/20/2018 15:05,156,153,130,439,3,100.0
470,3/20/2018 15:10,159,168,143,470,3,100.0
471,3/20/2018 15:15,171,170,146,487,3,100.0
472,3/20/2018 15:20,170,158,152,480,3,100.0
473,3/20/2018 15:25,178,170,140,488,3,100.0
474,3/20/2018 15:30,172,152,136,460,3,100.0
475,3/20/2018 15:35,161,148,133,442,3,100.0
476,3/20/2018 15:40,124,147,133,404,3,100.0
477,3/20/2018 15:45,155,152,143,450,3,100.0
478,3/20/2018 15:50,161,162,153,476,3,100.0
479,3/20/2018 15:55,162,154,155,471,3,100.0
480,3/20/2018 16:00,159,160,138,457,3,100.0
481,3/20/2018 16:05,152,145,144,441,3,100.0
482,3/20/2018 16:10,154,152,135,441,3,100.0
483,3/20/2018 16:15,163,154,152,469,3,100.0
484,3/20/2018 16:20,163,160,151,474,3,100.0
485,3/20/2018 16:25,161,160,150,471,3,100.0
486,3/20/2018 16:30,155,146,139,440,3,100.0
487,3/20/2018 16:35,153,155,151,459,3,100.0
488,3/20/2018 16:40,159,161,147,467,3,100.0
489,3/20/2018 16:45,158,150,139,447,3,100.0
490,3/20/2018 16:50,150,144,129,423,3,100.0
491,3/20/2018 16:55,159,167,145,471,3,100.0
492,3/20/2018 17:00,148,140,132,420,3,100.0
493,3/20/2018 17:05,147,146,139,432,3,100.0
494,3/20/2018 17:10,146,141,136,423,3,100.0
495,3/20/2018 17:15,165,151,150,466,3,100.0
496,3/20/2018 17:20,156,157,154,467,3,100.0
497,3/20/2018 17:25,176,162,143,481,3,100.0
498,3/20/2018 17:30,168,148,140,456,3,100.0
499,3/20/2018 17:35,172,162,151,485,3,100.0
500,3/20/2018 17:40,159,162,137,458,3,100.0
501,3/20/2018 17:45,160,157,144,461,3,100.0
502,3/20/2018 17:50,160,159,148,467,3,100.0
503,3/20/2018 17:55,131,133,141,405,3,100.0
504,3/20/2018 18:00,161,161,147,469,3,100.0
505,3/20/2018 18:05,159,147,139,445,3,100.0
506,3/20/2018 18:10,161,143,142,446,3,100.0
507,3/20/2018 18:15,162,154,149,465,3,100.0
508,3/20/2018 18:20,171,163,150,484,3,100.0
509,3/20/2018 18:25,149,162,140,451,3,100.0
510,3/20/2018 18:30,158,152,147,457,3,100.0
511,3/20/2018 18:35,164,169,158,491,3,100.0
512,3/20/2018 18:40,165,155,144,464,3,100.0
513,3/20/2018 18:45,170,168,147,485,3,100.0
514,3/20/2018 18:50,166,151,148,465,3,100.0
515,3/20/2018 18:55,165,161,145,471,3,100.0
516,3/20/2018 19:00,161,154,143,458,3,100.0
517,3/20/2018 19:05,158,152,146,456,3,100.0
518,3/20/2018 19:10,170,164,146,480,3,100.0
519,3/20/2018 19:15,155,151,145,451,3,100.0
520,3/20/2018 19:20,167,150,136,453,3,100.0
521,3/20/2018 19:25,166,156,135,457,3,100.0
522,3/20/2018 19:30,160,150,145,455,3,100.0
523,3/20/2018 19:35,167,153,136,456,3,100.0
524,3/20/2018 19:40,161,163,116,440,3,100.0
525,3/20/2018 19:45,140,154,136,430,3,100.0
526,3/20/2018 19:50,153,164,117,434,3,100.0
527,3/20/2018 19:55,165,149,131,445,3,100.0
528,3/20/2018 20:00,158,146,129,433,3,100.0
529,3/20/2018 20:05,166,153,132,451,3,100.0
530,3/20/2018 20:10,167,144,120,431,3,100.0
531,3/20/2018 20:15,151,137,107,395,3,100.0
532,3/20/2018 20:20,142,129,105,376,3,100.0
533,3/20/2018 20:25,152,133,103,388,3,100.0
534,3/20/2018 20:30,119,123,85,327,3,100.0
535,3/20/2018 20:35,153,128,109,390,3,100.0
536,3/20/2018 20:40,120,118,75,313,3,100.0
537,3/20/2018 20:45,136,110,94,340,3,100.0
538,3/20/2018 20:50,116,114,74,304,3,100.0
539,3/20/2018 20:55,117,105,83,305,3,100.0
540,3/20/2018 21:00,110,116,79,305,3,100.0
541,3/20/2018 21:05,119,111,87,317,3,100.0
542,3/20/2018 21:10,127,118,96,341,3,100.0
543,3/20/2018 21:15,126,111,72,309,3,100.0
544,3/20/2018 21:20,130,117,75,322,3,100.0
545,3/20/2018 21:25,122,117,94,333,3,100.0
546,3/20/2018 21:30,117,114,88,319,3,100.0
547,3/20/2018 21:35,131,114,77,322,3,100.0
548,3/20/2018 21:40,101,98,84,283,3,100.0
549,3/20/2018 21:45,111,89,70,270,3,100.0
550,3/20/2018 21:50,101,96,60,257,3,100.0
551,3/20/2018 21:55,85,85,73,243,3,100.0
552,3/20/2018 22:00,100,90,76,266,3,100.0
553,3/20/2018 22:05,111,93,69,273,3,100.0
554,3/20/2018 22:10,99,94,69,262,3,100.0
555,3/20/2018 22:15,102,91,77,270,3,100.0
556,3/20/2018 22:20,89,89,69,247,3,100.0
557,3/20/2018 22:25,84,87,54,225,3,100.0
558,3/20/2018 22:30,71,89,56,216,3,100.0
559,3/20/2018 22:35,83,75,69,227,3,100.0
560,3/20/2018 22:40,75,75,57,207,3,100.0
561,3/20/2018 22:45,83,72,60,215,3,100.0
562,3/20/2018 22:50,76,74,50,200,3,100.0
563,3/20/2018 22:55,58,60,47,165,3,100.0
564,3/20/2018 23:00,62,68,44,174,3,100.0
565,3/20/2018 23:05,69,61,42,172,3,100.0
566,3/20/2018 23:10,68,64,49,181,3,100.0
567,3/20/2018 23:15,69,74,46,189,3,100.0
568,3/20/2018 23:20,47,60,41,148,3,100.0
569,3/20/2018 23:25,46,71,40,157,3,100.0
570,3/20/2018 23:30,63,49,38,150,3,100.0
571,3/20/2018 23:35,54,58,38,150,3,100.0
572,3/20/2018 23:40,53,64,41,158,3,100.0
573,3/20/2018 23:45,52,66,43,161,3,100.0
574,3/20/2018 23:50,38,42,36,116,3,100.0
575,3/20/2018 23:55,48,50,30,128,3,100.0
576,3/21/2018 0:00,48,55,25,128,3,100.0
577,3/21/2018 0:05,47,43,32,122,3,100.0
578,3/21/2018 0:10,41,47,29,117,3,100.0
579,3/21/2018 0:15,44,42,36,122,3,100.0
580,3/21/2018 0:20,36,41,27,104,3,100.0
581,3/21/2018 0:25,30,42,27,99,3,100.0
582,3/21/2018 0:30,32,53,25,110,3,100.0
583,3/21/2018 0:35,33,39,28,100,3,100.0
584,3/21/2018 0:40,28,26,18,72,3,100.0
585,3/21/2018 0:45,26,37,24,87,3,100.0
586,3/21/2018 0:50,27,34,23,84,3,100.0
587,3/21/2018 0:55,24,31,20,75,3,100.0
588,3/21/2018 1:00,14,31,20,65,3,100.0
589,3/21/2018 1:05,19,38,23,80,3,100.0
590,3/21/2018 1:10,15,25,18,58,3,100.0
591,3/21/2018 1:15,20,24,20,64,3,100.0
592,3/21/2018 1:20,28,20,18,66,3,100.0
593,3/21/2018 1:25,16,28,16,60,3,100.0
594,3/21/2018 1:30,21,24,21,66,3,100.0
595,3/21/2018 1:35,22,29,18,69,3,100.0
596,3/21/2018 1:40,21,22,15,58,3,100.0
597,3/21/2018 1:45,19,26,19,64,3,100.0
598,3/21/2018 1:50,11,21,17,49,3,100.0
599,3/21/2018 1:55,19,30,18,67,3,100.0
600,3/21/2018 2:00,13,31,20,64,3,100.0
601,3/21/2018 2:05,16,29,19,64,3,100.0
602,3/21/2018 2:10,17,24,14,55,3,100.0
603,3/21/2018 2:15,19,29,16,64,3,100.0
604,3/21/2018 2:20,15,27,17,59,3,100.0
605,3/21/2018 2:25,11,21,24,56,3,100.0
606,3/21/2018 2:30,20,31,24,75,3,100.0
607,3/21/2018 2:35,21,22,26,69,3,100.0
608,3/21/2018 2:40,9,18,17,44,3,100.0
609,3/21/2018 2:45,11,20,21,52,3,100.0
610,3/21/2018 2:50,11,21,18,50,3,100.0
611,3/21/2018 2:55,12,20,10,42,3,100.0
612,3/21/2018 3:00,5,13,10,28,3,100.0
613,3/21/2018 3:05,7,13,11,31,3,100.0
614,3/21/2018 3:10,7,20,16,43,3,100.0
615,3/21/2018 3:15,10,17,14,41,3,100.0
616,3/21/2018 3:20,15,15,17,47,3,100.0
617,3/21/2018 3:25,10,19,16,45,3,100.0
618,3/21/2018 3:30,9,24,13,46,3,100.0
619,3/21/2018 3:35,17,28,19,64,3,100.0
620,3/21/2018 3:40,12,25,19,56,3,100.0
621,3/21/2018 3:45,16,17,15,48,3,100.0
622,3/21/2018 3:50,12,33,25,70,3,100.0
623,3/21/2018 3:55,22,30,19,71,3,100.0
624,3/21/2018 4:00,20,28,20,68,3,100.0
625,3/21/2018 4:05,15,23,16,54,3,100.0
626,3/21/2018 4:10,18,26,18,62,3,100.0
627,3/21/2018 4:15,32,38,26,96,3,100.0
628,3/21/2018 4:20,30,31,28,89,3,100.0
629,3/21/2018 4:25,37,40,30,107,3,100.0
630,3/21/2018 4:30,32,39,25,96,3,100.0
631,3/21/2018 4:35,43,40,28,111,3,100.0
632,3/21/2018 4:40,34,44,26,104,3,100.0
633,3/21/2018 4:45,41,41,36,118,3,100.0
634,3/21/2018 4:50,44,55,29,128,3,100.0
635,3/21/2018 4:55,43,48,29,120,3,100.0
636,3/21/2018 5:00,46,68,35,149,3,100.0
637,3/21/2018 5:05,51,56,39,146,3,100.0
638,3/21/2018 5:10,82,80,44,206,3,100.0
639,3/21/2018 5:15,85,84,53,222,3,100.0
640,3/21/2018 5:20,91,89,58,238,3,100.0
641,3/21/2018 5:25,106,93,61,260,3,100.0
642,3/21/2018 5:30,117,112,49,278,3,100.0
643,3/21/2018 5:35,133,113,64,310,3,100.0
644,3/21/2018 5:40,136,109,67,312,3,100.0
645,3/21/2018 5:45,153,120,73,346,3,100.0
646,3/21/2018 5:50,148,106,77,331,3,100.0
647,3/21/2018 5:55,145,125,68,338,3,100.0
648,3/21/2018 6:00,138,123,79,340,3,100.0
649,3/21/2018 6:05,117,90,64,271,3,100.0
650,3/21/2018 6:10,182,128,94,404,3,100.0
651,3/21/2018 6:15,146,119,88,353,3,100.0
652,3/21/2018 6:20,144,128,81,353,3,100.0
653,3/21/2018 6:25,163,132,85,380,3,100.0
654,3/21/2018 6:30,151,130,94,375,3,100.0
655,3/21/2018 6:35,168,145,112,425,3,100.0
656,3/21/2018 6:40,177,157,109,443,3,100.0
657,3/21/2018 6:45,168,155,111,434,3,100.0
658,3/21/2018 6:50,182,152,108,442,3,100.0
659,3/21/2018 6:55,186,162,101,449,3,100.0
660,3/21/2018 7:00,162,145,101,408,3,100.0
661,3/21/2018 7:05,189,163,121,473,3,100.0
662,3/21/2018 7:10,199,170,122,491,3,100.0
663,3/21/2018 7:15,203,178,138,519,3,100.0
664,3/21/2018 7:20,204,170,117,491,3,100.0
665,3/21/2018 7:25,180,160,149,489,3,100.0
666,3/21/2018 7:30,185,184,156,525,3,100.0
667,3/21/2018 7:35,183,170,124,477,3,100.0
668,3/21/2018 7:40,196,163,145,504,3,100.0
669,3/21/2018 7:45,188,169,125,482,3,100.0
670,3/21/2018 7:50,164,141,114,419,3,100.0
671,3/21/2018 7:55,174,165,127,466,3,100.0
672,3/21/2018 8:00,185,163,152,500,3,100.0
673,3/21/2018 8:05,183,171,137,491,3,100.0
674,3/21/2018 8:10,180,157,128,465,3,100.0
675,3/21/2018 8:15,149,145,130,424,3,100.0
676,3/21/2018 8:20,193,170,138,501,3,100.0
677,3/21/2018 8:25,172,151,125,448,3,100.0
678,3/21/2018 8:30,182,152,122,456,3,100.0
679,3/21/2018 8:35,188,150,128,466,3,100.0
680,3/21/2018 8:40,199,164,120,483,3,100.0
681,3/21/2018 8:45,193,157,130,480,3,100.0
682,3/21/2018 8:50,185,168,126,479,3,100.0
683,3/21/2018 8:55,188,170,120,478,3,100.0
684,3/21/2018 9:00,172,156,106,434,3,100.0
685,3/21/2018 9:05,176,156,110,442,3,100.0
686,3/21/2018 9:10,179,155,107,441,3,100.0
687,3/21/2018 9:15,178,144,107,429,3,100.0
688,3/21/2018 9:20,153,129,101,383,3,100.0
689,3/21/2018 9:25,190,172,130,492,3,100.0
690,3/21/2018 9:30,181,155,98,434,3,100.0
691,3/21/2018 9:35,181,148,111,440,3,100.0
692,3/21/2018 9:40,155,138,82,375,3,100.0
693,3/21/2018 9:45,152,135,94,381,3,100.0
694,3/21/2018 9:50,174,141,104,419,3,100.0
695,3/21/2018 9:55,167,139,106,412,3,100.0
696,3/21/2018 10:00,158,137,108,403,3,100.0
697,3/21/2018 10:05,128,127,81,336,3,100.0
698,3/21/2018 10:10,140,141,81,362,3,100.0
699,3/21/2018 10:15,161,145,104,410,3,100.0
700,3/21/2018 10:20,165,131,97,393,3,100.0
701,3/21/2018 10:25,149,143,89,381,3,100.0
702,3/21/2018 10:30,182,155,119,456,3,100.0
703,3/21/2018 10:35,165,141,107,413,3,100.0
704,3/21/2018 10:40,183,153,98,434,3,100.0
705,3/21/2018 10:45,184,143,98,425,3,100.0
706,3/21/2018 10:50,150,126,103,379,3,100.0
707,3/21/2018 10:55,164,152,98,414,3,100.0
708,3/21/2018 11:00,173,148,109,430,3,100.0
709,3/21/2018 11:05,160,155,108,423,3,100.0
710,3/21/2018 11:10,183,166,116,465,3,100.0
711,3/21/2018 11:15,170,155,104,429,3,100.0
712,3/21/2018 11:20,182,143,103,428,3,100.0
713,3/21/2018 11:25,132,117,91,340,3,100.0
714,3/21/2018 11:30,154,149,112,415,3,100.0
715,3/21/2018 11:35,140,134,92,366,3,100.0
716,3/21/2018 11:40,162,143,103,408,3,100.0
717,3/21/2018 11:45,144,130,111,385,3,100.0
718,3/21/2018 11:50,151,148,112,411,3,100.0
719,3/21/2018 11:55,143,148,107,398,3,100.0
720,3/21/2018 12:00,157,151,100,408,3,100.0
721,3/21/2018 12:05,172,151,110,433,3,100.0
722,3/21/2018 12:10,172,150,105,427,3,100.0
723,3/21/2018 12:15,172,159,112,443,3,100.0
724,3/21/2018 12:20,160,141,116,417,3,100.0
725,3/21/2018 12:25,179,162,119,460,3,100.0
726,3/21/2018 12:30,159,159,101,419,3,100.0
727,3/21/2018 12:35,151,131,98,380,3,100.0
728,3/21/2018 12:40,156,138,94,388,3,100.0
729,3/21/2018 12:45,138,126,106,370,3,100.0
730,3/21/2018 12:50,143,138,118,399,3,100.0
731,3/21/2018 12:55,150,131,116,397,3,100.0
732,3/21/2018 13:00,130,119,104,353,3,100.0
733,3/21/2018 13:05,144,123,111,378,3,100.0
734,3/21/2018 13:10,157,131,121,409,3,100.0
735,3/21/2018 13:15,147,131,106,384,3,100.0
736,3/21/2018 13:20,151,148,107,406,3,100.0
737,3/21/2018 13:25,148,133,123,404,3,100.0
738,3/21/2018 13:30,136,129,124,389,3,100.0
739,3/21/2018 13:35,159,166,129,454,3,100.0
740,3/21/2018 13:40,173,173,142,488,3,100.0
741,3/21/2018 13:45,184,173,149,506,3,100.0
742,3/21/2018 13:50,172,168,154,494,3,100.0
743,3/21/2018 13:55,153,143,132,428,3,100.0
744,3/21/2018 14:00,187,168,144,499,3,100.0
745,3/21/2018 14:05,178,177,141,496,3,100.0
746,3/21/2018 14:10,173,145,138,456,3,100.0
747,3/21/2018 14:15,173,162,128,463,3,100.0
748,3/21/2018 14:20,143,139,121,403,3,100.0
749,3/21/2018 14:25,160,164,147,471,3,100.0
750,3/21/2018 14:30,161,152,134,447,3,100.0
751,3/21/2018 14:35,159,154,141,454,3,100.0
752,3/21/2018 14:40,161,154,137,452,3,100.0
753,3/21/2018 14:45,155,152,134,441,3,100.0
754,3/21/2018 14:50,170,160,135,465,3,100.0
755,3/21/2018 14:55,156,146,139,441,3,100.0
756,3/21/2018 15:00,151,156,146,453,3,100.0
757,3/21/2018 15:05,165,168,156,489,3,100.0
758,3/21/2018 15:10,173,151,144,468,3,100.0
759,3/21/2018 15:15,143,139,138,420,3,100.0
760,3/21/2018 15:20,93,102,106,301,3,100.0
761,3/21/2018 15:25,128,122,117,367,3,100.0
762,3/21/2018 15:30,162,146,144,452,3,100.0
763,3/21/2018 15:35,143,140,129,412,3,100.0
764,3/21/2018 15:40,158,154,138,450,3,100.0
765,3/21/2018 15:45,140,143,128,411,3,100.0
766,3/21/2018 15:50,126,117,129,372,3,100.0
767,3/21/2018 15:55,152,158,139,449,3,100.0
768,3/21/2018 16:00,170,158,153,481,3,100.0
769,3/21/2018 16:05,132,136,132,400,3,100.0
770,3/21/2018 16:10,170,163,137,470,3,100.0
771,3/21/2018 16:15,165,159,138,462,3,100.0
772,3/21/2018 16:20,148,147,148,443,3,100.0
773,3/21/2018 16:25,166,166,172,504,3,100.0
774,3/21/2018 16:30,153,140,135,428,3,100.0
775,3/21/2018 16:35,138,142,131,411,3,100.0
776,3/21/2018 16:40,125,118,114,357,3,100.0
777,3/21/2018 16:45,139,139,128,406,3,100.0
778,3/21/2018 16:50,86,97,100,283,3,100.0
779,3/21/2018 16:55,100,108,108,316,3,100.0
780,3/21/2018 17:00,96,98,94,288,3,100.0
781,3/21/2018 17:05,109,117,125,351,3,100.0
782,3/21/2018 17:10,88,99,100,287,3,100.0
783,3/21/2018 17:15,124,120,119,363,3,100.0
784,3/21/2018 17:20,139,147,156,442,3,100.0
785,3/21/2018 17:25,163,157,148,468,3,100.0
786,3/21/2018 17:30,145,139,136,420,3,100.0
787,3/21/2018 17:35,150,146,142,438,3,100.0
788,3/21/2018 17:40,166,153,147,466,3,100.0
789,3/21/2018 17:45,159,149,135,443,3,100.0
790,3/21/2018 17:50,157,153,149,459,3,100.0
791,3/21/2018 17:55,171,158,154,483,3,100.0
792,3/21/2018 18:00,136,138,130,404,3,100.0
793,3/21/2018 18:05,163,153,147,463,3,100.0
794,3/21/2018 18:10,179,173,156,508,3,100.0
795,3/21/2018 18:15,172,174,152,498,3,100.0
796,3/21/2018 18:20,179,177,157,513,3,100.0
797,3/21/2018 18:25,163,173,131,467,3,100.0
798,3/21/2018 18:30,169,169,157,495,3,100.0
799,3/21/2018 18:35,167,161,140,468,3,100.0
800,3/21/2018 18:40,164,159,151,474,3,100.0
801,3/21/2018 18:45,178,161,145,484,3,100.0
802,3/21/2018 18:50,173,162,157,492,3,100.0
803,3/21/2018 18:55,167,153,149,469,3,100.0
804,3/21/2018 19:00,173,160,143,476,3,100.0
805,3/21/2018 19:05,154,148,134,436,3,100.0
806,3/21/2018 19:10,162,151,142,455,3,100.0
807,3/21/2018 19:15,158,154,131,443,3,100.0
808,3/21/2018 19:20,158,146,109,413,3,100.0
809,3/21/2018 19:25,168,149,109,426,3,100.0
810,3/21/2018 19:30,150,132,94,376,3,100.0
811,3/21/2018 19:35,134,142,116,392,3,100.0
812,3/21/2018 19:40,124,108,97,329,3,100.0
813,3/21/2018 19:45,164,135,109,408,3,100.0
814,3/21/2018 19:50,157,140,123,420,3,100.0
815,3/21/2018 19:55,129,119,109,357,3,100.0
816,3/21/2018 20:00,137,118,100,355,3,100.0
817,3/21/2018 20:05,131,137,83,351,3,100.0
818,3/21/2018 20:10,128,125,97,350,3,100.0
819,3/21/2018 20:15,134,134,91,359,3,100.0
820,3/21/2018 20:20,105,113,91,309,3,100.0
821,3/21/2018 20:25,135,127,94,356,3,100.0
822,3/21/2018 20:30,137,126,85,348,3,100.0
823,3/21/2018 20:35,131,122,101,354,3,100.0
824,3/21/2018 20:40,134,129,91,354,3,100.0
825,3/21/2018 20:45,140,117,97,354,3,100.0
826,3/21/2018 20:50,103,94,77,274,3,100.0
827,3/21/2018 20:55,134,111,78,323,3,100.0
828,3/21/2018 21:00,127,120,83,330,3,100.0
829,3/21/2018 21:05,129,120,72,321,3,100.0
830,3/21/2018 21:10,122,117,89,328,3,100.0
831,3/21/2018 21:15,119,112,78,309,3,100.0
832,3/21/2018 21:20,120,108,84,312,3,100.0
833,3/21/2018 21:25,124,109,83,316,3,100.0
834,3/21/2018 21:30,120,103,84,307,3,100.0
835,3/21/2018 21:35,94,86,72,252,3,100.0
836,3/21/2018 21:40,93,101,89,283,3,100.0
837,3/21/2018 21:45,115,99,85,299,3,100.0
838,3/21/2018 21:50,93,102,73,268,3,100.0
839,3/21/2018 21:55,113,100,69,282,3,100.0
840,3/21/2018 22:00,102,91,77,270,3,100.0
841,3/21/2018 22:05,87,82,65,234,3,100.0
842,3/21/2018 22:10,92,96,73,261,3,100.0
843,3/21/2018 22:15,85,86,67,238,3,100.0
844,3/21/2018 22:20,92,92,57,241,3,100.0
845,3/21/2018 22:25,96,93,77,266,3,100.0
846,3/21/2018 22:30,101,81,61,243,3,100.0
847,3/21/2018 22:35,93,83,62,238,3,100.0
848,3/21/2018 22:40,86,79,51,216,3,100.0
849,3/21/2018 22:45,70,73,61,204,3,100.0
850,3/21/2018 22:50,78,80,67,225,3,100.0
851,3/21/2018 22:55,71,70,39,180,3,100.0
852,3/21/2018 23:00,70,79,56,205,3,100.0
853,3/21/2018 23:05,62,66,49,177,3,100.0
854,3/21/2018 23:10,58,66,45,169,3,100.0
855,3/21/2018 23:15,64,63,34,161,3,100.0
856,3/21/2018 23:20,55,66,46,167,3,100.0
857,3/21/2018 23:25,66,59,38,163,3,100.0
858,3/21/2018 23:30,45,53,51,149,3,100.0
859,3/21/2018 23:35,46,53,39,138,3,100.0
860,3/21/2018 23:40,54,63,43,160,3,100.0
861,3/21/2018 23:45,63,54,44,161,3,100.0
862,3/21/2018 23:50,37,48,32,117,3,100.0
863,3/21/2018 23:55,37,46,28,111,3,100.0
864,3/22/2018 0:00,50,54,36,140,3,100.0
865,3/22/2018 0:05,35,47,35,117,3,100.0
866,3/22/2018 0:10,43,65,39,147,3,100.0
867,3/22/2018 0:15,36,36,39,111,3,100.0
868,3/22/2018 0:20,36,43,26,105,3,100.0
869,3/22/2018 0:25,36,40,29,105,3,100.0
870,3/22/2018 0:30,25,35,18,78,3,100.0
871,3/22/2018 0:35,33,44,30,107,3,100.0
872,3/22/2018 0:40,32,42,23,97,3,100.0
873,3/22/2018 0:45,33,36,20,89,3,100.0
874,3/22/2018 0:50,22,36,25,83,3,100.0
875,3/22/2018 0:55,38,41,20,99,3,100.0
876,3/22/2018 1:00,21,35,24,80,3,100.0
877,3/22/2018 1:05,24,31,22,77,3,100.0
878,3/22/2018 1:10,14,35,20,69,3,100.0
879,3/22/2018 1:15,20,35,33,88,3,100.0
880,3/22/2018 1:20,22,36,24,82,3,100.0
881,3/22/2018 1:25,31,33,17,81,3,100.0
882,3/22/2018 1:30,20,18,20,58,3,100.0
883,3/22/2018 1:35,20,29,18,67,3,100.0
884,3/22/2018 1:40,16,28,14,58,3,100.0
885,3/22/2018 1:45,14,29,13,56,3,100.0
886,3/22/2018 1:50,16,24,17,57,3,100.0
887,3/22/2018 1:55,14,23,18,55,3,100.0
888,3/22/2018 2:00,17,26,16,59,3,100.0
889,3/22/2018 2:05,25,21,19,65,3,100.0
890,3/22/2018 2:10,27,28,20,75,3,100.0
891,3/22/2018 2:15,16,22,20,58,3,100.0
892,3/22/2018 2:20,16,28,18,62,3,100.0
893,3/22/2018 2:25,17,18,14,49,3,100.0
894,3/22/2018 2:30,20,24,20,64,3,100.0
895,3/22/2018 2:35,15,23,10,48,3,100.0
896,3/22/2018 2:40,13,18,15,46,3,100.0
897,3/22/2018 2:45,7,18,12,37,3,100.0
898,3/22/2018 2:50,9,24,14,47,3,100.0
899,3/22/2018 2:55,14,17,15,46,3,100.0
900,3/22/2018 3:00,10,11,12,33,3,100.0
901,3/22/2018 3:05,7,22,15,44,3,100.0
902,3/22/2018 3:10,15,20,8,43,3,100.0
903,3/22/2018 3:15,12,17,17,46,3,100.0
904,3/22/2018 3:20,11,24,9,44,3,100.0
905,3/22/2018 3:25,12,20,11,43,3,100.0
906,3/22/2018 3:30,12,19,14,45,3,100.0
907,3/22/2018 3:35,10,22,13,45,3,100.0
908,3/22/2018 3:40,13,20,21,54,3,100.0
909,3/22/2018 3:45,18,26,18,62,3,100.0
910,3/22/2018 3:50,15,23,14,52,3,100.0
911,3/22/2018 3:55,8,23,15,46,3,100.0
912,3/22/2018 4:00,17,24,15,56,3,100.0
913,3/22/2018 4:05,16,22,19,57,3,100.0
914,3/22/2018 4:10,20,27,15,62,3,100.0
915,3/22/2018 4:15,26,40,22,88,3,100.0
916,3/22/2018 4:20,25,39,29,93,3,100.0
917,3/22/2018 4:25,41,33,21,95,3,100.0
918,3/22/2018 4:30,36,47,17,100,3,100.0
919,3/22/2018 4:35,34,44,28,106,3,100.0
920,3/22/2018 4:40,43,44,36,123,3,100.0
921,3/22/2018 4:45,39,39,28,106,3,100.0
922,3/22/2018 4:50,50,57,28,135,3,100.0
923,3/22/2018 4:55,31,50,20,101,3,100.0
924,3/22/2018 5:00,38,57,30,125,3,100.0
925,3/22/2018 5:05,65,66,36,167,3,100.0
926,3/22/2018 5:10,64,62,47,173,3,100.0
927,3/22/2018 5:15,78,85,43,206,3,100.0
928,3/22/2018 5:20,89,90,56,235,3,100.0
929,3/22/2018 5:25,117,86,54,257,3,100.0
930,3/22/2018 5:30,103,102,51,256,3,100.0
931,3/22/2018 5:35,115,91,63,269,3,100.0
932,3/22/2018 5:40,123,108,67,298,3,100.0
933,3/22/2018 5:45,114,92,63,269,3,100.0
934,3/22/2018 5:50,138,116,82,336,3,100.0
935,3/22/2018 5:55,148,119,73,340,3,100.0
936,3/22/2018 6:00,132,113,67,312,3,100.0
937,3/22/2018 6:05,147,113,71,331,3,100.0
938,3/22/2018 6:10,135,116,87,338,3,100.0
939,3/22/2018 6:15,137,121,77,335,3,100.0
940,3/22/2018 6:20,156,135,93,384,3,100.0
941,3/22/2018 6:25,169,147,97,413,3,100.0
942,3/22/2018 6:30,151,130,97,378,3,100.0
943,3/22/2018 6:35,153,126,86,365,3,100.0
944,3/22/2018 6:40,175,144,110,429,3,100.0
945,3/22/2018 6:45,169,156,117,442,3,100.0
946,3/22/2018 6:50,144,136,93,373,3,100.0
947,3/22/2018 6:55,175,152,112,439,3,100.0
948,3/22/2018 7:00,175,150,113,438,3,100.0
949,3/22/2018 7:05,181,139,91,411,3,100.0
950,3/22/2018 7:10,168,150,107,425,3,100.0
951,3/22/2018 7:15,174,153,118,445,3,100.0
952,3/22/2018 7:20,192,170,115,477,3,100.0
953,3/22/2018 7:25,184,158,128,470,3,100.0
954,3/22/2018 7:30,175,162,122,459,3,100.0
955,3/22/2018 7:35,173,166,118,457,3,100.0
956,3/22/2018 7:40,186,163,125,474,3,100.0
957,3/22/2018 7:45,182,161,124,467,3,100.0
958,3/22/2018 7:50,158,141,111,410,3,100.0
959,3/22/2018 7:55,168,159,117,444,3,100.0
960,3/22/2018 8:00,173,144,121,438,3,100.0
961,3/22/2018 8:05,156,138,105,399,3,100.0
962,3/22/2018 8:10,173,154,123,450,3,100.0
963,3/22/2018 8:15,167,157,122,446,3,100.0
964,3/22/2018 8:20,179,161,126,466,3,100.0
965,3/22/2018 8:25,167,158,126,451,3,100.0
966,3/22/2018 8:30,177,155,116,448,3,100.0
967,3/22/2018 8:35,167,153,131,451,3,100.0
968,3/22/2018 8:40,173,161,121,455,3,100.0
969,3/22/2018 8:45,168,164,123,455,3,100.0
970,3/22/2018 8:50,175,162,110,447,3,100.0
971,3/22/2018 8:55,173,143,123,439,3,100.0
972,3/22/2018 9:00,175,149,124,448,3,100.0
973,3/22/2018 9:05,172,135,93,400,3,100.0
974,3/22/2018 9:10,171,158,105,434,3,100.0
975,3/22/2018 9:15,184,145,117,446,3,100.0
976,3/22/2018 9:20,153,155,108,416,3,100.0
977,3/22/2018 9:25,164,150,114,428,3,100.0
978,3/22/2018 9:30,153,137,96,386,3,100.0
979,3/22/2018 9:35,158,137,97,392,3,100.0
980,3/22/2018 9:40,162,137,89,388,3,100.0
981,3/22/2018 9:45,159,121,97,377,3,100.0
982,3/22/2018 9:50,156,140,85,381,3,100.0
983,3/22/2018 9:55,144,128,94,366,3,100.0
984,3/22/2018 10:00,155,137,90,382,3,100.0
985,3/22/2018 10:05,140,135,95,370,3,100.0
986,3/22/2018 10:10,134,118,83,335,3,100.0
987,3/22/2018 10:15,152,147,115,414,3,100.0
988,3/22/2018 10:20,151,137,87,375,3,100.0
989,3/22/2018 10:25,156,130,108,394,3,100.0
990,3/22/2018 10:30,136,117,101,354,3,100.0
991,3/22/2018 10:35,144,125,111,380,3,100.0
992,3/22/2018 10:40,140,129,99,368,3,100.0
993,3/22/2018 10:45,129,102,99,330,3,100.0
994,3/22/2018 10:50,155,143,105,403,3,100.0
995,3/22/2018 10:55,155,142,115,412,3,100.0
996,3/22/2018 11:00,140,130,91,361,3,100.0
997,3/22/2018 11:05,159,127,89,375,3,100.0
998,3/22/2018 11:10,150,129,93,372,3,100.0
999,3/22/2018 11:15,153,138,102,393,3,100.0
1000,3/22/2018 11:20,135,132,92,359,3,100.0
1001,3/22/2018 11:25,175,139,112,426,3,100.0
1002,3/22/2018 11:30,153,136,100,389,3,100.0
1003,3/22/2018 11:35,146,135,103,384,3,100.0
1004,3/22/2018 11:40,151,153,110,414,3,100.0
1005,3/22/2018 11:45,151,143,108,402,3,100.0
1006,3/22/2018 11:50,163,143,112,418,3,100.0
1007,3/22/2018 11:55,133,133,92,358,3,100.0
1008,3/22/2018 12:00,160,139,109,408,3,100.0
1009,3/22/2018 12:05,155,139,116,410,3,100.0
1010,3/22/2018 12:10,153,138,110,401,3,100.0
1011,3/22/2018 12:15,171,150,98,419,3,100.0
1012,3/22/2018 12:20,160,136,112,408,3,100.0
1013,3/22/2018 12:25,157,142,116,415,3,100.0
1014,3/22/2018 12:30,147,137,96,380,3,100.0
1015,3/22/2018 12:35,149,143,103,395,3,100.0
1016,3/22/2018 12:40,137,132,108,377,3,100.0
1017,3/22/2018 12:45,144,143,111,398,3,100.0
1018,3/22/2018 12:50,140,135,108,383,3,100.0
1019,3/22/2018 12:55,159,141,109,409,3,100.0
1020,3/22/2018 13:00,144,137,98,379,3,100.0
1021,3/22/2018 13:05,146,137,105,388,3,100.0
1022,3/22/2018 13:10,152,138,117,407,3,100.0
1023,3/22/2018 13:15,153,141,112,406,3,100.0
1024,3/22/2018 13:20,147,129,128,404,3,100.0
1025,3/22/2018 13:25,144,140,114,398,3,100.0
1026,3/22/2018 13:30,148,140,115,403,3,100.0
1027,3/22/2018 13:35,163,140,114,417,3,100.0
1028,3/22/2018 13:40,151,145,118,414,3,100.0
1029,3/22/2018 13:45,162,156,150,468,3,100.0
1030,3/22/2018 13:50,150,149,123,422,3,100.0
1031,3/22/2018 13:55,160,156,134,450,3,100.0
1032,3/22/2018 14:00,161,149,137,447,3,100.0
1033,3/22/2018 14:05,152,148,129,429,3,100.0
1034,3/22/2018 14:10,137,134,118,389,3,100.0
1035,3/22/2018 14:15,159,147,137,443,3,100.0
1036,3/22/2018 14:20,164,155,138,457,3,100.0
1037,3/22/2018 14:25,163,160,141,464,3,100.0
1038,3/22/2018 14:30,166,159,144,469,3,100.0
1039,3/22/2018 14:35,156,156,140,452,3,100.0
1040,3/22/2018 14:40,159,148,136,443,3,100.0
1041,3/22/2018 14:45,152,147,121,420,3,100.0
1042,3/22/2018 14:50,162,157,156,475,3,100.0
1043,3/22/2018 14:55,163,162,154,479,3,100.0
1044,3/22/2018 15:00,173,178,148,499,3,100.0
1045,3/22/2018 15:05,181,176,156,513,3,100.0
1046,3/22/2018 15:10,160,147,130,437,3,100.0
1047,3/22/2018 15:15,164,169,137,470,3,100.0
1048,3/22/2018 15:20,172,170,137,479,3,100.0
1049,3/22/2018 15:25,168,173,140,481,3,100.0
1050,3/22/2018 15:30,157,176,139,472,3,100.0
1051,3/22/2018 15:35,174,164,148,486,3,100.0
1052,3/22/2018 15:40,181,170,150,501,3,100.0
1053,3/22/2018 15:45,177,176,149,502,3,100.0
1054,3/22/2018 15:50,176,162,149,487,3,100.0
1055,3/22/2018 15:55,174,180,158,512,3,100.0
1056,3/22/2018 16:00,171,169,153,493,3,100.0
1057,3/22/2018 16:05,171,163,150,484,3,100.0
1058,3/22/2018 16:10,181,170,163,514,3,100.0
1059,3/22/2018 16:15,183,173,138,494,3,100.0
1060,3/22/2018 16:20,156,150,142,448,3,100.0
1061,3/22/2018 16:25,171,160,133,464,3,100.0
1062,3/22/2018 16:30,176,162,148,486,3,100.0
1063,3/22/2018 16:35,151,152,136,439,3,100.0
1064,3/22/2018 16:40,158,155,142,455,3,100.0
1065,3/22/2018 16:45,152,147,137,436,3,100.0
1066,3/22/2018 16:50,143,140,123,406,3,100.0
1067,3/22/2018 16:55,146,143,116,405,3,100.0
1068,3/22/2018 17:00,158,146,122,426,3,100.0
1069,3/22/2018 17:05,136,152,114,402,3,100.0
1070,3/22/2018 17:10,134,138,120,392,3,100.0
1071,3/22/2018 17:15,159,157,143,459,3,100.0
1072,3/22/2018 17:20,161,161,144,466,3,100.0
1073,3/22/2018 17:25,143,147,150,440,3,100.0
1074,3/22/2018 17:30,171,156,142,469,3,100.0
1075,3/22/2018 17:35,150,157,142,449,3,100.0
1076,3/22/2018 17:40,161,161,136,458,3,100.0
1077,3/22/2018 17:45,166,144,132,442,3,100.0
1078,3/22/2018 17:50,163,160,136,459,3,100.0
1079,3/22/2018 17:55,143,145,133,421,3,100.0
1080,3/22/2018 18:00,153,154,142,449,3,100.0
1081,3/22/2018 18:05,148,160,148,456,3,100.0
1082,3/22/2018 18:10,145,145,118,408,3,100.0
1083,3/22/2018 18:15,171,157,140,468,3,100.0
1084,3/22/2018 18:20,159,166,136,461,3,100.0
1085,3/22/2018 18:25,167,151,138,456,3,100.0
1086,3/22/2018 18:30,166,155,139,460,3,100.0
1087,3/22/2018 18:35,156,156,139,451,3,100.0
1088,3/22/2018 18:40,179,171,131,481,3,100.0
1089,3/22/2018 18:45,163,149,126,438,3,100.0
1090,3/22/2018 18:50,156,145,122,423,3,100.0
1091,3/22/2018 18:55,154,157,113,424,3,100.0
1092,3/22/2018 19:00,164,162,120,446,3,100.0
1093,3/22/2018 19:05,172,154,123,449,3,100.0
1094,3/22/2018 19:10,148,115,97,360,3,100.0
1095,3/22/2018 19:15,163,141,120,424,3,100.0
1096,3/22/2018 19:20,141,140,118,399,3,100.0
1097,3/22/2018 19:25,133,132,100,365,3,100.0
1098,3/22/2018 19:30,161,133,112,406,3,100.0
1099,3/22/2018 19:35,142,141,106,389,3,100.0
1100,3/22/2018 19:40,141,134,106,381,3,100.0
1101,3/22/2018 19:45,149,147,109,405,3,100.0
1102,3/22/2018 19:50,140,134,99,373,3,100.0
1103,3/22/2018 19:55,148,135,109,392,3,100.0
1104,3/22/2018 20:00,137,123,98,358,3,100.0
1105,3/22/2018 20:05,124,114,89,327,3,100.0
1106,3/22/2018 20:10,137,140,97,374,3,100.0
1107,3/22/2018 20:15,131,117,95,343,3,100.0
1108,3/22/2018 20:20,139,125,109,373,3,100.0
1109,3/22/2018 20:25,127,129,83,339,3,100.0
1110,3/22/2018 20:30,131,119,89,339,3,100.0
1111,3/22/2018 20:35,106,123,84,313,3,100.0
1112,3/22/2018 20:40,119,110,90,319,3,100.0
1113,3/22/2018 20:45,129,119,79,327,3,100.0
1114,3/22/2018 20:50,129,117,75,321,3,100.0
1115,3/22/2018 20:55,116,111,89,316,3,100.0
1116,3/22/2018 21:00,114,115,76,305,3,100.0
1117,3/22/2018 21:05,113,108,84,305,3,100.0
1118,3/22/2018 21:10,121,114,78,313,3,100.0
1119,3/22/2018 21:15,128,124,74,326,3,100.0
1120,3/22/2018 21:20,126,122,86,334,3,100.0
1121,3/22/2018 21:25,122,123,99,344,3,100.0
1122,3/22/2018 21:30,107,113,83,303,3,100.0
1123,3/22/2018 21:35,113,101,59,273,3,100.0
1124,3/22/2018 21:40,125,122,81,328,3,100.0
1125,3/22/2018 21:45,118,114,79,311,3,100.0
1126,3/22/2018 21:50,108,109,74,291,3,100.0
1127,3/22/2018 21:55,118,109,81,308,3,100.0
1128,3/22/2018 22:00,118,108,61,287,3,100.0
1129,3/22/2018 22:05,117,103,57,277,3,100.0
1130,3/22/2018 22:10,119,98,74,291,3,100.0
1131,3/22/2018 22:15,136,126,85,347,3,100.0
1132,3/22/2018 22:20,105,93,71,269,3,100.0
1133,3/22/2018 22:25,99,93,82,274,3,100.0
1134,3/22/2018 22:30,106,100,73,279,3,100.0
1135,3/22/2018 22:35,89,88,65,242,3,100.0
1136,3/22/2018 22:40,75,72,51,198,3,100.0
1137,3/22/2018 22:45,86,93,57,236,3,100.0
1138,3/22/2018 22:50,86,76,57,219,3,100.0
1139,3/22/2018 22:55,86,86,59,231,3,100.0
1140,3/22/2018 23:00,76,74,49,199,3,100.0
1141,3/22/2018 23:05,77,80,49,206,3,100.0
1142,3/22/2018 23:10,73,67,46,186,3,100.0
1143,3/22/2018 23:15,72,68,46,186,3,100.0
1144,3/22/2018 23:20,62,63,42,167,3,100.0
1145,3/22/2018 23:25,68,76,44,188,3,100.0
1146,3/22/2018 23:30,75,66,35,176,3,100.0
1147,3/22/2018 23:35,49,65,30,144,3,100.0
1148,3/22/2018 23:40,64,59,33,156,3,100.0
1149,3/22/2018 23:45,70,64,48,182,3,100.0
1150,3/22/2018 23:50,63,67,53,183,3,100.0
1151,3/22/2018 23:55,77,72,32,181,3,100.0
1152,3/23/2018 0:00,61,61,37,159,3,100.0
1153,3/23/2018 0:05,61,68,31,160,3,100.0
1154,3/23/2018 0:10,30,50,35,115,3,100.0
1155,3/23/2018 0:15,53,50,26,129,3,100.0
1156,3/23/2018 0:20,50,32,35,117,3,100.0
1157,3/23/2018 0:25,51,54,37,142,3,100.0
1158,3/23/2018 0:30,51,60,29,140,3,100.0
1159,3/23/2018 0:35,36,36,30,102,3,100.0
1160,3/23/2018 0:40,40,51,39,130,3,100.0
1161,3/23/2018 0:45,32,49,18,99,3,100.0
1162,3/23/2018 0:50,32,38,14,84,3,100.0
1163,3/23/2018 0:55,38,44,32,114,3,100.0
1164,3/23/2018 1:00,25,37,21,83,3,100.0
1165,3/23/2018 1:05,40,40,23,103,3,100.0
1166,3/23/2018 1:10,28,39,24,91,3,100.0
1167,3/23/2018 1:15,35,33,28,96,3,100.0
1168,3/23/2018 1:20,31,44,26,101,3,100.0
1169,3/23/2018 1:25,22,33,20,75,3,100.0
1170,3/23/2018 1:30,24,36,22,82,3,100.0
1171,3/23/2018 1:35,22,33,19,74,3,100.0
1172,3/23/2018 1:40,25,32,18,75,3,100.0
1173,3/23/2018 1:45,33,34,11,78,3,100.0
1174,3/23/2018 1:50,19,34,19,72,3,100.0
1175,3/23/2018 1:55,26,39,20,85,3,100.0
1176,3/23/2018 2:00,19,22,22,63,3,100.0
1177,3/23/2018 2:05,28,33,19,80,3,100.0
1178,3/23/2018 2:10,25,27,18,70,3,100.0
1179,3/23/2018 2:15,19,36,27,82,3,100.0
1180,3/23/2018 2:20,18,30,14,62,3,100.0
1181,3/23/2018 2:25,19,32,21,72,3,100.0
1182,3/23/2018 2:30,18,28,13,59,3,100.0
1183,3/23/2018 2:35,17,16,14,47,3,100.0
1184,3/23/2018 2:40,10,28,21,59,3,100.0
1185,3/23/2018 2:45,16,24,21,61,3,100.0
1186,3/23/2018 2:50,21,23,14,58,3,100.0
1187,3/23/2018 2:55,10,17,12,39,3,100.0
1188,3/23/2018 3:00,19,22,18,59,3,100.0
1189,3/23/2018 3:05,17,23,19,59,3,100.0
1190,3/23/2018 3:10,17,25,20,62,3,100.0
1191,3/23/2018 3:15,15,23,22,60,3,100.0
1192,3/23/2018 3:20,18,23,16,57,3,100.0
1193,3/23/2018 3:25,14,20,17,51,3,100.0
1194,3/23/2018 3:30,20,27,21,68,3,100.0
1195,3/23/2018 3:35,21,25,23,69,3,100.0
1196,3/23/2018 3:40,18,19,14,51,3,100.0
1197,3/23/2018 3:45,17,26,19,62,3,100.0
1198,3/23/2018 3:50,20,26,16,62,3,100.0
1199,3/23/2018 3:55,14,21,22,57,3,100.0
1200,3/23/2018 4:00,17,27,23,67,3,100.0
1201,3/23/2018 4:05,15,24,17,56,3,0.0
1202,3/23/2018 4:10,20,30,21,71,3,0.0
1203,3/23/2018 4:15,23,34,16,73,3,100.0
1204,3/23/2018 4:20,33,40,25,98,3,100.0
1205,3/23/2018 4:25,41,41,29,111,3,100.0
1206,3/23/2018 4:30,31,48,22,101,3,100.0
1207,3/23/2018 4:35,46,46,32,124,3,100.0
1208,3/23/2018 4:40,29,43,28,100,3,100.0
1209,3/23/2018 4:45,55,48,39,142,3,100.0
1210,3/23/2018 4:50,37,56,28,121,3,100.0
1211,3/23/2018 4:55,39,53,32,124,3,100.0
1212,3/23/2018 5:00,50,55,35,140,3,100.0
1213,3/23/2018 5:05,53,59,43,155,3,100.0
1214,3/23/2018 5:10,74,74,44,192,3,100.0
1215,3/23/2018 5:15,78,78,54,210,3,100.0
1216,3/23/2018 5:20,107,74,61,242,3,100.0
1217,3/23/2018 5:25,101,73,49,223,3,100.0
1218,3/23/2018 5:30,118,95,56,269,3,100.0
1219,3/23/2018 5:35,106,99,64,269,3,100.0
1220,3/23/2018 5:40,138,119,74,331,3,100.0
1221,3/23/2018 5:45,123,104,68,295,3,100.0
1222,3/23/2018 5:50,114,95,62,271,3,100.0
1223,3/23/2018 5:55,119,103,67,289,3,100.0
1224,3/23/2018 6:00,124,103,78,305,3,100.0
1225,3/23/2018 6:05,146,100,89,335,3,100.0
1226,3/23/2018 6:10,142,122,74,338,3,100.0
1227,3/23/2018 6:15,157,146,84,387,3,100.0
1228,3/23/2018 6:20,157,131,78,366,3,100.0
1229,3/23/2018 6:25,158,125,75,358,3,100.0
1230,3/23/2018 6:30,150,124,84,358,3,100.0
1231,3/23/2018 6:35,152,130,104,386,3,100.0
1232,3/23/2018 6:40,140,143,87,370,3,100.0
1233,3/23/2018 6:45,172,151,113,436,3,100.0
1234,3/23/2018 6:50,139,108,88,335,3,100.0
1235,3/23/2018 6:55,180,150,115,445,3,100.0
1236,3/23/2018 7:00,169,144,103,416,3,100.0
1237,3/23/2018 7:05,153,135,100,388,3,100.0
1238,3/23/2018 7:10,163,146,98,407,3,100.0
1239,3/23/2018 7:15,183,149,113,445,3,100.0
1240,3/23/2018 7:20,178,157,122,457,3,100.0
1241,3/23/2018 7:25,196,171,128,495,3,100.0
1242,3/23/2018 7:30,185,162,123,470,3,100.0
1243,3/23/2018 7:35,183,173,127,483,3,100.0
1244,3/23/2018 7:40,204,188,138,530,3,100.0
1245,3/23/2018 7:45,178,157,123,458,3,100.0
1246,3/23/2018 7:50,188,170,121,479,3,100.0
1247,3/23/2018 7:55,175,162,116,453,3,100.0
1248,3/23/2018 8:00,152,146,120,418,3,100.0
1249,3/23/2018 8:05,140,133,122,395,3,100.0
1250,3/23/2018 8:10,177,170,134,481,3,100.0
1251,3/23/2018 8:15,147,144,108,399,3,100.0
1252,3/23/2018 8:20,193,161,121,475,3,100.0
1253,3/23/2018 8:25,172,155,102,429,3,100.0
1254,3/23/2018 8:30,179,168,135,482,3,100.0
1255,3/23/2018 8:35,176,131,110,417,3,100.0
1256,3/23/2018 8:40,171,166,111,448,3,100.0
1257,3/23/2018 8:45,177,152,107,436,3,100.0
1258,3/23/2018 8:50,179,140,119,438,3,100.0
1259,3/23/2018 8:55,172,149,114,435,3,100.0
1260,3/23/2018 9:00,188,170,121,479,3,100.0
1261,3/23/2018 9:05,194,152,115,461,3,100.0
1262,3/23/2018 9:10,157,134,97,388,3,100.0
1263,3/23/2018 9:15,149,132,96,377,3,100.0
1264,3/23/2018 9:20,157,142,98,397,3,100.0
1265,3/23/2018 9:25,156,136,79,371,3,100.0
1266,3/23/2018 9:30,159,139,107,405,3,100.0
1267,3/23/2018 9:35,180,158,117,455,3,100.0
1268,3/23/2018 9:40,183,138,102,423,3,100.0
1269,3/23/2018 9:45,159,147,115,421,3,100.0
1270,3/23/2018 9:50,161,137,99,397,3,100.0
1271,3/23/2018 9:55,163,154,102,419,3,100.0
1272,3/23/2018 10:00,150,141,90,381,3,100.0
1273,3/23/2018 10:05,157,141,99,397,3,100.0
1274,3/23/2018 10:10,163,157,99,419,3,100.0
1275,3/23/2018 10:15,169,142,96,407,3,100.0
1276,3/23/2018 10:20,173,147,103,423,3,100.0
1277,3/23/2018 10:25,182,143,105,430,3,100.0
1278,3/23/2018 10:30,189,166,130,485,3,100.0
1279,3/23/2018 10:35,169,157,112,438,3,100.0
1280,3/23/2018 10:40,171,154,117,442,3,100.0
1281,3/23/2018 10:45,184,166,139,489,3,100.0
1282,3/23/2018 10:50,183,167,102,452,3,100.0
1283,3/23/2018 10:55,166,144,105,415,3,100.0
1284,3/23/2018 11:00,142,135,98,375,3,100.0
1285,3/23/2018 11:05,158,144,100,402,3,100.0
1286,3/23/2018 11:10,164,164,118,446,3,100.0
1287,3/23/2018 11:15,152,138,118,408,3,100.0
1288,3/23/2018 11:20,164,164,123,451,3,100.0
1289,3/23/2018 11:25,174,161,105,440,3,100.0
1290,3/23/2018 11:30,156,157,114,427,3,100.0
1291,3/23/2018 11:35,184,158,119,461,3,100.0
1292,3/23/2018 11:40,192,166,129,487,3,100.0
1293,3/23/2018 11:45,176,165,115,456,3,100.0
1294,3/23/2018 11:50,186,170,135,491,3,100.0
1295,3/23/2018 11:55,194,160,117,471,3,100.0
1296,3/23/2018 12:00,171,167,100,438,3,100.0
1297,3/23/2018 12:05,173,154,109,436,3,100.0
1298,3/23/2018 12:10,182,168,123,473,3,100.0
1299,3/23/2018 12:15,177,165,111,453,3,100.0
1300,3/23/2018 12:20,173,157,123,453,3,100.0
1301,3/23/2018 12:25,174,164,132,470,3,100.0
1302,3/23/2018 12:30,182,171,128,481,3,100.0
1303,3/23/2018 12:35,179,169,123,471,3,100.0
1304,3/23/2018 12:40,159,144,111,414,3,100.0
1305,3/23/2018 12:45,172,175,124,471,3,100.0
1306,3/23/2018 12:50,147,146,130,423,3,100.0
1307,3/23/2018 12:55,157,142,131,430,3,100.0
1308,3/23/2018 13:00,158,162,123,443,3,100.0
1309,3/23/2018 13:05,177,173,120,470,3,100.0
1310,3/23/2018 13:10,188,186,134,508,3,100.0
1311,3/23/2018 13:15,156,139,134,429,3,100.0
1312,3/23/2018 13:20,159,154,132,445,3,100.0
1313,3/23/2018 13:25,160,144,130,434,3,100.0
1314,3/23/2018 13:30,156,144,127,427,3,100.0
1315,3/23/2018 13:35,163,154,150,467,3,100.0
1316,3/23/2018 13:40,185,175,141,501,3,100.0
1317,3/23/2018 13:45,164,177,134,475,3,100.0
1318,3/23/2018 13:50,171,178,150,499,3,100.0
1319,3/23/2018 13:55,157,150,136,443,3,100.0
1320,3/23/2018 14:00,177,162,142,481,3,100.0
1321,3/23/2018 14:05,171,174,151,496,3,100.0
1322,3/23/2018 14:10,170,159,135,464,3,100.0
1323,3/23/2018 14:15,154,143,139,436,3,100.0
1324,3/23/2018 14:20,151,140,124,415,3,100.0
1325,3/23/2018 14:25,172,162,145,479,3,0.0
1326,3/23/2018 14:30,157,150,135,442,3,0.0
1327,3/23/2018 14:35,154,150,134,438,3,0.0
1328,3/23/2018 14:40,160,157,142,459,3,0.0
1329,3/23/2018 14:45,154,147,125,426,3,0.0
1330,3/23/2018 14:50,140,138,124,402,3,0.0
1331,3/23/2018 14:55,160,150,136,446,3,0.0
1332,3/23/2018 15:00,148,145,130,423,3,0.0
1333,3/23/2018 15:05,154,153,136,443,3,0.0
1334,3/23/2018 15:10,165,155,139,459,3,0.0
1335,3/23/2018 15:15,155,153,138,446,3,0.0
1336,3/23/2018 15:20,157,145,135,437,3,0.0
1337,3/23/2018 15:25,157,148,131,436,3,0.0
1338,3/23/2018 15:30,160,149,136,445,3,0.0
1339,3/23/2018 15:35,146,132,125,403,3,0.0
1340,3/23/2018 15:40,144,143,132,419,3,0.0
1341,3/23/2018 15:45,141,143,127,411,3,0.0
1342,3/23/2018 15:50,137,131,133,401,3,0.0
1343,3/23/2018 15:55,150,140,129,419,3,0.0
1344,3/23/2018 16:00,135,133,127,395,3,0.0
1345,3/23/2018 16:05,132,126,122,380,3,0.0
1346,3/23/2018 16:10,145,135,133,413,3,0.0
1347,3/23/2018 16:15,155,142,133,430,3,0.0
1348,3/23/2018 16:20,133,136,128,397,3,0.0
1349,3/23/2018 16:25,136,131,125,392,3,0.0
1350,3/23/2018 16:30,138,138,134,410,3,0.0
1351,3/23/2018 16:35,140,133,134,407,3,0.0
1352,3/23/2018 16:40,142,135,136,413,3,0.0
1353,3/23/2018 16:45,149,143,132,424,3,0.0
1354,3/23/2018 16:50,138,131,126,395,3,0.0
1355,3/23/2018 16:55,139,135,124,398,3,0.0
1356,3/23/2018 17:00,148,147,140,435,3,0.0
1357,3/23/2018 17:05,136,131,122,389,3,0.0
1358,3/23/2018 17:10,132,126,120,378,3,0.0
1359,3/23/2018 17:15,145,136,133,414,3,0.0
1360,3/23/2018 17:20,130,135,130,395,3,0.0
1361,3/23/2018 17:25,140,137,134,411,3,0.0
1362,3/23/2018 17:30,131,130,125,386,3,0.0
1363,3/23/2018 17:35,134,131,120,385,3,0.0
1364,3/23/2018 17:40,138,131,130,399,3,0.0
1365,3/23/2018 17:45,143,133,128,404,3,0.0
1366,3/23/2018 17:50,150,142,135,427,3,0.0
1367,3/23/2018 17:55,152,143,131,426,3,0.0
1368,3/23/2018 18:00,146,134,130,410,3,0.0
1369,3/23/2018 18:05,146,143,127,416,3,0.0
1370,3/23/2018 18:10,147,139,129,415,3,0.0
1371,3/23/2018 18:15,145,135,135,415,3,100.0
1372,3/23/2018 18:20,137,129,135,401,3,100.0
1373,3/23/2018 18:25,161,146,131,438,3,100.0
1374,3/23/2018 18:30,157,141,149,447,3,100.0
1375,3/23/2018 18:35,160,154,140,454,3,100.0
1376,3/23/2018 18:40,147,161,155,463,3,100.0
1377,3/23/2018 18:45,154,160,157,471,3,100.0
1378,3/23/2018 18:50,157,159,137,453,3,100.0
1379,3/23/2018 18:55,131,140,126,397,3,100.0
1380,3/23/2018 19:00,160,159,154,473,3,100.0
1381,3/23/2018 19:05,155,157,148,460,3,100.0
1382,3/23/2018 19:10,171,175,145,491,3,100.0
1383,3/23/2018 19:15,157,165,150,472,3,100.0
1384,3/23/2018 19:20,169,163,140,472,3,100.0
1385,3/23/2018 19:25,162,163,129,454,3,100.0
1386,3/23/2018 19:30,153,144,127,424,3,100.0
1387,3/23/2018 19:35,160,141,122,423,3,100.0
1388,3/23/2018 19:40,58,74,88,220,3,100.0
1389,3/23/2018 19:45,52,69,82,203,3,100.0
1390,3/23/2018 19:50,121,122,116,359,3,100.0
1391,3/23/2018 19:55,125,135,119,379,3,100.0
1392,3/23/2018 20:00,132,136,119,387,3,100.0
1393,3/23/2018 20:05,147,149,133,429,3,100.0
1394,3/23/2018 20:10,141,138,129,408,3,100.0
1395,3/23/2018 20:15,148,152,127,427,3,100.0
1396,3/23/2018 20:20,139,133,119,391,3,100.0
1397,3/23/2018 20:25,149,141,129,419,3,100.0
1398,3/23/2018 20:30,149,138,138,425,3,100.0
1399,3/23/2018 20:35,89,107,75,271,3,100.0
1400,3/23/2018 20:40,58,64,56,178,3,100.0
1401,3/23/2018 20:45,86,88,61,235,3,100.0
1402,3/23/2018 20:50,102,98,89,289,3,100.0
1403,3/23/2018 20:55,116,113,84,313,3,100.0
1404,3/23/2018 21:00,148,122,93,363,3,100.0
1405,3/23/2018 21:05,151,134,109,394,3,100.0
1406,3/23/2018 21:10,141,144,111,396,3,100.0
1407,3/23/2018 21:15,163,157,123,443,3,100.0
1408,3/23/2018 21:20,158,136,116,410,3,100.0
1409,3/23/2018 21:25,165,152,127,444,3,100.0
1410,3/23/2018 21:30,151,143,124,418,3,100.0
1411,3/23/2018 21:35,153,143,131,427,3,100.0
1412,3/23/2018 21:40,141,141,137,419,3,100.0
1413,3/23/2018 21:45,131,114,108,353,3,100.0
1414,3/23/2018 21:50,143,135,140,418,3,100.0
1415,3/23/2018 21:55,142,140,112,394,3,100.0
1416,3/23/2018 22:00,153,128,99,380,3,100.0
1417,3/23/2018 22:05,140,128,89,357,3,100.0
1418,3/23/2018 22:10,130,122,97,349,3,100.0
1419,3/23/2018 22:15,138,132,94,364,3,100.0
1420,3/23/2018 22:20,127,109,80,316,3,100.0
1421,3/23/2018 22:25,140,116,84,340,3,100.0
1422,3/23/2018 22:30,100,102,78,280,3,100.0
1423,3/23/2018 22:35,123,107,89,319,3,100.0
1424,3/23/2018 22:40,130,123,72,325,3,100.0
1425,3/23/2018 22:45,105,108,79,292,3,100.0
1426,3/23/2018 22:50,117,107,67,291,3,100.0
1427,3/23/2018 22:55,95,100,51,246,3,100.0
1428,3/23/2018 23:00,107,91,72,270,3,100.0
1429,3/23/2018 23:05,103,99,60,262,3,100.0
1430,3/23/2018 23:10,98,101,68,267,3,100.0
1431,3/23/2018 23:15,91,95,59,245,3,100.0
1432,3/23/2018 23:20,106,109,65,280,3,100.0
1433,3/23/2018 23:25,84,93,57,234,3,100.0
1434,3/23/2018 23:30,90,88,64,242,3,100.0
1435,3/23/2018 23:35,67,67,56,190,3,100.0
1436,3/23/2018 23:40,84,83,63,230,3,100.0
1437,3/23/2018 23:45,82,87,52,221,3,100.0
1438,3/23/2018 23:50,91,86,57,234,3,100.0
1439,3/23/2018 23:55,66,70,57,193,3,100.0
1440,3/24/2018 0:00,64,62,38,164,3,100.0
1441,3/24/2018 0:05,44,58,42,144,3,100.0
1442,3/24/2018 0:10,45,49,41,135,3,100.0
1443,3/24/2018 0:15,49,58,52,159,3,100.0
1444,3/24/2018 0:20,54,66,55,175,3,100.0
1445,3/24/2018 0:25,65,78,55,198,3,100.0
1446,3/24/2018 0:30,48,53,47,148,3,100.0
1447,3/24/2018 0:35,53,55,29,137,3,100.0
1448,3/24/2018 0:40,62,66,39,167,3,100.0
1449,3/24/2018 0:45,49,44,33,126,3,100.0
1450,3/24/2018 0:50,48,56,35,139,3,100.0
1451,3/24/2018 0:55,50,49,36,135,3,100.0
1452,3/24/2018 1:00,38,50,30,118,3,100.0
1453,3/24/2018 1:05,40,36,27,103,3,100.0
1454,3/24/2018 1:10,40,47,29,116,3,100.0
1455,3/24/2018 1:15,51,48,33,132,3,100.0
1456,3/24/2018 1:20,47,53,34,134,3,100.0
1457,3/24/2018 1:25,29,44,20,93,3,100.0
1458,3/24/2018 1:30,34,40,29,103,3,100.0
1459,3/24/2018 1:35,30,41,31,102,3,100.0
1460,3/24/2018 1:40,22,36,25,83,3,100.0
1461,3/24/2018 1:45,35,37,24,96,3,100.0
1462,3/24/2018 1:50,22,41,20,83,3,100.0
1463,3/24/2018 1:55,28,33,30,91,3,100.0
1464,3/24/2018 2:00,33,41,27,101,3,100.0
1465,3/24/2018 2:05,26,37,23,86,3,100.0
1466,3/24/2018 2:10,23,22,20,65,3,100.0
1467,3/24/2018 2:15,24,26,29,79,3,100.0
1468,3/24/2018 2:20,25,37,26,88,3,100.0
1469,3/24/2018 2:25,29,30,30,89,3,100.0
1470,3/24/2018 2:30,21,25,16,62,3,100.0
1471,3/24/2018 2:35,17,28,26,71,3,100.0
1472,3/24/2018 2:40,26,31,20,77,3,100.0
1473,3/24/2018 2:45,21,24,14,59,3,100.0
1474,3/24/2018 2:50,18,28,16,62,3,100.0
1475,3/24/2018 2:55,23,23,37,83,3,100.0
1476,3/24/2018 3:00,25,30,23,78,3,100.0
1477,3/24/2018 3:05,10,29,14,53,3,100.0
1478,3/24/2018 3:10,20,19,16,55,3,100.0
1479,3/24/2018 3:15,18,22,16,56,3,100.0
1480,3/24/2018 3:20,10,21,14,45,3,100.0
1481,3/24/2018 3:25,20,25,11,56,3,100.0
1482,3/24/2018 3:30,11,21,8,40,3,100.0
1483,3/24/2018 3:35,18,16,16,50,3,100.0
1484,3/24/2018 3:40,12,21,17,50,3,100.0
1485,3/24/2018 3:45,23,23,21,67,3,100.0
1486,3/24/2018 3:50,16,15,16,47,3,100.0
1487,3/24/2018 3:55,21,27,21,69,3,100.0
1488,3/24/2018 4:00,19,27,20,66,3,100.0
1489,3/24/2018 4:05,16,21,11,48,3,100.0
1490,3/24/2018 4:10,18,23,19,60,3,100.0
1491,3/24/2018 4:15,24,30,18,72,3,100.0
1492,3/24/2018 4:20,18,26,19,63,3,100.0
1493,3/24/2018 4:25,19,18,20,57,3,100.0
1494,3/24/2018 4:30,21,27,16,64,3,100.0
1495,3/24/2018 4:35,22,29,21,72,3,100.0
1496,3/24/2018 4:40,23,25,24,72,3,100.0
1497,3/24/2018 4:45,25,31,21,77,3,100.0
1498,3/24/2018 4:50,37,48,29,114,3,100.0
1499,3/24/2018 4:55,28,31,22,81,3,100.0
1500,3/24/2018 5:00,23,33,24,80,3,100.0
1501,3/24/2018 5:05,23,43,26,92,3,100.0
1502,3/24/2018 5:10,24,38,40,102,3,100.0
1503,3/24/2018 5:15,52,54,27,133,3,100.0
1504,3/24/2018 5:20,46,44,34,124,3,100.0
1505,3/24/2018 5:25,51,65,41,157,3,100.0
1506,3/24/2018 5:30,66,58,39,163,3,100.0
1507,3/24/2018 5:35,49,56,40,145,3,100.0
1508,3/24/2018 5:40,67,70,50,187,3,100.0
1509,3/24/2018 5:45,61,67,47,175,3,100.0
1510,3/24/2018 5:50,64,79,37,180,3,100.0
1511,3/24/2018 5:55,59,65,33,157,3,100.0
1512,3/24/2018 6:00,53,63,45,161,3,100.0
1513,3/24/2018 6:05,54,56,34,144,3,100.0
1514,3/24/2018 6:10,63,80,49,192,3,100.0
1515,3/24/2018 6:15,75,78,55,208,3,100.0
1516,3/24/2018 6:20,64,79,44,187,3,100.0
1517,3/24/2018 6:25,90,84,57,231,3,100.0
1518,3/24/2018 6:30,79,88,48,215,3,100.0
1519,3/24/2018 6:35,83,93,51,227,3,100.0
1520,3/24/2018 6:40,83,93,48,224,3,100.0
1521,3/24/2018 6:45,115,100,55,270,3,100.0
1522,3/24/2018 6:50,112,97,68,277,3,100.0
1523,3/24/2018 6:55,76,92,63,231,3,100.0
1524,3/24/2018 7:00,97,88,54,239,3,100.0
1525,3/24/2018 7:05,105,103,74,282,3,100.0
1526,3/24/2018 7:10,96,114,66,276,3,100.0
1527,3/24/2018 7:15,125,109,74,308,3,100.0
1528,3/24/2018 7:20,94,80,53,227,3,100.0
1529,3/24/2018 7:25,133,126,73,332,3,100.0
1530,3/24/2018 7:30,137,128,72,337,3,100.0
1531,3/24/2018 7:35,130,115,84,329,3,100.0
1532,3/24/2018 7:40,119,118,87,324,3,100.0
1533,3/24/2018 7:45,126,131,92,349,3,100.0
1534,3/24/2018 7:50,126,128,77,331,3,100.0
1535,3/24/2018 7:55,108,108,62,278,3,100.0
1536,3/24/2018 8:00,113,106,76,295,3,100.0
1537,3/24/2018 8:05,149,131,91,371,3,100.0
1538,3/24/2018 8:10,139,119,76,334,3,100.0
1539,3/24/2018 8:15,135,134,74,343,3,100.0
1540,3/24/2018 8:20,155,159,101,415,3,100.0
1541,3/24/2018 8:25,172,157,99,428,3,100.0
1542,3/24/2018 8:30,151,128,77,356,3,100.0
1543,3/24/2018 8:35,150,144,82,376,3,100.0
1544,3/24/2018 8:40,167,138,93,398,3,100.0
1545,3/24/2018 8:45,163,144,109,416,3,100.0
1546,3/24/2018 8:50,138,119,77,334,3,100.0
1547,3/24/2018 8:55,164,150,99,413,3,100.0
1548,3/24/2018 9:00,153,146,90,389,3,100.0
1549,3/24/2018 9:05,152,147,100,399,3,100.0
1550,3/24/2018 9:10,171,166,112,449,3,100.0
1551,3/24/2018 9:15,154,148,99,401,3,100.0
1552,3/24/2018 9:20,163,151,125,439,3,100.0
1553,3/24/2018 9:25,177,145,95,417,3,100.0
1554,3/24/2018 9:30,174,159,102,435,3,100.0
1555,3/24/2018 9:35,179,167,103,449,3,100.0
1556,3/24/2018 9:40,172,161,123,456,3,100.0
1557,3/24/2018 9:45,168,167,143,478,3,100.0
1558,3/24/2018 9:50,189,163,113,465,3,100.0
1559,3/24/2018 9:55,182,172,123,477,3,100.0
1560,3/24/2018 10:00,191,173,115,479,3,100.0
1561,3/24/2018 10:05,154,142,122,418,3,100.0
1562,3/24/2018 10:10,142,134,108,384,3,100.0
1563,3/24/2018 10:15,144,138,116,398,3,100.0
1564,3/24/2018 10:20,158,150,130,438,3,100.0
1565,3/24/2018 10:25,124,122,128,374,3,100.0
1566,3/24/2018 10:30,128,131,111,370,3,100.0
1567,3/24/2018 10:35,157,143,117,417,3,100.0
1568,3/24/2018 10:40,148,142,124,414,3,100.0
1569,3/24/2018 10:45,156,170,116,442,3,100.0
1570,3/24/2018 10:50,171,168,132,471,3,100.0
1571,3/24/2018 10:55,175,160,127,462,3,100.0
1572,3/24/2018 11:00,159,143,123,425,3,100.0
1573,3/24/2018 11:05,168,159,118,445,3,100.0
1574,3/24/2018 11:10,174,152,115,441,3,100.0
1575,3/24/2018 11:15,190,171,117,478,3,100.0
1576,3/24/2018 11:20,162,141,109,412,3,100.0
1577,3/24/2018 11:25,162,158,111,431,3,100.0
1578,3/24/2018 11:30,180,157,109,446,3,100.0
1579,3/24/2018 11:35,169,155,127,451,3,100.0
1580,3/24/2018 11:40,173,163,116,452,3,100.0
1581,3/24/2018 11:45,172,163,122,457,3,100.0
1582,3/24/2018 11:50,170,137,115,422,3,100.0
1583,3/24/2018 11:55,151,136,114,401,3,100.0
1584,3/24/2018 12:00,162,151,104,417,3,100.0
1585,3/24/2018 12:05,160,166,126,452,3,100.0
1586,3/24/2018 12:10,141,144,101,386,3,100.0
1587,3/24/2018 12:15,182,155,138,475,3,100.0
1588,3/24/2018 12:20,169,157,121,447,3,100.0
1589,3/24/2018 12:25,178,163,127,468,3,100.0
1590,3/24/2018 12:30,177,156,131,464,3,100.0
1591,3/24/2018 12:35,161,153,132,446,3,100.0
1592,3/24/2018 12:40,175,179,116,470,3,100.0
1593,3/24/2018 12:45,160,153,127,440,3,100.0
1594,3/24/2018 12:50,180,173,140,493,3,100.0
1595,3/24/2018 12:55,176,150,129,455,3,100.0
1596,3/24/2018 13:00,178,173,132,483,3,100.0
1597,3/24/2018 13:05,166,143,110,419,3,100.0
1598,3/24/2018 13:10,197,182,131,510,3,100.0
1599,3/24/2018 13:15,174,162,128,464,3,100.0
1600,3/24/2018 13:20,175,167,136,478,3,100.0
1601,3/24/2018 13:25,161,155,139,455,3,100.0
1602,3/24/2018 13:30,166,167,154,487,3,100.0
1603,3/24/2018 13:35,146,139,133,418,3,100.0
1604,3/24/2018 13:40,165,157,137,459,3,100.0
1605,3/24/2018 13:45,154,154,139,447,3,100.0
1606,3/24/2018 13:50,159,162,152,473,3,100.0
1607,3/24/2018 13:55,154,146,123,423,3,100.0
1608,3/24/2018 14:00,154,147,135,436,3,100.0
1609,3/24/2018 14:05,173,162,148,483,3,100.0
1610,3/24/2018 14:10,157,152,135,444,3,100.0
1611,3/24/2018 14:15,154,154,118,426,3,100.0
1612,3/24/2018 14:20,156,153,131,440,3,100.0
1613,3/24/2018 14:25,159,148,139,446,3,100.0
1614,3/24/2018 14:30,153,161,131,445,3,100.0
1615,3/24/2018 14:35,156,148,140,444,3,100.0
1616,3/24/2018 14:40,129,124,124,377,3,100.0
1617,3/24/2018 14:45,157,151,137,445,3,100.0
1618,3/24/2018 14:50,158,159,137,454,3,100.0
1619,3/24/2018 14:55,153,150,133,436,3,100.0
1620,3/24/2018 15:00,145,149,141,435,3,100.0
1621,3/24/2018 15:05,139,134,134,407,3,100.0
1622,3/24/2018 15:10,144,141,143,428,3,100.0
1623,3/24/2018 15:15,156,142,139,437,3,100.0
1624,3/24/2018 15:20,152,152,138,442,3,100.0
1625,3/24/2018 15:25,153,138,140,431,3,100.0
1626,3/24/2018 15:30,151,145,125,421,3,100.0
1627,3/24/2018 15:35,159,154,132,445,3,100.0
1628,3/24/2018 15:40,167,153,140,460,3,100.0
1629,3/24/2018 15:45,158,140,130,428,3,100.0
1630,3/24/2018 15:50,148,166,130,444,3,100.0
1631,3/24/2018 15:55,169,149,140,458,3,100.0
1632,3/24/2018 16:00,160,165,127,452,3,100.0
1633,3/24/2018 16:05,166,148,120,434,3,100.0
1634,3/24/2018 16:10,180,158,140,478,3,100.0
1635,3/24/2018 16:15,176,182,147,505,3,100.0
1636,3/24/2018 16:20,157,146,149,452,3,100.0
1637,3/24/2018 16:25,154,153,140,447,3,100.0
1638,3/24/2018 16:30,154,144,144,442,3,100.0
1639,3/24/2018 16:35,165,161,149,475,3,100.0
1640,3/24/2018 16:40,153,143,133,429,3,100.0
1641,3/24/2018 16:45,148,151,134,433,3,100.0
1642,3/24/2018 16:50,143,144,132,419,3,100.0
1643,3/24/2018 16:55,170,161,155,486,3,100.0
1644,3/24/2018 17:00,161,148,131,440,3,100.0
1645,3/24/2018 17:05,164,138,131,433,3,100.0
1646,3/24/2018 17:10,151,152,131,434,3,100.0
1647,3/24/2018 17:15,145,138,135,418,3,100.0
1648,3/24/2018 17:20,163,160,140,463,3,100.0
1649,3/24/2018 17:25,147,152,130,429,3,100.0
1650,3/24/2018 17:30,165,155,136,456,3,100.0
1651,3/24/2018 17:35,161,163,135,459,3,100.0
1652,3/24/2018 17:40,170,170,137,477,3,100.0
1653,3/24/2018 17:45,146,142,141,429,3,100.0
1654,3/24/2018 17:50,162,151,135,448,3,100.0
1655,3/24/2018 17:55,145,135,128,408,3,100.0
1656,3/24/2018 18:00,164,149,145,458,3,100.0
1657,3/24/2018 18:05,142,128,124,394,3,100.0
1658,3/24/2018 18:10,158,147,134,439,3,100.0
1659,3/24/2018 18:15,152,147,142,441,3,100.0
1660,3/24/2018 18:20,163,147,139,449,3,100.0
1661,3/24/2018 18:25,143,143,126,412,3,100.0
1662,3/24/2018 18:30,147,144,111,402,3,100.0
1663,3/24/2018 18:35,143,137,128,408,3,100.0
1664,3/24/2018 18:40,143,143,116,402,3,100.0
1665,3/24/2018 18:45,143,142,112,397,3,100.0
1666,3/24/2018 18:50,136,148,117,401,3,100.0
1667,3/24/2018 18:55,153,127,121,401,3,100.0
1668,3/24/2018 19:00,150,157,127,434,3,100.0
1669,3/24/2018 19:05,149,136,109,394,3,100.0
1670,3/24/2018 19:10,138,132,112,382,3,100.0
1671,3/24/2018 19:15,154,147,110,411,3,100.0
1672,3/24/2018 19:20,168,143,126,437,3,100.0
1673,3/24/2018 19:25,150,144,117,411,3,100.0
1674,3/24/2018 19:30,142,138,103,383,3,100.0
1675,3/24/2018 19:35,149,135,117,401,3,100.0
1676,3/24/2018 19:40,144,143,90,377,3,100.0
1677,3/24/2018 19:45,148,134,121,403,3,100.0
1678,3/24/2018 19:50,146,131,97,374,3,100.0
1679,3/24/2018 19:55,140,135,107,382,3,100.0
1680,3/24/2018 20:00,127,126,91,344,3,100.0
1681,3/24/2018 20:05,154,146,95,395,3,100.0
1682,3/24/2018 20:10,147,133,96,376,3,100.0
1683,3/24/2018 20:15,139,124,102,365,3,100.0
1684,3/24/2018 20:20,151,144,117,412,3,100.0
1685,3/24/2018 20:25,156,142,113,411,3,100.0
1686,3/24/2018 20:30,136,116,102,354,3,100.0
1687,3/24/2018 20:35,143,133,98,374,3,100.0
1688,3/24/2018 20:40,154,150,116,420,3,100.0
1689,3/24/2018 20:45,143,125,81,349,3,100.0
1690,3/24/2018 20:50,149,149,115,413,3,100.0
1691,3/24/2018 20:55,129,133,89,351,3,100.0
1692,3/24/2018 21:00,144,158,90,392,3,100.0
1693,3/24/2018 21:05,134,131,103,368,3,100.0
1694,3/24/2018 21:10,144,122,95,361,3,100.0
1695,3/24/2018 21:15,156,136,101,393,3,100.0
1696,3/24/2018 21:20,119,121,92,332,3,100.0
1697,3/24/2018 21:25,138,130,85,353,3,100.0
1698,3/24/2018 21:30,140,136,93,369,3,100.0
1699,3/24/2018 21:35,144,145,114,403,3,100.0
1700,3/24/2018 21:40,127,130,89,346,3,100.0
1701,3/24/2018 21:45,154,142,97,393,3,100.0
1702,3/24/2018 21:50,110,112,81,303,3,100.0
1703,3/24/2018 21:55,128,134,79,341,3,100.0
1704,3/24/2018 22:00,118,116,83,317,3,100.0
1705,3/24/2018 22:05,125,112,74,311,3,100.0
1706,3/24/2018 22:10,127,116,79,322,3,100.0
1707,3/24/2018 22:15,112,117,81,310,3,100.0
1708,3/24/2018 22:20,119,110,77,306,3,100.0
1709,3/24/2018 22:25,131,110,79,320,3,100.0
1710,3/24/2018 22:30,108,110,90,308,3,100.0
1711,3/24/2018 22:35,115,101,81,297,3,100.0
1712,3/24/2018 22:40,119,113,70,302,3,100.0
1713,3/24/2018 22:45,111,106,70,287,3,100.0
1714,3/24/2018 22:50,111,114,70,295,3,100.0
1715,3/24/2018 22:55,105,98,65,268,3,100.0
1716,3/24/2018 23:00,92,103,66,261,3,100.0
1717,3/24/2018 23:05,90,99,61,250,3,100.0
1718,3/24/2018 23:10,96,91,59,246,3,100.0
1719,3/24/2018 23:15,91,85,62,238,3,100.0
1720,3/24/2018 23:20,83,96,70,249,3,100.0
1721,3/24/2018 23:25,91,91,54,236,3,100.0
1722,3/24/2018 23:30,84,74,49,207,3,100.0
1723,3/24/2018 23:35,86,71,53,210,3,100.0
1724,3/24/2018 23:40,68,83,48,199,3,100.0
1725,3/24/2018 23:45,58,73,66,197,3,100.0
1726,3/24/2018 23:50,61,75,46,182,3,100.0
1727,3/24/2018 23:55,55,73,38,166,3,100.0
1728,3/25/2018 0:00,59,61,49,169,3,100.0
1729,3/25/2018 0:05,60,67,42,169,3,100.0
1730,3/25/2018 0:10,69,79,49,197,3,100.0
1731,3/25/2018 0:15,62,61,51,174,3,100.0
1732,3/25/2018 0:20,65,65,35,165,3,100.0
1733,3/25/2018 0:25,53,67,45,165,3,100.0
1734,3/25/2018 0:30,54,47,31,132,3,100.0
1735,3/25/2018 0:35,55,66,34,155,3,100.0
1736,3/25/2018 0:40,46,69,38,153,3,100.0
1737,3/25/2018 0:45,51,56,41,148,3,100.0
1738,3/25/2018 0:50,47,49,35,131,3,100.0
1739,3/25/2018 0:55,35,46,27,108,3,100.0
1740,3/25/2018 1:00,42,46,38,126,3,100.0
1741,3/25/2018 1:05,43,58,38,139,3,100.0
1742,3/25/2018 1:10,38,44,28,110,3,100.0
1743,3/25/2018 1:15,34,44,28,106,3,100.0
1744,3/25/2018 1:20,29,38,31,98,3,100.0
1745,3/25/2018 1:25,17,37,32,86,3,100.0
1746,3/25/2018 1:30,37,39,30,106,3,100.0
1747,3/25/2018 1:35,40,44,34,118,3,100.0
1748,3/25/2018 1:40,31,39,25,95,3,100.0
1749,3/25/2018 1:45,35,39,32,106,3,100.0
1750,3/25/2018 1:50,21,38,31,90,3,100.0
1751,3/25/2018 1:55,29,26,26,81,3,100.0
1752,3/25/2018 2:00,26,30,15,71,3,100.0
1753,3/25/2018 2:05,23,37,23,83,3,100.0
1754,3/25/2018 2:10,21,42,24,87,3,100.0
1755,3/25/2018 2:15,23,33,22,78,3,100.0
1756,3/25/2018 2:20,18,28,17,63,3,100.0
1757,3/25/2018 2:25,23,32,21,76,3,100.0
1758,3/25/2018 2:30,25,29,23,77,3,100.0
1759,3/25/2018 2:35,21,39,21,81,3,100.0
1760,3/25/2018 2:40,28,34,23,85,3,100.0
1761,3/25/2018 2:45,26,32,26,84,3,100.0
1762,3/25/2018 2:50,23,31,20,74,3,100.0
1763,3/25/2018 2:55,25,26,16,67,3,100.0
1764,3/25/2018 3:00,18,29,18,65,3,100.0
1765,3/25/2018 3:05,12,30,11,53,3,100.0
1766,3/25/2018 3:10,14,26,16,56,3,100.0
1767,3/25/2018 3:15,7,24,17,48,3,100.0
1768,3/25/2018 3:20,22,25,15,62,3,100.0
1769,3/25/2018 3:25,14,26,13,53,3,100.0
1770,3/25/2018 3:30,13,27,21,61,3,100.0
1771,3/25/2018 3:35,19,23,19,61,3,100.0
1772,3/25/2018 3:40,16,15,16,47,3,100.0
1773,3/25/2018 3:45,11,22,21,54,3,100.0
1774,3/25/2018 3:50,11,20,17,48,3,100.0
1775,3/25/2018 3:55,12,22,16,50,3,100.0
1776,3/25/2018 4:00,10,16,19,45,3,100.0
1777,3/25/2018 4:05,17,25,16,58,3,100.0
1778,3/25/2018 4:10,10,15,10,35,3,100.0
1779,3/25/2018 4:15,15,23,14,52,3,100.0
1780,3/25/2018 4:20,10,20,15,45,3,100.0
1781,3/25/2018 4:25,13,27,21,61,3,100.0
1782,3/25/2018 4:30,12,21,14,47,3,100.0
1783,3/25/2018 4:35,16,22,14,52,3,100.0
1784,3/25/2018 4:40,11,28,15,54,3,100.0
1785,3/25/2018 4:45,13,28,15,56,3,100.0
1786,3/25/2018 4:50,17,33,22,72,3,100.0
1787,3/25/2018 4:55,17,29,12,58,3,100.0
1788,3/25/2018 5:00,13,23,11,47,3,100.0
1789,3/25/2018 5:05,18,24,22,64,3,100.0
1790,3/25/2018 5:10,18,31,17,66,3,100.0
1791,3/25/2018 5:15,21,34,25,80,3,100.0
1792,3/25/2018 5:20,25,36,26,87,3,100.0
1793,3/25/2018 5:25,29,44,28,101,3,100.0
1794,3/25/2018 5:30,26,27,31,84,3,100.0
1795,3/25/2018 5:35,34,33,30,97,3,100.0
1796,3/25/2018 5:40,27,48,30,105,3,100.0
1797,3/25/2018 5:45,33,49,30,112,3,100.0
1798,3/25/2018 5:50,32,38,25,95,3,100.0
1799,3/25/2018 5:55,26,38,27,91,3,100.0
1800,3/25/2018 6:00,32,50,24,106,3,100.0
1801,3/25/2018 6:05,42,49,29,120,3,100.0
1802,3/25/2018 6:10,29,47,31,107,3,100.0
1803,3/25/2018 6:15,40,45,23,108,3,100.0
1804,3/25/2018 6:20,57,54,33,144,3,100.0
1805,3/25/2018 6:25,60,60,41,161,3,100.0
1806,3/25/2018 6:30,50,59,47,156,3,100.0
1807,3/25/2018 6:35,53,55,42,150,3,100.0
1808,3/25/2018 6:40,64,77,49,190,3,100.0
1809,3/25/2018 6:45,55,63,50,168,3,100.0
1810,3/25/2018 6:50,57,71,52,180,3,100.0
1811,3/25/2018 6:55,67,63,45,175,3,100.0
1812,3/25/2018 7:00,57,63,41,161,3,100.0
1813,3/25/2018 7:05,71,68,47,186,3,100.0
1814,3/25/2018 7:10,54,60,36,150,3,100.0
1815,3/25/2018 7:15,61,74,52,187,3,100.0
1816,3/25/2018 7:20,70,69,51,190,3,100.0
1817,3/25/2018 7:25,64,72,59,195,3,100.0
1818,3/25/2018 7:30,71,90,60,221,3,100.0
1819,3/25/2018 7:35,89,91,61,241,3,100.0
1820,3/25/2018 7:40,82,82,54,218,3,100.0
1821,3/25/2018 7:45,67,73,68,208,3,100.0
1822,3/25/2018 7:50,98,80,78,256,3,100.0
1823,3/25/2018 7:55,70,65,53,188,3,100.0
1824,3/25/2018 8:00,88,85,56,229,3,100.0
1825,3/25/2018 8:05,108,95,72,275,3,100.0
1826,3/25/2018 8:10,77,90,54,221,3,100.0
1827,3/25/2018 8:15,98,108,81,287,3,100.0
1828,3/25/2018 8:20,107,110,76,293,3,100.0
1829,3/25/2018 8:25,107,100,80,287,3,100.0
1830,3/25/2018 8:30,94,98,66,258,3,100.0
1831,3/25/2018 8:35,108,110,60,278,3,100.0
1832,3/25/2018 8:40,90,97,65,252,3,100.0
1833,3/25/2018 8:45,113,117,74,304,3,100.0
1834,3/25/2018 8:50,93,111,68,272,3,100.0
1835,3/25/2018 8:55,97,99,74,270,3,100.0
1836,3/25/2018 9:00,110,94,76,280,3,100.0
1837,3/25/2018 9:05,89,106,71,266,3,100.0
1838,3/25/2018 9:10,113,118,71,302,3,100.0
1839,3/25/2018 9:15,107,124,91,322,3,100.0
1840,3/25/2018 9:20,114,97,74,285,3,100.0
1841,3/25/2018 9:25,154,130,92,376,3,100.0
1842,3/25/2018 9:30,127,115,81,323,3,100.0
1843,3/25/2018 9:35,142,125,94,361,3,100.0
1844,3/25/2018 9:40,136,142,75,353,3,100.0
1845,3/25/2018 9:45,144,127,92,363,3,100.0
1846,3/25/2018 9:50,118,110,81,309,3,100.0
1847,3/25/2018 9:55,124,102,63,289,3,100.0
1848,3/25/2018 10:00,123,122,89,334,3,100.0
1849,3/25/2018 10:05,144,116,86,346,3,100.0
1850,3/25/2018 10:10,114,115,74,303,3,100.0
1851,3/25/2018 10:15,160,145,110,415,3,100.0
1852,3/25/2018 10:20,128,101,71,300,3,100.0
1853,3/25/2018 10:25,164,143,102,409,3,100.0
1854,3/25/2018 10:30,147,157,96,400,3,100.0
1855,3/25/2018 10:35,149,139,88,376,3,100.0
1856,3/25/2018 10:40,178,151,113,442,3,100.0
1857,3/25/2018 10:45,160,146,101,407,3,100.0
1858,3/25/2018 10:50,160,155,126,441,3,100.0
1859,3/25/2018 10:55,161,156,97,414,3,100.0
1860,3/25/2018 11:00,157,130,108,395,3,100.0
1861,3/25/2018 11:05,151,132,81,364,3,100.0
1862,3/25/2018 11:10,163,154,109,426,3,100.0
1863,3/25/2018 11:15,173,167,131,471,3,100.0
1864,3/25/2018 11:20,189,171,124,484,3,100.0
1865,3/25/2018 11:25,116,112,113,341,3,100.0
1866,3/25/2018 11:30,95,107,114,316,3,100.0
1867,3/25/2018 11:35,73,80,106,259,3,100.0
1868,3/25/2018 11:40,81,100,107,288,3,100.0
1869,3/25/2018 11:45,101,101,120,322,3,100.0
1870,3/25/2018 11:50,163,166,125,454,3,100.0
1871,3/25/2018 11:55,171,170,142,483,3,100.0
0,3/25/2018 0:00,59,61,49,169,3,100.0
1,3/25/2018 0:05,60,67,42,169,3,100.0
2,3/25/2018 0:10,69,79,49,197,3,100.0
3,3/25/2018 0:15,62,61,51,174,3,100.0
4,3/25/2018 0:20,65,65,35,165,3,100.0
5,3/25/2018 0:25,53,67,45,165,3,100.0
6,3/25/2018 0:30,54,47,31,132,3,100.0
7,3/25/2018 0:35,55,66,34,155,3,100.0
8,3/25/2018 0:40,46,69,38,153,3,100.0
9,3/25/2018 0:45,51,56,41,148,3,100.0
10,3/25/2018 0:50,47,49,35,131,3,100.0
11,3/25/2018 0:55,35,46,27,108,3,100.0
12,3/25/2018 1:00,42,46,38,126,3,100.0
13,3/25/2018 1:05,43,58,38,139,3,100.0
14,3/25/2018 1:10,38,44,28,110,3,100.0
15,3/25/2018 1:15,34,44,28,106,3,100.0
16,3/25/2018 1:20,29,38,31,98,3,100.0
17,3/25/2018 1:25,17,37,32,86,3,100.0
18,3/25/2018 1:30,37,39,30,106,3,100.0
19,3/25/2018 1:35,40,44,34,118,3,100.0
20,3/25/2018 1:40,31,39,25,95,3,100.0
21,3/25/2018 1:45,35,39,32,106,3,100.0
22,3/25/2018 1:50,21,38,31,90,3,100.0
23,3/25/2018 1:55,29,26,26,81,3,100.0
24,3/25/2018 2:00,26,30,15,71,3,100.0
25,3/25/2018 2:05,23,37,23,83,3,100.0
26,3/25/2018 2:10,21,42,24,87,3,100.0
27,3/25/2018 2:15,23,33,22,78,3,100.0
28,3/25/2018 2:20,18,28,17,63,3,100.0
29,3/25/2018 2:25,23,32,21,76,3,100.0
30,3/25/2018 2:30,25,29,23,77,3,100.0
31,3/25/2018 2:35,21,39,21,81,3,100.0
32,3/25/2018 2:40,28,34,23,85,3,100.0
33,3/25/2018 2:45,26,32,26,84,3,100.0
34,3/25/2018 2:50,23,31,20,74,3,100.0
35,3/25/2018 2:55,25,26,16,67,3,100.0
36,3/25/2018 3:00,18,29,18,65,3,100.0
37,3/25/2018 3:05,12,30,11,53,3,100.0
38,3/25/2018 3:10,14,26,16,56,3,100.0
39,3/25/2018 3:15,7,24,17,48,3,100.0
40,3/25/2018 3:20,22,25,15,62,3,100.0
41,3/25/2018 3:25,14,26,13,53,3,100.0
42,3/25/2018 3:30,13,27,21,61,3,100.0
43,3/25/2018 3:35,19,23,19,61,3,100.0
44,3/25/2018 3:40,16,15,16,47,3,100.0
45,3/25/2018 3:45,11,22,21,54,3,100.0
46,3/25/2018 3:50,11,20,17,48,3,100.0
47,3/25/2018 3:55,12,22,16,50,3,100.0
48,3/25/2018 4:00,10,16,19,45,3,100.0
49,3/25/2018 4:05,17,25,16,58,3,100.0
50,3/25/2018 4:10,10,15,10,35,3,100.0
51,3/25/2018 4:15,15,23,14,52,3,100.0
52,3/25/2018 4:20,10,20,15,45,3,100.0
53,3/25/2018 4:25,13,27,21,61,3,100.0
54,3/25/2018 4:30,12,21,14,47,3,100.0
55,3/25/2018 4:35,16,22,14,52,3,100.0
56,3/25/2018 4:40,11,28,15,54,3,100.0
57,3/25/2018 4:45,13,28,15,56,3,100.0
58,3/25/2018 4:50,17,33,22,72,3,100.0
59,3/25/2018 4:55,17,29,12,58,3,100.0
60,3/25/2018 5:00,13,23,11,47,3,100.0
61,3/25/2018 5:05,18,24,22,64,3,100.0
62,3/25/2018 5:10,18,31,17,66,3,100.0
63,3/25/2018 5:15,21,34,25,80,3,100.0
64,3/25/2018 5:20,25,36,26,87,3,100.0
65,3/25/2018 5:25,29,44,28,101,3,100.0
66,3/25/2018 5:30,26,27,31,84,3,100.0
67,3/25/2018 5:35,34,33,30,97,3,100.0
68,3/25/2018 5:40,27,48,30,105,3,100.0
69,3/25/2018 5:45,33,49,30,112,3,100.0
70,3/25/2018 5:50,32,38,25,95,3,100.0
71,3/25/2018 5:55,26,38,27,91,3,100.0
72,3/25/2018 6:00,32,50,24,106,3,100.0
73,3/25/2018 6:05,42,49,29,120,3,100.0
74,3/25/2018 6:10,29,47,31,107,3,100.0
75,3/25/2018 6:15,40,45,23,108,3,100.0
76,3/25/2018 6:20,57,54,33,144,3,100.0
77,3/25/2018 6:25,60,60,41,161,3,100.0
78,3/25/2018 6:30,50,59,47,156,3,100.0
79,3/25/2018 6:35,53,55,42,150,3,100.0
80,3/25/2018 6:40,64,77,49,190,3,100.0
81,3/25/2018 6:45,55,63,50,168,3,100.0
82,3/25/2018 6:50,57,71,52,180,3,100.0
83,3/25/2018 6:55,67,63,45,175,3,100.0
84,3/25/2018 7:00,57,63,41,161,3,100.0
85,3/25/2018 7:05,71,68,47,186,3,100.0
86,3/25/2018 7:10,54,60,36,150,3,100.0
87,3/25/2018 7:15,61,74,52,187,3,100.0
88,3/25/2018 7:20,70,69,51,190,3,100.0
89,3/25/2018 7:25,64,72,59,195,3,100.0
90,3/25/2018 7:30,71,90,60,221,3,100.0
91,3/25/2018 7:35,89,91,61,241,3,100.0
92,3/25/2018 7:40,82,82,54,218,3,100.0
93,3/25/2018 7:45,67,73,68,208,3,100.0
94,3/25/2018 7:50,98,80,78,256,3,100.0
95,3/25/2018 7:55,70,65,53,188,3,100.0
96,3/25/2018 8:00,88,85,56,229,3,100.0
97,3/25/2018 8:05,108,95,72,275,3,100.0
98,3/25/2018 8:10,77,90,54,221,3,100.0
99,3/25/2018 8:15,98,108,81,287,3,100.0
100,3/25/2018 8:20,107,110,76,293,3,100.0
101,3/25/2018 8:25,107,100,80,287,3,100.0
102,3/25/2018 8:30,94,98,66,258,3,100.0
103,3/25/2018 8:35,108,110,60,278,3,100.0
104,3/25/2018 8:40,90,97,65,252,3,100.0
105,3/25/2018 8:45,113,117,74,304,3,100.0
106,3/25/2018 8:50,93,111,68,272,3,100.0
107,3/25/2018 8:55,97,99,74,270,3,100.0
108,3/25/2018 9:00,110,94,76,280,3,100.0
109,3/25/2018 9:05,89,106,71,266,3,100.0
110,3/25/2018 9:10,113,118,71,302,3,100.0
111,3/25/2018 9:15,107,124,91,322,3,100.0
112,3/25/2018 9:20,114,97,74,285,3,100.0
113,3/25/2018 9:25,154,130,92,376,3,100.0
114,3/25/2018 9:30,127,115,81,323,3,100.0
115,3/25/2018 9:35,142,125,94,361,3,100.0
116,3/25/2018 9:40,136,142,75,353,3,100.0
117,3/25/2018 9:45,144,127,92,363,3,100.0
118,3/25/2018 9:50,118,110,81,309,3,100.0
119,3/25/2018 9:55,124,102,63,289,3,100.0
120,3/25/2018 10:00,123,122,89,334,3,100.0
121,3/25/2018 10:05,144,116,86,346,3,100.0
122,3/25/2018 10:10,114,115,74,303,3,100.0
123,3/25/2018 10:15,160,145,110,415,3,100.0
124,3/25/2018 10:20,128,101,71,300,3,100.0
125,3/25/2018 10:25,164,143,102,409,3,100.0
126,3/25/2018 10:30,147,157,96,400,3,100.0
127,3/25/2018 10:35,149,139,88,376,3,100.0
128,3/25/2018 10:40,178,151,113,442,3,100.0
129,3/25/2018 10:45,160,146,101,407,3,100.0
130,3/25/2018 10:50,160,155,126,441,3,100.0
131,3/25/2018 10:55,161,156,97,414,3,100.0
132,3/25/2018 11:00,157,130,108,395,3,100.0
133,3/25/2018 11:05,151,132,81,364,3,100.0
134,3/25/2018 11:10,163,154,109,426,3,100.0
135,3/25/2018 11:15,173,167,131,471,3,100.0
136,3/25/2018 11:20,189,171,124,484,3,100.0
137,3/25/2018 11:25,116,112,113,341,3,100.0
138,3/25/2018 11:30,95,107,114,316,3,100.0
139,3/25/2018 11:35,73,80,106,259,3,100.0
140,3/25/2018 11:40,81,100,107,288,3,100.0
141,3/25/2018 11:45,101,101,120,322,3,100.0
142,3/25/2018 11:50,163,166,125,454,3,100.0
143,3/25/2018 11:55,171,170,142,483,3,100.0
144,3/25/2018 12:00,149,147,109,405,3,100.0
145,3/25/2018 12:05,130,123,93,346,3,100.0
146,3/25/2018 12:10,154,150,101,405,3,100.0
147,3/25/2018 12:15,169,152,108,429,3,100.0
148,3/25/2018 12:20,163,141,116,420,3,100.0
149,3/25/2018 12:25,153,154,118,425,3,100.0
150,3/25/2018 12:30,166,168,101,435,3,100.0
151,3/25/2018 12:35,184,148,109,441,3,100.0
152,3/25/2018 12:40,187,159,124,470,3,100.0
153,3/25/2018 12:45,168,158,107,433,3,100.0
154,3/25/2018 12:50,174,168,113,455,3,100.0
155,3/25/2018 12:55,155,149,124,428,3,100.0
156,3/25/2018 13:00,171,151,110,432,3,100.0
157,3/25/2018 13:05,160,150,102,412,3,100.0
158,3/25/2018 13:10,160,158,100,418,3,100.0
159,3/25/2018 13:15,93,114,83,290,3,100.0
160,3/25/2018 13:20,108,116,82,306,3,100.0
161,3/25/2018 13:25,111,108,96,315,3,100.0
162,3/25/2018 13:30,118,119,84,321,3,100.0
163,3/25/2018 13:35,111,108,91,310,3,100.0
164,3/25/2018 13:40,174,172,126,472,3,100.0
165,3/25/2018 13:45,169,176,136,481,3,100.0
166,3/25/2018 13:50,179,162,129,470,3,100.0
167,3/25/2018 13:55,168,172,132,472,3,100.0
168,3/25/2018 14:00,166,156,131,453,3,100.0
169,3/25/2018 14:05,181,172,154,507,3,100.0
170,3/25/2018 14:10,169,176,131,476,3,100.0
171,3/25/2018 14:15,152,156,129,437,3,100.0
172,3/25/2018 14:20,155,155,133,443,3,100.0
173,3/25/2018 14:25,144,161,123,428,3,100.0
174,3/25/2018 14:30,155,156,136,447,3,100.0
175,3/25/2018 14:35,156,158,141,455,3,100.0
176,3/25/2018 14:40,170,173,150,493,3,100.0
177,3/25/2018 14:45,171,162,132,465,3,100.0
178,3/25/2018 14:50,159,149,126,434,3,100.0
179,3/25/2018 14:55,161,149,123,433,3,100.0
180,3/25/2018 15:00,166,161,126,453,3,100.0
181,3/25/2018 15:05,168,152,130,450,3,100.0
182,3/25/2018 15:10,156,151,111,418,3,100.0
183,3/25/2018 15:15,167,149,111,427,3,100.0
184,3/25/2018 15:20,168,161,122,451,3,100.0
185,3/25/2018 15:25,182,158,123,463,3,100.0
186,3/25/2018 15:30,166,142,124,432,3,100.0
187,3/25/2018 15:35,171,168,122,461,3,100.0
188,3/25/2018 15:40,180,167,115,462,3,100.0
189,3/25/2018 15:45,168,148,124,440,3,100.0
190,3/25/2018 15:50,156,145,106,407,3,100.0
191,3/25/2018 15:55,164,153,121,438,3,100.0
192,3/25/2018 16:00,158,154,123,435,3,100.0
193,3/25/2018 16:05,158,142,117,417,3,100.0
194,3/25/2018 16:10,173,158,122,453,3,100.0
195,3/25/2018 16:15,178,175,137,490,3,100.0
196,3/25/2018 16:20,169,136,129,434,3,100.0
197,3/25/2018 16:25,174,156,123,453,3,100.0
198,3/25/2018 16:30,176,144,118,438,3,100.0
199,3/25/2018 16:35,182,175,125,482,3,100.0
200,3/25/2018 16:40,164,168,123,455,3,100.0
201,3/25/2018 16:45,162,138,107,407,3,100.0
202,3/25/2018 16:50,169,148,124,441,3,100.0
203,3/25/2018 16:55,162,174,118,454,3,100.0
204,3/25/2018 17:00,161,154,118,433,3,100.0
205,3/25/2018 17:05,174,159,113,446,3,100.0
206,3/25/2018 17:10,159,142,117,418,3,100.0
207,3/25/2018 17:15,140,146,116,402,3,100.0
208,3/25/2018 17:20,165,143,125,433,3,100.0
209,3/25/2018 17:25,174,160,128,462,3,100.0
210,3/25/2018 17:30,152,138,118,408,3,100.0
211,3/25/2018 17:35,168,156,129,453,3,100.0
212,3/25/2018 17:40,168,159,116,443,3,100.0
213,3/25/2018 17:45,151,148,108,407,3,100.0
214,3/25/2018 17:50,158,147,124,429,3,100.0
215,3/25/2018 17:55,147,141,106,394,3,100.0
216,3/25/2018 18:00,154,143,109,406,3,100.0
217,3/25/2018 18:05,148,148,105,401,3,100.0
218,3/25/2018 18:10,147,136,106,389,3,100.0
219,3/25/2018 18:15,142,155,107,404,3,100.0
220,3/25/2018 18:20,134,129,106,369,3,100.0
221,3/25/2018 18:25,137,133,95,365,3,100.0
222,3/25/2018 18:30,131,123,94,348,3,100.0
223,3/25/2018 18:35,145,140,102,387,3,100.0
224,3/25/2018 18:40,144,144,109,397,3,100.0
225,3/25/2018 18:45,134,138,87,359,3,100.0
226,3/25/2018 18:50,153,152,96,401,3,100.0
227,3/25/2018 18:55,138,135,104,377,3,100.0
228,3/25/2018 19:00,142,132,96,370,3,100.0
229,3/25/2018 19:05,129,119,90,338,3,100.0
230,3/25/2018 19:10,149,137,104,390,3,100.0
231,3/25/2018 19:15,167,149,112,428,3,100.0
232,3/25/2018 19:20,146,137,109,392,3,100.0
233,3/25/2018 19:25,139,138,100,377,3,100.0
234,3/25/2018 19:30,138,127,92,357,3,100.0
235,3/25/2018 19:35,132,138,91,361,3,100.0
236,3/25/2018 19:40,136,106,83,325,3,100.0
237,3/25/2018 19:45,130,114,89,333,3,100.0
238,3/25/2018 19:50,156,137,99,392,3,100.0
239,3/25/2018 19:55,139,127,90,356,3,100.0
240,3/25/2018 20:00,151,132,99,382,3,100.0
241,3/25/2018 20:05,130,115,82,327,3,100.0
242,3/25/2018 20:10,145,120,85,350,3,100.0
243,3/25/2018 20:15,151,126,97,374,3,100.0
244,3/25/2018 20:20,139,135,102,376,3,100.0
245,3/25/2018 20:25,147,130,99,376,3,100.0
246,3/25/2018 20:30,156,126,82,364,3,100.0
247,3/25/2018 20:35,127,134,83,344,3,100.0
248,3/25/2018 20:40,124,125,86,335,3,100.0
249,3/25/2018 20:45,146,139,95,380,3,100.0
250,3/25/2018 20:50,133,131,94,358,3,100.0
251,3/25/2018 20:55,132,112,87,331,3,100.0
252,3/25/2018 21:00,138,116,96,350,3,100.0
253,3/25/2018 21:05,126,115,82,323,3,100.0
254,3/25/2018 21:10,132,110,89,331,3,100.0
255,3/25/2018 21:15,139,129,97,365,3,100.0
256,3/25/2018 21:20,141,121,86,348,3,100.0
257,3/25/2018 21:25,113,119,71,303,3,100.0
258,3/25/2018 21:30,118,102,84,304,3,100.0
259,3/25/2018 21:35,132,130,79,341,3,100.0
260,3/25/2018 21:40,140,124,87,351,3,100.0
261,3/25/2018 21:45,116,107,91,314,3,100.0
262,3/25/2018 21:50,128,110,81,319,3,100.0
263,3/25/2018 21:55,130,122,74,326,3,100.0
264,3/25/2018 22:00,117,114,77,308,3,100.0
265,3/25/2018 22:05,112,108,78,298,3,100.0
266,3/25/2018 22:10,124,103,67,294,3,100.0
267,3/25/2018 22:15,108,109,74,291,3,100.0
268,3/25/2018 22:20,102,93,72,267,3,100.0
269,3/25/2018 22:25,103,106,63,272,3,100.0
270,3/25/2018 22:30,103,97,68,268,3,100.0
271,3/25/2018 22:35,117,111,71,299,3,100.0
272,3/25/2018 22:40,86,99,56,241,3,100.0
273,3/25/2018 22:45,100,80,59,239,3,100.0
274,3/25/2018 22:50,101,99,58,258,3,100.0
275,3/25/2018 22:55,78,77,56,211,3,100.0
276,3/25/2018 23:00,82,80,56,218,3,100.0
277,3/25/2018 23:05,67,79,43,189,3,100.0
278,3/25/2018 23:10,67,61,47,175,3,100.0
279,3/25/2018 23:15,87,76,58,221,3,100.0
280,3/25/2018 23:20,67,76,44,187,3,100.0
281,3/25/2018 23:25,67,89,52,208,3,100.0
282,3/25/2018 23:30,71,55,42,168,3,100.0
283,3/25/2018 23:35,33,49,25,107,3,100.0
284,3/25/2018 23:40,81,77,48,206,3,100.0
285,3/25/2018 23:45,60,58,43,161,3,100.0
286,3/25/2018 23:50,62,69,52,183,3,100.0
287,3/25/2018 23:55,74,64,39,177,3,100.0
288,3/26/2018 0:00,43,51,32,126,3,100.0
289,3/26/2018 0:05,67,72,37,176,3,100.0
290,3/26/2018 0:10,41,47,33,121,3,100.0
291,3/26/2018 0:15,38,40,32,110,3,100.0
292,3/26/2018 0:20,42,55,33,130,3,100.0
293,3/26/2018 0:25,44,40,29,113,3,100.0
294,3/26/2018 0:30,40,39,30,109,3,100.0
295,3/26/2018 0:35,29,34,18,81,3,100.0
296,3/26/2018 0:40,30,41,18,89,3,100.0
297,3/26/2018 0:45,34,43,28,105,3,100.0
298,3/26/2018 0:50,21,36,25,82,3,100.0
299,3/26/2018 0:55,21,43,18,82,3,100.0
300,3/26/2018 1:00,26,27,18,71,3,100.0
301,3/26/2018 1:05,19,34,26,79,3,100.0
302,3/26/2018 1:10,21,32,21,74,3,100.0
303,3/26/2018 1:15,30,35,22,87,3,100.0
304,3/26/2018 1:20,16,21,9,46,3,100.0
305,3/26/2018 1:25,17,23,18,58,3,100.0
306,3/26/2018 1:30,18,28,15,61,3,100.0
307,3/26/2018 1:35,19,25,14,58,3,100.0
308,3/26/2018 1:40,23,22,19,64,3,100.0
309,3/26/2018 1:45,11,29,11,51,3,100.0
310,3/26/2018 1:50,13,20,18,51,3,100.0
311,3/26/2018 1:55,16,24,13,53,3,100.0
312,3/26/2018 2:00,12,14,13,39,3,100.0
313,3/26/2018 2:05,12,20,16,48,3,100.0
314,3/26/2018 2:10,12,22,11,45,3,100.0
315,3/26/2018 2:15,16,23,17,56,3,100.0
316,3/26/2018 2:20,9,10,12,31,3,100.0
317,3/26/2018 2:25,12,17,20,49,3,100.0
318,3/26/2018 2:30,14,18,7,39,3,100.0
319,3/26/2018 2:35,5,10,10,25,3,100.0
320,3/26/2018 2:40,6,14,3,23,3,100.0
321,3/26/2018 2:45,6,13,12,31,3,100.0
322,3/26/2018 2:50,7,11,12,30,3,100.0
323,3/26/2018 2:55,5,16,9,30,3,100.0
324,3/26/2018 3:00,6,13,16,35,3,100.0
325,3/26/2018 3:05,6,16,14,36,3,100.0
326,3/26/2018 3:10,8,20,11,39,3,100.0
327,3/26/2018 3:15,12,20,14,46,3,100.0
328,3/26/2018 3:20,13,16,17,46,3,100.0
329,3/26/2018 3:25,12,15,22,49,3,100.0
330,3/26/2018 3:30,11,23,11,45,3,100.0
331,3/26/2018 3:35,8,21,16,45,3,100.0
332,3/26/2018 3:40,18,25,16,59,3,100.0
333,3/26/2018 3:45,10,27,19,56,3,100.0
334,3/26/2018 3:50,17,24,10,51,3,100.0
335,3/26/2018 3:55,22,22,11,55,3,100.0
336,3/26/2018 4:00,13,29,17,59,3,100.0
337,3/26/2018 4:05,10,21,19,50,3,100.0
338,3/26/2018 4:10,17,27,16,60,3,100.0
339,3/26/2018 4:15,27,35,12,74,3,100.0
340,3/26/2018 4:20,36,48,23,107,3,100.0
341,3/26/2018 4:25,31,38,20,89,3,100.0
342,3/26/2018 4:30,35,48,31,114,3,100.0
343,3/26/2018 4:35,42,56,28,126,3,100.0
344,3/26/2018 4:40,41,47,35,123,3,100.0
345,3/26/2018 4:45,30,52,28,110,3,100.0
346,3/26/2018 4:50,52,53,31,136,3,100.0
347,3/26/2018 4:55,42,60,36,138,3,100.0
348,3/26/2018 5:00,49,55,32,136,3,100.0
349,3/26/2018 5:05,74,73,41,188,3,100.0
350,3/26/2018 5:10,87,81,59,227,3,100.0
351,3/26/2018 5:15,91,87,43,221,3,100.0
352,3/26/2018 5:20,103,94,42,239,3,100.0
353,3/26/2018 5:25,114,98,67,279,3,100.0
354,3/26/2018 5:30,113,97,72,282,3,100.0
355,3/26/2018 5:35,122,95,55,272,3,100.0
356,3/26/2018 5:40,118,107,58,283,3,100.0
357,3/26/2018 5:45,133,120,76,329,3,100.0
358,3/26/2018 5:50,140,125,83,348,3,100.0
359,3/26/2018 5:55,144,128,84,356,3,100.0
360,3/26/2018 6:00,148,110,83,341,3,100.0
361,3/26/2018 6:05,164,123,80,367,3,100.0
362,3/26/2018 6:10,146,124,77,347,3,100.0
363,3/26/2018 6:15,163,142,96,401,3,100.0
364,3/26/2018 6:20,138,122,76,336,3,100.0
365,3/26/2018 6:25,161,136,86,383,3,100.0
366,3/26/2018 6:30,171,152,97,420,3,100.0
367,3/26/2018 6:35,172,143,97,412,3,100.0
368,3/26/2018 6:40,166,150,107,423,3,100.0
369,3/26/2018 6:45,185,152,98,435,3,100.0
370,3/26/2018 6:50,176,160,117,453,3,100.0
371,3/26/2018 6:55,174,160,109,443,3,100.0
372,3/26/2018 7:00,156,130,104,390,3,100.0
373,3/26/2018 7:05,149,149,115,413,3,100.0
374,3/26/2018 7:10,179,162,121,462,3,100.0
375,3/26/2018 7:15,170,154,111,435,3,100.0
376,3/26/2018 7:20,181,167,122,470,3,100.0
377,3/26/2018 7:25,166,166,122,454,3,100.0
378,3/26/2018 7:30,173,157,128,458,3,100.0
379,3/26/2018 7:35,190,184,135,509,3,100.0
380,3/26/2018 7:40,183,161,127,471,3,100.0
381,3/26/2018 7:45,199,173,133,505,3,100.0
382,3/26/2018 7:50,163,163,110,436,3,100.0
383,3/26/2018 7:55,183,171,124,478,3,100.0
384,3/26/2018 8:00,171,138,116,425,3,100.0
385,3/26/2018 8:05,170,149,116,435,3,100.0
386,3/26/2018 8:10,189,172,118,479,3,100.0
387,3/26/2018 8:15,186,166,116,468,3,100.0
388,3/26/2018 8:20,171,153,116,440,3,100.0
389,3/26/2018 8:25,197,163,133,493,3,100.0
390,3/26/2018 8:30,155,153,117,425,3,100.0
391,3/26/2018 8:35,183,159,127,469,3,100.0
392,3/26/2018 8:40,194,154,100,448,3,100.0
393,3/26/2018 8:45,171,140,111,422,3,100.0
394,3/26/2018 8:50,179,157,125,461,3,100.0
395,3/26/2018 8:55,150,142,96,388,3,100.0
396,3/26/2018 9:00,149,136,93,378,3,100.0
397,3/26/2018 9:05,148,150,109,407,3,100.0
398,3/26/2018 9:10,155,138,93,386,3,100.0
399,3/26/2018 9:15,182,140,95,417,3,100.0
400,3/26/2018 9:20,167,151,109,427,3,100.0
401,3/26/2018 9:25,164,137,105,406,3,100.0
402,3/26/2018 9:30,147,139,91,377,3,100.0
403,3/26/2018 9:35,142,134,89,365,3,100.0
404,3/26/2018 9:40,160,133,101,394,3,100.0
405,3/26/2018 9:45,133,116,92,341,3,100.0
406,3/26/2018 9:50,147,130,96,373,3,100.0
407,3/26/2018 9:55,162,144,95,401,3,100.0
408,3/26/2018 10:00,158,130,91,379,3,100.0
409,3/26/2018 10:05,135,123,90,348,3,100.0
410,3/26/2018 10:10,147,128,101,376,3,100.0
411,3/26/2018 10:15,166,147,93,406,3,100.0
412,3/26/2018 10:20,144,139,106,389,3,100.0
413,3/26/2018 10:25,142,132,90,364,3,100.0
414,3/26/2018 10:30,164,140,98,402,3,100.0
415,3/26/2018 10:35,162,147,103,412,3,100.0
416,3/26/2018 10:40,163,149,98,410,3,100.0
417,3/26/2018 10:45,167,148,117,432,3,100.0
418,3/26/2018 10:50,173,144,115,432,3,100.0
419,3/26/2018 10:55,171,139,106,416,3,100.0
420,3/26/2018 11:00,187,158,118,463,3,100.0
421,3/26/2018 11:05,169,156,111,436,3,100.0
422,3/26/2018 11:10,176,159,111,446,3,100.0
423,3/26/2018 11:15,162,149,113,424,3,100.0
424,3/26/2018 11:20,192,146,117,455,3,100.0
425,3/26/2018 11:25,181,158,114,453,3,100.0
426,3/26/2018 11:30,177,158,119,454,3,100.0
427,3/26/2018 11:35,171,157,109,437,3,100.0
428,3/26/2018 11:40,142,146,100,388,3,100.0
429,3/26/2018 11:45,146,149,100,395,3,100.0
430,3/26/2018 11:50,174,142,109,425,3,100.0
431,3/26/2018 11:55,183,153,123,459,3,100.0
432,3/26/2018 12:00,176,162,123,461,3,100.0
433,3/26/2018 12:05,197,167,112,476,3,100.0
434,3/26/2018 12:10,170,165,123,458,3,100.0
435,3/26/2018 12:15,164,142,101,407,3,100.0
436,3/26/2018 12:20,197,169,116,482,3,100.0
437,3/26/2018 12:25,152,153,107,412,3,100.0
438,3/26/2018 12:30,186,171,121,478,3,100.0
439,3/26/2018 12:35,168,160,112,440,3,100.0
440,3/26/2018 12:40,178,179,132,489,3,100.0
441,3/26/2018 12:45,141,139,108,388,3,100.0
442,3/26/2018 12:50,166,153,133,452,3,100.0
443,3/26/2018 12:55,179,158,129,466,3,100.0
444,3/26/2018 13:00,182,158,119,459,3,100.0
445,3/26/2018 13:05,165,146,112,423,3,100.0
446,3/26/2018 13:10,149,143,112,404,3,100.0
447,3/26/2018 13:15,156,147,116,419,3,100.0
448,3/26/2018 13:20,169,162,117,448,3,100.0
449,3/26/2018 13:25,173,140,106,419,3,100.0
450,3/26/2018 13:30,171,143,119,433,3,100.0
451,3/26/2018 13:35,173,155,117,445,3,100.0
452,3/26/2018 13:40,169,171,128,468,3,100.0
453,3/26/2018 13:45,191,171,158,520,3,100.0
454,3/26/2018 13:50,182,173,124,479,3,100.0
455,3/26/2018 13:55,163,163,138,464,3,100.0
456,3/26/2018 14:00,164,163,126,453,3,100.0
457,3/26/2018 14:05,173,161,134,468,3,100.0
458,3/26/2018 14:10,163,178,128,469,3,100.0
459,3/26/2018 14:15,181,174,109,464,3,100.0
460,3/26/2018 14:20,178,173,147,498,3,100.0
461,3/26/2018 14:25,188,175,144,507,3,100.0
462,3/26/2018 14:30,171,163,128,462,3,100.0
463,3/26/2018 14:35,174,168,137,479,3,100.0
464,3/26/2018 14:40,191,170,152,513,3,100.0
465,3/26/2018 14:45,180,158,148,486,3,100.0
466,3/26/2018 14:50,121,131,124,376,3,100.0
467,3/26/2018 14:55,145,143,129,417,3,100.0
468,3/26/2018 15:00,162,146,144,452,3,100.0
469,3/26/2018 15:05,152,143,135,430,3,100.0
470,3/26/2018 15:10,164,161,147,472,3,100.0
471,3/26/2018 15:15,166,166,155,487,3,100.0
472,3/26/2018 15:20,154,157,139,450,3,100.0
473,3/26/2018 15:25,153,168,139,460,3,100.0
474,3/26/2018 15:30,144,154,130,428,3,100.0
475,3/26/2018 15:35,148,147,127,422,3,100.0
476,3/26/2018 15:40,142,137,127,406,3,100.0
477,3/26/2018 15:45,131,123,120,374,3,100.0
478,3/26/2018 15:50,141,138,133,412,3,100.0
479,3/26/2018 15:55,142,142,124,408,3,100.0
480,3/26/2018 16:00,162,145,136,443,3,100.0
481,3/26/2018 16:05,135,134,125,394,3,100.0
482,3/26/2018 16:10,107,107,97,311,3,100.0
483,3/26/2018 16:15,148,145,143,436,3,100.0
484,3/26/2018 16:20,145,144,138,427,3,100.0
485,3/26/2018 16:25,162,146,133,441,3,100.0
486,3/26/2018 16:30,153,141,133,427,3,100.0
487,3/26/2018 16:35,133,129,123,385,3,100.0
488,3/26/2018 16:40,142,138,133,413,3,100.0
489,3/26/2018 16:45,146,133,130,409,3,100.0
490,3/26/2018 16:50,130,131,136,397,3,100.0
491,3/26/2018 16:55,138,145,134,417,3,100.0
492,3/26/2018 17:00,134,144,135,413,3,100.0
493,3/26/2018 17:05,130,129,127,386,3,100.0
494,3/26/2018 17:10,160,158,140,458,3,100.0
495,3/26/2018 17:15,156,141,141,438,3,100.0
496,3/26/2018 17:20,152,146,146,444,3,100.0
497,3/26/2018 17:25,159,155,157,471,3,100.0
498,3/26/2018 17:30,160,162,155,477,3,100.0
499,3/26/2018 17:35,145,146,137,428,3,100.0
500,3/26/2018 17:40,152,144,142,438,3,100.0
501,3/26/2018 17:45,153,141,143,437,3,100.0
502,3/26/2018 17:50,167,149,155,471,3,100.0
503,3/26/2018 17:55,157,152,150,459,3,100.0
504,3/26/2018 18:00,175,176,158,509,3,100.0
505,3/26/2018 18:05,164,171,150,485,3,100.0
506,3/26/2018 18:10,158,156,152,466,3,100.0
507,3/26/2018 18:15,169,159,139,467,3,100.0
508,3/26/2018 18:20,167,148,148,463,3,100.0
509,3/26/2018 18:25,169,162,154,485,3,100.0
510,3/26/2018 18:30,148,151,135,434,3,100.0
511,3/26/2018 18:35,143,162,139,444,3,100.0
512,3/26/2018 18:40,163,152,146,461,3,100.0
513,3/26/2018 18:45,161,147,133,441,3,100.0
514,3/26/2018 18:50,165,163,153,481,3,100.0
515,3/26/2018 18:55,153,156,143,452,3,100.0
516,3/26/2018 19:00,151,149,126,426,3,100.0
517,3/26/2018 19:05,150,165,128,443,3,100.0
518,3/26/2018 19:10,164,169,135,468,3,100.0
519,3/26/2018 19:15,156,136,135,427,3,100.0
520,3/26/2018 19:20,142,137,104,383,3,100.0
521,3/26/2018 19:25,151,152,118,421,3,100.0
522,3/26/2018 19:30,150,142,104,396,3,100.0
523,3/26/2018 19:35,140,135,101,376,3,100.0
524,3/26/2018 19:40,147,139,109,395,3,100.0
525,3/26/2018 19:45,151,131,104,386,3,100.0
526,3/26/2018 19:50,122,128,89,339,3,100.0
527,3/26/2018 19:55,127,126,94,347,3,100.0
528,3/26/2018 20:00,136,122,115,373,3,100.0
529,3/26/2018 20:05,147,124,110,381,3,100.0
530,3/26/2018 20:10,155,126,103,384,3,100.0
531,3/26/2018 20:15,144,132,103,379,3,100.0
532,3/26/2018 20:20,127,126,84,337,3,100.0
533,3/26/2018 20:25,144,124,90,358,3,100.0
534,3/26/2018 20:30,146,120,89,355,3,100.0
535,3/26/2018 20:35,131,129,93,353,3,100.0
536,3/26/2018 20:40,123,109,90,322,3,100.0
537,3/26/2018 20:45,135,117,82,334,3,100.0
538,3/26/2018 20:50,115,116,90,321,3,100.0
539,3/26/2018 20:55,130,124,90,344,3,100.0
540,3/26/2018 21:00,107,113,92,312,3,100.0
541,3/26/2018 21:05,126,113,71,310,3,100.0
542,3/26/2018 21:10,111,100,71,282,3,100.0
543,3/26/2018 21:15,110,106,66,282,3,100.0
544,3/26/2018 21:20,126,113,95,334,3,100.0
545,3/26/2018 21:25,131,111,90,332,3,100.0
546,3/26/2018 21:30,120,110,72,302,3,100.0
547,3/26/2018 21:35,110,118,74,302,3,100.0
548,3/26/2018 21:40,97,97,69,263,3,100.0
549,3/26/2018 21:45,106,104,73,283,3,100.0
550,3/26/2018 21:50,106,83,72,261,3,100.0
551,3/26/2018 21:55,93,105,67,265,3,100.0
552,3/26/2018 22:00,97,86,61,244,3,100.0
553,3/26/2018 22:05,94,89,64,247,3,100.0
554,3/26/2018 22:10,109,91,61,261,3,100.0
555,3/26/2018 22:15,112,97,74,283,3,100.0
556,3/26/2018 22:20,96,92,64,252,3,100.0
557,3/26/2018 22:25,83,75,56,214,3,100.0
558,3/26/2018 22:30,86,90,66,242,3,100.0
559,3/26/2018 22:35,98,94,65,257,3,100.0
560,3/26/2018 22:40,91,83,60,234,3,100.0
561,3/26/2018 22:45,83,90,72,245,3,100.0
562,3/26/2018 22:50,77,78,50,205,3,100.0
563,3/26/2018 22:55,82,77,55,214,3,100.0
564,3/26/2018 23:00,69,73,52,194,3,100.0
565,3/26/2018 23:05,74,87,45,206,3,100.0
566,3/26/2018 23:10,62,66,53,181,3,100.0
567,3/26/2018 23:15,80,73,64,217,3,100.0
568,3/26/2018 23:20,67,60,36,163,3,100.0
569,3/26/2018 23:25,58,57,41,156,3,100.0
570,3/26/2018 23:30,54,65,41,160,3,100.0
571,3/26/2018 23:35,56,62,43,161,3,100.0
572,3/26/2018 23:40,50,53,45,148,3,100.0
573,3/26/2018 23:45,53,68,31,152,3,100.0
574,3/26/2018 23:50,41,42,34,117,3,100.0
575,3/26/2018 23:55,63,69,43,175,3,100.0
576,3/27/2018 0:00,33,48,43,124,3,100.0
577,3/27/2018 0:05,38,52,32,122,3,100.0
578,3/27/2018 0:10,33,47,36,116,3,100.0
579,3/27/2018 0:15,40,53,45,138,3,100.0
580,3/27/2018 0:20,33,41,22,96,3,100.0
581,3/27/2018 0:25,33,42,31,106,3,100.0
582,3/27/2018 0:30,35,37,33,105,3,100.0
583,3/27/2018 0:35,36,32,25,93,3,100.0
584,3/27/2018 0:40,32,32,24,88,3,100.0
585,3/27/2018 0:45,29,34,28,91,3,100.0
586,3/27/2018 0:50,28,37,23,88,3,100.0
587,3/27/2018 0:55,28,26,29,83,3,100.0
588,3/27/2018 1:00,19,29,24,72,3,100.0
589,3/27/2018 1:05,24,33,23,80,3,100.0
590,3/27/2018 1:10,27,27,18,72,3,100.0
591,3/27/2018 1:15,21,39,22,82,3,100.0
592,3/27/2018 1:20,23,24,21,68,3,100.0
593,3/27/2018 1:25,13,24,20,57,3,100.0
594,3/27/2018 1:30,23,27,20,70,3,100.0
595,3/27/2018 1:35,21,23,13,57,3,100.0
596,3/27/2018 1:40,17,19,22,58,3,100.0
597,3/27/2018 1:45,17,26,21,64,3,100.0
598,3/27/2018 1:50,19,26,24,69,3,100.0
599,3/27/2018 1:55,22,24,15,61,3,100.0
600,3/27/2018 2:00,14,22,19,55,3,100.0
601,3/27/2018 2:05,16,22,11,49,3,100.0
602,3/27/2018 2:10,15,21,10,46,3,100.0
603,3/27/2018 2:15,16,12,19,47,3,100.0
604,3/27/2018 2:20,13,15,22,50,3,100.0
605,3/27/2018 2:25,13,25,15,53,3,100.0
606,3/27/2018 2:30,16,23,16,55,3,100.0
607,3/27/2018 2:35,11,18,15,44,3,100.0
608,3/27/2018 2:40,12,25,13,50,3,100.0
609,3/27/2018 2:45,13,19,16,48,3,100.0
610,3/27/2018 2:50,4,14,10,28,3,100.0
611,3/27/2018 2:55,6,22,14,42,3,100.0
612,3/27/2018 3:00,15,20,14,49,3,100.0
613,3/27/2018 3:05,15,17,15,47,3,100.0
614,3/27/2018 3:10,4,13,16,33,3,100.0
615,3/27/2018 3:15,8,17,14,39,3,100.0
616,3/27/2018 3:20,13,20,10,43,3,100.0
617,3/27/2018 3:25,12,16,14,42,3,100.0
618,3/27/2018 3:30,10,15,19,44,3,100.0
619,3/27/2018 3:35,13,23,16,52,3,100.0
620,3/27/2018 3:40,8,19,16,43,3,100.0
621,3/27/2018 3:45,11,14,16,41,3,100.0
622,3/27/2018 3:50,18,24,23,65,3,100.0
623,3/27/2018 3:55,19,22,17,58,3,100.0
624,3/27/2018 4:00,19,26,14,59,3,100.0
625,3/27/2018 4:05,18,24,25,67,3,100.0
626,3/27/2018 4:10,15,25,15,55,3,100.0
627,3/27/2018 4:15,21,33,17,71,3,100.0
628,3/27/2018 4:20,27,40,24,91,3,100.0
629,3/27/2018 4:25,44,44,21,109,3,100.0
630,3/27/2018 4:30,30,36,18,84,3,100.0
631,3/27/2018 4:35,46,45,34,125,3,100.0
632,3/27/2018 4:40,33,40,25,98,3,100.0
633,3/27/2018 4:45,58,52,34,144,3,100.0
634,3/27/2018 4:50,52,46,35,133,3,100.0
635,3/27/2018 4:55,46,56,40,142,3,100.0
636,3/27/2018 5:00,54,52,33,139,3,100.0
637,3/27/2018 5:05,65,59,47,171,3,100.0
638,3/27/2018 5:10,69,82,48,199,3,100.0
639,3/27/2018 5:15,95,86,40,221,3,100.0
640,3/27/2018 5:20,104,98,51,253,3,100.0
641,3/27/2018 5:25,97,68,61,226,3,100.0
642,3/27/2018 5:30,106,93,59,258,3,100.0
643,3/27/2018 5:35,141,118,63,322,3,100.0
644,3/27/2018 5:40,148,115,70,333,3,100.0
645,3/27/2018 5:45,132,122,74,328,3,100.0
646,3/27/2018 5:50,156,134,79,369,3,100.0
647,3/27/2018 5:55,128,112,80,320,3,100.0
648,3/27/2018 6:00,134,122,73,329,3,100.0
649,3/27/2018 6:05,161,130,82,373,3,100.0
650,3/27/2018 6:10,154,139,80,373,3,100.0
651,3/27/2018 6:15,155,143,99,397,3,100.0
652,3/27/2018 6:20,168,146,92,406,3,100.0
653,3/27/2018 6:25,161,132,92,385,3,100.0
654,3/27/2018 6:30,156,135,89,380,3,100.0
655,3/27/2018 6:35,188,148,96,432,3,100.0
656,3/27/2018 6:40,180,138,96,414,3,100.0
657,3/27/2018 6:45,185,163,122,470,3,100.0
658,3/27/2018 6:50,189,145,110,444,3,100.0
659,3/27/2018 6:55,176,144,112,432,3,100.0
660,3/27/2018 7:00,172,129,104,405,3,100.0
661,3/27/2018 7:05,153,155,119,427,3,100.0
662,3/27/2018 7:10,170,152,118,440,3,100.0
663,3/27/2018 7:15,171,150,126,447,3,100.0
664,3/27/2018 7:20,170,164,125,459,3,100.0
665,3/27/2018 7:25,157,143,120,420,3,100.0
666,3/27/2018 7:30,170,164,134,468,3,100.0
667,3/27/2018 7:35,181,163,142,486,3,100.0
668,3/27/2018 7:40,185,169,142,496,3,100.0
669,3/27/2018 7:45,191,174,134,499,3,100.0
670,3/27/2018 7:50,189,167,128,484,3,100.0
671,3/27/2018 7:55,175,157,114,446,3,100.0
672,3/27/2018 8:00,178,151,126,455,3,100.0
673,3/27/2018 8:05,168,143,102,413,3,100.0
674,3/27/2018 8:10,173,149,109,431,3,100.0
675,3/27/2018 8:15,138,117,122,377,3,100.0
676,3/27/2018 8:20,168,154,115,437,3,100.0
677,3/27/2018 8:25,186,150,124,460,3,100.0
678,3/27/2018 8:30,181,163,131,475,3,100.0
679,3/27/2018 8:35,192,166,106,464,3,100.0
680,3/27/2018 8:40,190,153,119,462,3,100.0
681,3/27/2018 8:45,175,149,78,402,3,100.0
682,3/27/2018 8:50,182,164,116,462,3,100.0
683,3/27/2018 8:55,191,151,125,467,3,100.0
684,3/27/2018 9:00,150,142,102,394,3,100.0
685,3/27/2018 9:05,173,154,99,426,3,100.0
686,3/27/2018 9:10,173,137,109,419,3,100.0
687,3/27/2018 9:15,149,134,88,371,3,100.0
688,3/27/2018 9:20,175,138,101,414,3,100.0
689,3/27/2018 9:25,158,128,106,392,3,100.0
690,3/27/2018 9:30,151,140,101,392,3,100.0
691,3/27/2018 9:35,176,141,103,420,3,100.0
692,3/27/2018 9:40,167,141,101,409,3,100.0
693,3/27/2018 9:45,152,148,89,389,3,100.0
694,3/27/2018 9:50,178,148,103,429,3,100.0
695,3/27/2018 9:55,161,149,97,407,3,100.0
696,3/27/2018 10:00,144,143,100,387,3,100.0
697,3/27/2018 10:05,149,149,89,387,3,100.0
698,3/27/2018 10:10,143,143,96,382,3,100.0
699,3/27/2018 10:15,160,137,101,398,3,100.0
700,3/27/2018 10:20,175,139,106,420,3,100.0
701,3/27/2018 10:25,174,144,104,422,3,100.0
702,3/27/2018 10:30,159,148,96,403,3,100.0
703,3/27/2018 10:35,165,136,98,399,3,100.0
704,3/27/2018 10:40,182,142,97,421,3,100.0
705,3/27/2018 10:45,160,146,106,412,3,100.0
706,3/27/2018 10:50,148,140,95,383,3,100.0
707,3/27/2018 10:55,158,135,77,370,3,100.0
708,3/27/2018 11:00,156,141,100,397,3,100.0
709,3/27/2018 11:05,175,140,107,422,3,100.0
710,3/27/2018 11:10,156,150,114,420,3,100.0
711,3/27/2018 11:15,172,140,110,422,3,100.0
712,3/27/2018 11:20,171,148,95,414,3,100.0
713,3/27/2018 11:25,159,139,117,415,3,100.0
714,3/27/2018 11:30,176,159,126,461,3,100.0
715,3/27/2018 11:35,167,139,122,428,3,100.0
716,3/27/2018 11:40,180,153,130,463,3,100.0
717,3/27/2018 11:45,165,159,98,422,3,100.0
718,3/27/2018 11:50,179,161,117,457,3,100.0
719,3/27/2018 11:55,170,151,115,436,3,100.0
720,3/27/2018 12:00,160,151,115,426,3,100.0
721,3/27/2018 12:05,159,150,102,411,3,100.0
722,3/27/2018 12:10,153,149,103,405,3,100.0
723,3/27/2018 12:15,156,144,103,403,3,100.0
724,3/27/2018 12:20,171,137,127,435,3,100.0
725,3/27/2018 12:25,164,165,100,429,3,100.0
726,3/27/2018 12:30,154,156,111,421,3,100.0
727,3/27/2018 12:35,171,149,113,433,3,100.0
728,3/27/2018 12:40,176,163,125,464,3,100.0
729,3/27/2018 12:45,181,163,125,469,3,100.0
730,3/27/2018 12:50,185,173,139,497,3,100.0
731,3/27/2018 12:55,206,153,125,484,3,100.0
732,3/27/2018 13:00,176,156,126,458,3,100.0
733,3/27/2018 13:05,186,153,118,457,3,100.0
734,3/27/2018 13:10,179,166,121,466,3,100.0
735,3/27/2018 13:15,179,174,123,476,3,100.0
736,3/27/2018 13:20,185,156,113,454,3,100.0
737,3/27/2018 13:25,181,162,127,470,3,100.0
738,3/27/2018 13:30,191,166,121,478,3,100.0
739,3/27/2018 13:35,183,170,131,484,3,100.0
740,3/27/2018 13:40,176,142,125,443,3,100.0
741,3/27/2018 13:45,155,147,115,417,3,100.0
742,3/27/2018 13:50,172,159,147,478,3,100.0
743,3/27/2018 13:55,183,173,143,499,3,100.0
744,3/27/2018 14:00,173,168,139,480,3,100.0
745,3/27/2018 14:05,185,167,126,478,3,100.0
746,3/27/2018 14:10,179,163,142,484,3,100.0
747,3/27/2018 14:15,174,162,137,473,3,100.0
748,3/27/2018 14:20,171,167,140,478,3,100.0
749,3/27/2018 14:25,179,158,127,464,3,100.0
750,3/27/2018 14:30,145,144,121,410,3,100.0
751,3/27/2018 14:35,164,166,130,460,3,100.0
752,3/27/2018 14:40,167,150,139,456,3,100.0
753,3/27/2018 14:45,154,140,131,425,3,100.0
754,3/27/2018 14:50,166,154,139,459,3,100.0
755,3/27/2018 14:55,150,148,119,417,3,100.0
756,3/27/2018 15:00,150,155,140,445,3,100.0
757,3/27/2018 15:05,160,151,143,454,3,100.0
758,3/27/2018 15:10,160,150,143,453,3,100.0
759,3/27/2018 15:15,150,142,138,430,3,100.0
760,3/27/2018 15:20,96,104,111,311,3,100.0
761,3/27/2018 15:25,136,134,115,385,3,100.0
762,3/27/2018 15:30,143,132,130,405,3,100.0
763,3/27/2018 15:35,154,145,135,434,3,100.0
764,3/27/2018 15:40,168,156,155,479,3,100.0
765,3/27/2018 15:45,123,114,118,355,3,100.0
766,3/27/2018 15:50,140,126,127,393,3,100.0
767,3/27/2018 15:55,154,153,136,443,3,100.0
768,3/27/2018 16:00,163,154,152,469,3,100.0
769,3/27/2018 16:05,150,158,150,458,3,100.0
770,3/27/2018 16:10,149,136,128,413,3,100.0
771,3/27/2018 16:15,125,122,127,374,3,100.0
772,3/27/2018 16:20,136,132,127,395,3,100.0
773,3/27/2018 16:25,143,137,123,403,3,100.0
774,3/27/2018 16:30,163,150,141,454,3,100.0
775,3/27/2018 16:35,119,118,120,357,3,100.0
776,3/27/2018 16:40,152,144,134,430,3,100.0
777,3/27/2018 16:45,142,138,131,411,3,100.0
778,3/27/2018 16:50,126,127,127,380,3,100.0
779,3/27/2018 16:55,126,120,130,376,3,100.0
780,3/27/2018 17:00,139,128,136,403,3,100.0
781,3/27/2018 17:05,117,122,119,358,3,100.0
782,3/27/2018 17:10,154,138,147,439,3,100.0
783,3/27/2018 17:15,139,127,124,390,3,100.0
784,3/27/2018 17:20,131,134,127,392,3,100.0
785,3/27/2018 17:25,146,134,139,419,3,100.0
786,3/27/2018 17:30,130,133,127,390,3,100.0
787,3/27/2018 17:35,141,134,132,407,3,100.0
788,3/27/2018 17:40,143,133,121,397,3,100.0
789,3/27/2018 17:45,145,138,127,410,3,100.0
790,3/27/2018 17:50,151,140,132,423,3,100.0
791,3/27/2018 17:55,142,147,138,427,3,100.0
792,3/27/2018 18:00,144,141,127,412,3,100.0
793,3/27/2018 18:05,140,136,141,417,3,100.0
794,3/27/2018 18:10,136,130,136,402,3,100.0
795,3/27/2018 18:15,139,139,133,411,3,100.0
796,3/27/2018 18:20,141,134,140,415,3,100.0
797,3/27/2018 18:25,147,143,140,430,3,100.0
798,3/27/2018 18:30,158,143,146,447,3,100.0
799,3/27/2018 18:35,160,146,133,439,3,100.0
800,3/27/2018 18:40,156,134,123,413,3,100.0
801,3/27/2018 18:45,144,143,133,420,3,100.0
802,3/27/2018 18:50,169,155,142,466,3,100.0
803,3/27/2018 18:55,159,147,136,442,3,100.0
804,3/27/2018 19:00,166,147,144,457,3,100.0
805,3/27/2018 19:05,169,158,133,460,3,100.0
806,3/27/2018 19:10,164,144,136,444,3,100.0
807,3/27/2018 19:15,150,143,116,409,3,100.0
808,3/27/2018 19:20,171,148,128,447,3,100.0
809,3/27/2018 19:25,174,166,132,472,3,100.0
810,3/27/2018 19:30,161,159,130,450,3,100.0
811,3/27/2018 19:35,167,149,142,458,3,100.0
812,3/27/2018 19:40,156,155,143,454,3,100.0
813,3/27/2018 19:45,150,137,133,420,3,100.0
814,3/27/2018 19:50,157,146,120,423,3,100.0
815,3/27/2018 19:55,161,150,131,442,3,100.0
816,3/27/2018 20:00,160,156,138,454,3,100.0
817,3/27/2018 20:05,164,151,139,454,3,100.0
818,3/27/2018 20:10,140,134,128,402,3,100.0
819,3/27/2018 20:15,143,142,131,416,3,100.0
820,3/27/2018 20:20,151,134,130,415,3,100.0
821,3/27/2018 20:25,148,131,131,410,3,100.0
822,3/27/2018 20:30,144,122,113,379,3,100.0
823,3/27/2018 20:35,147,132,100,379,3,100.0
824,3/27/2018 20:40,154,141,107,402,3,100.0
825,3/27/2018 20:45,157,145,105,407,3,100.0
826,3/27/2018 20:50,152,143,119,414,3,100.0
827,3/27/2018 20:55,141,125,110,376,3,100.0
828,3/27/2018 21:00,137,116,106,359,3,100.0
829,3/27/2018 21:05,133,130,91,354,3,100.0
830,3/27/2018 21:10,129,115,98,342,3,100.0
831,3/27/2018 21:15,120,110,95,325,3,100.0
832,3/27/2018 21:20,128,127,102,357,3,100.0
833,3/27/2018 21:25,112,109,76,297,3,100.0
834,3/27/2018 21:30,120,119,72,311,3,100.0
835,3/27/2018 21:35,110,110,71,291,3,100.0
836,3/27/2018 21:40,117,129,90,336,3,100.0
837,3/27/2018 21:45,107,110,82,299,3,100.0
838,3/27/2018 21:50,126,108,75,309,3,100.0
839,3/27/2018 21:55,120,96,64,280,3,100.0
840,3/27/2018 22:00,101,100,82,283,3,100.0
841,3/27/2018 22:05,120,112,68,300,3,100.0
842,3/27/2018 22:10,110,98,65,273,3,100.0
843,3/27/2018 22:15,101,90,72,263,3,100.0
844,3/27/2018 22:20,123,114,79,316,3,100.0
845,3/27/2018 22:25,104,93,74,271,3,100.0
846,3/27/2018 22:30,94,104,70,268,3,100.0
847,3/27/2018 22:35,92,91,52,235,3,100.0
848,3/27/2018 22:40,100,95,73,268,3,100.0
849,3/27/2018 22:45,80,80,50,210,3,100.0
850,3/27/2018 22:50,68,84,51,203,3,100.0
851,3/27/2018 22:55,83,74,48,205,3,100.0
852,3/27/2018 23:00,82,66,43,191,3,100.0
853,3/27/2018 23:05,55,63,41,159,3,100.0
854,3/27/2018 23:10,73,65,44,182,3,100.0
855,3/27/2018 23:15,69,66,53,188,3,100.0
856,3/27/2018 23:20,58,61,46,165,3,100.0
857,3/27/2018 23:25,67,80,48,195,3,100.0
858,3/27/2018 23:30,61,54,50,165,3,100.0
859,3/27/2018 23:35,53,53,33,139,3,100.0
860,3/27/2018 23:40,54,68,41,163,3,100.0
861,3/27/2018 23:45,57,66,47,170,3,100.0
862,3/27/2018 23:50,54,50,34,138,3,100.0
863,3/27/2018 23:55,44,45,29,118,3,100.0
864,3/28/2018 0:00,50,47,32,129,3,100.0
865,3/28/2018 0:05,33,53,28,114,3,100.0
866,3/28/2018 0:10,38,50,30,118,3,100.0
867,3/28/2018 0:15,37,46,46,129,3,100.0
868,3/28/2018 0:20,34,44,27,105,3,100.0
869,3/28/2018 0:25,35,54,31,120,3,100.0
870,3/28/2018 0:30,42,41,29,112,3,100.0
871,3/28/2018 0:35,25,18,19,62,3,100.0
872,3/28/2018 0:40,34,41,23,98,3,100.0
873,3/28/2018 0:45,34,43,34,111,3,100.0
874,3/28/2018 0:50,28,35,26,89,3,100.0
875,3/28/2018 0:55,31,39,20,90,3,100.0
876,3/28/2018 1:00,21,39,20,80,3,100.0
877,3/28/2018 1:05,18,26,14,58,3,100.0
878,3/28/2018 1:10,26,28,28,82,3,100.0
879,3/28/2018 1:15,27,29,29,85,3,100.0
880,3/28/2018 1:20,19,25,15,59,3,100.0
881,3/28/2018 1:25,18,21,25,64,3,100.0
882,3/28/2018 1:30,19,32,25,76,3,100.0
883,3/28/2018 1:35,15,23,22,60,3,100.0
884,3/28/2018 1:40,13,29,18,60,3,100.0
885,3/28/2018 1:45,13,32,18,63,3,100.0
886,3/28/2018 1:50,27,26,22,75,3,100.0
887,3/28/2018 1:55,17,23,16,56,3,100.0
888,3/28/2018 2:00,15,21,14,50,3,100.0
889,3/28/2018 2:05,11,18,21,50,3,100.0
890,3/28/2018 2:10,14,23,16,53,3,100.0
891,3/28/2018 2:15,19,19,26,64,3,100.0
892,3/28/2018 2:20,16,25,17,58,3,100.0
893,3/28/2018 2:25,14,21,13,48,3,100.0
894,3/28/2018 2:30,16,19,19,54,3,100.0
895,3/28/2018 2:35,11,28,18,57,3,100.0
896,3/28/2018 2:40,13,17,15,45,3,100.0
897,3/28/2018 2:45,12,23,24,59,3,100.0
898,3/28/2018 2:50,10,15,18,43,3,100.0
899,3/28/2018 2:55,9,12,12,33,3,100.0
900,3/28/2018 3:00,6,10,11,27,3,100.0
901,3/28/2018 3:05,10,16,16,42,3,100.0
902,3/28/2018 3:10,7,14,11,32,3,100.0
903,3/28/2018 3:15,14,20,12,46,3,100.0
904,3/28/2018 3:20,15,27,22,64,3,100.0
905,3/28/2018 3:25,13,21,12,46,3,100.0
906,3/28/2018 3:30,12,24,14,50,3,100.0
907,3/28/2018 3:35,12,23,24,59,3,100.0
908,3/28/2018 3:40,13,19,18,50,3,100.0
909,3/28/2018 3:45,11,23,20,54,3,100.0
910,3/28/2018 3:50,17,18,17,52,3,100.0
911,3/28/2018 3:55,19,21,23,63,3,100.0
912,3/28/2018 4:00,17,38,18,73,3,100.0
913,3/28/2018 4:05,11,19,16,46,3,100.0
914,3/28/2018 4:10,20,27,15,62,3,100.0
915,3/28/2018 4:15,27,29,21,77,3,100.0
916,3/28/2018 4:20,29,37,30,96,3,100.0
917,3/28/2018 4:25,25,24,21,70,3,100.0
918,3/28/2018 4:30,38,39,29,106,3,100.0
919,3/28/2018 4:35,27,46,32,105,3,100.0
920,3/28/2018 4:40,37,46,25,108,3,100.0
921,3/28/2018 4:45,42,47,39,128,3,100.0
922,3/28/2018 4:50,49,52,33,134,3,100.0
923,3/28/2018 4:55,38,58,40,136,3,100.0
924,3/28/2018 5:00,48,61,38,147,3,100.0
925,3/28/2018 5:05,70,62,35,167,3,100.0
926,3/28/2018 5:10,73,76,53,202,3,100.0
927,3/28/2018 5:15,95,82,48,225,3,100.0
928,3/28/2018 5:20,98,89,48,235,3,100.0
929,3/28/2018 5:25,99,92,47,238,3,100.0
930,3/28/2018 5:30,122,94,57,273,3,100.0
931,3/28/2018 5:35,119,111,55,285,3,100.0
932,3/28/2018 5:40,132,128,81,341,3,100.0
933,3/28/2018 5:45,144,128,78,350,3,100.0
934,3/28/2018 5:50,145,118,89,352,3,100.0
935,3/28/2018 5:55,138,114,63,315,3,100.0
936,3/28/2018 6:00,158,134,78,370,3,100.0
937,3/28/2018 6:05,165,126,67,358,3,100.0
938,3/28/2018 6:10,150,145,89,384,3,100.0
939,3/28/2018 6:15,116,96,68,280,3,100.0
940,3/28/2018 6:20,164,118,92,374,3,100.0
941,3/28/2018 6:25,156,138,97,391,3,100.0
942,3/28/2018 6:30,163,134,96,393,3,100.0
943,3/28/2018 6:35,166,141,88,395,3,100.0
944,3/28/2018 6:40,169,149,102,420,3,100.0
945,3/28/2018 6:45,180,147,114,441,3,100.0
946,3/28/2018 6:50,181,148,100,429,3,100.0
947,3/28/2018 6:55,179,147,97,423,3,100.0
948,3/28/2018 7:00,154,135,89,378,3,100.0
949,3/28/2018 7:05,149,145,108,402,3,100.0
950,3/28/2018 7:10,159,143,120,422,3,100.0
951,3/28/2018 7:15,177,161,119,457,3,100.0
952,3/28/2018 7:20,169,158,121,448,3,100.0
953,3/28/2018 7:25,181,159,135,475,3,100.0
954,3/28/2018 7:30,184,169,118,471,3,100.0
955,3/28/2018 7:35,170,150,123,443,3,100.0
956,3/28/2018 7:40,166,161,113,440,3,100.0
957,3/28/2018 7:45,175,169,148,492,3,100.0
958,3/28/2018 7:50,176,159,117,452,3,100.0
959,3/28/2018 7:55,182,167,113,462,3,100.0
960,3/28/2018 8:00,176,144,136,456,3,100.0
961,3/28/2018 8:05,173,155,113,441,3,100.0
962,3/28/2018 8:10,171,154,105,430,3,100.0
963,3/28/2018 8:15,172,139,117,428,3,100.0
964,3/28/2018 8:20,180,145,132,457,3,100.0
965,3/28/2018 8:25,174,133,118,425,3,100.0
966,3/28/2018 8:30,169,160,131,460,3,100.0
967,3/28/2018 8:35,186,171,131,488,3,100.0
968,3/28/2018 8:40,199,169,131,499,3,100.0
969,3/28/2018 8:45,187,148,119,454,3,100.0
970,3/28/2018 8:50,164,140,115,419,3,100.0
971,3/28/2018 8:55,188,155,102,445,3,100.0
972,3/28/2018 9:00,173,160,113,446,3,100.0
973,3/28/2018 9:05,161,132,96,389,3,100.0
974,3/28/2018 9:10,145,125,92,362,3,100.0
975,3/28/2018 9:15,152,137,102,391,3,100.0
976,3/28/2018 9:20,148,142,93,383,3,100.0
977,3/28/2018 9:25,165,145,112,422,3,100.0
978,3/28/2018 9:30,157,143,117,417,3,100.0
979,3/28/2018 9:35,164,156,113,433,3,100.0
980,3/28/2018 9:40,162,134,94,390,3,100.0
981,3/28/2018 9:45,176,140,104,420,3,100.0
982,3/28/2018 9:50,154,132,102,388,3,100.0
983,3/28/2018 9:55,158,135,94,387,3,100.0
984,3/28/2018 10:00,174,143,96,413,3,100.0
985,3/28/2018 10:05,167,149,103,419,3,100.0
986,3/28/2018 10:10,158,155,99,412,3,100.0
987,3/28/2018 10:15,171,148,99,418,3,100.0
988,3/28/2018 10:20,180,147,105,432,3,100.0
989,3/28/2018 10:25,190,145,124,459,3,100.0
990,3/28/2018 10:30,172,155,84,411,3,100.0
991,3/28/2018 10:35,169,144,114,427,3,100.0
992,3/28/2018 10:40,182,164,108,454,3,100.0
993,3/28/2018 10:45,173,147,115,435,3,100.0
994,3/28/2018 10:50,172,158,99,429,3,100.0
995,3/28/2018 10:55,174,146,112,432,3,100.0
996,3/28/2018 11:00,179,158,121,458,3,100.0
997,3/28/2018 11:05,158,149,112,419,3,100.0
998,3/28/2018 11:10,190,143,121,454,3,100.0
999,3/28/2018 11:15,159,156,108,423,3,100.0
1000,3/28/2018 11:20,169,157,103,429,3,100.0
1001,3/28/2018 11:25,167,154,119,440,3,100.0
1002,3/28/2018 11:30,176,156,109,441,3,100.0
1003,3/28/2018 11:35,168,163,96,427,3,100.0
1004,3/28/2018 11:40,155,153,97,405,3,100.0
1005,3/28/2018 11:45,156,143,109,408,3,100.0
1006,3/28/2018 11:50,169,157,126,452,3,100.0
1007,3/28/2018 11:55,166,150,111,427,3,100.0
1008,3/28/2018 12:00,168,153,103,424,3,100.0
1009,3/28/2018 12:05,143,156,110,409,3,100.0
1010,3/28/2018 12:10,189,157,129,475,3,100.0
1011,3/28/2018 12:15,188,159,121,468,3,100.0
1012,3/28/2018 12:20,176,168,124,468,3,100.0
1013,3/28/2018 12:25,171,166,112,449,3,100.0
1014,3/28/2018 12:30,187,164,134,485,3,100.0
1015,3/28/2018 12:35,182,167,126,475,3,100.0
1016,3/28/2018 12:40,180,163,122,465,3,100.0
1017,3/28/2018 12:45,191,164,116,471,3,100.0
1018,3/28/2018 12:50,178,145,124,447,3,100.0
1019,3/28/2018 12:55,180,167,114,461,3,100.0
1020,3/28/2018 13:00,183,148,132,463,3,100.0
1021,3/28/2018 13:05,177,169,125,471,3,100.0
1022,3/28/2018 13:10,170,153,115,438,3,100.0
1023,3/28/2018 13:15,169,168,133,470,3,100.0
1024,3/28/2018 13:20,184,165,117,466,3,100.0
1025,3/28/2018 13:25,163,160,124,447,3,100.0
1026,3/28/2018 13:30,178,172,133,483,3,100.0
1027,3/28/2018 13:35,165,165,143,473,3,100.0
1028,3/28/2018 13:40,184,158,146,488,3,100.0
1029,3/28/2018 13:45,175,175,139,489,3,100.0
1030,3/28/2018 13:50,183,168,146,497,3,100.0
1031,3/28/2018 13:55,174,162,126,462,3,100.0
1032,3/28/2018 14:00,162,169,120,451,3,100.0
1033,3/28/2018 14:05,169,166,137,472,3,100.0
1034,3/28/2018 14:10,181,186,131,498,3,100.0
1035,3/28/2018 14:15,154,147,135,436,3,100.0
1036,3/28/2018 14:20,163,148,129,440,3,100.0
1037,3/28/2018 14:25,162,152,134,448,3,100.0
1038,3/28/2018 14:30,148,132,119,399,3,100.0
1039,3/28/2018 14:35,166,165,133,464,3,100.0
1040,3/28/2018 14:40,156,158,134,448,3,100.0
1041,3/28/2018 14:45,165,147,139,451,3,100.0
1042,3/28/2018 14:50,151,146,147,444,3,100.0
1043,3/28/2018 14:55,162,149,136,447,3,100.0
1044,3/28/2018 15:00,157,149,141,447,3,100.0
1045,3/28/2018 15:05,154,147,141,442,3,100.0
1046,3/28/2018 15:10,157,141,131,429,3,100.0
1047,3/28/2018 15:15,146,143,133,422,3,100.0
1048,3/28/2018 15:20,157,148,135,440,3,100.0
1049,3/28/2018 15:25,152,157,142,451,3,100.0
1050,3/28/2018 15:30,167,156,142,465,3,100.0
1051,3/28/2018 15:35,160,164,149,473,3,100.0
1052,3/28/2018 15:40,150,130,129,409,3,100.0
1053,3/28/2018 15:45,155,149,138,442,3,100.0
1054,3/28/2018 15:50,138,132,135,405,3,100.0
1055,3/28/2018 15:55,126,125,121,372,3,100.0
1056,3/28/2018 16:00,132,133,122,387,3,100.0
1057,3/28/2018 16:05,152,142,130,424,3,100.0
1058,3/28/2018 16:10,151,143,130,424,3,100.0
1059,3/28/2018 16:15,152,139,136,427,3,100.0
1060,3/28/2018 16:20,148,140,134,422,3,100.0
1061,3/28/2018 16:25,100,102,117,319,3,100.0
1062,3/28/2018 16:30,129,138,139,406,3,100.0
1063,3/28/2018 16:35,145,141,139,425,3,100.0
1064,3/28/2018 16:40,144,133,133,410,3,100.0
1065,3/28/2018 16:45,153,141,140,434,3,100.0
1066,3/28/2018 16:50,141,140,136,417,3,100.0
1067,3/28/2018 16:55,146,143,143,432,3,100.0
1068,3/28/2018 17:00,135,127,126,388,3,100.0
1069,3/28/2018 17:05,148,141,131,420,3,100.0
1070,3/28/2018 17:10,115,118,113,346,3,100.0
1071,3/28/2018 17:15,149,134,139,422,3,100.0
1072,3/28/2018 17:20,157,148,149,454,3,100.0
1073,3/28/2018 17:25,112,111,104,327,3,100.0
1074,3/28/2018 17:30,140,131,133,404,3,100.0
1075,3/28/2018 17:35,138,130,131,399,3,100.0
1076,3/28/2018 17:40,148,145,140,433,3,100.0
1077,3/28/2018 17:45,152,144,127,423,3,100.0
1078,3/28/2018 17:50,121,115,117,353,3,100.0
1079,3/28/2018 17:55,117,104,104,325,3,100.0
1080,3/28/2018 18:00,144,153,144,441,3,100.0
1081,3/28/2018 18:05,122,121,120,363,3,100.0
1082,3/28/2018 18:10,110,100,100,310,3,100.0
1083,3/28/2018 18:15,121,126,129,376,3,100.0
1084,3/28/2018 18:20,96,98,100,294,3,100.0
1085,3/28/2018 18:25,128,137,119,384,3,100.0
1086,3/28/2018 18:30,150,133,136,419,3,100.0
1087,3/28/2018 18:35,151,158,134,443,3,100.0
1088,3/28/2018 18:40,158,139,146,443,3,100.0
1089,3/28/2018 18:45,146,147,145,438,3,100.0
1090,3/28/2018 18:50,153,144,144,441,3,100.0
1091,3/28/2018 18:55,142,138,126,406,3,100.0
1092,3/28/2018 19:00,149,151,133,433,3,100.0
1093,3/28/2018 19:05,158,146,137,441,3,100.0
1094,3/28/2018 19:10,148,137,124,409,3,100.0
1095,3/28/2018 19:15,143,136,128,407,3,100.0
1096,3/28/2018 19:20,156,146,137,439,3,100.0
1097,3/28/2018 19:25,156,148,132,436,3,100.0
1098,3/28/2018 19:30,144,135,137,416,3,100.0
1099,3/28/2018 19:35,154,139,127,420,3,100.0
1100,3/28/2018 19:40,143,135,132,410,3,100.0
1101,3/28/2018 19:45,155,140,146,441,3,100.0
1102,3/28/2018 19:50,153,137,128,418,3,100.0
1103,3/28/2018 19:55,147,147,128,422,3,100.0
1104,3/28/2018 20:00,145,135,128,408,3,100.0
1105,3/28/2018 20:05,153,140,136,429,3,100.0
1106,3/28/2018 20:10,151,143,133,427,3,100.0
1107,3/28/2018 20:15,162,144,142,448,3,100.0
1108,3/28/2018 20:20,149,148,142,439,3,100.0
1109,3/28/2018 20:25,151,150,137,438,3,100.0
1110,3/28/2018 20:30,150,137,109,396,3,100.0
1111,3/28/2018 20:35,159,147,111,417,3,100.0
1112,3/28/2018 20:40,145,136,102,383,3,100.0
1113,3/28/2018 20:45,156,141,120,417,3,100.0
1114,3/28/2018 20:50,162,154,116,432,3,100.0
1115,3/28/2018 20:55,158,139,111,408,3,100.0
1116,3/28/2018 21:00,148,137,104,389,3,100.0
1117,3/28/2018 21:05,150,150,110,410,3,100.0
1118,3/28/2018 21:10,171,146,101,418,3,100.0
1119,3/28/2018 21:15,143,120,97,360,3,100.0
1120,3/28/2018 21:20,136,119,98,353,3,100.0
1121,3/28/2018 21:25,145,118,101,364,3,100.0
1122,3/28/2018 21:30,158,124,104,386,3,100.0
1123,3/28/2018 21:35,109,115,75,299,3,100.0
1124,3/28/2018 21:40,114,110,77,301,3,100.0
1125,3/28/2018 21:45,131,118,93,342,3,100.0
1126,3/28/2018 21:50,126,120,84,330,3,100.0
1127,3/28/2018 21:55,108,109,80,297,3,100.0
1128,3/28/2018 22:00,111,98,71,280,3,100.0
1129,3/28/2018 22:05,132,125,80,337,3,100.0
1130,3/28/2018 22:10,105,107,79,291,3,100.0
1131,3/28/2018 22:15,139,134,107,380,3,100.0
1132,3/28/2018 22:20,122,119,84,325,3,100.0
1133,3/28/2018 22:25,125,109,87,321,3,100.0
1134,3/28/2018 22:30,122,102,83,307,3,100.0
1135,3/28/2018 22:35,106,104,49,259,3,100.0
1136,3/28/2018 22:40,110,91,65,266,3,100.0
1137,3/28/2018 22:45,83,94,52,229,3,100.0
1138,3/28/2018 22:50,83,90,53,226,3,100.0
1139,3/28/2018 22:55,92,87,57,236,3,100.0
1140,3/28/2018 23:00,77,81,49,207,3,100.0
1141,3/28/2018 23:05,80,64,53,197,3,100.0
1142,3/28/2018 23:10,72,76,51,199,3,100.0
1143,3/28/2018 23:15,77,80,60,217,3,100.0
1144,3/28/2018 23:20,70,72,47,189,3,100.0
1145,3/28/2018 23:25,75,71,48,194,3,100.0
1146,3/28/2018 23:30,70,61,32,163,3,100.0
1147,3/28/2018 23:35,62,73,43,178,3,100.0
1148,3/28/2018 23:40,67,67,47,181,3,100.0
1149,3/28/2018 23:45,73,80,45,198,3,100.0
1150,3/28/2018 23:50,50,60,38,148,3,100.0
1151,3/28/2018 23:55,57,57,31,145,3,100.0
1152,3/29/2018 0:00,47,51,28,126,3,100.0
1153,3/29/2018 0:05,45,53,42,140,3,100.0
1154,3/29/2018 0:10,55,61,41,157,3,100.0
1155,3/29/2018 0:15,48,47,37,132,3,100.0
1156,3/29/2018 0:20,43,46,26,115,3,100.0
1157,3/29/2018 0:25,39,38,29,106,3,100.0
1158,3/29/2018 0:30,27,37,25,89,3,100.0
1159,3/29/2018 0:35,30,29,30,89,3,100.0
1160,3/29/2018 0:40,38,41,27,106,3,100.0
1161,3/29/2018 0:45,32,50,28,110,3,100.0
1162,3/29/2018 0:50,20,28,15,63,3,100.0
1163,3/29/2018 0:55,39,49,31,119,3,100.0
1164,3/29/2018 1:00,32,28,20,80,3,100.0
1165,3/29/2018 1:05,23,33,23,79,3,100.0
1166,3/29/2018 1:10,30,39,27,96,3,100.0
1167,3/29/2018 1:15,19,38,26,83,3,100.0
1168,3/29/2018 1:20,18,31,22,71,3,100.0
1169,3/29/2018 1:25,23,21,17,61,3,100.0
1170,3/29/2018 1:30,24,38,19,81,3,100.0
1171,3/29/2018 1:35,26,33,20,79,3,100.0
1172,3/29/2018 1:40,19,26,20,65,3,100.0
1173,3/29/2018 1:45,17,30,21,68,3,100.0
1174,3/29/2018 1:50,25,33,22,80,3,100.0
1175,3/29/2018 1:55,26,30,18,74,3,100.0
1176,3/29/2018 2:00,14,14,10,38,3,100.0
1177,3/29/2018 2:05,11,17,12,40,3,100.0
1178,3/29/2018 2:10,24,15,18,57,3,100.0
1179,3/29/2018 2:15,24,23,20,67,3,100.0
1180,3/29/2018 2:20,17,19,16,52,3,100.0
1181,3/29/2018 2:25,21,27,20,68,3,100.0
1182,3/29/2018 2:30,14,14,19,47,3,100.0
1183,3/29/2018 2:35,11,10,18,39,3,100.0
1184,3/29/2018 2:40,9,21,17,47,3,100.0
1185,3/29/2018 2:45,6,17,13,36,3,100.0
1186,3/29/2018 2:50,13,32,18,63,3,100.0
1187,3/29/2018 2:55,8,18,18,44,3,100.0
1188,3/29/2018 3:00,10,17,9,36,3,100.0
1189,3/29/2018 3:05,4,17,15,36,3,100.0
1190,3/29/2018 3:10,10,20,13,43,3,100.0
1191,3/29/2018 3:15,8,19,16,43,3,100.0
1192,3/29/2018 3:20,11,23,14,48,3,100.0
1193,3/29/2018 3:25,19,21,17,57,3,100.0
1194,3/29/2018 3:30,13,17,13,43,3,100.0
1195,3/29/2018 3:35,14,21,16,51,3,100.0
1196,3/29/2018 3:40,13,19,12,44,3,100.0
1197,3/29/2018 3:45,13,27,22,62,3,100.0
1198,3/29/2018 3:50,19,28,17,64,3,100.0
1199,3/29/2018 3:55,17,25,18,60,3,100.0
1200,3/29/2018 4:00,10,24,15,49,3,100.0
1201,3/29/2018 4:05,21,24,17,62,3,100.0
1202,3/29/2018 4:10,13,23,18,54,3,100.0
1203,3/29/2018 4:15,30,34,23,87,3,100.0
1204,3/29/2018 4:20,27,39,23,89,3,100.0
1205,3/29/2018 4:25,37,47,23,107,3,100.0
1206,3/29/2018 4:30,40,42,30,112,3,100.0
1207,3/29/2018 4:35,35,38,25,98,3,100.0
1208,3/29/2018 4:40,35,35,45,115,3,100.0
1209,3/29/2018 4:45,37,53,30,120,3,100.0
1210,3/29/2018 4:50,55,48,42,145,3,100.0
1211,3/29/2018 4:55,47,40,36,123,3,100.0
1212,3/29/2018 5:00,56,46,42,144,3,100.0
1213,3/29/2018 5:05,52,62,48,162,3,100.0
1214,3/29/2018 5:10,67,73,43,183,3,100.0
1215,3/29/2018 5:15,78,80,42,200,3,100.0
1216,3/29/2018 5:20,90,91,55,236,3,100.0
1217,3/29/2018 5:25,90,76,52,218,3,100.0
1218,3/29/2018 5:30,119,107,59,285,3,100.0
1219,3/29/2018 5:35,122,104,75,301,3,100.0
1220,3/29/2018 5:40,118,98,77,293,3,100.0
1221,3/29/2018 5:45,141,123,77,341,3,100.0
1222,3/29/2018 5:50,137,103,86,326,3,100.0
1223,3/29/2018 5:55,163,123,80,366,3,100.0
1224,3/29/2018 6:00,134,100,66,300,3,100.0
1225,3/29/2018 6:05,154,106,76,336,3,100.0
1226,3/29/2018 6:10,156,126,74,356,3,100.0
1227,3/29/2018 6:15,132,145,75,352,3,100.0
1228,3/29/2018 6:20,168,148,85,401,3,100.0
1229,3/29/2018 6:25,156,139,86,381,3,100.0
1230,3/29/2018 6:30,169,153,91,413,3,100.0
1231,3/29/2018 6:35,177,149,104,430,3,100.0
1232,3/29/2018 6:40,175,144,104,423,3,100.0
1233,3/29/2018 6:45,191,155,105,451,3,100.0
1234,3/29/2018 6:50,191,161,108,460,3,100.0
1235,3/29/2018 6:55,176,143,99,418,3,100.0
1236,3/29/2018 7:00,173,149,112,434,3,100.0
1237,3/29/2018 7:05,186,150,101,437,3,100.0
1238,3/29/2018 7:10,176,160,105,441,3,100.0
1239,3/29/2018 7:15,186,156,126,468,3,100.0
1240,3/29/2018 7:20,200,149,107,456,3,100.0
1241,3/29/2018 7:25,192,162,123,477,3,100.0
1242,3/29/2018 7:30,197,180,139,516,3,100.0
1243,3/29/2018 7:35,186,171,121,478,3,100.0
1244,3/29/2018 7:40,191,173,124,488,3,100.0
1245,3/29/2018 7:45,196,168,129,493,3,100.0
1246,3/29/2018 7:50,202,191,129,522,3,100.0
1247,3/29/2018 7:55,199,154,110,463,3,100.0
1248,3/29/2018 8:00,189,158,126,473,3,100.0
1249,3/29/2018 8:05,167,150,106,423,3,100.0
1250,3/29/2018 8:10,201,179,129,509,3,100.0
1251,3/29/2018 8:15,207,169,121,497,3,100.0
1252,3/29/2018 8:20,194,163,114,471,3,100.0
1253,3/29/2018 8:25,189,157,117,463,3,100.0
1254,3/29/2018 8:30,181,156,106,443,3,100.0
1255,3/29/2018 8:35,187,152,114,453,3,100.0
1256,3/29/2018 8:40,150,135,93,378,3,100.0
1257,3/29/2018 8:45,176,166,121,463,3,100.0
1258,3/29/2018 8:50,173,150,120,443,3,100.0
1259,3/29/2018 8:55,184,145,100,429,3,100.0
1260,3/29/2018 9:00,183,156,98,437,3,100.0
1261,3/29/2018 9:05,184,154,118,456,3,100.0
1262,3/29/2018 9:10,165,144,83,392,3,100.0
1263,3/29/2018 9:15,158,128,104,390,3,100.0
1264,3/29/2018 9:20,178,154,103,435,3,100.0
1265,3/29/2018 9:25,156,142,105,403,3,100.0
1266,3/29/2018 9:30,150,144,107,401,3,100.0
1267,3/29/2018 9:35,169,156,91,416,3,100.0
1268,3/29/2018 9:40,156,154,101,411,3,100.0
1269,3/29/2018 9:45,151,139,86,376,3,100.0
1270,3/29/2018 9:50,180,146,118,444,3,100.0
1271,3/29/2018 9:55,168,162,112,442,3,100.0
1272,3/29/2018 10:00,172,155,106,433,3,100.0
1273,3/29/2018 10:05,171,153,107,431,3,100.0
1274,3/29/2018 10:10,168,138,110,416,3,100.0
1275,3/29/2018 10:15,170,144,105,419,3,100.0
1276,3/29/2018 10:20,169,159,113,441,3,100.0
1277,3/29/2018 10:25,171,148,101,420,3,100.0
1278,3/29/2018 10:30,157,149,81,387,3,100.0
1279,3/29/2018 10:35,183,156,112,451,3,100.0
1280,3/29/2018 10:40,182,153,102,437,3,100.0
1281,3/29/2018 10:45,170,161,120,451,3,100.0
1282,3/29/2018 10:50,189,165,118,472,3,100.0
1283,3/29/2018 10:55,177,166,109,452,3,100.0
1284,3/29/2018 11:00,162,143,98,403,3,100.0
1285,3/29/2018 11:05,157,145,101,403,3,100.0
1286,3/29/2018 11:10,178,173,117,468,3,100.0
1287,3/29/2018 11:15,150,133,96,379,3,100.0
1288,3/29/2018 11:20,157,166,113,436,3,100.0
1289,3/29/2018 11:25,177,147,123,447,3,100.0
1290,3/29/2018 11:30,165,167,109,441,3,100.0
1291,3/29/2018 11:35,175,165,123,463,3,100.0
1292,3/29/2018 11:40,149,146,117,412,3,100.0
1293,3/29/2018 11:45,163,159,114,436,3,100.0
1294,3/29/2018 11:50,183,167,132,482,3,100.0
1295,3/29/2018 11:55,161,160,126,447,3,100.0
1296,3/29/2018 12:00,143,135,106,384,3,100.0
1297,3/29/2018 12:05,136,129,95,360,3,100.0
1298,3/29/2018 12:10,171,158,120,449,3,100.0
1299,3/29/2018 12:15,175,165,124,464,3,100.0
1300,3/29/2018 12:20,181,160,129,470,3,100.0
1301,3/29/2018 12:25,170,176,113,459,3,100.0
1302,3/29/2018 12:30,172,154,115,441,3,100.0
1303,3/29/2018 12:35,164,147,109,420,3,100.0
1304,3/29/2018 12:40,162,153,111,426,3,100.0
1305,3/29/2018 12:45,177,146,131,454,3,100.0
1306,3/29/2018 12:50,146,136,124,406,3,100.0
1307,3/29/2018 12:55,169,166,141,476,3,100.0
1308,3/29/2018 13:00,166,165,138,469,3,100.0
1309,3/29/2018 13:05,170,162,134,466,3,100.0
1310,3/29/2018 13:10,149,139,128,416,3,100.0
1311,3/29/2018 13:15,178,167,121,466,3,100.0
1312,3/29/2018 13:20,177,165,145,487,3,100.0
1313,3/29/2018 13:25,168,173,144,485,3,100.0
1314,3/29/2018 13:30,152,153,141,446,3,100.0
1315,3/29/2018 13:35,162,155,129,446,3,100.0
1316,3/29/2018 13:40,159,151,132,442,3,100.0
1317,3/29/2018 13:45,159,151,133,443,3,100.0
1318,3/29/2018 13:50,147,146,126,419,3,100.0
1319,3/29/2018 13:55,138,128,120,386,3,100.0
1320,3/29/2018 14:00,152,145,124,421,3,100.0
1321,3/29/2018 14:05,168,164,128,460,3,100.0
1322,3/29/2018 14:10,162,151,140,453,3,100.0
1323,3/29/2018 14:15,158,158,141,457,3,100.0
1324,3/29/2018 14:20,163,154,148,465,3,100.0
1325,3/29/2018 14:25,147,133,123,403,3,100.0
1326,3/29/2018 14:30,158,143,127,428,3,100.0
1327,3/29/2018 14:35,168,139,141,448,3,100.0
1328,3/29/2018 14:40,166,159,147,472,3,100.0
1329,3/29/2018 14:45,133,139,129,401,3,100.0
1330,3/29/2018 14:50,148,134,126,408,3,100.0
1331,3/29/2018 14:55,150,134,126,410,3,100.0
1332,3/29/2018 15:00,163,161,139,463,3,100.0
1333,3/29/2018 15:05,153,146,132,431,3,100.0
1334,3/29/2018 15:10,129,125,126,380,3,100.0
1335,3/29/2018 15:15,141,140,134,415,3,100.0
1336,3/29/2018 15:20,128,135,124,387,3,100.0
1337,3/29/2018 15:25,151,141,124,416,3,100.0
1338,3/29/2018 15:30,165,161,148,474,3,100.0
1339,3/29/2018 15:35,139,146,124,409,3,100.0
1340,3/29/2018 15:40,150,146,135,431,3,100.0
1341,3/29/2018 15:45,127,127,113,367,3,100.0
1342,3/29/2018 15:50,128,127,123,378,3,100.0
1343,3/29/2018 15:55,137,126,124,387,3,100.0
1344,3/29/2018 16:00,112,116,116,344,3,100.0
1345,3/29/2018 16:05,131,141,127,399,3,100.0
1346,3/29/2018 16:10,122,133,130,385,3,100.0
1347,3/29/2018 16:15,103,107,95,305,3,100.0
1348,3/29/2018 16:20,132,134,119,385,3,100.0
1349,3/29/2018 16:25,115,120,124,359,3,100.0
1350,3/29/2018 16:30,108,102,111,321,3,100.0
1351,3/29/2018 16:35,118,120,111,349,3,100.0
1352,3/29/2018 16:40,134,132,123,389,3,100.0
1353,3/29/2018 16:45,121,119,120,360,3,100.0
1354,3/29/2018 16:50,118,119,122,359,3,100.0
1355,3/29/2018 16:55,113,112,112,337,3,100.0
1356,3/29/2018 17:00,126,122,118,366,3,100.0
1357,3/29/2018 17:05,128,129,124,381,3,100.0
1358,3/29/2018 17:10,127,116,128,371,3,100.0
1359,3/29/2018 17:15,108,114,121,343,3,100.0
1360,3/29/2018 17:20,109,108,114,331,3,100.0
1361,3/29/2018 17:25,133,127,127,387,3,100.0
1362,3/29/2018 17:30,132,125,131,388,3,100.0
1363,3/29/2018 17:35,122,118,112,352,3,100.0
1364,3/29/2018 17:40,132,122,120,374,3,100.0
1365,3/29/2018 17:45,127,125,127,379,3,100.0
1366,3/29/2018 17:50,154,147,134,435,3,0.0
1367,3/29/2018 17:55,143,140,131,414,3,0.0
1368,3/29/2018 18:00,146,146,136,428,3,0.0
1369,3/29/2018 18:05,156,148,139,443,3,0.0
1370,3/29/2018 18:10,153,144,132,429,3,0.0
1371,3/29/2018 18:15,155,148,138,441,3,0.0
1372,3/29/2018 18:20,155,152,137,444,3,0.0
1373,3/29/2018 18:25,150,145,135,430,3,0.0
1374,3/29/2018 18:30,156,145,134,435,3,0.0
1375,3/29/2018 18:35,152,151,138,441,3,0.0
1376,3/29/2018 18:40,155,145,133,433,3,0.0
1377,3/29/2018 18:45,151,143,130,424,3,0.0
1378,3/29/2018 18:50,150,143,129,422,3,0.0
1379,3/29/2018 18:55,153,152,127,432,3,0.0
1380,3/29/2018 19:00,163,152,126,441,3,0.0
1381,3/29/2018 19:05,162,147,125,434,3,0.0
1382,3/29/2018 19:10,146,144,128,418,3,0.0
1383,3/29/2018 19:15,158,141,132,431,3,0.0
1384,3/29/2018 19:20,146,143,133,422,3,0.0
1385,3/29/2018 19:25,155,138,127,420,3,0.0
1386,3/29/2018 19:30,148,143,127,418,3,0.0
1387,3/29/2018 19:35,154,142,130,426,3,0.0
1388,3/29/2018 19:40,145,143,131,419,3,0.0
1389,3/29/2018 19:45,155,147,130,432,3,0.0
1390,3/29/2018 19:50,153,146,126,425,3,0.0
1391,3/29/2018 19:55,147,133,120,400,3,0.0
1392,3/29/2018 20:00,147,136,121,404,3,0.0
1393,3/29/2018 20:05,155,143,126,424,3,0.0
1394,3/29/2018 20:10,147,141,117,405,3,0.0
1395,3/29/2018 20:15,144,125,113,382,3,0.0
1396,3/29/2018 20:20,146,152,133,431,3,0.0
1397,3/29/2018 20:25,159,145,132,436,3,0.0
1398,3/29/2018 20:30,146,139,122,407,3,0.0
1399,3/29/2018 20:35,135,127,121,383,3,0.0
1400,3/29/2018 20:40,150,149,133,432,3,100.0
1401,3/29/2018 20:45,156,144,126,426,3,100.0
1402,3/29/2018 20:50,162,152,129,443,3,100.0
1403,3/29/2018 20:55,160,140,118,418,3,100.0
1404,3/29/2018 21:00,158,146,121,425,3,100.0
1405,3/29/2018 21:05,162,152,112,426,3,100.0
1406,3/29/2018 21:10,162,157,133,452,3,100.0
1407,3/29/2018 21:15,164,144,114,422,3,100.0
1408,3/29/2018 21:20,156,156,104,416,3,100.0
1409,3/29/2018 21:25,156,152,127,435,3,100.0
1410,3/29/2018 21:30,154,138,100,392,3,100.0
1411,3/29/2018 21:35,152,138,99,389,3,100.0
1412,3/29/2018 21:40,143,124,96,363,3,100.0
1413,3/29/2018 21:45,127,116,94,337,3,100.0
1414,3/29/2018 21:50,125,127,87,339,3,100.0
1415,3/29/2018 21:55,138,128,77,343,3,100.0
1416,3/29/2018 22:00,128,121,98,347,3,100.0
1417,3/29/2018 22:05,127,116,93,336,3,100.0
1418,3/29/2018 22:10,131,128,101,360,3,100.0
1419,3/29/2018 22:15,134,120,81,335,3,100.0
1420,3/29/2018 22:20,111,99,80,290,3,100.0
1421,3/29/2018 22:25,138,124,94,356,3,100.0
1422,3/29/2018 22:30,128,117,81,326,3,100.0
1423,3/29/2018 22:35,113,98,69,280,3,100.0
1424,3/29/2018 22:40,110,101,69,280,3,100.0
1425,3/29/2018 22:45,101,114,75,290,3,100.0
1426,3/29/2018 22:50,115,117,93,325,3,100.0
1427,3/29/2018 22:55,102,96,60,258,3,100.0
1428,3/29/2018 23:00,93,106,77,276,3,100.0
1429,3/29/2018 23:05,98,95,60,253,3,100.0
1430,3/29/2018 23:10,99,94,66,259,3,100.0
1431,3/29/2018 23:15,94,91,67,252,3,100.0
1432,3/29/2018 23:20,94,86,61,241,3,100.0
1433,3/29/2018 23:25,93,82,56,231,3,100.0
1434,3/29/2018 23:30,78,72,51,201,3,100.0
1435,3/29/2018 23:35,75,83,49,207,3,100.0
1436,3/29/2018 23:40,89,78,45,212,3,100.0
1437,3/29/2018 23:45,83,87,47,217,3,100.0
1438,3/29/2018 23:50,68,67,51,186,3,100.0
1439,3/29/2018 23:55,61,65,48,174,3,100.0
1440,3/30/2018 0:00,68,68,45,181,3,100.0
1441,3/30/2018 0:05,66,69,44,179,3,100.0
1442,3/30/2018 0:10,51,62,44,157,3,100.0
1443,3/30/2018 0:15,82,83,52,217,3,100.0
1444,3/30/2018 0:20,64,58,41,163,3,100.0
1445,3/30/2018 0:25,55,67,37,159,3,100.0
1446,3/30/2018 0:30,47,52,30,129,3,100.0
1447,3/30/2018 0:35,56,56,37,149,3,100.0
1448,3/30/2018 0:40,53,54,29,136,3,100.0
1449,3/30/2018 0:45,49,56,34,139,3,100.0
1450,3/30/2018 0:50,40,38,27,105,3,100.0
1451,3/30/2018 0:55,43,47,20,110,3,100.0
1452,3/30/2018 1:00,30,35,25,90,3,100.0
1453,3/30/2018 1:05,31,53,28,112,3,100.0
1454,3/30/2018 1:10,41,45,27,113,3,100.0
1455,3/30/2018 1:15,39,42,32,113,3,100.0
1456,3/30/2018 1:20,40,48,24,112,3,100.0
1457,3/30/2018 1:25,40,33,17,90,3,100.0
1458,3/30/2018 1:30,25,31,16,72,3,100.0
1459,3/30/2018 1:35,34,41,26,101,3,100.0
1460,3/30/2018 1:40,23,38,22,83,3,100.0
1461,3/30/2018 1:45,34,46,23,103,3,100.0
1462,3/30/2018 1:50,31,23,21,75,3,100.0
1463,3/30/2018 1:55,27,31,21,79,3,100.0
1464,3/30/2018 2:00,22,20,20,62,3,100.0
1465,3/30/2018 2:05,16,33,16,65,3,100.0
1466,3/30/2018 2:10,21,35,22,78,3,100.0
1467,3/30/2018 2:15,21,33,26,80,3,100.0
1468,3/30/2018 2:20,20,35,20,75,3,100.0
1469,3/30/2018 2:25,24,36,19,79,3,100.0
1470,3/30/2018 2:30,21,36,22,79,3,100.0
1471,3/30/2018 2:35,19,23,23,65,3,100.0
1472,3/30/2018 2:40,21,19,13,53,3,100.0
1473,3/30/2018 2:45,9,21,25,55,3,100.0
1474,3/30/2018 2:50,20,30,22,72,3,100.0
1475,3/30/2018 2:55,19,29,18,66,3,100.0
1476,3/30/2018 3:00,12,28,14,54,3,100.0
1477,3/30/2018 3:05,14,23,18,55,3,100.0
1478,3/30/2018 3:10,15,25,19,59,3,100.0
1479,3/30/2018 3:15,17,27,15,59,3,100.0
1480,3/30/2018 3:20,14,25,18,57,3,100.0
1481,3/30/2018 3:25,10,29,15,54,3,100.0
1482,3/30/2018 3:30,23,28,14,65,3,100.0
1483,3/30/2018 3:35,22,24,22,68,3,100.0
1484,3/30/2018 3:40,12,19,16,47,3,100.0
1485,3/30/2018 3:45,23,29,19,71,3,100.0
1486,3/30/2018 3:50,17,30,16,63,3,100.0
1487,3/30/2018 3:55,14,23,19,56,3,100.0
1488,3/30/2018 4:00,18,22,20,60,3,100.0
1489,3/30/2018 4:05,17,27,21,65,3,100.0
1490,3/30/2018 4:10,18,25,19,62,3,100.0
1491,3/30/2018 4:15,29,29,23,81,3,100.0
1492,3/30/2018 4:20,37,41,29,107,3,100.0
1493,3/30/2018 4:25,37,37,32,106,3,100.0
1494,3/30/2018 4:30,43,36,28,107,3,100.0
1495,3/30/2018 4:35,37,49,27,113,3,100.0
1496,3/30/2018 4:40,46,54,31,131,3,100.0
1497,3/30/2018 4:45,40,42,39,121,3,100.0
1498,3/30/2018 4:50,43,57,30,130,3,100.0
1499,3/30/2018 4:55,50,39,39,128,3,100.0
1500,3/30/2018 5:00,35,58,32,125,3,100.0
1501,3/30/2018 5:05,48,58,43,149,3,100.0
1502,3/30/2018 5:10,73,64,40,177,3,100.0
1503,3/30/2018 5:15,86,78,51,215,3,100.0
1504,3/30/2018 5:20,87,78,45,210,3,100.0
1505,3/30/2018 5:25,88,86,40,214,3,100.0
1506,3/30/2018 5:30,110,92,51,253,3,100.0
1507,3/30/2018 5:35,98,85,58,241,3,100.0
1508,3/30/2018 5:40,108,99,74,281,3,100.0
1509,3/30/2018 5:45,118,100,74,292,3,100.0
1510,3/30/2018 5:50,130,105,70,305,3,100.0
1511,3/30/2018 5:55,114,110,61,285,3,100.0
1512,3/30/2018 6:00,130,110,69,309,3,100.0
1513,3/30/2018 6:05,128,110,60,298,3,100.0
1514,3/30/2018 6:10,124,118,76,318,3,100.0
1515,3/30/2018 6:15,118,117,72,307,3,100.0
1516,3/30/2018 6:20,143,125,80,348,3,100.0
1517,3/30/2018 6:25,154,118,75,347,3,100.0
1518,3/30/2018 6:30,136,125,83,344,3,100.0
1519,3/30/2018 6:35,143,129,81,353,3,100.0
1520,3/30/2018 6:40,152,138,92,382,3,100.0
1521,3/30/2018 6:45,170,139,90,399,3,100.0
1522,3/30/2018 6:50,163,131,108,402,3,100.0
1523,3/30/2018 6:55,137,119,94,350,3,100.0
1524,3/30/2018 7:00,185,140,99,424,3,100.0
1525,3/30/2018 7:05,165,130,97,392,3,100.0
1526,3/30/2018 7:10,157,147,81,385,3,100.0
1527,3/30/2018 7:15,147,128,91,366,3,100.0
1528,3/30/2018 7:20,158,140,96,394,3,100.0
1529,3/30/2018 7:25,169,149,104,422,3,100.0
1530,3/30/2018 7:30,152,135,96,383,3,100.0
1531,3/30/2018 7:35,153,148,112,413,3,100.0
1532,3/30/2018 7:40,171,142,105,418,3,100.0
1533,3/30/2018 7:45,178,167,115,460,3,100.0
1534,3/30/2018 7:50,176,172,128,476,3,100.0
1535,3/30/2018 7:55,165,147,110,422,3,100.0
1536,3/30/2018 8:00,160,145,94,399,3,100.0
1537,3/30/2018 8:05,164,163,101,428,3,100.0
1538,3/30/2018 8:10,145,155,84,384,3,100.0
1539,3/30/2018 8:15,145,118,87,350,3,100.0
1540,3/30/2018 8:20,167,150,89,406,3,100.0
1541,3/30/2018 8:25,163,150,109,422,3,100.0
1542,3/30/2018 8:30,170,149,103,422,3,100.0
1543,3/30/2018 8:35,169,139,101,409,3,100.0
1544,3/30/2018 8:40,163,157,111,431,3,100.0
1545,3/30/2018 8:45,166,155,99,420,3,100.0
1546,3/30/2018 8:50,188,140,95,423,3,100.0
1547,3/30/2018 8:55,174,140,90,404,3,100.0
1548,3/30/2018 9:00,164,141,98,403,3,100.0
1549,3/30/2018 9:05,136,156,87,379,3,100.0
1550,3/30/2018 9:10,142,118,93,353,3,100.0
1551,3/30/2018 9:15,169,139,96,404,3,100.0
1552,3/30/2018 9:20,173,149,99,421,3,100.0
1553,3/30/2018 9:25,168,160,93,421,3,100.0
1554,3/30/2018 9:30,179,149,92,420,3,100.0
1555,3/30/2018 9:35,183,159,101,443,3,100.0
1556,3/30/2018 9:40,147,129,92,368,3,100.0
1557,3/30/2018 9:45,137,134,103,374,3,100.0
1558,3/30/2018 9:50,144,138,115,397,3,100.0
1559,3/30/2018 9:55,171,147,118,436,3,100.0
1560,3/30/2018 10:00,159,154,90,403,3,100.0
1561,3/30/2018 10:05,161,153,99,413,3,100.0
1562,3/30/2018 10:10,151,138,109,398,3,100.0
1563,3/30/2018 10:15,161,144,108,413,3,100.0
1564,3/30/2018 10:20,154,153,98,405,3,100.0
1565,3/30/2018 10:25,171,144,105,420,3,100.0
1566,3/30/2018 10:30,162,144,108,414,3,100.0
1567,3/30/2018 10:35,164,154,115,433,3,100.0
1568,3/30/2018 10:40,165,146,94,405,3,100.0
1569,3/30/2018 10:45,176,163,104,443,3,100.0
1570,3/30/2018 10:50,169,154,105,428,3,100.0
1571,3/30/2018 10:55,177,159,119,455,3,100.0
1572,3/30/2018 11:00,181,178,110,469,3,100.0
1573,3/30/2018 11:05,184,166,124,474,3,100.0
1574,3/30/2018 11:10,169,154,111,434,3,100.0
1575,3/30/2018 11:15,177,158,133,468,3,100.0
1576,3/30/2018 11:20,197,170,131,498,3,100.0
1577,3/30/2018 11:25,168,158,118,444,3,100.0
1578,3/30/2018 11:30,193,175,133,501,3,100.0
1579,3/30/2018 11:35,170,171,118,459,3,100.0
1580,3/30/2018 11:40,183,168,119,470,3,100.0
1581,3/30/2018 11:45,181,162,131,474,3,100.0
1582,3/30/2018 11:50,135,127,101,363,3,100.0
1583,3/30/2018 11:55,183,164,134,481,3,100.0
1584,3/30/2018 12:00,185,167,115,467,3,100.0
1585,3/30/2018 12:05,173,160,142,475,3,100.0
1586,3/30/2018 12:10,174,153,126,453,3,100.0
1587,3/30/2018 12:15,187,164,126,477,3,100.0
1588,3/30/2018 12:20,162,154,111,427,3,100.0
1589,3/30/2018 12:25,175,152,119,446,3,100.0
1590,3/30/2018 12:30,178,156,128,462,3,100.0
1591,3/30/2018 12:35,165,154,123,442,3,100.0
1592,3/30/2018 12:40,178,152,116,446,3,100.0
1593,3/30/2018 12:45,169,161,125,455,3,100.0
1594,3/30/2018 12:50,171,165,131,467,3,100.0
1595,3/30/2018 12:55,173,167,140,480,3,100.0
1596,3/30/2018 13:00,152,156,126,434,3,100.0
1597,3/30/2018 13:05,167,145,144,456,3,100.0
1598,3/30/2018 13:10,167,158,143,468,3,100.0
1599,3/30/2018 13:15,170,164,156,490,3,100.0
1600,3/30/2018 13:20,166,165,135,466,3,100.0
1601,3/30/2018 13:25,168,166,141,475,3,100.0
1602,3/30/2018 13:30,126,142,123,391,3,100.0
1603,3/30/2018 13:35,149,139,125,413,3,100.0
1604,3/30/2018 13:40,116,126,114,356,3,100.0
1605,3/30/2018 13:45,148,150,137,435,3,100.0
1606,3/30/2018 13:50,160,147,124,431,3,100.0
1607,3/30/2018 13:55,170,172,157,499,3,100.0
1608,3/30/2018 14:00,142,145,130,417,3,100.0
1609,3/30/2018 14:05,168,153,137,458,3,100.0
1610,3/30/2018 14:10,159,158,140,457,3,100.0
1611,3/30/2018 14:15,158,158,133,449,3,100.0
1612,3/30/2018 14:20,139,124,133,396,3,100.0
1613,3/30/2018 14:25,134,129,131,394,3,100.0
1614,3/30/2018 14:30,159,140,142,441,3,100.0
1615,3/30/2018 14:35,145,137,143,425,3,100.0
1616,3/30/2018 14:40,132,137,127,396,3,100.0
1617,3/30/2018 14:45,131,132,127,390,3,100.0
1618,3/30/2018 14:50,137,142,129,408,3,100.0
1619,3/30/2018 14:55,144,133,126,403,3,100.0
1620,3/30/2018 15:00,146,151,133,430,3,100.0
1621,3/30/2018 15:05,146,132,136,414,3,100.0
1622,3/30/2018 15:10,155,153,135,443,3,100.0
1623,3/30/2018 15:15,138,136,126,400,3,100.0
1624,3/30/2018 15:20,121,123,119,363,3,100.0
1625,3/30/2018 15:25,131,130,128,389,3,100.0
1626,3/30/2018 15:30,145,141,129,415,3,100.0
1627,3/30/2018 15:35,141,132,132,405,3,100.0
1628,3/30/2018 15:40,151,140,136,427,3,100.0
1629,3/30/2018 15:45,143,136,130,409,3,100.0
1630,3/30/2018 15:50,143,134,128,405,3,100.0
1631,3/30/2018 15:55,131,140,136,407,3,100.0
1632,3/30/2018 16:00,159,153,140,452,3,100.0
1633,3/30/2018 16:05,113,109,116,338,3,100.0
1634,3/30/2018 16:10,153,144,144,441,3,100.0
1635,3/30/2018 16:15,149,146,128,423,3,100.0
1636,3/30/2018 16:20,131,138,124,393,3,100.0
1637,3/30/2018 16:25,131,131,135,397,3,100.0
1638,3/30/2018 16:30,130,135,129,394,3,100.0
1639,3/30/2018 16:35,130,131,123,384,3,100.0
1640,3/30/2018 16:40,117,108,120,345,3,100.0
1641,3/30/2018 16:45,120,131,125,376,3,100.0
1642,3/30/2018 16:50,144,141,135,420,3,100.0
1643,3/30/2018 16:55,147,139,137,423,3,100.0
1644,3/30/2018 17:00,158,140,131,429,3,100.0
1645,3/30/2018 17:05,145,134,128,407,3,100.0
1646,3/30/2018 17:10,154,134,140,428,3,100.0
1647,3/30/2018 17:15,151,153,139,443,3,100.0
1648,3/30/2018 17:20,150,136,138,424,3,100.0
1649,3/30/2018 17:25,132,127,125,384,3,100.0
1650,3/30/2018 17:30,138,143,121,402,3,100.0
1651,3/30/2018 17:35,142,134,128,404,3,100.0
1652,3/30/2018 17:40,140,125,137,402,3,100.0
1653,3/30/2018 17:45,144,139,142,425,3,100.0
1654,3/30/2018 17:50,166,156,143,465,3,100.0
1655,3/30/2018 17:55,128,128,133,389,3,100.0
1656,3/30/2018 18:00,146,149,138,433,3,100.0
1657,3/30/2018 18:05,151,153,136,440,3,100.0
1658,3/30/2018 18:10,168,171,156,495,3,100.0
1659,3/30/2018 18:15,152,141,132,425,3,100.0
1660,3/30/2018 18:20,164,162,153,479,3,100.0
1661,3/30/2018 18:25,171,165,164,500,3,100.0
1662,3/30/2018 18:30,166,152,143,461,3,100.0
1663,3/30/2018 18:35,164,154,146,464,3,100.0
1664,3/30/2018 18:40,148,149,144,441,3,100.0
1665,3/30/2018 18:45,163,154,131,448,3,100.0
1666,3/30/2018 18:50,154,157,126,437,3,100.0
1667,3/30/2018 18:55,156,157,113,426,3,100.0
1668,3/30/2018 19:00,154,147,133,434,3,100.0
1669,3/30/2018 19:05,166,143,126,435,3,100.0
1670,3/30/2018 19:10,169,155,125,449,3,100.0
1671,3/30/2018 19:15,158,147,114,419,3,100.0
1672,3/30/2018 19:20,146,141,125,412,3,100.0
1673,3/30/2018 19:25,167,138,103,408,3,100.0
1674,3/30/2018 19:30,163,132,113,408,3,100.0
1675,3/30/2018 19:35,160,149,112,421,3,100.0
1676,3/30/2018 19:40,162,151,106,419,3,100.0
1677,3/30/2018 19:45,165,133,106,404,3,100.0
1678,3/30/2018 19:50,146,126,100,372,3,100.0
1679,3/30/2018 19:55,166,137,98,401,3,100.0
1680,3/30/2018 20:00,137,129,113,379,3,100.0
1681,3/30/2018 20:05,146,133,108,387,3,100.0
1682,3/30/2018 20:10,144,138,95,377,3,100.0
1683,3/30/2018 20:15,148,126,104,378,3,100.0
1684,3/30/2018 20:20,134,122,104,360,3,100.0
1685,3/30/2018 20:25,167,153,130,450,3,100.0
1686,3/30/2018 20:30,137,133,108,378,3,100.0
1687,3/30/2018 20:35,140,132,94,366,3,100.0
1688,3/30/2018 20:40,154,114,99,367,3,100.0
1689,3/30/2018 20:45,143,123,112,378,3,100.0
1690,3/30/2018 20:50,135,123,98,356,3,100.0
1691,3/30/2018 20:55,132,130,83,345,3,100.0
1692,3/30/2018 21:00,143,129,79,351,3,100.0
1693,3/30/2018 21:05,128,110,81,319,3,100.0
1694,3/30/2018 21:10,127,112,90,329,3,100.0
1695,3/30/2018 21:15,136,124,98,358,3,100.0
1696,3/30/2018 21:20,144,130,94,368,3,100.0
1697,3/30/2018 21:25,147,126,98,371,3,100.0
1698,3/30/2018 21:30,126,121,84,331,3,100.0
1699,3/30/2018 21:35,116,121,73,310,3,100.0
1700,3/30/2018 21:40,122,112,88,322,3,100.0
1701,3/30/2018 21:45,127,118,88,333,3,100.0
1702,3/30/2018 21:50,109,102,86,297,3,100.0
1703,3/30/2018 21:55,110,102,72,284,3,100.0
1704,3/30/2018 22:00,121,117,89,327,3,100.0
1705,3/30/2018 22:05,120,112,87,319,3,100.0
1706,3/30/2018 22:10,109,108,84,301,3,100.0
1707,3/30/2018 22:15,111,122,87,320,3,100.0
1708,3/30/2018 22:20,117,112,87,316,3,100.0
1709,3/30/2018 22:25,113,119,76,308,3,100.0
1710,3/30/2018 22:30,137,120,86,343,3,100.0
1711,3/30/2018 22:35,136,122,91,349,3,100.0
1712,3/30/2018 22:40,116,101,80,297,3,100.0
1713,3/30/2018 22:45,110,118,78,306,3,100.0
1714,3/30/2018 22:50,124,101,83,308,3,100.0
1715,3/30/2018 22:55,89,104,68,261,3,100.0
1716,3/30/2018 23:00,126,100,80,306,3,100.0
1717,3/30/2018 23:05,109,100,64,273,3,100.0
1718,3/30/2018 23:10,110,106,67,283,3,100.0
1719,3/30/2018 23:15,105,94,67,266,3,100.0
1720,3/30/2018 23:20,72,73,57,202,3,100.0
1721,3/30/2018 23:25,74,64,51,189,3,100.0
1722,3/30/2018 23:30,72,66,50,188,3,100.0
1723,3/30/2018 23:35,80,80,47,207,3,100.0
1724,3/30/2018 23:40,107,113,60,280,3,100.0
1725,3/30/2018 23:45,96,99,74,269,3,100.0
1726,3/30/2018 23:50,68,77,57,202,3,100.0
1727,3/30/2018 23:55,98,82,55,235,3,100.0
1728,3/31/2018 0:00,59,75,47,181,3,100.0
1729,3/31/2018 0:05,74,71,63,208,3,100.0
1730,3/31/2018 0:10,65,69,58,192,3,100.0
1731,3/31/2018 0:15,64,66,49,179,3,100.0
1732,3/31/2018 0:20,65,77,47,189,3,100.0
1733,3/31/2018 0:25,53,67,40,160,3,100.0
1734,3/31/2018 0:30,49,57,30,136,3,100.0
1735,3/31/2018 0:35,56,57,43,156,3,100.0
1736,3/31/2018 0:40,59,58,32,149,3,100.0
1737,3/31/2018 0:45,52,58,39,149,3,100.0
1738,3/31/2018 0:50,43,54,49,146,3,100.0
1739,3/31/2018 0:55,43,51,29,123,3,100.0
1740,3/31/2018 1:00,37,55,29,121,3,100.0
1741,3/31/2018 1:05,49,55,27,131,3,100.0
1742,3/31/2018 1:10,35,40,21,96,3,100.0
1743,3/31/2018 1:15,41,43,34,118,3,100.0
1744,3/31/2018 1:20,30,38,28,96,3,100.0
1745,3/31/2018 1:25,26,31,17,74,3,100.0
1746,3/31/2018 1:30,40,46,30,116,3,100.0
1747,3/31/2018 1:35,33,44,32,109,3,100.0
1748,3/31/2018 1:40,27,39,26,92,3,100.0
1749,3/31/2018 1:45,27,36,25,88,3,100.0
1750,3/31/2018 1:50,25,38,22,85,3,100.0
1751,3/31/2018 1:55,25,33,26,84,3,100.0
1752,3/31/2018 2:00,25,35,20,80,3,100.0
1753,3/31/2018 2:05,27,37,23,87,3,100.0
1754,3/31/2018 2:10,26,38,24,88,3,100.0
1755,3/31/2018 2:15,21,32,29,82,3,100.0
1756,3/31/2018 2:20,35,33,33,101,3,100.0
1757,3/31/2018 2:25,17,31,22,70,3,100.0
1758,3/31/2018 2:30,22,22,27,71,3,100.0
1759,3/31/2018 2:35,25,29,23,77,3,100.0
1760,3/31/2018 2:40,19,28,15,62,3,100.0
1761,3/31/2018 2:45,19,30,22,71,3,100.0
1762,3/31/2018 2:50,12,22,16,50,3,100.0
1763,3/31/2018 2:55,15,21,22,58,3,100.0
1764,3/31/2018 3:00,8,14,11,33,3,100.0
1765,3/31/2018 3:05,11,18,13,42,3,100.0
1766,3/31/2018 3:10,17,18,14,49,3,100.0
1767,3/31/2018 3:15,27,38,29,94,3,100.0
1768,3/31/2018 3:20,17,29,13,59,3,100.0
1769,3/31/2018 3:25,20,25,12,57,3,100.0
1770,3/31/2018 3:30,10,22,17,49,3,100.0
1771,3/31/2018 3:35,8,23,15,46,3,100.0
1772,3/31/2018 3:40,10,23,21,54,3,100.0
1773,3/31/2018 3:45,12,16,11,39,3,100.0
1774,3/31/2018 3:50,15,19,20,54,3,100.0
1775,3/31/2018 3:55,12,21,14,47,3,100.0
1776,3/31/2018 4:00,15,21,15,51,3,100.0
1777,3/31/2018 4:05,10,16,18,44,3,100.0
1778,3/31/2018 4:10,14,20,13,47,3,100.0
1779,3/31/2018 4:15,16,30,18,64,3,100.0
1780,3/31/2018 4:20,19,33,22,74,3,100.0
1781,3/31/2018 4:25,20,30,14,64,3,100.0
1782,3/31/2018 4:30,23,36,25,84,3,100.0
1783,3/31/2018 4:35,18,26,24,68,3,100.0
1784,3/31/2018 4:40,15,27,25,67,3,100.0
1785,3/31/2018 4:45,20,24,14,58,3,100.0
1786,3/31/2018 4:50,30,28,20,78,3,100.0
1787,3/31/2018 4:55,24,28,20,72,3,100.0
1788,3/31/2018 5:00,23,38,29,90,3,100.0
1789,3/31/2018 5:05,27,34,19,80,3,100.0
1790,3/31/2018 5:10,30,38,30,98,3,100.0
1791,3/31/2018 5:15,38,42,34,114,3,100.0
1792,3/31/2018 5:20,34,42,30,106,3,100.0
1793,3/31/2018 5:25,38,50,33,121,3,100.0
1794,3/31/2018 5:30,43,44,31,118,3,100.0
1795,3/31/2018 5:35,41,55,31,127,3,100.0
1796,3/31/2018 5:40,54,57,33,144,3,100.0
1797,3/31/2018 5:45,56,56,40,152,3,100.0
1798,3/31/2018 5:50,54,60,39,153,3,100.0
1799,3/31/2018 5:55,39,44,33,116,3,100.0
1800,3/31/2018 6:00,49,59,33,141,3,100.0
1801,3/31/2018 6:05,56,58,40,154,3,100.0
1802,3/31/2018 6:10,46,55,30,131,3,100.0
1803,3/31/2018 6:15,50,64,34,148,3,100.0
1804,3/31/2018 6:20,69,66,44,179,3,100.0
1805,3/31/2018 6:25,92,83,41,216,3,100.0
1806,3/31/2018 6:30,71,62,48,181,3,100.0
1807,3/31/2018 6:35,83,74,57,214,3,100.0
1808,3/31/2018 6:40,83,87,58,228,3,100.0
1809,3/31/2018 6:45,91,84,60,235,3,100.0
1810,3/31/2018 6:50,64,81,55,200,3,100.0
1811,3/31/2018 6:55,85,83,61,229,3,100.0
1812,3/31/2018 7:00,83,82,54,219,3,100.0
1813,3/31/2018 7:05,84,89,56,229,3,100.0
1814,3/31/2018 7:10,78,83,53,214,3,100.0
1815,3/31/2018 7:15,95,95,59,249,3,100.0
1816,3/31/2018 7:20,102,98,64,264,3,100.0
1817,3/31/2018 7:25,119,115,73,307,3,100.0
1818,3/31/2018 7:30,112,120,76,308,3,100.0
1819,3/31/2018 7:35,107,105,65,277,3,100.0
1820,3/31/2018 7:40,116,114,81,311,3,100.0
1821,3/31/2018 7:45,134,126,91,351,3,100.0
1822,3/31/2018 7:50,110,103,81,294,3,100.0
1823,3/31/2018 7:55,130,113,71,314,3,100.0
1824,3/31/2018 8:00,116,111,73,300,3,100.0
1825,3/31/2018 8:05,129,119,74,322,3,100.0
1826,3/31/2018 8:10,118,119,75,312,3,100.0
1827,3/31/2018 8:15,130,106,67,303,3,100.0
1828,3/31/2018 8:20,117,111,63,291,3,100.0
1829,3/31/2018 8:25,140,128,82,350,3,100.0
1830,3/31/2018 8:30,134,129,88,351,3,100.0
1831,3/31/2018 8:35,158,147,89,394,3,100.0
1832,3/31/2018 8:40,164,140,84,388,3,100.0
1833,3/31/2018 8:45,158,138,90,386,3,100.0
1834,3/31/2018 8:50,151,137,82,370,3,100.0
1835,3/31/2018 8:55,154,126,98,378,3,100.0
1836,3/31/2018 9:00,151,137,74,362,3,100.0
1837,3/31/2018 9:05,146,134,80,360,3,100.0
1838,3/31/2018 9:10,134,135,90,359,3,100.0
1839,3/31/2018 9:15,167,144,112,423,3,100.0
1840,3/31/2018 9:20,152,141,84,377,3,100.0
1841,3/31/2018 9:25,176,148,110,434,3,100.0
1842,3/31/2018 9:30,182,151,108,441,3,100.0
1843,3/31/2018 9:35,164,145,106,415,3,100.0
1844,3/31/2018 9:40,168,147,104,419,3,100.0
1845,3/31/2018 9:45,143,122,81,346,3,100.0
1846,3/31/2018 9:50,151,154,101,406,3,100.0
1847,3/31/2018 9:55,158,145,101,404,3,100.0
1848,3/31/2018 10:00,167,163,108,438,3,100.0
1849,3/31/2018 10:05,169,140,93,402,3,100.0
1850,3/31/2018 10:10,142,134,93,369,3,100.0
1851,3/31/2018 10:15,167,152,102,421,3,100.0
1852,3/31/2018 10:20,169,149,115,433,3,100.0
1853,3/31/2018 10:25,159,146,101,406,3,100.0
1854,3/31/2018 10:30,184,168,110,462,3,100.0
1855,3/31/2018 10:35,180,158,112,450,3,100.0
1856,3/31/2018 10:40,195,151,114,460,3,100.0
1857,3/31/2018 10:45,196,169,131,496,3,100.0
1858,3/31/2018 10:50,188,166,118,472,3,100.0
1859,3/31/2018 10:55,170,158,102,430,3,100.0
1860,3/31/2018 11:00,172,163,120,455,3,100.0
1861,3/31/2018 11:05,177,161,101,439,3,100.0
1862,3/31/2018 11:10,190,171,125,486,3,100.0
1863,3/31/2018 11:15,181,159,111,451,3,100.0
1864,3/31/2018 11:20,182,161,110,453,3,100.0
1865,3/31/2018 11:25,174,172,122,468,3,100.0
1866,3/31/2018 11:30,179,164,122,465,3,100.0
1867,3/31/2018 11:35,183,171,137,491,3,100.0
1868,3/31/2018 11:40,174,159,121,454,3,100.0
1869,3/31/2018 11:45,184,183,117,484,3,100.0
1870,3/31/2018 11:50,164,156,126,446,3,100.0
1871,3/31/2018 11:55,170,153,113,436,3,100.0
