,5 Minutes,Lane 1 Flow (Veh/5 Minutes),Lane 2 Flow (Veh/5 Minutes),Lane 3 Flow (Veh/5 Minutes),Flow (Veh/5 Minutes),# Lane Points,% Observed
1407,3/23/2018 21:15,163,157,123,443,3,100.0
1408,3/23/2018 21:20,158,136,116,410,3,100.0
1409,3/23/2018 21:25,165,152,127,444,3,100.0
1410,3/23/2018 21:30,151,143,124,418,3,100.0
1411,3/23/2018 21:35,153,143,131,427,3,100.0
1412,3/23/2018 21:40,141,141,137,419,3,100.0
1413,3/23/2018 21:45,131,114,108,353,3,100.0
1414,3/23/2018 21:50,143,135,140,418,3,100.0
1415,3/23/2018 21:55,142,140,112,394,3,100.0
1416,3/23/2018 22:00,153,128,99,380,3,100.0
1417,3/23/2018 22:05,140,128,89,357,3,100.0
1418,3/23/2018 22:10,130,122,97,349,3,100.0
1419,3/23/2018 22:15,138,132,94,364,3,100.0
1420,3/23/2018 22:20,127,109,80,316,3,100.0
1421,3/23/2018 22:25,140,116,84,340,3,100.0
1422,3/23/2018 22:30,100,102,78,280,3,100.0
1423,3/23/2018 22:35,123,107,89,319,3,100.0
1424,3/23/2018 22:40,130,123,72,325,3,100.0
1425,3/23/2018 22:45,105,108,79,292,3,100.0
1426,3/23/2018 22:50,117,107,67,291,3,100.0
1427,3/23/2018 22:55,95,100,51,246,3,100.0
1428,3/23/2018 23:00,107,91,72,270,3,100.0
1429,3/23/2018 23:05,103,99,60,262,3,100.0
1430,3/23/2018 23:10,98,101,68,267,3,100.0
1431,3/23/2018 23:15,91,95,59,245,3,100.0
1432,3/23/2018 23:20,106,109,65,280,3,100.0
1433,3/23/2018 23:25,84,93,57,234,3,100.0
1434,3/23/2018 23:30,90,88,64,242,3,100.0
1435,3/23/2018 23:35,67,67,56,190,3,100.0
1436,3/23/2018 23:40,84,83,63,230,3,100.0
1437,3/23/2018 23:45,82,87,52,221,3,100.0
1438,3/23/2018 23:50,91,86,57,234,3,100.0
1439,3/23/2018 23:55,66,70,57,193,3,100.0
1440,3/24/2018 0:00,64,62,38,164,3,100.0
1441,3/24/2018 0:05,44,58,42,144,3,100.0
1442,3/24/2018 0:10,45,49,41,135,3,100.0
1443,3/24/2018 0:15,49,58,52,159,3,100.0
1444,3/24/2018 0:20,54,66,55,175,3,100.0
1445,3/24/2018 0:25,65,78,55,198,3,100.0
1446,3/24/2018 0:30,48,53,47,148,3,100.0
1447,3/24/2018 0:35,53,55,29,137,3,100.0
1448,3/24/2018 0:40,62,66,39,167,3,100.0
1449,3/24/2018 0:45,49,44,33,126,3,100.0
1450,3/24/2018 0:50,48,56,35,139,3,100.0
1451,3/24/2018 0:55,50,49,36,135,3,100.0
1452,3/24/2018 1:00,38,50,30,118,3,100.0
1453,3/24/2018 1:05,40,36,27,103,3,100.0
1454,3/24/2018 1:10,40,47,29,116,3,100.0
1455,3/24/2018 1:15,51,48,33,132,3,100.0
1456,3/24/2018 1:20,47,53,34,134,3,100.0
1457,3/24/2018 1:25,29,44,20,93,3,100.0
1458,3/24/2018 1:30,34,40,29,103,3,100.0
1459,3/24/2018 1:35,30,41,31,102,3,100.0
1460,3/24/2018 1:40,22,36,25,83,3,100.0
1461,3/24/2018 1:45,35,37,24,96,3,100.0
1462,3/24/2018 1:50,22,41,20,83,3,100.0
1463,3/24/2018 1:55,28,33,30,91,3,100.0
1464,3/24/2018 2:00,33,41,27,101,3,100.0
1465,3/24/2018 2:05,26,37,23,86,3,100.0
1466,3/24/2018 2:10,23,22,20,65,3,100.0
1467,3/24/2018 2:15,24,26,29,79,3,100.0
1468,3/24/2018 2:20,25,37,26,88,3,100.0
1469,3/24/2018 2:25,29,30,30,89,3,100.0
1470,3/24/2018 2:30,21,25,16,62,3,100.0
1471,3/24/2018 2:35,17,28,26,71,3,100.0
1472,3/24/2018 2:40,26,31,20,77,3,100.0
1473,3/24/2018 2:45,21,24,14,59,3,100.0
1474,3/24/2018 2:50,18,28,16,62,3,100.0
1475,3/24/2018 2:55,23,23,37,83,3,100.0
1476,3/24/2018 3:00,25,30,23,78,3,100.0
1477,3/24/2018 3:05,10,29,14,53,3,100.0
1478,3/24/2018 3:10,20,19,16,55,3,100.0
1479,3/24/2018 3:15,18,22,16,56,3,100.0
1480,3/24/2018 3:20,10,21,14,45,3,100.0
1481,3/24/2018 3:25,20,25,11,56,3,100.0
1482,3/24/2018 3:30,11,21,8,40,3,100.0
1483,3/24/2018 3:35,18,16,16,50,3,100.0
1484,3/24/2018 3:40,12,21,17,50,3,100.0
1485,3/24/2018 3:45,23,23,21,67,3,100.0
1486,3/24/2018 3:50,16,15,16,47,3,100.0
1487,3/24/2018 3:55,21,27,21,69,3,100.0
1488,3/24/2018 4:00,19,27,20,66,3,100.0
1489,3/24/2018 4:05,16,21,11,48,3,100.0
1490,3/24/2018 4:10,18,23,19,60,3,100.0
1491,3/24/2018 4:15,24,30,18,72,3,100.0
1492,3/24/2018 4:20,18,26,19,63,3,100.0
1493,3/24/2018 4:25,19,18,20,57,3,100.0
1494,3/24/2018 4:30,21,27,16,64,3,100.0
1495,3/24/2018 4:35,22,29,21,72,3,100.0
1496,3/24/2018 4:40,23,25,24,72,3,100.0
1497,3/24/2018 4:45,25,31,21,77,3,100.0
1498,3/24/2018 4:50,37,48,29,114,3,100.0
1499,3/24/2018 4:55,28,31,22,81,3,100.0
1500,3/24/2018 5:00,23,33,24,80,3,100.0
1501,3/24/2018 5:05,23,43,26,92,3,100.0
1502,3/24/2018 5:10,24,38,40,102,3,100.0
1503,3/24/2018 5:15,52,54,27,133,3,100.0
1504,3/24/2018 5:20,46,44,34,124,3,100.0
1505,3/24/2018 5:25,51,65,41,157,3,100.0
1506,3/24/2018 5:30,66,58,39,163,3,100.0
1507,3/24/2018 5:35,49,56,40,145,3,100.0
1508,3/24/2018 5:40,67,70,50,187,3,100.0
1509,3/24/2018 5:45,61,67,47,175,3,100.0
1510,3/24/2018 5:50,64,79,37,180,3,100.0
1511,3/24/2018 5:55,59,65,33,157,3,100.0
1512,3/24/2018 6:00,53,63,45,161,3,100.0
1513,3/24/2018 6:05,54,56,34,144,3,100.0
1514,3/24/2018 6:10,63,80,49,192,3,100.0
1515,3/24/2018 6:15,75,78,55,208,3,100.0
1516,3/24/2018 6:20,64,79,44,187,3,100.0
1517,3/24/2018 6:25,90,84,57,231,3,100.0
1518,3/24/2018 6:30,79,88,48,215,3,100.0
1519,3/24/2018 6:35,83,93,51,227,3,100.0
1520,3/24/2018 6:40,83,93,48,224,3,100.0
1521,3/24/2018 6:45,115,100,55,270,3,100.0
1522,3/24/2018 6:50,112,97,68,277,3,100.0
1523,3/24/2018 6:55,76,92,63,231,3,100.0
1524,3/24/2018 7:00,97,88,54,239,3,100.0
1525,3/24/2018 7:05,105,103,74,282,3,100.0
1526,3/24/2018 7:10,96,114,66,276,3,100.0
1527,3/24/2018 7:15,125,109,74,308,3,100.0
1528,3/24/2018 7:20,94,80,53,227,3,100.0
1529,3/24/2018 7:25,133,126,73,332,3,100.0
1530,3/24/2018 7:30,137,128,72,337,3,100.0
1531,3/24/2018 7:35,130,115,84,329,3,100.0
1532,3/24/2018 7:40,119,118,87,324,3,100.0
1533,3/24/2018 7:45,126,131,92,349,3,100.0
1534,3/24/2018 7:50,126,128,77,331,3,100.0
1535,3/24/2018 7:55,108,108,62,278,3,100.0
1536,3/24/2018 8:00,113,106,76,295,3,100.0
1537,3/24/2018 8:05,149,131,91,371,3,100.0
1538,3/24/2018 8:10,139,119,76,334,3,100.0
1539,3/24/2018 8:15,135,134,74,343,3,100.0
1540,3/24/2018 8:20,155,159,101,415,3,100.0
1541,3/24/2018 8:25,172,157,99,428,3,100.0
1542,3/24/2018 8:30,151,128,77,356,3,100.0
1543,3/24/2018 8:35,150,144,82,376,3,100.0
1544,3/24/2018 8:40,167,138,93,398,3,100.0
1545,3/24/2018 8:45,163,144,109,416,3,100.0
1546,3/24/2018 8:50,138,119,77,334,3,100.0
1547,3/24/2018 8:55,164,150,99,413,3,100.0
1548,3/24/2018 9:00,153,146,90,389,3,100.0
1549,3/24/2018 9:05,152,147,100,399,3,100.0
1550,3/24/2018 9:10,171,166,112,449,3,100.0
1551,3/24/2018 9:15,154,148,99,401,3,100.0
1552,3/24/2018 9:20,163,151,125,439,3,100.0
1553,3/24/2018 9:25,177,145,95,417,3,100.0
1554,3/24/2018 9:30,174,159,102,435,3,100.0
1555,3/24/2018 9:35,179,167,103,449,3,100.0
1556,3/24/2018 9:40,172,161,123,456,3,100.0
1557,3/24/2018 9:45,168,167,143,478,3,100.0
1558,3/24/2018 9:50,189,163,113,465,3,100.0
1559,3/24/2018 9:55,182,172,123,477,3,100.0
1560,3/24/2018 10:00,191,173,115,479,3,100.0
1561,3/24/2018 10:05,154,142,122,418,3,100.0
1562,3/24/2018 10:10,142,134,108,384,3,100.0
1563,3/24/2018 10:15,144,138,116,398,3,100.0
1564,3/24/2018 10:20,158,150,130,438,3,100.0
1565,3/24/2018 10:25,124,122,128,374,3,100.0
1566,3/24/2018 10:30,128,131,111,370,3,100.0
1567,3/24/2018 10:35,157,143,117,417,3,100.0
1568,3/24/2018 10:40,148,142,124,414,3,100.0
1569,3/24/2018 10:45,156,170,116,442,3,100.0
1570,3/24/2018 10:50,171,168,132,471,3,100.0
1571,3/24/2018 10:55,175,160,127,462,3,100.0
1572,3/24/2018 11:00,159,143,123,425,3,100.0
1573,3/24/2018 11:05,168,159,118,445,3,100.0
1574,3/24/2018 11:10,174,152,115,441,3,100.0
1575,3/24/2018 11:15,190,171,117,478,3,100.0
1576,3/24/2018 11:20,162,141,109,412,3,100.0
1577,3/24/2018 11:25,162,158,111,431,3,100.0
1578,3/24/2018 11:30,180,157,109,446,3,100.0
1579,3/24/2018 11:35,169,155,127,451,3,100.0
1580,3/24/2018 11:40,173,163,116,452,3,100.0
1581,3/24/2018 11:45,172,163,122,457,3,100.0
1582,3/24/2018 11:50,170,137,115,422,3,100.0
1583,3/24/2018 11:55,151,136,114,401,3,100.0
1584,3/24/2018 12:00,162,151,104,417,3,100.0
1585,3/24/2018 12:05,160,166,126,452,3,100.0
1586,3/24/2018 12:10,141,144,101,386,3,100.0
1587,3/24/2018 12:15,182,155,138,475,3,100.0
1588,3/24/2018 12:20,169,157,121,447,3,100.0
1589,3/24/2018 12:25,178,163,127,468,3,100.0
1590,3/24/2018 12:30,177,156,131,464,3,100.0
1591,3/24/2018 12:35,161,153,132,446,3,100.0
1592,3/24/2018 12:40,175,179,116,470,3,100.0
1593,3/24/2018 12:45,160,153,127,440,3,100.0
1594,3/24/2018 12:50,180,173,140,493,3,100.0
1595,3/24/2018 12:55,176,150,129,455,3,100.0
1596,3/24/2018 13:00,178,173,132,483,3,100.0
1597,3/24/2018 13:05,166,143,110,419,3,100.0
1598,3/24/2018 13:10,197,182,131,510,3,100.0
1599,3/24/2018 13:15,174,162,128,464,3,100.0
1600,3/24/2018 13:20,175,167,136,478,3,100.0
1601,3/24/2018 13:25,161,155,139,455,3,100.0
1602,3/24/2018 13:30,166,167,154,487,3,100.0
1603,3/24/2018 13:35,146,139,133,418,3,100.0
1604,3/24/2018 13:40,165,157,137,459,3,100.0
1605,3/24/2018 13:45,154,154,139,447,3,100.0
1606,3/24/2018 13:50,159,162,152,473,3,100.0
1607,3/24/2018 13:55,154,146,123,423,3,100.0
1608,3/24/2018 14:00,154,147,135,436,3,100.0
1609,3/24/2018 14:05,173,162,148,483,3,100.0
1610,3/24/2018 14:10,157,152,135,444,3,100.0
1611,3/24/2018 14:15,154,154,118,426,3,100.0
1612,3/24/2018 14:20,156,153,131,440,3,100.0
1613,3/24/2018 14:25,159,148,139,446,3,100.0
1614,3/24/2018 14:30,153,161,131,445,3,100.0
1615,3/24/2018 14:35,156,148,140,444,3,100.0
1616,3/24/2018 14:40,129,124,124,377,3,100.0
1617,3/24/2018 14:45,157,151,137,445,3,100.0
1618,3/24/2018 14:50,158,159,137,454,3,100.0
1619,3/24/2018 14:55,153,150,133,436,3,100.0
1620,3/24/2018 15:00,145,149,141,435,3,100.0
1621,3/24/2018 15:05,139,134,134,407,3,100.0
1622,3/24/2018 15:10,144,141,143,428,3,100.0
1623,3/24/2018 15:15,156,142,139,437,3,100.0
1624,3/24/2018 15:20,152,152,138,442,3,100.0
1625,3/24/2018 15:25,153,138,140,431,3,100.0
1626,3/24/2018 15:30,151,145,125,421,3,100.0
1627,3/24/2018 15:35,159,154,132,445,3,100.0
1628,3/24/2018 15:40,167,153,140,460,3,100.0
1629,3/24/2018 15:45,158,140,130,428,3,100.0
1630,3/24/2018 15:50,148,166,130,444,3,100.0
1631,3/24/2018 15:55,169,149,140,458,3,100.0
1632,3/24/2018 16:00,160,165,127,452,3,100.0
1633,3/24/2018 16:05,166,148,120,434,3,100.0
1634,3/24/2018 16:10,180,158,140,478,3,100.0
1635,3/24/2018 16:15,176,182,147,505,3,100.0
1636,3/24/2018 16:20,157,146,149,452,3,100.0
1637,3/24/2018 16:25,154,153,140,447,3,100.0
1638,3/24/2018 16:30,154,144,144,442,3,100.0
1639,3/24/2018 16:35,165,161,149,475,3,100.0
1640,3/24/2018 16:40,153,143,133,429,3,100.0
1641,3/24/2018 16:45,148,151,134,433,3,100.0
1642,3/24/2018 16:50,143,144,132,419,3,100.0
1643,3/24/2018 16:55,170,161,155,486,3,100.0
1644,3/24/2018 17:00,161,148,131,440,3,100.0
1645,3/24/2018 17:05,164,138,131,433,3,100.0
1646,3/24/2018 17:10,151,152,131,434,3,100.0
1647,3/24/2018 17:15,145,138,135,418,3,100.0
1648,3/24/2018 17:20,163,160,140,463,3,100.0
1649,3/24/2018 17:25,147,152,130,429,3,100.0
1650,3/24/2018 17:30,165,155,136,456,3,100.0
1651,3/24/2018 17:35,161,163,135,459,3,100.0
1652,3/24/2018 17:40,170,170,137,477,3,100.0
1653,3/24/2018 17:45,146,142,141,429,3,100.0
1654,3/24/2018 17:50,162,151,135,448,3,100.0
1655,3/24/2018 17:55,145,135,128,408,3,100.0
1656,3/24/2018 18:00,164,149,145,458,3,100.0
1657,3/24/2018 18:05,142,128,124,394,3,100.0
1658,3/24/2018 18:10,158,147,134,439,3,100.0
1659,3/24/2018 18:15,152,147,142,441,3,100.0
1660,3/24/2018 18:20,163,147,139,449,3,100.0
1661,3/24/2018 18:25,143,143,126,412,3,100.0
1662,3/24/2018 18:30,147,144,111,402,3,100.0
1663,3/24/2018 18:35,143,137,128,408,3,100.0
1664,3/24/2018 18:40,143,143,116,402,3,100.0
1665,3/24/2018 18:45,143,142,112,397,3,100.0
1666,3/24/2018 18:50,136,148,117,401,3,100.0
1667,3/24/2018 18:55,153,127,121,401,3,100.0
1668,3/24/2018 19:00,150,157,127,434,3,100.0
1669,3/24/2018 19:05,149,136,109,394,3,100.0
1670,3/24/2018 19:10,138,132,112,382,3,100.0
1671,3/24/2018 19:15,154,147,110,411,3,100.0
1672,3/24/2018 19:20,168,143,126,437,3,100.0
1673,3/24/2018 19:25,150,144,117,411,3,100.0
1674,3/24/2018 19:30,142,138,103,383,3,100.0
1675,3/24/2018 19:35,149,135,117,401,3,100.0
1676,3/24/2018 19:40,144,143,90,377,3,100.0
1677,3/24/2018 19:45,148,134,121,403,3,100.0
1678,3/24/2018 19:50,146,131,97,374,3,100.0
1679,3/24/2018 19:55,140,135,107,382,3,100.0
1680,3/24/2018 20:00,127,126,91,344,3,100.0
1681,3/24/2018 20:05,154,146,95,395,3,100.0
1682,3/24/2018 20:10,147,133,96,376,3,100.0
1683,3/24/2018 20:15,139,124,102,365,3,100.0
1684,3/24/2018 20:20,151,144,117,412,3,100.0
1685,3/24/2018 20:25,156,142,113,411,3,100.0
1686,3/24/2018 20:30,136,116,102,354,3,100.0
1687,3/24/2018 20:35,143,133,98,374,3,100.0
1688,3/24/2018 20:40,154,150,116,420,3,100.0
1689,3/24/2018 20:45,143,125,81,349,3,100.0
1690,3/24/2018 20:50,149,149,115,413,3,100.0
1691,3/24/2018 20:55,129,133,89,351,3,100.0
1692,3/24/2018 21:00,144,158,90,392,3,100.0
1693,3/24/2018 21:05,134,131,103,368,3,100.0
1694,3/24/2018 21:10,144,122,95,361,3,100.0
1695,3/24/2018 21:15,156,136,101,393,3,100.0
1696,3/24/2018 21:20,119,121,92,332,3,100.0
1697,3/24/2018 21:25,138,130,85,353,3,100.0
1698,3/24/2018 21:30,140,136,93,369,3,100.0
1699,3/24/2018 21:35,144,145,114,403,3,100.0
1700,3/24/2018 21:40,127,130,89,346,3,100.0
1701,3/24/2018 21:45,154,142,97,393,3,100.0
1702,3/24/2018 21:50,110,112,81,303,3,100.0
1703,3/24/2018 21:55,128,134,79,341,3,100.0
1704,3/24/2018 22:00,118,116,83,317,3,100.0
1705,3/24/2018 22:05,125,112,74,311,3,100.0
1706,3/24/2018 22:10,127,116,79,322,3,100.0
1707,3/24/2018 22:15,112,117,81,310,3,100.0
1708,3/24/2018 22:20,119,110,77,306,3,100.0
1709,3/24/2018 22:25,131,110,79,320,3,100.0
1710,3/24/2018 22:30,108,110,90,308,3,100.0
1711,3/24/2018 22:35,115,101,81,297,3,100.0
1712,3/24/2018 22:40,119,113,70,302,3,100.0
1713,3/24/2018 22:45,111,106,70,287,3,100.0
1714,3/24/2018 22:50,111,114,70,295,3,100.0
1715,3/24/2018 22:55,105,98,65,268,3,100.0
1716,3/24/2018 23:00,92,103,66,261,3,100.0
1717,3/24/2018 23:05,90,99,61,250,3,100.0
1718,3/24/2018 23:10,96,91,59,246,3,100.0
1719,3/24/2018 23:15,91,85,62,238,3,100.0
1720,3/24/2018 23:20,83,96,70,249,3,100.0
1721,3/24/2018 23:25,91,91,54,236,3,100.0
1722,3/24/2018 23:30,84,74,49,207,3,100.0
1723,3/24/2018 23:35,86,71,53,210,3,100.0
1724,3/24/2018 23:40,68,83,48,199,3,100.0
1725,3/24/2018 23:45,58,73,66,197,3,100.0
1726,3/24/2018 23:50,61,75,46,182,3,100.0
1727,3/24/2018 23:55,55,73,38,166,3,100.0
1728,3/25/2018 0:00,59,61,49,169,3,100.0
1729,3/25/2018 0:05,60,67,42,169,3,100.0
1730,3/25/2018 0:10,69,79,49,197,3,100.0
1731,3/25/2018 0:15,62,61,51,174,3,100.0
1732,3/25/2018 0:20,65,65,35,165,3,100.0
1733,3/25/2018 0:25,53,67,45,165,3,100.0
1734,3/25/2018 0:30,54,47,31,132,3,100.0
1735,3/25/2018 0:35,55,66,34,155,3,100.0
1736,3/25/2018 0:40,46,69,38,153,3,100.0
1737,3/25/2018 0:45,51,56,41,148,3,100.0
1738,3/25/2018 0:50,47,49,35,131,3,100.0
1739,3/25/2018 0:55,35,46,27,108,3,100.0
1740,3/25/2018 1:00,42,46,38,126,3,100.0
1741,3/25/2018 1:05,43,58,38,139,3,100.0
1742,3/25/2018 1:10,38,44,28,110,3,100.0
1743,3/25/2018 1:15,34,44,28,106,3,100.0
1744,3/25/2018 1:20,29,38,31,98,3,100.0
1745,3/25/2018 1:25,17,37,32,86,3,100.0
1746,3/25/2018 1:30,37,39,30,106,3,100.0
1747,3/25/2018 1:35,40,44,34,118,3,100.0
1748,3/25/2018 1:40,31,39,25,95,3,100.0
1749,3/25/2018 1:45,35,39,32,106,3,100.0
1750,3/25/2018 1:50,21,38,31,90,3,100.0
1751,3/25/2018 1:55,29,26,26,81,3,100.0
1752,3/25/2018 2:00,26,30,15,71,3,100.0
1753,3/25/2018 2:05,23,37,23,83,3,100.0
1754,3/25/2018 2:10,21,42,24,87,3,100.0
1755,3/25/2018 2:15,23,33,22,78,3,100.0
1756,3/25/2018 2:20,18,28,17,63,3,100.0
1757,3/25/2018 2:25,23,32,21,76,3,100.0
1758,3/25/2018 2:30,25,29,23,77,3,100.0
1759,3/25/2018 2:35,21,39,21,81,3,100.0
1760,3/25/2018 2:40,28,34,23,85,3,100.0
1761,3/25/2018 2:45,26,32,26,84,3,100.0
1762,3/25/2018 2:50,23,31,20,74,3,100.0
1763,3/25/2018 2:55,25,26,16,67,3,100.0
1764,3/25/2018 3:00,18,29,18,65,3,100.0
1765,3/25/2018 3:05,12,30,11,53,3,100.0
1766,3/25/2018 3:10,14,26,16,56,3,100.0
1767,3/25/2018 3:15,7,24,17,48,3,100.0
1768,3/25/2018 3:20,22,25,15,62,3,100.0
1769,3/25/2018 3:25,14,26,13,53,3,100.0
1770,3/25/2018 3:30,13,27,21,61,3,100.0
1771,3/25/2018 3:35,19,23,19,61,3,100.0
1772,3/25/2018 3:40,16,15,16,47,3,100.0
1773,3/25/2018 3:45,11,22,21,54,3,100.0
1774,3/25/2018 3:50,11,20,17,48,3,100.0
1775,3/25/2018 3:55,12,22,16,50,3,100.0
1776,3/25/2018 4:00,10,16,19,45,3,100.0
1777,3/25/2018 4:05,17,25,16,58,3,100.0
1778,3/25/2018 4:10,10,15,10,35,3,100.0
1779,3/25/2018 4:15,15,23,14,52,3,100.0
1780,3/25/2018 4:20,10,20,15,45,3,100.0
1781,3/25/2018 4:25,13,27,21,61,3,100.0
1782,3/25/2018 4:30,12,21,14,47,3,100.0
1783,3/25/2018 4:35,16,22,14,52,3,100.0
1784,3/25/2018 4:40,11,28,15,54,3,100.0
1785,3/25/2018 4:45,13,28,15,56,3,100.0
1786,3/25/2018 4:50,17,33,22,72,3,100.0
1787,3/25/2018 4:55,17,29,12,58,3,100.0
1788,3/25/2018 5:00,13,23,11,47,3,100.0
1789,3/25/2018 5:05,18,24,22,64,3,100.0
1790,3/25/2018 5:10,18,31,17,66,3,100.0
1791,3/25/2018 5:15,21,34,25,80,3,100.0
1792,3/25/2018 5:20,25,36,26,87,3,100.0
1793,3/25/2018 5:25,29,44,28,101,3,100.0
1794,3/25/2018 5:30,26,27,31,84,3,100.0
1795,3/25/2018 5:35,34,33,30,97,3,100.0
1796,3/25/2018 5:40,27,48,30,105,3,100.0
1797,3/25/2018 5:45,33,49,30,112,3,100.0
1798,3/25/2018 5:50,32,38,25,95,3,100.0
1799,3/25/2018 5:55,26,38,27,91,3,100.0
1800,3/25/2018 6:00,32,50,24,106,3,100.0
1801,3/25/2018 6:05,42,49,29,120,3,100.0
1802,3/25/2018 6:10,29,47,31,107,3,100.0
1803,3/25/2018 6:15,40,45,23,108,3,100.0
1804,3/25/2018 6:20,57,54,33,144,3,100.0
1805,3/25/2018 6:25,60,60,41,161,3,100.0
1806,3/25/2018 6:30,50,59,47,156,3,100.0
1807,3/25/2018 6:35,53,55,42,150,3,100.0
1808,3/25/2018 6:40,64,77,49,190,3,100.0
1809,3/25/2018 6:45,55,63,50,168,3,100.0
1810,3/25/2018 6:50,57,71,52,180,3,100.0
1811,3/25/2018 6:55,67,63,45,175,3,100.0
1812,3/25/2018 7:00,57,63,41,161,3,100.0
1813,3/25/2018 7:05,71,68,47,186,3,100.0
1814,3/25/2018 7:10,54,60,36,150,3,100.0
1815,3/25/2018 7:15,61,74,52,187,3,100.0
1816,3/25/2018 7:20,70,69,51,190,3,100.0
1817,3/25/2018 7:25,64,72,59,195,3,100.0
1818,3/25/2018 7:30,71,90,60,221,3,100.0
1819,3/25/2018 7:35,89,91,61,241,3,100.0
1820,3/25/2018 7:40,82,82,54,218,3,100.0
1821,3/25/2018 7:45,67,73,68,208,3,100.0
1822,3/25/2018 7:50,98,80,78,256,3,100.0
1823,3/25/2018 7:55,70,65,53,188,3,100.0
1824,3/25/2018 8:00,88,85,56,229,3,100.0
1825,3/25/2018 8:05,108,95,72,275,3,100.0
1826,3/25/2018 8:10,77,90,54,221,3,100.0
1827,3/25/2018 8:15,98,108,81,287,3,100.0
1828,3/25/2018 8:20,107,110,76,293,3,100.0
1829,3/25/2018 8:25,107,100,80,287,3,100.0
1830,3/25/2018 8:30,94,98,66,258,3,100.0
1831,3/25/2018 8:35,108,110,60,278,3,100.0
1832,3/25/2018 8:40,90,97,65,252,3,100.0
1833,3/25/2018 8:45,113,117,74,304,3,100.0
1834,3/25/2018 8:50,93,111,68,272,3,100.0
1835,3/25/2018 8:55,97,99,74,270,3,100.0
1836,3/25/2018 9:00,110,94,76,280,3,100.0
1837,3/25/2018 9:05,89,106,71,266,3,100.0
1838,3/25/2018 9:10,113,118,71,302,3,100.0
1839,3/25/2018 9:15,107,124,91,322,3,100.0
1840,3/25/2018 9:20,114,97,74,285,3,100.0
1841,3/25/2018 9:25,154,130,92,376,3,100.0
1842,3/25/2018 9:30,127,115,81,323,3,100.0
1843,3/25/2018 9:35,142,125,94,361,3,100.0
1844,3/25/2018 9:40,136,142,75,353,3,100.0
1845,3/25/2018 9:45,144,127,92,363,3,100.0
1846,3/25/2018 9:50,118,110,81,309,3,100.0
1847,3/25/2018 9:55,124,102,63,289,3,100.0
1848,3/25/2018 10:00,123,122,89,334,3,100.0
1849,3/25/2018 10:05,144,116,86,346,3,100.0
1850,3/25/2018 10:10,114,115,74,303,3,100.0
1851,3/25/2018 10:15,160,145,110,415,3,100.0
1852,3/25/2018 10:20,128,101,71,300,3,100.0
1853,3/25/2018 10:25,164,143,102,409,3,100.0
1854,3/25/2018 10:30,147,157,96,400,3,100.0
1855,3/25/2018 10:35,149,139,88,376,3,100.0
1856,3/25/2018 10:40,178,151,113,442,3,100.0
1857,3/25/2018 10:45,160,146,101,407,3,100.0
1858,3/25/2018 10:50,160,155,126,441,3,100.0
1859,3/25/2018 10:55,161,156,97,414,3,100.0
1860,3/25/2018 11:00,157,130,108,395,3,100.0
1861,3/25/2018 11:05,151,132,81,364,3,100.0
1862,3/25/2018 11:10,163,154,109,426,3,100.0
1863,3/25/2018 11:15,173,167,131,471,3,100.0
1864,3/25/2018 11:20,189,171,124,484,3,100.0
1865,3/25/2018 11:25,116,112,113,341,3,100.0
1866,3/25/2018 11:30,95,107,114,316,3,100.0
1867,3/25/2018 11:35,73,80,106,259,3,100.0
1868,3/25/2018 11:40,81,100,107,288,3,100.0
1869,3/25/2018 11:45,101,101,120,322,3,100.0
1870,3/25/2018 11:50,163,166,125,454,3,100.0
1871,3/25/2018 11:55,171,170,142,483,3,100.0
0,3/25/2018 0:00,59,61,49,169,3,100.0
1,3/25/2018 0:05,60,67,42,169,3,100.0
2,3/25/2018 0:10,69,79,49,197,3,100.0
3,3/25/2018 0:15,62,61,51,174,3,100.0
4,3/25/2018 0:20,65,65,35,165,3,100.0
5,3/25/2018 0:25,53,67,45,165,3,100.0
6,3/25/2018 0:30,54,47,31,132,3,100.0
7,3/25/2018 0:35,55,66,34,155,3,100.0
8,3/25/2018 0:40,46,69,38,153,3,100.0
9,3/25/2018 0:45,51,56,41,148,3,100.0
10,3/25/2018 0:50,47,49,35,131,3,100.0
11,3/25/2018 0:55,35,46,27,108,3,100.0
12,3/25/2018 1:00,42,46,38,126,3,100.0
13,3/25/2018 1:05,43,58,38,139,3,100.0
14,3/25/2018 1:10,38,44,28,110,3,100.0
15,3/25/2018 1:15,34,44,28,106,3,100.0
16,3/25/2018 1:20,29,38,31,98,3,100.0
17,3/25/2018 1:25,17,37,32,86,3,100.0
18,3/25/2018 1:30,37,39,30,106,3,100.0
19,3/25/2018 1:35,40,44,34,118,3,100.0
20,3/25/2018 1:40,31,39,25,95,3,100.0
21,3/25/2018 1:45,35,39,32,106,3,100.0
22,3/25/2018 1:50,21,38,31,90,3,100.0
23,3/25/2018 1:55,29,26,26,81,3,100.0
24,3/25/2018 2:00,26,30,15,71,3,100.0
25,3/25/2018 2:05,23,37,23,83,3,100.0
26,3/25/2018 2:10,21,42,24,87,3,100.0
27,3/25/2018 2:15,23,33,22,78,3,100.0
28,3/25/2018 2:20,18,28,17,63,3,100.0
29,3/25/2018 2:25,23,32,21,76,3,100.0
30,3/25/2018 2:30,25,29,23,77,3,100.0
31,3/25/2018 2:35,21,39,21,81,3,100.0
32,3/25/2018 2:40,28,34,23,85,3,100.0
33,3/25/2018 2:45,26,32,26,84,3,100.0
34,3/25/2018 2:50,23,31,20,74,3,100.0
35,3/25/2018 2:55,25,26,16,67,3,100.0
36,3/25/2018 3:00,18,29,18,65,3,100.0
37,3/25/2018 3:05,12,30,11,53,3,100.0
38,3/25/2018 3:10,14,26,16,56,3,100.0
39,3/25/2018 3:15,7,24,17,48,3,100.0
40,3/25/2018 3:20,22,25,15,62,3,100.0
41,3/25/2018 3:25,14,26,13,53,3,100.0
42,3/25/2018 3:30,13,27,21,61,3,100.0
43,3/25/2018 3:35,19,23,19,61,3,100.0
44,3/25/2018 3:40,16,15,16,47,3,100.0
45,3/25/2018 3:45,11,22,21,54,3,100.0
46,3/25/2018 3:50,11,20,17,48,3,100.0
47,3/25/2018 3:55,12,22,16,50,3,100.0
48,3/25/2018 4:00,10,16,19,45,3,100.0
49,3/25/2018 4:05,17,25,16,58,3,100.0
50,3/25/2018 4:10,10,15,10,35,3,100.0
51,3/25/2018 4:15,15,23,14,52,3,100.0
52,3/25/2018 4:20,10,20,15,45,3,100.0
53,3/25/2018 4:25,13,27,21,61,3,100.0
54,3/25/2018 4:30,12,21,14,47,3,100.0
55,3/25/2018 4:35,16,22,14,52,3,100.0
56,3/25/2018 4:40,11,28,15,54,3,100.0
57,3/25/2018 4:45,13,28,15,56,3,100.0
58,3/25/2018 4:50,17,33,22,72,3,100.0
59,3/25/2018 4:55,17,29,12,58,3,100.0
60,3/25/2018 5:00,13,23,11,47,3,100.0
61,3/25/2018 5:05,18,24,22,64,3,100.0
62,3/25/2018 5:10,18,31,17,66,3,100.0
63,3/25/2018 5:15,21,34,25,80,3,100.0
64,3/25/2018 5:20,25,36,26,87,3,100.0
65,3/25/2018 5:25,29,44,28,101,3,100.0
66,3/25/2018 5:30,26,27,31,84,3,100.0
67,3/25/2018 5:35,34,33,30,97,3,100.0
68,3/25/2018 5:40,27,48,30,105,3,100.0
69,3/25/2018 5:45,33,49,30,112,3,100.0
70,3/25/2018 5:50,32,38,25,95,3,100.0
71,3/25/2018 5:55,26,38,27,91,3,100.0
72,3/25/2018 6:00,32,50,24,106,3,100.0
73,3/25/2018 6:05,42,49,29,120,3,100.0
74,3/25/2018 6:10,29,47,31,107,3,100.0
75,3/25/2018 6:15,40,45,23,108,3,100.0
76,3/25/2018 6:20,57,54,33,144,3,100.0
77,3/25/2018 6:25,60,60,41,161,3,100.0
78,3/25/2018 6:30,50,59,47,156,3,100.0
79,3/25/2018 6:35,53,55,42,150,3,100.0
80,3/25/2018 6:40,64,77,49,190,3,100.0
81,3/25/2018 6:45,55,63,50,168,3,100.0
82,3/25/2018 6:50,57,71,52,180,3,100.0
83,3/25/2018 6:55,67,63,45,175,3,100.0
84,3/25/2018 7:00,57,63,41,161,3,100.0
85,3/25/2018 7:05,71,68,47,186,3,100.0
86,3/25/2018 7:10,54,60,36,150,3,100.0
87,3/25/2018 7:15,61,74,52,187,3,100.0
88,3/25/2018 7:20,70,69,51,190,3,100.0
89,3/25/2018 7:25,64,72,59,195,3,100.0
90,3/25/2018 7:30,71,90,60,221,3,100.0
91,3/25/2018 7:35,89,91,61,241,3,100.0
92,3/25/2018 7:40,82,82,54,218,3,100.0
93,3/25/2018 7:45,67,73,68,208,3,100.0
94,3/25/2018 7:50,98,80,78,256,3,100.0
95,3/25/2018 7:55,70,65,53,188,3,100.0
96,3/25/2018 8:00,88,85,56,229,3,100.0
97,3/25/2018 8:05,108,95,72,275,3,100.0
98,3/25/2018 8:10,77,90,54,221,3,100.0
99,3/25/2018 8:15,98,108,81,287,3,100.0
100,3/25/2018 8:20,107,110,76,293,3,100.0
101,3/25/2018 8:25,107,100,80,287,3,100.0
102,3/25/2018 8:30,94,98,66,258,3,100.0
103,3/25/2018 8:35,108,110,60,278,3,100.0
104,3/25/2018 8:40,90,97,65,252,3,100.0
105,3/25/2018 8:45,113,117,74,304,3,100.0
106,3/25/2018 8:50,93,111,68,272,3,100.0
107,3/25/2018 8:55,97,99,74,270,3,100.0
108,3/25/2018 9:00,110,94,76,280,3,100.0
109,3/25/2018 9:05,89,106,71,266,3,100.0
110,3/25/2018 9:10,113,118,71,302,3,100.0
111,3/25/2018 9:15,107,124,91,322,3,100.0
112,3/25/2018 9:20,114,97,74,285,3,100.0
113,3/25/2018 9:25,154,130,92,376,3,100.0
114,3/25/2018 9:30,127,115,81,323,3,100.0
115,3/25/2018 9:35,142,125,94,361,3,100.0
116,3/25/2018 9:40,136,142,75,353,3,100.0
117,3/25/2018 9:45,144,127,92,363,3,100.0
118,3/25/2018 9:50,118,110,81,309,3,100.0
119,3/25/2018 9:55,124,102,63,289,3,100.0
120,3/25/2018 10:00,123,122,89,334,3,100.0
121,3/25/2018 10:05,144,116,86,346,3,100.0
122,3/25/2018 10:10,114,115,74,303,3,100.0
123,3/25/2018 10:15,160,145,110,415,3,100.0
124,3/25/2018 10:20,128,101,71,300,3,100.0
125,3/25/2018 10:25,164,143,102,409,3,100.0
126,3/25/2018 10:30,147,157,96,400,3,100.0
127,3/25/2018 10:35,149,139,88,376,3,100.0
128,3/25/2018 10:40,178,151,113,442,3,100.0
129,3/25/2018 10:45,160,146,101,407,3,100.0
130,3/25/2018 10:50,160,155,126,441,3,100.0
131,3/25/2018 10:55,161,156,97,414,3,100.0
132,3/25/2018 11:00,157,130,108,395,3,100.0
133,3/25/2018 11:05,151,132,81,364,3,100.0
134,3/25/2018 11:10,163,154,109,426,3,100.0
135,3/25/2018 11:15,173,167,131,471,3,100.0
136,3/25/2018 11:20,189,171,124,484,3,100.0
137,3/25/2018 11:25,116,112,113,341,3,100.0
138,3/25/2018 11:30,95,107,114,316,3,100.0
139,3/25/2018 11:35,73,80,106,259,3,100.0
140,3/25/2018 11:40,81,100,107,288,3,100.0
141,3/25/2018 11:45,101,101,120,322,3,100.0
142,3/25/2018 11:50,163,166,125,454,3,100.0
143,3/25/2018 11:55,171,170,142,483,3,100.0
144,3/25/2018 12:00,149,147,109,405,3,100.0
145,3/25/2018 12:05,130,123,93,346,3,100.0
146,3/25/2018 12:10,154,150,101,405,3,100.0
147,3/25/2018 12:15,169,152,108,429,3,100.0
148,3/25/2018 12:20,163,141,116,420,3,100.0
149,3/25/2018 12:25,153,154,118,425,3,100.0
150,3/25/2018 12:30,166,168,101,435,3,100.0
151,3/25/2018 12:35,184,148,109,441,3,100.0
152,3/25/2018 12:40,187,159,124,470,3,100.0
153,3/25/2018 12:45,168,158,107,433,3,100.0
154,3/25/2018 12:50,174,168,113,455,3,100.0
155,3/25/2018 12:55,155,149,124,428,3,100.0
156,3/25/2018 13:00,171,151,110,432,3,100.0
157,3/25/2018 13:05,160,150,102,412,3,100.0
158,3/25/2018 13:10,160,158,100,418,3,100.0
159,3/25/2018 13:15,93,114,83,290,3,100.0
160,3/25/2018 13:20,108,116,82,306,3,100.0
161,3/25/2018 13:25,111,108,96,315,3,100.0
162,3/25/2018 13:30,118,119,84,321,3,100.0
163,3/25/2018 13:35,111,108,91,310,3,100.0
164,3/25/2018 13:40,174,172,126,472,3,100.0
165,3/25/2018 13:45,169,176,136,481,3,100.0
166,3/25/2018 13:50,179,162,129,470,3,100.0
167,3/25/2018 13:55,168,172,132,472,3,100.0
168,3/25/2018 14:00,166,156,131,453,3,100.0
169,3/25/2018 14:05,181,172,154,507,3,100.0
170,3/25/2018 14:10,169,176,131,476,3,100.0
171,3/25/2018 14:15,152,156,129,437,3,100.0
172,3/25/2018 14:20,155,155,133,443,3,100.0
173,3/25/2018 14:25,144,161,123,428,3,100.0
174,3/25/2018 14:30,155,156,136,447,3,100.0
175,3/25/2018 14:35,156,158,141,455,3,100.0
176,3/25/2018 14:40,170,173,150,493,3,100.0
177,3/25/2018 14:45,171,162,132,465,3,100.0
178,3/25/2018 14:50,159,149,126,434,3,100.0
179,3/25/2018 14:55,161,149,123,433,3,100.0
180,3/25/2018 15:00,166,161,126,453,3,100.0
181,3/25/2018 15:05,168,152,130,450,3,100.0
182,3/25/2018 15:10,156,151,111,418,3,100.0
183,3/25/2018 15:15,167,149,111,427,3,100.0
184,3/25/2018 15:20,168,161,122,451,3,100.0
185,3/25/2018 15:25,182,158,123,463,3,100.0
186,3/25/2018 15:30,166,142,124,432,3,100.0
187,3/25/2018 15:35,171,168,122,461,3,100.0
188,3/25/2018 15:40,180,167,115,462,3,100.0
189,3/25/2018 15:45,168,148,124,440,3,100.0
190,3/25/2018 15:50,156,145,106,407,3,100.0
191,3/25/2018 15:55,164,153,121,438,3,100.0
192,3/25/2018 16:00,158,154,123,435,3,100.0
193,3/25/2018 16:05,158,142,117,417,3,100.0
194,3/25/2018 16:10,173,158,122,453,3,100.0
195,3/25/2018 16:15,178,175,137,490,3,100.0
196,3/25/2018 16:20,169,136,129,434,3,100.0
197,3/25/2018 16:25,174,156,123,453,3,100.0
198,3/25/2018 16:30,176,144,118,438,3,100.0
199,3/25/2018 16:35,182,175,125,482,3,100.0
200,3/25/2018 16:40,164,168,123,455,3,100.0
201,3/25/2018 16:45,162,138,107,407,3,100.0
202,3/25/2018 16:50,169,148,124,441,3,100.0
203,3/25/2018 16:55,162,174,118,454,3,100.0
204,3/25/2018 17:00,161,154,118,433,3,100.0
205,3/25/2018 17:05,174,159,113,446,3,100.0
206,3/25/2018 17:10,159,142,117,418,3,100.0
207,3/25/2018 17:15,140,146,116,402,3,100.0
208,3/25/2018 17:20,165,143,125,433,3,100.0
209,3/25/2018 17:25,174,160,128,462,3,100.0
210,3/25/2018 17:30,152,138,118,408,3,100.0
211,3/25/2018 17:35,168,156,129,453,3,100.0
212,3/25/2018 17:40,168,159,116,443,3,100.0
213,3/25/2018 17:45,151,148,108,407,3,100.0
214,3/25/2018 17:50,158,147,124,429,3,100.0
215,3/25/2018 17:55,147,141,106,394,3,100.0
216,3/25/2018 18:00,154,143,109,406,3,100.0
217,3/25/2018 18:05,148,148,105,401,3,100.0
218,3/25/2018 18:10,147,136,106,389,3,100.0
219,3/25/2018 18:15,142,155,107,404,3,100.0
220,3/25/2018 18:20,134,129,106,369,3,100.0
221,3/25/2018 18:25,137,133,95,365,3,100.0
222,3/25/2018 18:30,131,123,94,348,3,100.0
223,3/25/2018 18:35,145,140,102,387,3,100.0
224,3/25/2018 18:40,144,144,109,397,3,100.0
225,3/25/2018 18:45,134,138,87,359,3,100.0
226,3/25/2018 18:50,153,152,96,401,3,100.0
227,3/25/2018 18:55,138,135,104,377,3,100.0
228,3/25/2018 19:00,142,132,96,370,3,100.0
229,3/25/2018 19:05,129,119,90,338,3,100.0
230,3/25/2018 19:10,149,137,104,390,3,100.0
231,3/25/2018 19:15,167,149,112,428,3,100.0
232,3/25/2018 19:20,146,137,109,392,3,100.0
233,3/25/2018 19:25,139,138,100,377,3,100.0
234,3/25/2018 19:30,138,127,92,357,3,100.0
235,3/25/2018 19:35,132,138,91,361,3,100.0
236,3/25/2018 19:40,136,106,83,325,3,100.0
237,3/25/2018 19:45,130,114,89,333,3,100.0
238,3/25/2018 19:50,156,137,99,392,3,100.0
239,3/25/2018 19:55,139,127,90,356,3,100.0
240,3/25/2018 20:00,151,132,99,382,3,100.0
241,3/25/2018 20:05,130,115,82,327,3,100.0
242,3/25/2018 20:10,145,120,85,350,3,100.0
243,3/25/2018 20:15,151,126,97,374,3,100.0
244,3/25/2018 20:20,139,135,102,376,3,100.0
245,3/25/2018 20:25,147,130,99,376,3,100.0
246,3/25/2018 20:30,156,126,82,364,3,100.0
247,3/25/2018 20:35,127,134,83,344,3,100.0
248,3/25/2018 20:40,124,125,86,335,3,100.0
249,3/25/2018 20:45,146,139,95,380,3,100.0
250,3/25/2018 20:50,133,131,94,358,3,100.0
251,3/25/2018 20:55,132,112,87,331,3,100.0
252,3/25/2018 21:00,138,116,96,350,3,100.0
253,3/25/2018 21:05,126,115,82,323,3,100.0
254,3/25/2018 21:10,132,110,89,331,3,100.0
255,3/25/2018 21:15,139,129,97,365,3,100.0
256,3/25/2018 21:20,141,121,86,348,3,100.0
257,3/25/2018 21:25,113,119,71,303,3,100.0
258,3/25/2018 21:30,118,102,84,304,3,100.0
259,3/25/2018 21:35,132,130,79,341,3,100.0
260,3/25/2018 21:40,140,124,87,351,3,100.0
261,3/25/2018 21:45,116,107,91,314,3,100.0
262,3/25/2018 21:50,128,110,81,319,3,100.0
263,3/25/2018 21:55,130,122,74,326,3,100.0
264,3/25/2018 22:00,117,114,77,308,3,100.0
265,3/25/2018 22:05,112,108,78,298,3,100.0
266,3/25/2018 22:10,124,103,67,294,3,100.0
267,3/25/2018 22:15,108,109,74,291,3,100.0
268,3/25/2018 22:20,102,93,72,267,3,100.0
269,3/25/2018 22:25,103,106,63,272,3,100.0
270,3/25/2018 22:30,103,97,68,268,3,100.0
271,3/25/2018 22:35,117,111,71,299,3,100.0
272,3/25/2018 22:40,86,99,56,241,3,100.0
273,3/25/2018 22:45,100,80,59,239,3,100.0
274,3/25/2018 22:50,101,99,58,258,3,100.0
275,3/25/2018 22:55,78,77,56,211,3,100.0
276,3/25/2018 23:00,82,80,56,218,3,100.0
277,3/25/2018 23:05,67,79,43,189,3,100.0
278,3/25/2018 23:10,67,61,47,175,3,100.0
279,3/25/2018 23:15,87,76,58,221,3,100.0
280,3/25/2018 23:20,67,76,44,187,3,100.0
281,3/25/2018 23:25,67,89,52,208,3,100.0
282,3/25/2018 23:30,71,55,42,168,3,100.0
283,3/25/2018 23:35,33,49,25,107,3,100.0
284,3/25/2018 23:40,81,77,48,206,3,100.0
285,3/25/2018 23:45,60,58,43,161,3,100.0
286,3/25/2018 23:50,62,69,52,183,3,100.0
287,3/25/2018 23:55,74,64,39,177,3,100.0
288,3/26/2018 0:00,43,51,32,126,3,100.0
289,3/26/2018 0:05,67,72,37,176,3,100.0
290,3/26/2018 0:10,41,47,33,121,3,100.0
291,3/26/2018 0:15,38,40,32,110,3,100.0
292,3/26/2018 0:20,42,55,33,130,3,100.0
293,3/26/2018 0:25,44,40,29,113,3,100.0
294,3/26/2018 0:30,40,39,30,109,3,100.0
295,3/26/2018 0:35,29,34,18,81,3,100.0
296,3/26/2018 0:40,30,41,18,89,3,100.0
297,3/26/2018 0:45,34,43,28,105,3,100.0
298,3/26/2018 0:50,21,36,25,82,3,100.0
299,3/26/2018 0:55,21,43,18,82,3,100.0
300,3/26/2018 1:00,26,27,18,71,3,100.0
301,3/26/2018 1:05,19,34,26,79,3,100.0
302,3/26/2018 1:10,21,32,21,74,3,100.0
303,3/26/2018 1:15,30,35,22,87,3,100.0
304,3/26/2018 1:20,16,21,9,46,3,100.0
305,3/26/2018 1:25,17,23,18,58,3,100.0
306,3/26/2018 1:30,18,28,15,61,3,100.0
307,3/26/2018 1:35,19,25,14,58,3,100.0
308,3/26/2018 1:40,23,22,19,64,3,100.0
309,3/26/2018 1:45,11,29,11,51,3,100.0
310,3/26/2018 1:50,13,20,18,51,3,100.0
311,3/26/2018 1:55,16,24,13,53,3,100.0
312,3/26/2018 2:00,12,14,13,39,3,100.0
313,3/26/2018 2:05,12,20,16,48,3,100.0
314,3/26/2018 2:10,12,22,11,45,3,100.0
315,3/26/2018 2:15,16,23,17,56,3,100.0
316,3/26/2018 2:20,9,10,12,31,3,100.0
317,3/26/2018 2:25,12,17,20,49,3,100.0
318,3/26/2018 2:30,14,18,7,39,3,100.0
319,3/26/2018 2:35,5,10,10,25,3,100.0
320,3/26/2018 2:40,6,14,3,23,3,100.0
321,3/26/2018 2:45,6,13,12,31,3,100.0
322,3/26/2018 2:50,7,11,12,30,3,100.0
323,3/26/2018 2:55,5,16,9,30,3,100.0
324,3/26/2018 3:00,6,13,16,35,3,100.0
325,3/26/2018 3:05,6,16,14,36,3,100.0
326,3/26/2018 3:10,8,20,11,39,3,100.0
327,3/26/2018 3:15,12,20,14,46,3,100.0
328,3/26/2018 3:20,13,16,17,46,3,100.0
329,3/26/2018 3:25,12,15,22,49,3,100.0
330,3/26/2018 3:30,11,23,11,45,3,100.0
331,3/26/2018 3:35,8,21,16,45,3,100.0
332,3/26/2018 3:40,18,25,16,59,3,100.0
333,3/26/2018 3:45,10,27,19,56,3,100.0
334,3/26/2018 3:50,17,24,10,51,3,100.0
335,3/26/2018 3:55,22,22,11,55,3,100.0
336,3/26/2018 4:00,13,29,17,59,3,100.0
337,3/26/2018 4:05,10,21,19,50,3,100.0
338,3/26/2018 4:10,17,27,16,60,3,100.0
339,3/26/2018 4:15,27,35,12,74,3,100.0
340,3/26/2018 4:20,36,48,23,107,3,100.0
341,3/26/2018 4:25,31,38,20,89,3,100.0
342,3/26/2018 4:30,35,48,31,114,3,100.0
343,3/26/2018 4:35,42,56,28,126,3,100.0
344,3/26/2018 4:40,41,47,35,123,3,100.0
345,3/26/2018 4:45,30,52,28,110,3,100.0
346,3/26/2018 4:50,52,53,31,136,3,100.0
347,3/26/2018 4:55,42,60,36,138,3,100.0
348,3/26/2018 5:00,49,55,32,136,3,100.0
349,3/26/2018 5:05,74,73,41,188,3,100.0
350,3/26/2018 5:10,87,81,59,227,3,100.0
351,3/26/2018 5:15,91,87,43,221,3,100.0
352,3/26/2018 5:20,103,94,42,239,3,100.0
353,3/26/2018 5:25,114,98,67,279,3,100.0
354,3/26/2018 5:30,113,97,72,282,3,100.0
355,3/26/2018 5:35,122,95,55,272,3,100.0
356,3/26/2018 5:40,118,107,58,283,3,100.0
357,3/26/2018 5:45,133,120,76,329,3,100.0
358,3/26/2018 5:50,140,125,83,348,3,100.0
359,3/26/2018 5:55,144,128,84,356,3,100.0
360,3/26/2018 6:00,148,110,83,341,3,100.0
361,3/26/2018 6:05,164,123,80,367,3,100.0
362,3/26/2018 6:10,146,124,77,347,3,100.0
363,3/26/2018 6:15,163,142,96,401,3,100.0
364,3/26/2018 6:20,138,122,76,336,3,100.0
365,3/26/2018 6:25,161,136,86,383,3,100.0
366,3/26/2018 6:30,171,152,97,420,3,100.0
367,3/26/2018 6:35,172,143,97,412,3,100.0
368,3/26/2018 6:40,166,150,107,423,3,100.0
369,3/26/2018 6:45,185,152,98,435,3,100.0
370,3/26/2018 6:50,176,160,117,453,3,100.0
371,3/26/2018 6:55,174,160,109,443,3,100.0
372,3/26/2018 7:00,156,130,104,390,3,100.0
373,3/26/2018 7:05,149,149,115,413,3,100.0
374,3/26/2018 7:10,179,162,121,462,3,100.0
375,3/26/2018 7:15,170,154,111,435,3,100.0
376,3/26/2018 7:20,181,167,122,470,3,100.0
377,3/26/2018 7:25,166,166,122,454,3,100.0
378,3/26/2018 7:30,173,157,128,458,3,100.0
379,3/26/2018 7:35,190,184,135,509,3,100.0
380,3/26/2018 7:40,183,161,127,471,3,100.0
381,3/26/2018 7:45,199,173,133,505,3,100.0
382,3/26/2018 7:50,163,163,110,436,3,100.0
383,3/26/2018 7:55,183,171,124,478,3,100.0
384,3/26/2018 8:00,171,138,116,425,3,100.0
385,3/26/2018 8:05,170,149,116,435,3,100.0
386,3/26/2018 8:10,189,172,118,479,3,100.0
387,3/26/2018 8:15,186,166,116,468,3,100.0
388,3/26/2018 8:20,171,153,116,440,3,100.0
389,3/26/2018 8:25,197,163,133,493,3,100.0
390,3/26/2018 8:30,155,153,117,425,3,100.0
391,3/26/2018 8:35,183,159,127,469,3,100.0
392,3/26/2018 8:40,194,154,100,448,3,100.0
393,3/26/2018 8:45,171,140,111,422,3,100.0
394,3/26/2018 8:50,179,157,125,461,3,100.0
395,3/26/2018 8:55,150,142,96,388,3,100.0
396,3/26/2018 9:00,149,136,93,378,3,100.0
397,3/26/2018 9:05,148,150,109,407,3,100.0
398,3/26/2018 9:10,155,138,93,386,3,100.0
399,3/26/2018 9:15,182,140,95,417,3,100.0
400,3/26/2018 9:20,167,151,109,427,3,100.0
401,3/26/2018 9:25,164,137,105,406,3,100.0
402,3/26/2018 9:30,147,139,91,377,3,100.0
403,3/26/2018 9:35,142,134,89,365,3,100.0
404,3/26/2018 9:40,160,133,101,394,3,100.0
405,3/26/2018 9:45,133,116,92,341,3,100.0
406,3/26/2018 9:50,147,130,96,373,3,100.0
407,3/26/2018 9:55,162,144,95,401,3,100.0
408,3/26/2018 10:00,158,130,91,379,3,100.0
409,3/26/2018 10:05,135,123,90,348,3,100.0
410,3/26/2018 10:10,147,128,101,376,3,100.0
411,3/26/2018 10:15,166,147,93,406,3,100.0
412,3/26/2018 10:20,144,139,106,389,3,100.0
413,3/26/2018 10:25,142,132,90,364,3,100.0
414,3/26/2018 10:30,164,140,98,402,3,100.0
415,3/26/2018 10:35,162,147,103,412,3,100.0
416,3/26/2018 10:40,163,149,98,410,3,100.0
417,3/26/2018 10:45,167,148,117,432,3,100.0
418,3/26/2018 10:50,173,144,115,432,3,100.0
419,3/26/2018 10:55,171,139,106,416,3,100.0
420,3/26/2018 11:00,187,158,118,463,3,100.0
421,3/26/2018 11:05,169,156,111,436,3,100.0
422,3/26/2018 11:10,176,159,111,446,3,100.0
423,3/26/2018 11:15,162,149,113,424,3,100.0
424,3/26/2018 11:20,192,146,117,455,3,100.0
425,3/26/2018 11:25,181,158,114,453,3,100.0
426,3/26/2018 11:30,177,158,119,454,3,100.0
427,3/26/2018 11:35,171,157,109,437,3,100.0
428,3/26/2018 11:40,142,146,100,388,3,100.0
429,3/26/2018 11:45,146,149,100,395,3,100.0
430,3/26/2018 11:50,174,142,109,425,3,100.0
431,3/26/2018 11:55,183,153,123,459,3,100.0
432,3/26/2018 12:00,176,162,123,461,3,100.0
433,3/26/2018 12:05,197,167,112,476,3,100.0
434,3/26/2018 12:10,170,165,123,458,3,100.0
435,3/26/2018 12:15,164,142,101,407,3,100.0
436,3/26/2018 12:20,197,169,116,482,3,100.0
437,3/26/2018 12:25,152,153,107,412,3,100.0
438,3/26/2018 12:30,186,171,121,478,3,100.0
439,3/26/2018 12:35,168,160,112,440,3,100.0
440,3/26/2018 12:40,178,179,132,489,3,100.0
441,3/26/2018 12:45,141,139,108,388,3,100.0
442,3/26/2018 12:50,166,153,133,452,3,100.0
443,3/26/2018 12:55,179,158,129,466,3,100.0
444,3/26/2018 13:00,182,158,119,459,3,100.0
445,3/26/2018 13:05,165,146,112,423,3,100.0
446,3/26/2018 13:10,149,143,112,404,3,100.0
447,3/26/2018 13:15,156,147,116,419,3,100.0
448,3/26/2018 13:20,169,162,117,448,3,100.0
449,3/26/2018 13:25,173,140,106,419,3,100.0
450,3/26/2018 13:30,171,143,119,433,3,100.0
451,3/26/2018 13:35,173,155,117,445,3,100.0
452,3/26/2018 13:40,169,171,128,468,3,100.0
453,3/26/2018 13:45,191,171,158,520,3,100.0
454,3/26/2018 13:50,182,173,124,479,3,100.0
455,3/26/2018 13:55,163,163,138,464,3,100.0
456,3/26/2018 14:00,164,163,126,453,3,100.0
457,3/26/2018 14:05,173,161,134,468,3,100.0
458,3/26/2018 14:10,163,178,128,469,3,100.0
459,3/26/2018 14:15,181,174,109,464,3,100.0
460,3/26/2018 14:20,178,173,147,498,3,100.0
461,3/26/2018 14:25,188,175,144,507,3,100.0
462,3/26/2018 14:30,171,163,128,462,3,100.0
463,3/26/2018 14:35,174,168,137,479,3,100.0
464,3/26/2018 14:40,191,170,152,513,3,100.0
465,3/26/2018 14:45,180,158,148,486,3,100.0
466,3/26/2018 14:50,121,131,124,376,3,100.0
467,3/26/2018 14:55,145,143,129,417,3,100.0
468,3/26/2018 15:00,162,146,144,452,3,100.0
469,3/26/2018 15:05,152,143,135,430,3,100.0
470,3/26/2018 15:10,164,161,147,472,3,100.0
471,3/26/2018 15:15,166,166,155,487,3,100.0
472,3/26/2018 15:20,154,157,139,450,3,100.0
473,3/26/2018 15:25,153,168,139,460,3,100.0
474,3/26/2018 15:30,144,154,130,428,3,100.0
475,3/26/2018 15:35,148,147,127,422,3,100.0
476,3/26/2018 15:40,142,137,127,406,3,100.0
477,3/26/2018 15:45,131,123,120,374,3,100.0
478,3/26/2018 15:50,141,138,133,412,3,100.0
479,3/26/2018 15:55,142,142,124,408,3,100.0
480,3/26/2018 16:00,162,145,136,443,3,100.0
481,3/26/2018 16:05,135,134,125,394,3,100.0
482,3/26/2018 16:10,107,107,97,311,3,100.0
483,3/26/2018 16:15,148,145,143,436,3,100.0
484,3/26/2018 16:20,145,144,138,427,3,100.0
485,3/26/2018 16:25,162,146,133,441,3,100.0
486,3/26/2018 16:30,153,141,133,427,3,100.0
487,3/26/2018 16:35,133,129,123,385,3,100.0
488,3/26/2018 16:40,142,138,133,413,3,100.0
489,3/26/2018 16:45,146,133,130,409,3,100.0
490,3/26/2018 16:50,130,131,136,397,3,100.0
491,3/26/2018 16:55,138,145,134,417,3,100.0
492,3/26/2018 17:00,134,144,135,413,3,100.0
493,3/26/2018 17:05,130,129,127,386,3,100.0
494,3/26/2018 17:10,160,158,140,458,3,100.0
495,3/26/2018 17:15,156,141,141,438,3,100.0
496,3/26/2018 17:20,152,146,146,444,3,100.0
497,3/26/2018 17:25,159,155,157,471,3,100.0
498,3/26/2018 17:30,160,162,155,477,3,100.0
499,3/26/2018 17:35,145,146,137,428,3,100.0
500,3/26/2018 17:40,152,144,142,438,3,100.0
501,3/26/2018 17:45,153,141,143,437,3,100.0
502,3/26/2018 17:50,167,149,155,471,3,100.0
503,3/26/2018 17:55,157,152,150,459,3,100.0
504,3/26/2018 18:00,175,176,158,509,3,100.0
505,3/26/2018 18:05,164,171,150,485,3,100.0
506,3/26/2018 18:10,158,156,152,466,3,100.0
507,3/26/2018 18:15,169,159,139,467,3,100.0
508,3/26/2018 18:20,167,148,148,463,3,100.0
509,3/26/2018 18:25,169,162,154,485,3,100.0
510,3/26/2018 18:30,148,151,135,434,3,100.0
511,3/26/2018 18:35,143,162,139,444,3,100.0
512,3/26/2018 18:40,163,152,146,461,3,100.0
513,3/26/2018 18:45,161,147,133,441,3,100.0
514,3/26/2018 18:50,165,163,153,481,3,100.0
515,3/26/2018 18:55,153,156,143,452,3,100.0
516,3/26/2018 19:00,151,149,126,426,3,100.0
517,3/26/2018 19:05,150,165,128,443,3,100.0
518,3/26/2018 19:10,164,169,135,468,3,100.0
519,3/26/2018 19:15,156,136,135,427,3,100.0
520,3/26/2018 19:20,142,137,104,383,3,100.0
521,3/26/2018 19:25,151,152,118,421,3,100.0
522,3/26/2018 19:30,150,142,104,396,3,100.0
523,3/26/2018 19:35,140,135,101,376,3,100.0
524,3/26/2018 19:40,147,139,109,395,3,100.0
525,3/26/2018 19:45,151,131,104,386,3,100.0
526,3/26/2018 19:50,122,128,89,339,3,100.0
527,3/26/2018 19:55,127,126,94,347,3,100.0
528,3/26/2018 20:00,136,122,115,373,3,100.0
529,3/26/2018 20:05,147,124,110,381,3,100.0
530,3/26/2018 20:10,155,126,103,384,3,100.0
531,3/26/2018 20:15,144,132,103,379,3,100.0
532,3/26/2018 20:20,127,126,84,337,3,100.0
533,3/26/2018 20:25,144,124,90,358,3,100.0
534,3/26/2018 20:30,146,120,89,355,3,100.0
535,3/26/2018 20:35,131,129,93,353,3,100.0
536,3/26/2018 20:40,123,109,90,322,3,100.0
537,3/26/2018 20:45,135,117,82,334,3,100.0
538,3/26/2018 20:50,115,116,90,321,3,100.0
539,3/26/2018 20:55,130,124,90,344,3,100.0
540,3/26/2018 21:00,107,113,92,312,3,100.0
541,3/26/2018 21:05,126,113,71,310,3,100.0
542,3/26/2018 21:10,111,100,71,282,3,100.0
543,3/26/2018 21:15,110,106,66,282,3,100.0
544,3/26/2018 21:20,126,113,95,334,3,100.0
545,3/26/2018 21:25,131,111,90,332,3,100.0
546,3/26/2018 21:30,120,110,72,302,3,100.0
547,3/26/2018 21:35,110,118,74,302,3,100.0
548,3/26/2018 21:40,97,97,69,263,3,100.0
549,3/26/2018 21:45,106,104,73,283,3,100.0
550,3/26/2018 21:50,106,83,72,261,3,100.0
551,3/26/2018 21:55,93,105,67,265,3,100.0
552,3/26/2018 22:00,97,86,61,244,3,100.0
553,3/26/2018 22:05,94,89,64,247,3,100.0
554,3/26/2018 22:10,109,91,61,261,3,100.0
555,3/26/2018 22:15,112,97,74,283,3,100.0
556,3/26/2018 22:20,96,92,64,252,3,100.0
557,3/26/2018 22:25,83,75,56,214,3,100.0
558,3/26/2018 22:30,86,90,66,242,3,100.0
559,3/26/2018 22:35,98,94,65,257,3,100.0
560,3/26/2018 22:40,91,83,60,234,3,100.0
561,3/26/2018 22:45,83,90,72,245,3,100.0
562,3/26/2018 22:50,77,78,50,205,3,100.0
563,3/26/2018 22:55,82,77,55,214,3,100.0
564,3/26/2018 23:00,69,73,52,194,3,100.0
565,3/26/2018 23:05,74,87,45,206,3,100.0
566,3/26/2018 23:10,62,66,53,181,3,100.0
567,3/26/2018 23:15,80,73,64,217,3,100.0
568,3/26/2018 23:20,67,60,36,163,3,100.0
569,3/26/2018 23:25,58,57,41,156,3,100.0
570,3/26/2018 23:30,54,65,41,160,3,100.0
571,3/26/2018 23:35,56,62,43,161,3,100.0
572,3/26/2018 23:40,50,53,45,148,3,100.0
573,3/26/2018 23:45,53,68,31,152,3,100.0
574,3/26/2018 23:50,41,42,34,117,3,100.0
575,3/26/2018 23:55,63,69,43,175,3,100.0
576,3/27/2018 0:00,33,48,43,124,3,100.0
577,3/27/2018 0:05,38,52,32,122,3,100.0
578,3/27/2018 0:10,33,47,36,116,3,100.0
579,3/27/2018 0:15,40,53,45,138,3,100.0
580,3/27/2018 0:20,33,41,22,96,3,100.0
581,3/27/2018 0:25,33,42,31,106,3,100.0
582,3/27/2018 0:30,35,37,33,105,3,100.0
583,3/27/2018 0:35,36,32,25,93,3,100.0
584,3/27/2018 0:40,32,32,24,88,3,100.0
585,3/27/2018 0:45,29,34,28,91,3,100.0
586,3/27/2018 0:50,28,37,23,88,3,100.0
587,3/27/2018 0:55,28,26,29,83,3,100.0
588,3/27/2018 1:00,19,29,24,72,3,100.0
589,3/27/2018 1:05,24,33,23,80,3,100.0
590,3/27/2018 1:10,27,27,18,72,3,100.0
591,3/27/2018 1:15,21,39,22,82,3,100.0
592,3/27/2018 1:20,23,24,21,68,3,100.0
593,3/27/2018 1:25,13,24,20,57,3,100.0
594,3/27/2018 1:30,23,27,20,70,3,100.0
595,3/27/2018 1:35,21,23,13,57,3,100.0
596,3/27/2018 1:40,17,19,22,58,3,100.0
597,3/27/2018 1:45,17,26,21,64,3,100.0
598,3/27/2018 1:50,19,26,24,69,3,100.0
599,3/27/2018 1:55,22,24,15,61,3,100.0
600,3/27/2018 2:00,14,22,19,55,3,100.0
601,3/27/2018 2:05,16,22,11,49,3,100.0
602,3/27/2018 2:10,15,21,10,46,3,100.0
603,3/27/2018 2:15,16,12,19,47,3,100.0
604,3/27/2018 2:20,13,15,22,50,3,100.0
605,3/27/2018 2:25,13,25,15,53,3,100.0
606,3/27/2018 2:30,16,23,16,55,3,100.0
607,3/27/2018 2:35,11,18,15,44,3,100.0
608,3/27/2018 2:40,12,25,13,50,3,100.0
609,3/27/2018 2:45,13,19,16,48,3,100.0
610,3/27/2018 2:50,4,14,10,28,3,100.0
611,3/27/2018 2:55,6,22,14,42,3,100.0
612,3/27/2018 3:00,15,20,14,49,3,100.0
613,3/27/2018 3:05,15,17,15,47,3,100.0
614,3/27/2018 3:10,4,13,16,33,3,100.0
615,3/27/2018 3:15,8,17,14,39,3,100.0
616,3/27/2018 3:20,13,20,10,43,3,100.0
617,3/27/2018 3:25,12,16,14,42,3,100.0
618,3/27/2018 3:30,10,15,19,44,3,100.0
619,3/27/2018 3:35,13,23,16,52,3,100.0
620,3/27/2018 3:40,8,19,16,43,3,100.0
621,3/27/2018 3:45,11,14,16,41,3,100.0
622,3/27/2018 3:50,18,24,23,65,3,100.0
623,3/27/2018 3:55,19,22,17,58,3,100.0
624,3/27/2018 4:00,19,26,14,59,3,100.0
625,3/27/2018 4:05,18,24,25,67,3,100.0
626,3/27/2018 4:10,15,25,15,55,3,100.0
627,3/27/2018 4:15,21,33,17,71,3,100.0
628,3/27/2018 4:20,27,40,24,91,3,100.0
629,3/27/2018 4:25,44,44,21,109,3,100.0
630,3/27/2018 4:30,30,36,18,84,3,100.0
631,3/27/2018 4:35,46,45,34,125,3,100.0
632,3/27/2018 4:40,33,40,25,98,3,100.0
633,3/27/2018 4:45,58,52,34,144,3,100.0
634,3/27/2018 4:50,52,46,35,133,3,100.0
635,3/27/2018 4:55,46,56,40,142,3,100.0
636,3/27/2018 5:00,54,52,33,139,3,100.0
637,3/27/2018 5:05,65,59,47,171,3,100.0
638,3/27/2018 5:10,69,82,48,199,3,100.0
639,3/27/2018 5:15,95,86,40,221,3,100.0
640,3/27/2018 5:20,104,98,51,253,3,100.0
641,3/27/2018 5:25,97,68,61,226,3,100.0
642,3/27/2018 5:30,106,93,59,258,3,100.0
643,3/27/2018 5:35,141,118,63,322,3,100.0
644,3/27/2018 5:40,148,115,70,333,3,100.0
645,3/27/2018 5:45,132,122,74,328,3,100.0
646,3/27/2018 5:50,156,134,79,369,3,100.0
647,3/27/2018 5:55,128,112,80,320,3,100.0
648,3/27/2018 6:00,134,122,73,329,3,100.0
649,3/27/2018 6:05,161,130,82,373,3,100.0
650,3/27/2018 6:10,154,139,80,373,3,100.0
651,3/27/2018 6:15,155,143,99,397,3,100.0
652,3/27/2018 6:20,168,146,92,406,3,100.0
653,3/27/2018 6:25,161,132,92,385,3,100.0
654,3/27/2018 6:30,156,135,89,380,3,100.0
655,3/27/2018 6:35,188,148,96,432,3,100.0
656,3/27/2018 6:40,180,138,96,414,3,100.0
657,3/27/2018 6:45,185,163,122,470,3,100.0
658,3/27/2018 6:50,189,145,110,444,3,100.0
659,3/27/2018 6:55,176,144,112,432,3,100.0
660,3/27/2018 7:00,172,129,104,405,3,100.0
661,3/27/2018 7:05,153,155,119,427,3,100.0
662,3/27/2018 7:10,170,152,118,440,3,100.0
663,3/27/2018 7:15,171,150,126,447,3,100.0
664,3/27/2018 7:20,170,164,125,459,3,100.0
665,3/27/2018 7:25,157,143,120,420,3,100.0
666,3/27/2018 7:30,170,164,134,468,3,100.0
667,3/27/2018 7:35,181,163,142,486,3,100.0
668,3/27/2018 7:40,185,169,142,496,3,100.0
669,3/27/2018 7:45,191,174,134,499,3,100.0
670,3/27/2018 7:50,189,167,128,484,3,100.0
671,3/27/2018 7:55,175,157,114,446,3,100.0
672,3/27/2018 8:00,178,151,126,455,3,100.0
673,3/27/2018 8:05,168,143,102,413,3,100.0
674,3/27/2018 8:10,173,149,109,431,3,100.0
675,3/27/2018 8:15,138,117,122,377,3,100.0
676,3/27/2018 8:20,168,154,115,437,3,100.0
677,3/27/2018 8:25,186,150,124,460,3,100.0
678,3/27/2018 8:30,181,163,131,475,3,100.0
679,3/27/2018 8:35,192,166,106,464,3,100.0
680,3/27/2018 8:40,190,153,119,462,3,100.0
681,3/27/2018 8:45,175,149,78,402,3,100.0
682,3/27/2018 8:50,182,164,116,462,3,100.0
683,3/27/2018 8:55,191,151,125,467,3,100.0
684,3/27/2018 9:00,150,142,102,394,3,100.0
685,3/27/2018 9:05,173,154,99,426,3,100.0
686,3/27/2018 9:10,173,137,109,419,3,100.0
687,3/27/2018 9:15,149,134,88,371,3,100.0
688,3/27/2018 9:20,175,138,101,414,3,100.0
689,3/27/2018 9:25,158,128,106,392,3,100.0
690,3/27/2018 9:30,151,140,101,392,3,100.0
691,3/27/2018 9:35,176,141,103,420,3,100.0
692,3/27/2018 9:40,167,141,101,409,3,100.0
693,3/27/2018 9:45,152,148,89,389,3,100.0
694,3/27/2018 9:50,178,148,103,429,3,100.0
695,3/27/2018 9:55,161,149,97,407,3,100.0
696,3/27/2018 10:00,144,143,100,387,3,100.0
697,3/27/2018 10:05,149,149,89,387,3,100.0
698,3/27/2018 10:10,143,143,96,382,3,100.0
699,3/27/2018 10:15,160,137,101,398,3,100.0
700,3/27/2018 10:20,175,139,106,420,3,100.0
701,3/27/2018 10:25,174,144,104,422,3,100.0
702,3/27/2018 10:30,159,148,96,403,3,100.0
703,3/27/2018 10:35,165,136,98,399,3,100.0
704,3/27/2018 10:40,182,142,97,421,3,100.0
705,3/27/2018 10:45,160,146,106,412,3,100.0
706,3/27/2018 10:50,148,140,95,383,3,100.0
707,3/27/2018 10:55,158,135,77,370,3,100.0
708,3/27/2018 11:00,156,141,100,397,3,100.0
709,3/27/2018 11:05,175,140,107,422,3,100.0
710,3/27/2018 11:10,156,150,114,420,3,100.0
711,3/27/2018 11:15,172,140,110,422,3,100.0
712,3/27/2018 11:20,171,148,95,414,3,100.0
713,3/27/2018 11:25,159,139,117,415,3,100.0
714,3/27/2018 11:30,176,159,126,461,3,100.0
715,3/27/2018 11:35,167,139,122,428,3,100.0
716,3/27/2018 11:40,180,153,130,463,3,100.0
717,3/27/2018 11:45,165,159,98,422,3,100.0
718,3/27/2018 11:50,179,161,117,457,3,100.0
719,3/27/2018 11:55,170,151,115,436,3,100.0
720,3/27/2018 12:00,160,151,115,426,3,100.0
721,3/27/2018 12:05,159,150,102,411,3,100.0
722,3/27/2018 12:10,153,149,103,405,3,100.0
723,3/27/2018 12:15,156,144,103,403,3,100.0
724,3/27/2018 12:20,171,137,127,435,3,100.0
725,3/27/2018 12:25,164,165,100,429,3,100.0
726,3/27/2018 12:30,154,156,111,421,3,100.0
727,3/27/2018 12:35,171,149,113,433,3,100.0
728,3/27/2018 12:40,176,163,125,464,3,100.0
729,3/27/2018 12:45,181,163,125,469,3,100.0
730,3/27/2018 12:50,185,173,139,497,3,100.0
731,3/27/2018 12:55,206,153,125,484,3,100.0
732,3/27/2018 13:00,176,156,126,458,3,100.0
733,3/27/2018 13:05,186,153,118,457,3,100.0
734,3/27/2018 13:10,179,166,121,466,3,100.0
735,3/27/2018 13:15,179,174,123,476,3,100.0
736,3/27/2018 13:20,185,156,113,454,3,100.0
737,3/27/2018 13:25,181,162,127,470,3,100.0
738,3/27/2018 13:30,191,166,121,478,3,100.0
739,3/27/2018 13:35,183,170,131,484,3,100.0
740,3/27/2018 13:40,176,142,125,443,3,100.0
741,3/27/2018 13:45,155,147,115,417,3,100.0
742,3/27/2018 13:50,172,159,147,478,3,100.0
743,3/27/2018 13:55,183,173,143,499,3,100.0
744,3/27/2018 14:00,173,168,139,480,3,100.0
745,3/27/2018 14:05,185,167,126,478,3,100.0
746,3/27/2018 14:10,179,163,142,484,3,100.0
747,3/27/2018 14:15,174,162,137,473,3,100.0
748,3/27/2018 14:20,171,167,140,478,3,100.0
749,3/27/2018 14:25,179,158,127,464,3,100.0
750,3/27/2018 14:30,145,144,121,410,3,100.0
751,3/27/2018 14:35,164,166,130,460,3,100.0
752,3/27/2018 14:40,167,150,139,456,3,100.0
753,3/27/2018 14:45,154,140,131,425,3,100.0
754,3/27/2018 14:50,166,154,139,459,3,100.0
755,3/27/2018 14:55,150,148,119,417,3,100.0
756,3/27/2018 15:00,150,155,140,445,3,100.0
757,3/27/2018 15:05,160,151,143,454,3,100.0
758,3/27/2018 15:10,160,150,143,453,3,100.0
759,3/27/2018 15:15,150,142,138,430,3,100.0
760,3/27/2018 15:20,96,104,111,311,3,100.0
761,3/27/2018 15:25,136,134,115,385,3,100.0
762,3/27/2018 15:30,143,132,130,405,3,100.0
763,3/27/2018 15:35,154,145,135,434,3,100.0
764,3/27/2018 15:40,168,156,155,479,3,100.0
765,3/27/2018 15:45,123,114,118,355,3,100.0
766,3/27/2018 15:50,140,126,127,393,3,100.0
767,3/27/2018 15:55,154,153,136,443,3,100.0
768,3/27/2018 16:00,163,154,152,469,3,100.0
769,3/27/2018 16:05,150,158,150,458,3,100.0
770,3/27/2018 16:10,149,136,128,413,3,100.0
771,3/27/2018 16:15,125,122,127,374,3,100.0
772,3/27/2018 16:20,136,132,127,395,3,100.0
773,3/27/2018 16:25,143,137,123,403,3,100.0
774,3/27/2018 16:30,163,150,141,454,3,100.0
775,3/27/2018 16:35,119,118,120,357,3,100.0
776,3/27/2018 16:40,152,144,134,430,3,100.0
777,3/27/2018 16:45,142,138,131,411,3,100.0
778,3/27/2018 16:50,126,127,127,380,3,100.0
779,3/27/2018 16:55,126,120,130,376,3,100.0
780,3/27/2018 17:00,139,128,136,403,3,100.0
781,3/27/2018 17:05,117,122,119,358,3,100.0
782,3/27/2018 17:10,154,138,147,439,3,100.0
783,3/27/2018 17:15,139,127,124,390,3,100.0
784,3/27/2018 17:20,131,134,127,392,3,100.0
785,3/27/2018 17:25,146,134,139,419,3,100.0
786,3/27/2018 17:30,130,133,127,390,3,100.0
787,3/27/2018 17:35,141,134,132,407,3,100.0
788,3/27/2018 17:40,143,133,121,397,3,100.0
789,3/27/2018 17:45,145,138,127,410,3,100.0
790,3/27/2018 17:50,151,140,132,423,3,100.0
791,3/27/2018 17:55,142,147,138,427,3,100.0
792,3/27/2018 18:00,144,141,127,412,3,100.0
793,3/27/2018 18:05,140,136,141,417,3,100.0
794,3/27/2018 18:10,136,130,136,402,3,100.0
795,3/27/2018 18:15,139,139,133,411,3,100.0
796,3/27/2018 18:20,141,134,140,415,3,100.0
797,3/27/2018 18:25,147,143,140,430,3,100.0
798,3/27/2018 18:30,158,143,146,447,3,100.0
799,3/27/2018 18:35,160,146,133,439,3,100.0
800,3/27/2018 18:40,156,134,123,413,3,100.0
801,3/27/2018 18:45,144,143,133,420,3,100.0
802,3/27/2018 18:50,169,155,142,466,3,100.0
803,3/27/2018 18:55,159,147,136,442,3,100.0
804,3/27/2018 19:00,166,147,144,457,3,100.0
805,3/27/2018 19:05,169,158,133,460,3,100.0
806,3/27/2018 19:10,164,144,136,444,3,100.0
807,3/27/2018 19:15,150,143,116,409,3,100.0
808,3/27/2018 19:20,171,148,128,447,3,100.0
809,3/27/2018 19:25,174,166,132,472,3,100.0
810,3/27/2018 19:30,161,159,130,450,3,100.0
811,3/27/2018 19:35,167,149,142,458,3,100.0
812,3/27/2018 19:40,156,155,143,454,3,100.0
813,3/27/2018 19:45,150,137,133,420,3,100.0
814,3/27/2018 19:50,157,146,120,423,3,100.0
815,3/27/2018 19:55,161,150,131,442,3,100.0
816,3/27/2018 20:00,160,156,138,454,3,100.0
817,3/27/2018 20:05,164,151,139,454,3,100.0
818,3/27/2018 20:10,140,134,128,402,3,100.0
819,3/27/2018 20:15,143,142,131,416,3,100.0
820,3/27/2018 20:20,151,134,130,415,3,100.0
821,3/27/2018 20:25,148,131,131,410,3,100.0
822,3/27/2018 20:30,144,122,113,379,3,100.0
823,3/27/2018 20:35,147,132,100,379,3,100.0
824,3/27/2018 20:40,154,141,107,402,3,100.0
825,3/27/2018 20:45,157,145,105,407,3,100.0
826,3/27/2018 20:50,152,143,119,414,3,100.0
827,3/27/2018 20:55,141,125,110,376,3,100.0
828,3/27/2018 21:00,137,116,106,359,3,100.0
829,3/27/2018 21:05,133,130,91,354,3,100.0
830,3/27/2018 21:10,129,115,98,342,3,100.0
831,3/27/2018 21:15,120,110,95,325,3,100.0
832,3/27/2018 21:20,128,127,102,357,3,100.0
833,3/27/2018 21:25,112,109,76,297,3,100.0
834,3/27/2018 21:30,120,119,72,311,3,100.0
835,3/27/2018 21:35,110,110,71,291,3,100.0
836,3/27/2018 21:40,117,129,90,336,3,100.0
837,3/27/2018 21:45,107,110,82,299,3,100.0
838,3/27/2018 21:50,126,108,75,309,3,100.0
839,3/27/2018 21:55,120,96,64,280,3,100.0
840,3/27/2018 22:00,101,100,82,283,3,100.0
841,3/27/2018 22:05,120,112,68,300,3,100.0
842,3/27/2018 22:10,110,98,65,273,3,100.0
843,3/27/2018 22:15,101,90,72,263,3,100.0
844,3/27/2018 22:20,123,114,79,316,3,100.0
845,3/27/2018 22:25,104,93,74,271,3,100.0
846,3/27/2018 22:30,94,104,70,268,3,100.0
847,3/27/2018 22:35,92,91,52,235,3,100.0
848,3/27/2018 22:40,100,95,73,268,3,100.0
849,3/27/2018 22:45,80,80,50,210,3,100.0
850,3/27/2018 22:50,68,84,51,203,3,100.0
851,3/27/2018 22:55,83,74,48,205,3,100.0
852,3/27/2018 23:00,82,66,43,191,3,100.0
853,3/27/2018 23:05,55,63,41,159,3,100.0
854,3/27/2018 23:10,73,65,44,182,3,100.0
855,3/27/2018 23:15,69,66,53,188,3,100.0
856,3/27/2018 23:20,58,61,46,165,3,100.0
857,3/27/2018 23:25,67,80,48,195,3,100.0
858,3/27/2018 23:30,61,54,50,165,3,100.0
859,3/27/2018 23:35,53,53,33,139,3,100.0
860,3/27/2018 23:40,54,68,41,163,3,100.0
861,3/27/2018 23:45,57,66,47,170,3,100.0
862,3/27/2018 23:50,54,50,34,138,3,100.0
863,3/27/2018 23:55,44,45,29,118,3,100.0
864,3/28/2018 0:00,50,47,32,129,3,100.0
865,3/28/2018 0:05,33,53,28,114,3,100.0
866,3/28/2018 0:10,38,50,30,118,3,100.0
867,3/28/2018 0:15,37,46,46,129,3,100.0
868,3/28/2018 0:20,34,44,27,105,3,100.0
869,3/28/2018 0:25,35,54,31,120,3,100.0
870,3/28/2018 0:30,42,41,29,112,3,100.0
871,3/28/2018 0:35,25,18,19,62,3,100.0
872,3/28/2018 0:40,34,41,23,98,3,100.0
873,3/28/2018 0:45,34,43,34,111,3,100.0
874,3/28/2018 0:50,28,35,26,89,3,100.0
875,3/28/2018 0:55,31,39,20,90,3,100.0
876,3/28/2018 1:00,21,39,20,80,3,100.0
877,3/28/2018 1:05,18,26,14,58,3,100.0
878,3/28/2018 1:10,26,28,28,82,3,100.0
879,3/28/2018 1:15,27,29,29,85,3,100.0
880,3/28/2018 1:20,19,25,15,59,3,100.0
881,3/28/2018 1:25,18,21,25,64,3,100.0
882,3/28/2018 1:30,19,32,25,76,3,100.0
883,3/28/2018 1:35,15,23,22,60,3,100.0
884,3/28/2018 1:40,13,29,18,60,3,100.0
885,3/28/2018 1:45,13,32,18,63,3,100.0
886,3/28/2018 1:50,27,26,22,75,3,100.0
887,3/28/2018 1:55,17,23,16,56,3,100.0
888,3/28/2018 2:00,15,21,14,50,3,100.0
889,3/28/2018 2:05,11,18,21,50,3,100.0
890,3/28/2018 2:10,14,23,16,53,3,100.0
891,3/28/2018 2:15,19,19,26,64,3,100.0
892,3/28/2018 2:20,16,25,17,58,3,100.0
893,3/28/2018 2:25,14,21,13,48,3,100.0
894,3/28/2018 2:30,16,19,19,54,3,100.0
895,3/28/2018 2:35,11,28,18,57,3,100.0
896,3/28/2018 2:40,13,17,15,45,3,100.0
897,3/28/2018 2:45,12,23,24,59,3,100.0
898,3/28/2018 2:50,10,15,18,43,3,100.0
899,3/28/2018 2:55,9,12,12,33,3,100.0
900,3/28/2018 3:00,6,10,11,27,3,100.0
901,3/28/2018 3:05,10,16,16,42,3,100.0
902,3/28/2018 3:10,7,14,11,32,3,100.0
903,3/28/2018 3:15,14,20,12,46,3,100.0
904,3/28/2018 3:20,15,27,22,64,3,100.0
905,3/28/2018 3:25,13,21,12,46,3,100.0
906,3/28/2018 3:30,12,24,14,50,3,100.0
907,3/28/2018 3:35,12,23,24,59,3,100.0
908,3/28/2018 3:40,13,19,18,50,3,100.0
909,3/28/2018 3:45,11,23,20,54,3,100.0
910,3/28/2018 3:50,17,18,17,52,3,100.0
911,3/28/2018 3:55,19,21,23,63,3,100.0
912,3/28/2018 4:00,17,38,18,73,3,100.0
913,3/28/2018 4:05,11,19,16,46,3,100.0
914,3/28/2018 4:10,20,27,15,62,3,100.0
915,3/28/2018 4:15,27,29,21,77,3,100.0
916,3/28/2018 4:20,29,37,30,96,3,100.0
917,3/28/2018 4:25,25,24,21,70,3,100.0
918,3/28/2018 4:30,38,39,29,106,3,100.0
919,3/28/2018 4:35,27,46,32,105,3,100.0
920,3/28/2018 4:40,37,46,25,108,3,100.0
921,3/28/2018 4:45,42,47,39,128,3,100.0
922,3/28/2018 4:50,49,52,33,134,3,100.0
923,3/28/2018 4:55,38,58,40,136,3,100.0
924,3/28/2018 5:00,48,61,38,147,3,100.0
925,3/28/2018 5:05,70,62,35,167,3,100.0
926,3/28/2018 5:10,73,76,53,202,3,100.0
927,3/28/2018 5:15,95,82,48,225,3,100.0
928,3/28/2018 5:20,98,89,48,235,3,100.0
929,3/28/2018 5:25,99,92,47,238,3,100.0
930,3/28/2018 5:30,122,94,57,273,3,100.0
931,3/28/2018 5:35,119,111,55,285,3,100.0
932,3/28/2018 5:40,132,128,81,341,3,100.0
933,3/28/2018 5:45,144,128,78,350,3,100.0
934,3/28/2018 5:50,145,118,89,352,3,100.0
935,3/28/2018 5:55,138,114,63,315,3,100.0
936,3/28/2018 6:00,158,134,78,370,3,100.0
937,3/28/2018 6:05,165,126,67,358,3,100.0
938,3/28/2018 6:10,150,145,89,384,3,100.0
939,3/28/2018 6:15,116,96,68,280,3,100.0
940,3/28/2018 6:20,164,118,92,374,3,100.0
941,3/28/2018 6:25,156,138,97,391,3,100.0
942,3/28/2018 6:30,163,134,96,393,3,100.0
943,3/28/2018 6:35,166,141,88,395,3,100.0
944,3/28/2018 6:40,169,149,102,420,3,100.0
945,3/28/2018 6:45,180,147,114,441,3,100.0
946,3/28/2018 6:50,181,148,100,429,3,100.0
947,3/28/2018 6:55,179,147,97,423,3,100.0
948,3/28/2018 7:00,154,135,89,378,3,100.0
949,3/28/2018 7:05,149,145,108,402,3,100.0
950,3/28/2018 7:10,159,143,120,422,3,100.0
951,3/28/2018 7:15,177,161,119,457,3,100.0
952,3/28/2018 7:20,169,158,121,448,3,100.0
953,3/28/2018 7:25,181,159,135,475,3,100.0
954,3/28/2018 7:30,184,169,118,471,3,100.0
955,3/28/2018 7:35,170,150,123,443,3,100.0
956,3/28/2018 7:40,166,161,113,440,3,100.0
957,3/28/2018 7:45,175,169,148,492,3,100.0
958,3/28/2018 7:50,176,159,117,452,3,100.0
959,3/28/2018 7:55,182,167,113,462,3,100.0
960,3/28/2018 8:00,176,144,136,456,3,100.0
961,3/28/2018 8:05,173,155,113,441,3,100.0
962,3/28/2018 8:10,171,154,105,430,3,100.0
963,3/28/2018 8:15,172,139,117,428,3,100.0
964,3/28/2018 8:20,180,145,132,457,3,100.0
965,3/28/2018 8:25,174,133,118,425,3,100.0
966,3/28/2018 8:30,169,160,131,460,3,100.0
967,3/28/2018 8:35,186,171,131,488,3,100.0
968,3/28/2018 8:40,199,169,131,499,3,100.0
969,3/28/2018 8:45,187,148,119,454,3,100.0
970,3/28/2018 8:50,164,140,115,419,3,100.0
971,3/28/2018 8:55,188,155,102,445,3,100.0
972,3/28/2018 9:00,173,160,113,446,3,100.0
973,3/28/2018 9:05,161,132,96,389,3,100.0
974,3/28/2018 9:10,145,125,92,362,3,100.0
975,3/28/2018 9:15,152,137,102,391,3,100.0
976,3/28/2018 9:20,148,142,93,383,3,100.0
977,3/28/2018 9:25,165,145,112,422,3,100.0
978,3/28/2018 9:30,157,143,117,417,3,100.0
979,3/28/2018 9:35,164,156,113,433,3,100.0
980,3/28/2018 9:40,162,134,94,390,3,100.0
981,3/28/2018 9:45,176,140,104,420,3,100.0
982,3/28/2018 9:50,154,132,102,388,3,100.0
983,3/28/2018 9:55,158,135,94,387,3,100.0
984,3/28/2018 10:00,174,143,96,413,3,100.0
985,3/28/2018 10:05,167,149,103,419,3,100.0
986,3/28/2018 10:10,158,155,99,412,3,100.0
987,3/28/2018 10:15,171,148,99,418,3,100.0
988,3/28/2018 10:20,180,147,105,432,3,100.0
989,3/28/2018 10:25,190,145,124,459,3,100.0
990,3/28/2018 10:30,172,155,84,411,3,100.0
991,3/28/2018 10:35,169,144,114,427,3,100.0
992,3/28/2018 10:40,182,164,108,454,3,100.0
993,3/28/2018 10:45,173,147,115,435,3,100.0
994,3/28/2018 10:50,172,158,99,429,3,100.0
995,3/28/2018 10:55,174,146,112,432,3,100.0
996,3/28/2018 11:00,179,158,121,458,3,100.0
997,3/28/2018 11:05,158,149,112,419,3,100.0
998,3/28/2018 11:10,190,143,121,454,3,100.0
999,3/28/2018 11:15,159,156,108,423,3,100.0
1000,3/28/2018 11:20,169,157,103,429,3,100.0
1001,3/28/2018 11:25,167,154,119,440,3,100.0
1002,3/28/2018 11:30,176,156,109,441,3,100.0
1003,3/28/2018 11:35,168,163,96,427,3,100.0
1004,3/28/2018 11:40,155,153,97,405,3,100.0
1005,3/28/2018 11:45,156,143,109,408,3,100.0
1006,3/28/2018 11:50,169,157,126,452,3,100.0
1007,3/28/2018 11:55,166,150,111,427,3,100.0
1008,3/28/2018 12:00,168,153,103,424,3,100.0
1009,3/28/2018 12:05,143,156,110,409,3,100.0
1010,3/28/2018 12:10,189,157,129,475,3,100.0
1011,3/28/2018 12:15,188,159,121,468,3,100.0
1012,3/28/2018 12:20,176,168,124,468,3,100.0
1013,3/28/2018 12:25,171,166,112,449,3,100.0
1014,3/28/2018 12:30,187,164,134,485,3,100.0
1015,3/28/2018 12:35,182,167,126,475,3,100.0
1016,3/28/2018 12:40,180,163,122,465,3,100.0
1017,3/28/2018 12:45,191,164,116,471,3,100.0
1018,3/28/2018 12:50,178,145,124,447,3,100.0
1019,3/28/2018 12:55,180,167,114,461,3,100.0
1020,3/28/2018 13:00,183,148,132,463,3,100.0
1021,3/28/2018 13:05,177,169,125,471,3,100.0
1022,3/28/2018 13:10,170,153,115,438,3,100.0
1023,3/28/2018 13:15,169,168,133,470,3,100.0
1024,3/28/2018 13:20,184,165,117,466,3,100.0
1025,3/28/2018 13:25,163,160,124,447,3,100.0
1026,3/28/2018 13:30,178,172,133,483,3,100.0
1027,3/28/2018 13:35,165,165,143,473,3,100.0
1028,3/28/2018 13:40,184,158,146,488,3,100.0
1029,3/28/2018 13:45,175,175,139,489,3,100.0
1030,3/28/2018 13:50,183,168,146,497,3,100.0
1031,3/28/2018 13:55,174,162,126,462,3,100.0
1032,3/28/2018 14:00,162,169,120,451,3,100.0
1033,3/28/2018 14:05,169,166,137,472,3,100.0
1034,3/28/2018 14:10,181,186,131,498,3,100.0
1035,3/28/2018 14:15,154,147,135,436,3,100.0
1036,3/28/2018 14:20,163,148,129,440,3,100.0
1037,3/28/2018 14:25,162,152,134,448,3,100.0
1038,3/28/2018 14:30,148,132,119,399,3,100.0
1039,3/28/2018 14:35,166,165,133,464,3,100.0
1040,3/28/2018 14:40,156,158,134,448,3,100.0
1041,3/28/2018 14:45,165,147,139,451,3,100.0
1042,3/28/2018 14:50,151,146,147,444,3,100.0
1043,3/28/2018 14:55,162,149,136,447,3,100.0
1044,3/28/2018 15:00,157,149,141,447,3,100.0
1045,3/28/2018 15:05,154,147,141,442,3,100.0
1046,3/28/2018 15:10,157,141,131,429,3,100.0
1047,3/28/2018 15:15,146,143,133,422,3,100.0
1048,3/28/2018 15:20,157,148,135,440,3,100.0
1049,3/28/2018 15:25,152,157,142,451,3,100.0
1050,3/28/2018 15:30,167,156,142,465,3,100.0
1051,3/28/2018 15:35,160,164,149,473,3,100.0
1052,3/28/2018 15:40,150,130,129,409,3,100.0
1053,3/28/2018 15:45,155,149,138,442,3,100.0
1054,3/28/2018 15:50,138,132,135,405,3,100.0
1055,3/28/2018 15:55,126,125,121,372,3,100.0
1056,3/28/2018 16:00,132,133,122,387,3,100.0
1057,3/28/2018 16:05,152,142,130,424,3,100.0
1058,3/28/2018 16:10,151,143,130,424,3,100.0
1059,3/28/2018 16:15,152,139,136,427,3,100.0
1060,3/28/2018 16:20,148,140,134,422,3,100.0
1061,3/28/2018 16:25,100,102,117,319,3,100.0
1062,3/28/2018 16:30,129,138,139,406,3,100.0
1063,3/28/2018 16:35,145,141,139,425,3,100.0
1064,3/28/2018 16:40,144,133,133,410,3,100.0
1065,3/28/2018 16:45,153,141,140,434,3,100.0
1066,3/28/2018 16:50,141,140,136,417,3,100.0
1067,3/28/2018 16:55,146,143,143,432,3,100.0
1068,3/28/2018 17:00,135,127,126,388,3,100.0
1069,3/28/2018 17:05,148,141,131,420,3,100.0
1070,3/28/2018 17:10,115,118,113,346,3,100.0
1071,3/28/2018 17:15,149,134,139,422,3,100.0
1072,3/28/2018 17:20,157,148,149,454,3,100.0
1073,3/28/2018 17:25,112,111,104,327,3,100.0
1074,3/28/2018 17:30,140,131,133,404,3,100.0
1075,3/28/2018 17:35,138,130,131,399,3,100.0
1076,3/28/2018 17:40,148,145,140,433,3,100.0
1077,3/28/2018 17:45,152,144,127,423,3,100.0
1078,3/28/2018 17:50,121,115,117,353,3,100.0
1079,3/28/2018 17:55,117,104,104,325,3,100.0
1080,3/28/2018 18:00,144,153,144,441,3,100.0
1081,3/28/2018 18:05,122,121,120,363,3,100.0
1082,3/28/2018 18:10,110,100,100,310,3,100.0
1083,3/28/2018 18:15,121,126,129,376,3,100.0
1084,3/28/2018 18:20,96,98,100,294,3,100.0
1085,3/28/2018 18:25,128,137,119,384,3,100.0
1086,3/28/2018 18:30,150,133,136,419,3,100.0
1087,3/28/2018 18:35,151,158,134,443,3,100.0
1088,3/28/2018 18:40,158,139,146,443,3,100.0
1089,3/28/2018 18:45,146,147,145,438,3,100.0
1090,3/28/2018 18:50,153,144,144,441,3,100.0
1091,3/28/2018 18:55,142,138,126,406,3,100.0
1092,3/28/2018 19:00,149,151,133,433,3,100.0
1093,3/28/2018 19:05,158,146,137,441,3,100.0
1094,3/28/2018 19:10,148,137,124,409,3,100.0
1095,3/28/2018 19:15,143,136,128,407,3,100.0
1096,3/28/2018 19:20,156,146,137,439,3,100.0
1097,3/28/2018 19:25,156,148,132,436,3,100.0
1098,3/28/2018 19:30,144,135,137,416,3,100.0
1099,3/28/2018 19:35,154,139,127,420,3,100.0
1100,3/28/2018 19:40,143,135,132,410,3,100.0
1101,3/28/2018 19:45,155,140,146,441,3,100.0
1102,3/28/2018 19:50,153,137,128,418,3,100.0
1103,3/28/2018 19:55,147,147,128,422,3,100.0
1104,3/28/2018 20:00,145,135,128,408,3,100.0
1105,3/28/2018 20:05,153,140,136,429,3,100.0
1106,3/28/2018 20:10,151,143,133,427,3,100.0
1107,3/28/2018 20:15,162,144,142,448,3,100.0
1108,3/28/2018 20:20,149,148,142,439,3,100.0
1109,3/28/2018 20:25,151,150,137,438,3,100.0
1110,3/28/2018 20:30,150,137,109,396,3,100.0
1111,3/28/2018 20:35,159,147,111,417,3,100.0
1112,3/28/2018 20:40,145,136,102,383,3,100.0
1113,3/28/2018 20:45,156,141,120,417,3,100.0
1114,3/28/2018 20:50,162,154,116,432,3,100.0
1115,3/28/2018 20:55,158,139,111,408,3,100.0
1116,3/28/2018 21:00,148,137,104,389,3,100.0
1117,3/28/2018 21:05,150,150,110,410,3,100.0
1118,3/28/2018 21:10,171,146,101,418,3,100.0
1119,3/28/2018 21:15,143,120,97,360,3,100.0
1120,3/28/2018 21:20,136,119,98,353,3,100.0
1121,3/28/2018 21:25,145,118,101,364,3,100.0
1122,3/28/2018 21:30,158,124,104,386,3,100.0
1123,3/28/2018 21:35,109,115,75,299,3,100.0
1124,3/28/2018 21:40,114,110,77,301,3,100.0
1125,3/28/2018 21:45,131,118,93,342,3,100.0
1126,3/28/2018 21:50,126,120,84,330,3,100.0
1127,3/28/2018 21:55,108,109,80,297,3,100.0
1128,3/28/2018 22:00,111,98,71,280,3,100.0
1129,3/28/2018 22:05,132,125,80,337,3,100.0
1130,3/28/2018 22:10,105,107,79,291,3,100.0
1131,3/28/2018 22:15,139,134,107,380,3,100.0
1132,3/28/2018 22:20,122,119,84,325,3,100.0
1133,3/28/2018 22:25,125,109,87,321,3,100.0
1134,3/28/2018 22:30,122,102,83,307,3,100.0
1135,3/28/2018 22:35,106,104,49,259,3,100.0
1136,3/28/2018 22:40,110,91,65,266,3,100.0
1137,3/28/2018 22:45,83,94,52,229,3,100.0
1138,3/28/2018 22:50,83,90,53,226,3,100.0
1139,3/28/2018 22:55,92,87,57,236,3,100.0
1140,3/28/2018 23:00,77,81,49,207,3,100.0
1141,3/28/2018 23:05,80,64,53,197,3,100.0
1142,3/28/2018 23:10,72,76,51,199,3,100.0
1143,3/28/2018 23:15,77,80,60,217,3,100.0
1144,3/28/2018 23:20,70,72,47,189,3,100.0
1145,3/28/2018 23:25,75,71,48,194,3,100.0
1146,3/28/2018 23:30,70,61,32,163,3,100.0
1147,3/28/2018 23:35,62,73,43,178,3,100.0
1148,3/28/2018 23:40,67,67,47,181,3,100.0
1149,3/28/2018 23:45,73,80,45,198,3,100.0
1150,3/28/2018 23:50,50,60,38,148,3,100.0
1151,3/28/2018 23:55,57,57,31,145,3,100.0
1152,3/29/2018 0:00,47,51,28,126,3,100.0
1153,3/29/2018 0:05,45,53,42,140,3,100.0
1154,3/29/2018 0:10,55,61,41,157,3,100.0
1155,3/29/2018 0:15,48,47,37,132,3,100.0
1156,3/29/2018 0:20,43,46,26,115,3,100.0
1157,3/29/2018 0:25,39,38,29,106,3,100.0
1158,3/29/2018 0:30,27,37,25,89,3,100.0
1159,3/29/2018 0:35,30,29,30,89,3,100.0
1160,3/29/2018 0:40,38,41,27,106,3,100.0
1161,3/29/2018 0:45,32,50,28,110,3,100.0
1162,3/29/2018 0:50,20,28,15,63,3,100.0
1163,3/29/2018 0:55,39,49,31,119,3,100.0
1164,3/29/2018 1:00,32,28,20,80,3,100.0
1165,3/29/2018 1:05,23,33,23,79,3,100.0
1166,3/29/2018 1:10,30,39,27,96,3,100.0
1167,3/29/2018 1:15,19,38,26,83,3,100.0
1168,3/29/2018 1:20,18,31,22,71,3,100.0
1169,3/29/2018 1:25,23,21,17,61,3,100.0
1170,3/29/2018 1:30,24,38,19,81,3,100.0
1171,3/29/2018 1:35,26,33,20,79,3,100.0
1172,3/29/2018 1:40,19,26,20,65,3,100.0
1173,3/29/2018 1:45,17,30,21,68,3,100.0
1174,3/29/2018 1:50,25,33,22,80,3,100.0
1175,3/29/2018 1:55,26,30,18,74,3,100.0
1176,3/29/2018 2:00,14,14,10,38,3,100.0
1177,3/29/2018 2:05,11,17,12,40,3,100.0
1178,3/29/2018 2:10,24,15,18,57,3,100.0
1179,3/29/2018 2:15,24,23,20,67,3,100.0
1180,3/29/2018 2:20,17,19,16,52,3,100.0
1181,3/29/2018 2:25,21,27,20,68,3,100.0
1182,3/29/2018 2:30,14,14,19,47,3,100.0
1183,3/29/2018 2:35,11,10,18,39,3,100.0
1184,3/29/2018 2:40,9,21,17,47,3,100.0
1185,3/29/2018 2:45,6,17,13,36,3,100.0
1186,3/29/2018 2:50,13,32,18,63,3,100.0
1187,3/29/2018 2:55,8,18,18,44,3,100.0
1188,3/29/2018 3:00,10,17,9,36,3,100.0
1189,3/29/2018 3:05,4,17,15,36,3,100.0
1190,3/29/2018 3:10,10,20,13,43,3,100.0
1191,3/29/2018 3:15,8,19,16,43,3,100.0
1192,3/29/2018 3:20,11,23,14,48,3,100.0
1193,3/29/2018 3:25,19,21,17,57,3,100.0
1194,3/29/2018 3:30,13,17,13,43,3,100.0
1195,3/29/2018 3:35,14,21,16,51,3,100.0
1196,3/29/2018 3:40,13,19,12,44,3,100.0
1197,3/29/2018 3:45,13,27,22,62,3,100.0
1198,3/29/2018 3:50,19,28,17,64,3,100.0
1199,3/29/2018 3:55,17,25,18,60,3,100.0
1200,3/29/2018 4:00,10,24,15,49,3,100.0
1201,3/29/2018 4:05,21,24,17,62,3,100.0
1202,3/29/2018 4:10,13,23,18,54,3,100.0
1203,3/29/2018 4:15,30,34,23,87,3,100.0
1204,3/29/2018 4:20,27,39,23,89,3,100.0
1205,3/29/2018 4:25,37,47,23,107,3,100.0
1206,3/29/2018 4:30,40,42,30,112,3,100.0
1207,3/29/2018 4:35,35,38,25,98,3,100.0
1208,3/29/2018 4:40,35,35,45,115,3,100.0
1209,3/29/2018 4:45,37,53,30,120,3,100.0
1210,3/29/2018 4:50,55,48,42,145,3,100.0
1211,3/29/2018 4:55,47,40,36,123,3,100.0
1212,3/29/2018 5:00,56,46,42,144,3,100.0
1213,3/29/2018 5:05,52,62,48,162,3,100.0
1214,3/29/2018 5:10,67,73,43,183,3,100.0
1215,3/29/2018 5:15,78,80,42,200,3,100.0
1216,3/29/2018 5:20,90,91,55,236,3,100.0
1217,3/29/2018 5:25,90,76,52,218,3,100.0
1218,3/29/2018 5:30,119,107,59,285,3,100.0
1219,3/29/2018 5:35,122,104,75,301,3,100.0
1220,3/29/2018 5:40,118,98,77,293,3,100.0
1221,3/29/2018 5:45,141,123,77,341,3,100.0
1222,3/29/2018 5:50,137,103,86,326,3,100.0
1223,3/29/2018 5:55,163,123,80,366,3,100.0
1224,3/29/2018 6:00,134,100,66,300,3,100.0
1225,3/29/2018 6:05,154,106,76,336,3,100.0
1226,3/29/2018 6:10,156,126,74,356,3,100.0
1227,3/29/2018 6:15,132,145,75,352,3,100.0
1228,3/29/2018 6:20,168,148,85,401,3,100.0
1229,3/29/2018 6:25,156,139,86,381,3,100.0
1230,3/29/2018 6:30,169,153,91,413,3,100.0
1231,3/29/2018 6:35,177,149,104,430,3,100.0
1232,3/29/2018 6:40,175,144,104,423,3,100.0
1233,3/29/2018 6:45,191,155,105,451,3,100.0
1234,3/29/2018 6:50,191,161,108,460,3,100.0
1235,3/29/2018 6:55,176,143,99,418,3,100.0
1236,3/29/2018 7:00,173,149,112,434,3,100.0
1237,3/29/2018 7:05,186,150,101,437,3,100.0
1238,3/29/2018 7:10,176,160,105,441,3,100.0
1239,3/29/2018 7:15,186,156,126,468,3,100.0
1240,3/29/2018 7:20,200,149,107,456,3,100.0
1241,3/29/2018 7:25,192,162,123,477,3,100.0
1242,3/29/2018 7:30,197,180,139,516,3,100.0
1243,3/29/2018 7:35,186,171,121,478,3,100.0
1244,3/29/2018 7:40,191,173,124,488,3,100.0
1245,3/29/2018 7:45,196,168,129,493,3,100.0
1246,3/29/2018 7:50,202,191,129,522,3,100.0
1247,3/29/2018 7:55,199,154,110,463,3,100.0
1248,3/29/2018 8:00,189,158,126,473,3,100.0
1249,3/29/2018 8:05,167,150,106,423,3,100.0
1250,3/29/2018 8:10,201,179,129,509,3,100.0
1251,3/29/2018 8:15,207,169,121,497,3,100.0
1252,3/29/2018 8:20,194,163,114,471,3,100.0
1253,3/29/2018 8:25,189,157,117,463,3,100.0
1254,3/29/2018 8:30,181,156,106,443,3,100.0
1255,3/29/2018 8:35,187,152,114,453,3,100.0
1256,3/29/2018 8:40,150,135,93,378,3,100.0
1257,3/29/2018 8:45,176,166,121,463,3,100.0
1258,3/29/2018 8:50,173,150,120,443,3,100.0
1259,3/29/2018 8:55,184,145,100,429,3,100.0
1260,3/29/2018 9:00,183,156,98,437,3,100.0
1261,3/29/2018 9:05,184,154,118,456,3,100.0
1262,3/29/2018 9:10,165,144,83,392,3,100.0
1263,3/29/2018 9:15,158,128,104,390,3,100.0
1264,3/29/2018 9:20,178,154,103,435,3,100.0
1265,3/29/2018 9:25,156,142,105,403,3,100.0
1266,3/29/2018 9:30,150,144,107,401,3,100.0
1267,3/29/2018 9:35,169,156,91,416,3,100.0
1268,3/29/2018 9:40,156,154,101,411,3,100.0
1269,3/29/2018 9:45,151,139,86,376,3,100.0
1270,3/29/2018 9:50,180,146,118,444,3,100.0
1271,3/29/2018 9:55,168,162,112,442,3,100.0
1272,3/29/2018 10:00,172,155,106,433,3,100.0
1273,3/29/2018 10:05,171,153,107,431,3,100.0
1274,3/29/2018 10:10,168,138,110,416,3,100.0
1275,3/29/2018 10:15,170,144,105,419,3,100.0
1276,3/29/2018 10:20,169,159,113,441,3,100.0
1277,3/29/2018 10:25,171,148,101,420,3,100.0
1278,3/29/2018 10:30,157,149,81,387,3,100.0
1279,3/29/2018 10:35,183,156,112,451,3,100.0
1280,3/29/2018 10:40,182,153,102,437,3,100.0
1281,3/29/2018 10:45,170,161,120,451,3,100.0
1282,3/29/2018 10:50,189,165,118,472,3,100.0
1283,3/29/2018 10:55,177,166,109,452,3,100.0
1284,3/29/2018 11:00,162,143,98,403,3,100.0
1285,3/29/2018 11:05,157,145,101,403,3,100.0
1286,3/29/2018 11:10,178,173,117,468,3,100.0
1287,3/29/2018 11:15,150,133,96,379,3,100.0
1288,3/29/2018 11:20,157,166,113,436,3,100.0
1289,3/29/2018 11:25,177,147,123,447,3,100.0
1290,3/29/2018 11:30,165,167,109,441,3,100.0
1291,3/29/2018 11:35,175,165,123,463,3,100.0
1292,3/29/2018 11:40,149,146,117,412,3,100.0
1293,3/29/2018 11:45,163,159,114,436,3,100.0
1294,3/29/2018 11:50,183,167,132,482,3,100.0
1295,3/29/2018 11:55,161,160,126,447,3,100.0
1296,3/29/2018 12:00,143,135,106,384,3,100.0
1297,3/29/2018 12:05,136,129,95,360,3,100.0
1298,3/29/2018 12:10,171,158,120,449,3,100.0
1299,3/29/2018 12:15,175,165,124,464,3,100.0
1300,3/29/2018 12:20,181,160,129,470,3,100.0
1301,3/29/2018 12:25,170,176,113,459,3,100.0
1302,3/29/2018 12:30,172,154,115,441,3,100.0
1303,3/29/2018 12:35,164,147,109,420,3,100.0
1304,3/29/2018 12:40,162,153,111,426,3,100.0
1305,3/29/2018 12:45,177,146,131,454,3,100.0
1306,3/29/2018 12:50,146,136,124,406,3,100.0
1307,3/29/2018 12:55,169,166,141,476,3,100.0
1308,3/29/2018 13:00,166,165,138,469,3,100.0
1309,3/29/2018 13:05,170,162,134,466,3,100.0
1310,3/29/2018 13:10,149,139,128,416,3,100.0
1311,3/29/2018 13:15,178,167,121,466,3,100.0
1312,3/29/2018 13:20,177,165,145,487,3,100.0
1313,3/29/2018 13:25,168,173,144,485,3,100.0
1314,3/29/2018 13:30,152,153,141,446,3,100.0
1315,3/29/2018 13:35,162,155,129,446,3,100.0
1316,3/29/2018 13:40,159,151,132,442,3,100.0
1317,3/29/2018 13:45,159,151,133,443,3,100.0
1318,3/29/2018 13:50,147,146,126,419,3,100.0
1319,3/29/2018 13:55,138,128,120,386,3,100.0
1320,3/29/2018 14:00,152,145,124,421,3,100.0
1321,3/29/2018 14:05,168,164,128,460,3,100.0
1322,3/29/2018 14:10,162,151,140,453,3,100.0
1323,3/29/2018 14:15,158,158,141,457,3,100.0
1324,3/29/2018 14:20,163,154,148,465,3,100.0
1325,3/29/2018 14:25,147,133,123,403,3,100.0
1326,3/29/2018 14:30,158,143,127,428,3,100.0
1327,3/29/2018 14:35,168,139,141,448,3,100.0
1328,3/29/2018 14:40,166,159,147,472,3,100.0
1329,3/29/2018 14:45,133,139,129,401,3,100.0
1330,3/29/2018 14:50,148,134,126,408,3,100.0
1331,3/29/2018 14:55,150,134,126,410,3,100.0
1332,3/29/2018 15:00,163,161,139,463,3,100.0
1333,3/29/2018 15:05,153,146,132,431,3,100.0
1334,3/29/2018 15:10,129,125,126,380,3,100.0
1335,3/29/2018 15:15,141,140,134,415,3,100.0
1336,3/29/2018 15:20,128,135,124,387,3,100.0
1337,3/29/2018 15:25,151,141,124,416,3,100.0
1338,3/29/2018 15:30,165,161,148,474,3,100.0
1339,3/29/2018 15:35,139,146,124,409,3,100.0
1340,3/29/2018 15:40,150,146,135,431,3,100.0
1341,3/29/2018 15:45,127,127,113,367,3,100.0
1342,3/29/2018 15:50,128,127,123,378,3,100.0
1343,3/29/2018 15:55,137,126,124,387,3,100.0
1344,3/29/2018 16:00,112,116,116,344,3,100.0
1345,3/29/2018 16:05,131,141,127,399,3,100.0
1346,3/29/2018 16:10,122,133,130,385,3,100.0
1347,3/29/2018 16:15,103,107,95,305,3,100.0
1348,3/29/2018 16:20,132,134,119,385,3,100.0
1349,3/29/2018 16:25,115,120,124,359,3,100.0
1350,3/29/2018 16:30,108,102,111,321,3,100.0
1351,3/29/2018 16:35,118,120,111,349,3,100.0
1352,3/29/2018 16:40,134,132,123,389,3,100.0
1353,3/29/2018 16:45,121,119,120,360,3,100.0
1354,3/29/2018 16:50,118,119,122,359,3,100.0
1355,3/29/2018 16:55,113,112,112,337,3,100.0
1356,3/29/2018 17:00,126,122,118,366,3,100.0
1357,3/29/2018 17:05,128,129,124,381,3,100.0
1358,3/29/2018 17:10,127,116,128,371,3,100.0
1359,3/29/2018 17:15,108,114,121,343,3,100.0
1360,3/29/2018 17:20,109,108,114,331,3,100.0
1361,3/29/2018 17:25,133,127,127,387,3,100.0
1362,3/29/2018 17:30,132,125,131,388,3,100.0
1363,3/29/2018 17:35,122,118,112,352,3,100.0
1364,3/29/2018 17:40,132,122,120,374,3,100.0
1365,3/29/2018 17:45,127,125,127,379,3,100.0
1366,3/29/2018 17:50,154,147,134,435,3,0.0
1367,3/29/2018 17:55,143,140,131,414,3,0.0
1368,3/29/2018 18:00,146,146,136,428,3,0.0
1369,3/29/2018 18:05,156,148,139,443,3,0.0
1370,3/29/2018 18:10,153,144,132,429,3,0.0
1371,3/29/2018 18:15,155,148,138,441,3,0.0
1372,3/29/2018 18:20,155,152,137,444,3,0.0
1373,3/29/2018 18:25,150,145,135,430,3,0.0
1374,3/29/2018 18:30,156,145,134,435,3,0.0
1375,3/29/2018 18:35,152,151,138,441,3,0.0
1376,3/29/2018 18:40,155,145,133,433,3,0.0
1377,3/29/2018 18:45,151,143,130,424,3,0.0
1378,3/29/2018 18:50,150,143,129,422,3,0.0
1379,3/29/2018 18:55,153,152,127,432,3,0.0
1380,3/29/2018 19:00,163,152,126,441,3,0.0
1381,3/29/2018 19:05,162,147,125,434,3,0.0
1382,3/29/2018 19:10,146,144,128,418,3,0.0
1383,3/29/2018 19:15,158,141,132,431,3,0.0
1384,3/29/2018 19:20,146,143,133,422,3,0.0
1385,3/29/2018 19:25,155,138,127,420,3,0.0
1386,3/29/2018 19:30,148,143,127,418,3,0.0
1387,3/29/2018 19:35,154,142,130,426,3,0.0
1388,3/29/2018 19:40,145,143,131,419,3,0.0
1389,3/29/2018 19:45,155,147,130,432,3,0.0
1390,3/29/2018 19:50,153,146,126,425,3,0.0
1391,3/29/2018 19:55,147,133,120,400,3,0.0
1392,3/29/2018 20:00,147,136,121,404,3,0.0
1393,3/29/2018 20:05,155,143,126,424,3,0.0
1394,3/29/2018 20:10,147,141,117,405,3,0.0
1395,3/29/2018 20:15,144,125,113,382,3,0.0
1396,3/29/2018 20:20,146,152,133,431,3,0.0
1397,3/29/2018 20:25,159,145,132,436,3,0.0
1398,3/29/2018 20:30,146,139,122,407,3,0.0
1399,3/29/2018 20:35,135,127,121,383,3,0.0
1400,3/29/2018 20:40,150,149,133,432,3,100.0
1401,3/29/2018 20:45,156,144,126,426,3,100.0
1402,3/29/2018 20:50,162,152,129,443,3,100.0
1403,3/29/2018 20:55,160,140,118,418,3,100.0
1404,3/29/2018 21:00,158,146,121,425,3,100.0
1405,3/29/2018 21:05,162,152,112,426,3,100.0
1406,3/29/2018 21:10,162,157,133,452,3,100.0
1407,3/29/2018 21:15,164,144,114,422,3,100.0
1408,3/29/2018 21:20,156,156,104,416,3,100.0
1409,3/29/2018 21:25,156,152,127,435,3,100.0
1410,3/29/2018 21:30,154,138,100,392,3,100.0
1411,3/29/2018 21:35,152,138,99,389,3,100.0
1412,3/29/2018 21:40,143,124,96,363,3,100.0
1413,3/29/2018 21:45,127,116,94,337,3,100.0
1414,3/29/2018 21:50,125,127,87,339,3,100.0
1415,3/29/2018 21:55,138,128,77,343,3,100.0
1416,3/29/2018 22:00,128,121,98,347,3,100.0
1417,3/29/2018 22:05,127,116,93,336,3,100.0
1418,3/29/2018 22:10,131,128,101,360,3,100.0
1419,3/29/2018 22:15,134,120,81,335,3,100.0
1420,3/29/2018 22:20,111,99,80,290,3,100.0
1421,3/29/2018 22:25,138,124,94,356,3,100.0
1422,3/29/2018 22:30,128,117,81,326,3,100.0
1423,3/29/2018 22:35,113,98,69,280,3,100.0
1424,3/29/2018 22:40,110,101,69,280,3,100.0
1425,3/29/2018 22:45,101,114,75,290,3,100.0
1426,3/29/2018 22:50,115,117,93,325,3,100.0
1427,3/29/2018 22:55,102,96,60,258,3,100.0
1428,3/29/2018 23:00,93,106,77,276,3,100.0
1429,3/29/2018 23:05,98,95,60,253,3,100.0
1430,3/29/2018 23:10,99,94,66,259,3,100.0
1431,3/29/2018 23:15,94,91,67,252,3,100.0
1432,3/29/2018 23:20,94,86,61,241,3,100.0
1433,3/29/2018 23:25,93,82,56,231,3,100.0
1434,3/29/2018 23:30,78,72,51,201,3,100.0
1435,3/29/2018 23:35,75,83,49,207,3,100.0
1436,3/29/2018 23:40,89,78,45,212,3,100.0
1437,3/29/2018 23:45,83,87,47,217,3,100.0
1438,3/29/2018 23:50,68,67,51,186,3,100.0
1439,3/29/2018 23:55,61,65,48,174,3,100.0
1440,3/30/2018 0:00,68,68,45,181,3,100.0
1441,3/30/2018 0:05,66,69,44,179,3,100.0
1442,3/30/2018 0:10,51,62,44,157,3,100.0
1443,3/30/2018 0:15,82,83,52,217,3,100.0
1444,3/30/2018 0:20,64,58,41,163,3,100.0
1445,3/30/2018 0:25,55,67,37,159,3,100.0
1446,3/30/2018 0:30,47,52,30,129,3,100.0
1447,3/30/2018 0:35,56,56,37,149,3,100.0
1448,3/30/2018 0:40,53,54,29,136,3,100.0
1449,3/30/2018 0:45,49,56,34,139,3,100.0
1450,3/30/2018 0:50,40,38,27,105,3,100.0
1451,3/30/2018 0:55,43,47,20,110,3,100.0
1452,3/30/2018 1:00,30,35,25,90,3,100.0
1453,3/30/2018 1:05,31,53,28,112,3,100.0
1454,3/30/2018 1:10,41,45,27,113,3,100.0
1455,3/30/2018 1:15,39,42,32,113,3,100.0
1456,3/30/2018 1:20,40,48,24,112,3,100.0
1457,3/30/2018 1:25,40,33,17,90,3,100.0
1458,3/30/2018 1:30,25,31,16,72,3,100.0
1459,3/30/2018 1:35,34,41,26,101,3,100.0
1460,3/30/2018 1:40,23,38,22,83,3,100.0
1461,3/30/2018 1:45,34,46,23,103,3,100.0
1462,3/30/2018 1:50,31,23,21,75,3,100.0
1463,3/30/2018 1:55,27,31,21,79,3,100.0
1464,3/30/2018 2:00,22,20,20,62,3,100.0
1465,3/30/2018 2:05,16,33,16,65,3,100.0
1466,3/30/2018 2:10,21,35,22,78,3,100.0
1467,3/30/2018 2:15,21,33,26,80,3,100.0
1468,3/30/2018 2:20,20,35,20,75,3,100.0
1469,3/30/2018 2:25,24,36,19,79,3,100.0
1470,3/30/2018 2:30,21,36,22,79,3,100.0
1471,3/30/2018 2:35,19,23,23,65,3,100.0
1472,3/30/2018 2:40,21,19,13,53,3,100.0
1473,3/30/2018 2:45,9,21,25,55,3,100.0
1474,3/30/2018 2:50,20,30,22,72,3,100.0
1475,3/30/2018 2:55,19,29,18,66,3,100.0
1476,3/30/2018 3:00,12,28,14,54,3,100.0
1477,3/30/2018 3:05,14,23,18,55,3,100.0
1478,3/30/2018 3:10,15,25,19,59,3,100.0
1479,3/30/2018 3:15,17,27,15,59,3,100.0
1480,3/30/2018 3:20,14,25,18,57,3,100.0
1481,3/30/2018 3:25,10,29,15,54,3,100.0
1482,3/30/2018 3:30,23,28,14,65,3,100.0
1483,3/30/2018 3:35,22,24,22,68,3,100.0
1484,3/30/2018 3:40,12,19,16,47,3,100.0
1485,3/30/2018 3:45,23,29,19,71,3,100.0
1486,3/30/2018 3:50,17,30,16,63,3,100.0
1487,3/30/2018 3:55,14,23,19,56,3,100.0
1488,3/30/2018 4:00,18,22,20,60,3,100.0
1489,3/30/2018 4:05,17,27,21,65,3,100.0
1490,3/30/2018 4:10,18,25,19,62,3,100.0
1491,3/30/2018 4:15,29,29,23,81,3,100.0
1492,3/30/2018 4:20,37,41,29,107,3,100.0
1493,3/30/2018 4:25,37,37,32,106,3,100.0
1494,3/30/2018 4:30,43,36,28,107,3,100.0
1495,3/30/2018 4:35,37,49,27,113,3,100.0
1496,3/30/2018 4:40,46,54,31,131,3,100.0
1497,3/30/2018 4:45,40,42,39,121,3,100.0
1498,3/30/2018 4:50,43,57,30,130,3,100.0
1499,3/30/2018 4:55,50,39,39,128,3,100.0
1500,3/30/2018 5:00,35,58,32,125,3,100.0
1501,3/30/2018 5:05,48,58,43,149,3,100.0
1502,3/30/2018 5:10,73,64,40,177,3,100.0
1503,3/30/2018 5:15,86,78,51,215,3,100.0
1504,3/30/2018 5:20,87,78,45,210,3,100.0
1505,3/30/2018 5:25,88,86,40,214,3,100.0
1506,3/30/2018 5:30,110,92,51,253,3,100.0
1507,3/30/2018 5:35,98,85,58,241,3,100.0
1508,3/30/2018 5:40,108,99,74,281,3,100.0
1509,3/30/2018 5:45,118,100,74,292,3,100.0
1510,3/30/2018 5:50,130,105,70,305,3,100.0
1511,3/30/2018 5:55,114,110,61,285,3,100.0
1512,3/30/2018 6:00,130,110,69,309,3,100.0
1513,3/30/2018 6:05,128,110,60,298,3,100.0
1514,3/30/2018 6:10,124,118,76,318,3,100.0
1515,3/30/2018 6:15,118,117,72,307,3,100.0
1516,3/30/2018 6:20,143,125,80,348,3,100.0
1517,3/30/2018 6:25,154,118,75,347,3,100.0
1518,3/30/2018 6:30,136,125,83,344,3,100.0
1519,3/30/2018 6:35,143,129,81,353,3,100.0
1520,3/30/2018 6:40,152,138,92,382,3,100.0
1521,3/30/2018 6:45,170,139,90,399,3,100.0
1522,3/30/2018 6:50,163,131,108,402,3,100.0
1523,3/30/2018 6:55,137,119,94,350,3,100.0
1524,3/30/2018 7:00,185,140,99,424,3,100.0
1525,3/30/2018 7:05,165,130,97,392,3,100.0
1526,3/30/2018 7:10,157,147,81,385,3,100.0
1527,3/30/2018 7:15,147,128,91,366,3,100.0
1528,3/30/2018 7:20,158,140,96,394,3,100.0
1529,3/30/2018 7:25,169,149,104,422,3,100.0
1530,3/30/2018 7:30,152,135,96,383,3,100.0
1531,3/30/2018 7:35,153,148,112,413,3,100.0
1532,3/30/2018 7:40,171,142,105,418,3,100.0
1533,3/30/2018 7:45,178,167,115,460,3,100.0
1534,3/30/2018 7:50,176,172,128,476,3,100.0
1535,3/30/2018 7:55,165,147,110,422,3,100.0
1536,3/30/2018 8:00,160,145,94,399,3,100.0
1537,3/30/2018 8:05,164,163,101,428,3,100.0
1538,3/30/2018 8:10,145,155,84,384,3,100.0
1539,3/30/2018 8:15,145,118,87,350,3,100.0
1540,3/30/2018 8:20,167,150,89,406,3,100.0
1541,3/30/2018 8:25,163,150,109,422,3,100.0
1542,3/30/2018 8:30,170,149,103,422,3,100.0
1543,3/30/2018 8:35,169,139,101,409,3,100.0
1544,3/30/2018 8:40,163,157,111,431,3,100.0
1545,3/30/2018 8:45,166,155,99,420,3,100.0
1546,3/30/2018 8:50,188,140,95,423,3,100.0
1547,3/30/2018 8:55,174,140,90,404,3,100.0
1548,3/30/2018 9:00,164,141,98,403,3,100.0
1549,3/30/2018 9:05,136,156,87,379,3,100.0
1550,3/30/2018 9:10,142,118,93,353,3,100.0
1551,3/30/2018 9:15,169,139,96,404,3,100.0
1552,3/30/2018 9:20,173,149,99,421,3,100.0
1553,3/30/2018 9:25,168,160,93,421,3,100.0
1554,3/30/2018 9:30,179,149,92,420,3,100.0
1555,3/30/2018 9:35,183,159,101,443,3,100.0
1556,3/30/2018 9:40,147,129,92,368,3,100.0
1557,3/30/2018 9:45,137,134,103,374,3,100.0
1558,3/30/2018 9:50,144,138,115,397,3,100.0
1559,3/30/2018 9:55,171,147,118,436,3,100.0
1560,3/30/2018 10:00,159,154,90,403,3,100.0
1561,3/30/2018 10:05,161,153,99,413,3,100.0
1562,3/30/2018 10:10,151,138,109,398,3,100.0
1563,3/30/2018 10:15,161,144,108,413,3,100.0
1564,3/30/2018 10:20,154,153,98,405,3,100.0
1565,3/30/2018 10:25,171,144,105,420,3,100.0
1566,3/30/2018 10:30,162,144,108,414,3,100.0
1567,3/30/2018 10:35,164,154,115,433,3,100.0
1568,3/30/2018 10:40,165,146,94,405,3,100.0
1569,3/30/2018 10:45,176,163,104,443,3,100.0
1570,3/30/2018 10:50,169,154,105,428,3,100.0
1571,3/30/2018 10:55,177,159,119,455,3,100.0
1572,3/30/2018 11:00,181,178,110,469,3,100.0
1573,3/30/2018 11:05,184,166,124,474,3,100.0
1574,3/30/2018 11:10,169,154,111,434,3,100.0
1575,3/30/2018 11:15,177,158,133,468,3,100.0
1576,3/30/2018 11:20,197,170,131,498,3,100.0
1577,3/30/2018 11:25,168,158,118,444,3,100.0
1578,3/30/2018 11:30,193,175,133,501,3,100.0
1579,3/30/2018 11:35,170,171,118,459,3,100.0
1580,3/30/2018 11:40,183,168,119,470,3,100.0
1581,3/30/2018 11:45,181,162,131,474,3,100.0
1582,3/30/2018 11:50,135,127,101,363,3,100.0
1583,3/30/2018 11:55,183,164,134,481,3,100.0
1584,3/30/2018 12:00,185,167,115,467,3,100.0
1585,3/30/2018 12:05,173,160,142,475,3,100.0
1586,3/30/2018 12:10,174,153,126,453,3,100.0
1587,3/30/2018 12:15,187,164,126,477,3,100.0
1588,3/30/2018 12:20,162,154,111,427,3,100.0
1589,3/30/2018 12:25,175,152,119,446,3,100.0
1590,3/30/2018 12:30,178,156,128,462,3,100.0
1591,3/30/2018 12:35,165,154,123,442,3,100.0
1592,3/30/2018 12:40,178,152,116,446,3,100.0
1593,3/30/2018 12:45,169,161,125,455,3,100.0
1594,3/30/2018 12:50,171,165,131,467,3,100.0
1595,3/30/2018 12:55,173,167,140,480,3,100.0
1596,3/30/2018 13:00,152,156,126,434,3,100.0
1597,3/30/2018 13:05,167,145,144,456,3,100.0
1598,3/30/2018 13:10,167,158,143,468,3,100.0
1599,3/30/2018 13:15,170,164,156,490,3,100.0
1600,3/30/2018 13:20,166,165,135,466,3,100.0
1601,3/30/2018 13:25,168,166,141,475,3,100.0
1602,3/30/2018 13:30,126,142,123,391,3,100.0
1603,3/30/2018 13:35,149,139,125,413,3,100.0
1604,3/30/2018 13:40,116,126,114,356,3,100.0
1605,3/30/2018 13:45,148,150,137,435,3,100.0
1606,3/30/2018 13:50,160,147,124,431,3,100.0
1607,3/30/2018 13:55,170,172,157,499,3,100.0
1608,3/30/2018 14:00,142,145,130,417,3,100.0
1609,3/30/2018 14:05,168,153,137,458,3,100.0
1610,3/30/2018 14:10,159,158,140,457,3,100.0
1611,3/30/2018 14:15,158,158,133,449,3,100.0
1612,3/30/2018 14:20,139,124,133,396,3,100.0
1613,3/30/2018 14:25,134,129,131,394,3,100.0
1614,3/30/2018 14:30,159,140,142,441,3,100.0
1615,3/30/2018 14:35,145,137,143,425,3,100.0
1616,3/30/2018 14:40,132,137,127,396,3,100.0
1617,3/30/2018 14:45,131,132,127,390,3,100.0
1618,3/30/2018 14:50,137,142,129,408,3,100.0
1619,3/30/2018 14:55,144,133,126,403,3,100.0
1620,3/30/2018 15:00,146,151,133,430,3,100.0
1621,3/30/2018 15:05,146,132,136,414,3,100.0
1622,3/30/2018 15:10,155,153,135,443,3,100.0
1623,3/30/2018 15:15,138,136,126,400,3,100.0
1624,3/30/2018 15:20,121,123,119,363,3,100.0
1625,3/30/2018 15:25,131,130,128,389,3,100.0
1626,3/30/2018 15:30,145,141,129,415,3,100.0
1627,3/30/2018 15:35,141,132,132,405,3,100.0
1628,3/30/2018 15:40,151,140,136,427,3,100.0
1629,3/30/2018 15:45,143,136,130,409,3,100.0
1630,3/30/2018 15:50,143,134,128,405,3,100.0
1631,3/30/2018 15:55,131,140,136,407,3,100.0
1632,3/30/2018 16:00,159,153,140,452,3,100.0
1633,3/30/2018 16:05,113,109,116,338,3,100.0
1634,3/30/2018 16:10,153,144,144,441,3,100.0
1635,3/30/2018 16:15,149,146,128,423,3,100.0
1636,3/30/2018 16:20,131,138,124,393,3,100.0
1637,3/30/2018 16:25,131,131,135,397,3,100.0
1638,3/30/2018 16:30,130,135,129,394,3,100.0
1639,3/30/2018 16:35,130,131,123,384,3,100.0
1640,3/30/2018 16:40,117,108,120,345,3,100.0
1641,3/30/2018 16:45,120,131,125,376,3,100.0
1642,3/30/2018 16:50,144,141,135,420,3,100.0
1643,3/30/2018 16:55,147,139,137,423,3,100.0
1644,3/30/2018 17:00,158,140,131,429,3,100.0
1645,3/30/2018 17:05,145,134,128,407,3,100.0
1646,3/30/2018 17:10,154,134,140,428,3,100.0
1647,3/30/2018 17:15,151,153,139,443,3,100.0
1648,3/30/2018 17:20,150,136,138,424,3,100.0
1649,3/30/2018 17:25,132,127,125,384,3,100.0
1650,3/30/2018 17:30,138,143,121,402,3,100.0
1651,3/30/2018 17:35,142,134,128,404,3,100.0
1652,3/30/2018 17:40,140,125,137,402,3,100.0
1653,3/30/2018 17:45,144,139,142,425,3,100.0
1654,3/30/2018 17:50,166,156,143,465,3,100.0
1655,3/30/2018 17:55,128,128,133,389,3,100.0
1656,3/30/2018 18:00,146,149,138,433,3,100.0
1657,3/30/2018 18:05,151,153,136,440,3,100.0
1658,3/30/2018 18:10,168,171,156,495,3,100.0
1659,3/30/2018 18:15,152,141,132,425,3,100.0
1660,3/30/2018 18:20,164,162,153,479,3,100.0
1661,3/30/2018 18:25,171,165,164,500,3,100.0
1662,3/30/2018 18:30,166,152,143,461,3,100.0
1663,3/30/2018 18:35,164,154,146,464,3,100.0
1664,3/30/2018 18:40,148,149,144,441,3,100.0
1665,3/30/2018 18:45,163,154,131,448,3,100.0
1666,3/30/2018 18:50,154,157,126,437,3,100.0
1667,3/30/2018 18:55,156,157,113,426,3,100.0
1668,3/30/2018 19:00,154,147,133,434,3,100.0
1669,3/30/2018 19:05,166,143,126,435,3,100.0
1670,3/30/2018 19:10,169,155,125,449,3,100.0
1671,3/30/2018 19:15,158,147,114,419,3,100.0
1672,3/30/2018 19:20,146,141,125,412,3,100.0
1673,3/30/2018 19:25,167,138,103,408,3,100.0
1674,3/30/2018 19:30,163,132,113,408,3,100.0
1675,3/30/2018 19:35,160,149,112,421,3,100.0
1676,3/30/2018 19:40,162,151,106,419,3,100.0
1677,3/30/2018 19:45,165,133,106,404,3,100.0
1678,3/30/2018 19:50,146,126,100,372,3,100.0
1679,3/30/2018 19:55,166,137,98,401,3,100.0
1680,3/30/2018 20:00,137,129,113,379,3,100.0
1681,3/30/2018 20:05,146,133,108,387,3,100.0
1682,3/30/2018 20:10,144,138,95,377,3,100.0
1683,3/30/2018 20:15,148,126,104,378,3,100.0
1684,3/30/2018 20:20,134,122,104,360,3,100.0
1685,3/30/2018 20:25,167,153,130,450,3,100.0
1686,3/30/2018 20:30,137,133,108,378,3,100.0
1687,3/30/2018 20:35,140,132,94,366,3,100.0
1688,3/30/2018 20:40,154,114,99,367,3,100.0
1689,3/30/2018 20:45,143,123,112,378,3,100.0
1690,3/30/2018 20:50,135,123,98,356,3,100.0
1691,3/30/2018 20:55,132,130,83,345,3,100.0
1692,3/30/2018 21:00,143,129,79,351,3,100.0
1693,3/30/2018 21:05,128,110,81,319,3,100.0
1694,3/30/2018 21:10,127,112,90,329,3,100.0
1695,3/30/2018 21:15,136,124,98,358,3,100.0
1696,3/30/2018 21:20,144,130,94,368,3,100.0
1697,3/30/2018 21:25,147,126,98,371,3,100.0
1698,3/30/2018 21:30,126,121,84,331,3,100.0
1699,3/30/2018 21:35,116,121,73,310,3,100.0
1700,3/30/2018 21:40,122,112,88,322,3,100.0
1701,3/30/2018 21:45,127,118,88,333,3,100.0
1702,3/30/2018 21:50,109,102,86,297,3,100.0
1703,3/30/2018 21:55,110,102,72,284,3,100.0
1704,3/30/2018 22:00,121,117,89,327,3,100.0
1705,3/30/2018 22:05,120,112,87,319,3,100.0
1706,3/30/2018 22:10,109,108,84,301,3,100.0
1707,3/30/2018 22:15,111,122,87,320,3,100.0
1708,3/30/2018 22:20,117,112,87,316,3,100.0
1709,3/30/2018 22:25,113,119,76,308,3,100.0
1710,3/30/2018 22:30,137,120,86,343,3,100.0
1711,3/30/2018 22:35,136,122,91,349,3,100.0
1712,3/30/2018 22:40,116,101,80,297,3,100.0
1713,3/30/2018 22:45,110,118,78,306,3,100.0
1714,3/30/2018 22:50,124,101,83,308,3,100.0
1715,3/30/2018 22:55,89,104,68,261,3,100.0
1716,3/30/2018 23:00,126,100,80,306,3,100.0
1717,3/30/2018 23:05,109,100,64,273,3,100.0
1718,3/30/2018 23:10,110,106,67,283,3,100.0
1719,3/30/2018 23:15,105,94,67,266,3,100.0
1720,3/30/2018 23:20,72,73,57,202,3,100.0
1721,3/30/2018 23:25,74,64,51,189,3,100.0
1722,3/30/2018 23:30,72,66,50,188,3,100.0
1723,3/30/2018 23:35,80,80,47,207,3,100.0
1724,3/30/2018 23:40,107,113,60,280,3,100.0
1725,3/30/2018 23:45,96,99,74,269,3,100.0
1726,3/30/2018 23:50,68,77,57,202,3,100.0
1727,3/30/2018 23:55,98,82,55,235,3,100.0
1728,3/31/2018 0:00,59,75,47,181,3,100.0
1729,3/31/2018 0:05,74,71,63,208,3,100.0
1730,3/31/2018 0:10,65,69,58,192,3,100.0
1731,3/31/2018 0:15,64,66,49,179,3,100.0
1732,3/31/2018 0:20,65,77,47,189,3,100.0
1733,3/31/2018 0:25,53,67,40,160,3,100.0
1734,3/31/2018 0:30,49,57,30,136,3,100.0
1735,3/31/2018 0:35,56,57,43,156,3,100.0
1736,3/31/2018 0:40,59,58,32,149,3,100.0
1737,3/31/2018 0:45,52,58,39,149,3,100.0
1738,3/31/2018 0:50,43,54,49,146,3,100.0
1739,3/31/2018 0:55,43,51,29,123,3,100.0
1740,3/31/2018 1:00,37,55,29,121,3,100.0
1741,3/31/2018 1:05,49,55,27,131,3,100.0
1742,3/31/2018 1:10,35,40,21,96,3,100.0
1743,3/31/2018 1:15,41,43,34,118,3,100.0
1744,3/31/2018 1:20,30,38,28,96,3,100.0
1745,3/31/2018 1:25,26,31,17,74,3,100.0
1746,3/31/2018 1:30,40,46,30,116,3,100.0
1747,3/31/2018 1:35,33,44,32,109,3,100.0
1748,3/31/2018 1:40,27,39,26,92,3,100.0
1749,3/31/2018 1:45,27,36,25,88,3,100.0
1750,3/31/2018 1:50,25,38,22,85,3,100.0
1751,3/31/2018 1:55,25,33,26,84,3,100.0
1752,3/31/2018 2:00,25,35,20,80,3,100.0
1753,3/31/2018 2:05,27,37,23,87,3,100.0
1754,3/31/2018 2:10,26,38,24,88,3,100.0
1755,3/31/2018 2:15,21,32,29,82,3,100.0
1756,3/31/2018 2:20,35,33,33,101,3,100.0
1757,3/31/2018 2:25,17,31,22,70,3,100.0
1758,3/31/2018 2:30,22,22,27,71,3,100.0
1759,3/31/2018 2:35,25,29,23,77,3,100.0
1760,3/31/2018 2:40,19,28,15,62,3,100.0
1761,3/31/2018 2:45,19,30,22,71,3,100.0
1762,3/31/2018 2:50,12,22,16,50,3,100.0
1763,3/31/2018 2:55,15,21,22,58,3,100.0
1764,3/31/2018 3:00,8,14,11,33,3,100.0
1765,3/31/2018 3:05,11,18,13,42,3,100.0
1766,3/31/2018 3:10,17,18,14,49,3,100.0
1767,3/31/2018 3:15,27,38,29,94,3,100.0
1768,3/31/2018 3:20,17,29,13,59,3,100.0
1769,3/31/2018 3:25,20,25,12,57,3,100.0
1770,3/31/2018 3:30,10,22,17,49,3,100.0
1771,3/31/2018 3:35,8,23,15,46,3,100.0
1772,3/31/2018 3:40,10,23,21,54,3,100.0
1773,3/31/2018 3:45,12,16,11,39,3,100.0
1774,3/31/2018 3:50,15,19,20,54,3,100.0
1775,3/31/2018 3:55,12,21,14,47,3,100.0
1776,3/31/2018 4:00,15,21,15,51,3,100.0
1777,3/31/2018 4:05,10,16,18,44,3,100.0
1778,3/31/2018 4:10,14,20,13,47,3,100.0
1779,3/31/2018 4:15,16,30,18,64,3,100.0
1780,3/31/2018 4:20,19,33,22,74,3,100.0
1781,3/31/2018 4:25,20,30,14,64,3,100.0
1782,3/31/2018 4:30,23,36,25,84,3,100.0
1783,3/31/2018 4:35,18,26,24,68,3,100.0
1784,3/31/2018 4:40,15,27,25,67,3,100.0
1785,3/31/2018 4:45,20,24,14,58,3,100.0
1786,3/31/2018 4:50,30,28,20,78,3,100.0
1787,3/31/2018 4:55,24,28,20,72,3,100.0
1788,3/31/2018 5:00,23,38,29,90,3,100.0
1789,3/31/2018 5:05,27,34,19,80,3,100.0
1790,3/31/2018 5:10,30,38,30,98,3,100.0
1791,3/31/2018 5:15,38,42,34,114,3,100.0
1792,3/31/2018 5:20,34,42,30,106,3,100.0
1793,3/31/2018 5:25,38,50,33,121,3,100.0
1794,3/31/2018 5:30,43,44,31,118,3,100.0
1795,3/31/2018 5:35,41,55,31,127,3,100.0
1796,3/31/2018 5:40,54,57,33,144,3,100.0
1797,3/31/2018 5:45,56,56,40,152,3,100.0
1798,3/31/2018 5:50,54,60,39,153,3,100.0
1799,3/31/2018 5:55,39,44,33,116,3,100.0
1800,3/31/2018 6:00,49,59,33,141,3,100.0
1801,3/31/2018 6:05,56,58,40,154,3,100.0
1802,3/31/2018 6:10,46,55,30,131,3,100.0
1803,3/31/2018 6:15,50,64,34,148,3,100.0
1804,3/31/2018 6:20,69,66,44,179,3,100.0
1805,3/31/2018 6:25,92,83,41,216,3,100.0
1806,3/31/2018 6:30,71,62,48,181,3,100.0
1807,3/31/2018 6:35,83,74,57,214,3,100.0
1808,3/31/2018 6:40,83,87,58,228,3,100.0
1809,3/31/2018 6:45,91,84,60,235,3,100.0
1810,3/31/2018 6:50,64,81,55,200,3,100.0
1811,3/31/2018 6:55,85,83,61,229,3,100.0
1812,3/31/2018 7:00,83,82,54,219,3,100.0
1813,3/31/2018 7:05,84,89,56,229,3,100.0
1814,3/31/2018 7:10,78,83,53,214,3,100.0
1815,3/31/2018 7:15,95,95,59,249,3,100.0
1816,3/31/2018 7:20,102,98,64,264,3,100.0
1817,3/31/2018 7:25,119,115,73,307,3,100.0
1818,3/31/2018 7:30,112,120,76,308,3,100.0
1819,3/31/2018 7:35,107,105,65,277,3,100.0
1820,3/31/2018 7:40,116,114,81,311,3,100.0
1821,3/31/2018 7:45,134,126,91,351,3,100.0
1822,3/31/2018 7:50,110,103,81,294,3,100.0
1823,3/31/2018 7:55,130,113,71,314,3,100.0
1824,3/31/2018 8:00,116,111,73,300,3,100.0
1825,3/31/2018 8:05,129,119,74,322,3,100.0
1826,3/31/2018 8:10,118,119,75,312,3,100.0
1827,3/31/2018 8:15,130,106,67,303,3,100.0
1828,3/31/2018 8:20,117,111,63,291,3,100.0
1829,3/31/2018 8:25,140,128,82,350,3,100.0
1830,3/31/2018 8:30,134,129,88,351,3,100.0
1831,3/31/2018 8:35,158,147,89,394,3,100.0
1832,3/31/2018 8:40,164,140,84,388,3,100.0
1833,3/31/2018 8:45,158,138,90,386,3,100.0
1834,3/31/2018 8:50,151,137,82,370,3,100.0
1835,3/31/2018 8:55,154,126,98,378,3,100.0
1836,3/31/2018 9:00,151,137,74,362,3,100.0
1837,3/31/2018 9:05,146,134,80,360,3,100.0
1838,3/31/2018 9:10,134,135,90,359,3,100.0
1839,3/31/2018 9:15,167,144,112,423,3,100.0
1840,3/31/2018 9:20,152,141,84,377,3,100.0
1841,3/31/2018 9:25,176,148,110,434,3,100.0
1842,3/31/2018 9:30,182,151,108,441,3,100.0
1843,3/31/2018 9:35,164,145,106,415,3,100.0
1844,3/31/2018 9:40,168,147,104,419,3,100.0
1845,3/31/2018 9:45,143,122,81,346,3,100.0
1846,3/31/2018 9:50,151,154,101,406,3,100.0
1847,3/31/2018 9:55,158,145,101,404,3,100.0
1848,3/31/2018 10:00,167,163,108,438,3,100.0
1849,3/31/2018 10:05,169,140,93,402,3,100.0
1850,3/31/2018 10:10,142,134,93,369,3,100.0
1851,3/31/2018 10:15,167,152,102,421,3,100.0
1852,3/31/2018 10:20,169,149,115,433,3,100.0
1853,3/31/2018 10:25,159,146,101,406,3,100.0
1854,3/31/2018 10:30,184,168,110,462,3,100.0
1855,3/31/2018 10:35,180,158,112,450,3,100.0
1856,3/31/2018 10:40,195,151,114,460,3,100.0
1857,3/31/2018 10:45,196,169,131,496,3,100.0
1858,3/31/2018 10:50,188,166,118,472,3,100.0
1859,3/31/2018 10:55,170,158,102,430,3,100.0
1860,3/31/2018 11:00,172,163,120,455,3,100.0
1861,3/31/2018 11:05,177,161,101,439,3,100.0
1862,3/31/2018 11:10,190,171,125,486,3,100.0
1863,3/31/2018 11:15,181,159,111,451,3,100.0
1864,3/31/2018 11:20,182,161,110,453,3,100.0
1865,3/31/2018 11:25,174,172,122,468,3,100.0
1866,3/31/2018 11:30,179,164,122,465,3,100.0
1867,3/31/2018 11:35,183,171,137,491,3,100.0
1868,3/31/2018 11:40,174,159,121,454,3,100.0
1869,3/31/2018 11:45,184,183,117,484,3,100.0
1870,3/31/2018 11:50,164,156,126,446,3,100.0
1871,3/31/2018 11:55,170,153,113,436,3,100.0
