,5 Minutes,Lane 1 Flow (Veh/5 Minutes),Lane 2 Flow (Veh/5 Minutes),Lane 3 Flow (Veh/5 Minutes),Lane 4 Flow (Veh/5 Minutes),Lane 5 Flow (Veh/5 Minutes),Flow (Veh/5 Minutes),# Lane Points,% Observed
1275,3/23/2018 21:15,106,90,101,54,68,419,5,100
1276,3/23/2018 21:20,118,91,101,71,81,462,5,100
1277,3/23/2018 21:25,116,74,105,50,74,419,5,100
1278,3/23/2018 21:30,115,84,111,49,68,427,5,100
1279,3/23/2018 21:35,112,85,111,47,86,441,5,100
1280,3/23/2018 21:40,123,93,117,59,62,454,5,100
1281,3/23/2018 21:45,109,90,115,45,78,437,5,100
1282,3/23/2018 21:50,112,96,101,53,69,431,5,100
1283,3/23/2018 21:55,106,92,98,41,66,403,5,100
1284,3/23/2018 22:00,110,86,111,47,67,421,5,100
1285,3/23/2018 22:05,113,78,110,54,66,421,5,100
1286,3/23/2018 22:10,104,90,108,39,68,409,5,100
1287,3/23/2018 22:15,111,86,99,42,78,416,5,100
1288,3/23/2018 22:20,111,89,104,51,75,430,5,100
1289,3/23/2018 22:25,96,81,94,52,71,394,5,100
1290,3/23/2018 22:30,104,86,96,49,49,384,5,100
1291,3/23/2018 22:35,101,80,99,42,58,380,5,100
1292,3/23/2018 22:40,94,87,88,44,65,378,5,100
1293,3/23/2018 22:45,84,62,67,35,49,297,5,100
1294,3/23/2018 22:50,100,92,97,43,63,395,5,100
1295,3/23/2018 22:55,82,78,91,46,66,363,5,100
1296,3/23/2018 23:00,90,68,75,36,58,327,5,100
1297,3/23/2018 23:05,92,60,81,43,65,341,5,100
1298,3/23/2018 23:10,85,70,84,33,60,332,5,100
1299,3/23/2018 23:15,78,69,73,43,58,321,5,100
1300,3/23/2018 23:20,90,67,69,39,66,331,5,100
1301,3/23/2018 23:25,73,63,71,38,47,292,5,100
1302,3/23/2018 23:30,74,58,72,40,55,299,5,100
1303,3/23/2018 23:35,75,67,79,31,63,315,5,100
1304,3/23/2018 23:40,67,53,69,38,54,281,5,100
1305,3/23/2018 23:45,77,53,67,31,45,273,5,100
1306,3/23/2018 23:50,58,60,56,36,46,256,5,100
1307,3/23/2018 23:55,55,58,58,28,42,241,5,100
1308,3/24/2018 0:00,59,51,67,39,44,260,5,100
1309,3/24/2018 0:05,58,43,61,28,36,226,5,100
1310,3/24/2018 0:10,55,42,72,20,44,233,5,100
1311,3/24/2018 0:15,42,51,56,29,45,223,5,100
1312,3/24/2018 0:20,31,50,47,19,43,190,5,100
1313,3/24/2018 0:25,49,47,58,22,42,218,5,100
1314,3/24/2018 0:30,55,47,53,29,39,223,5,100
1315,3/24/2018 0:35,48,42,51,24,37,202,5,100
1316,3/24/2018 0:40,43,46,71,19,41,220,5,100
1317,3/24/2018 0:45,54,46,59,15,40,214,5,100
1318,3/24/2018 0:50,33,43,59,27,46,208,5,100
1319,3/24/2018 0:55,24,27,31,17,32,131,5,100
1320,3/24/2018 1:00,25,40,49,19,31,164,5,100
1321,3/24/2018 1:05,41,37,49,21,28,176,5,100
1322,3/24/2018 1:10,35,43,53,21,32,184,5,100
1323,3/24/2018 1:15,28,35,55,14,30,162,5,100
1324,3/24/2018 1:20,32,34,31,16,34,147,5,100
1325,3/24/2018 1:25,27,37,40,16,27,147,5,100
1326,3/24/2018 1:30,24,28,38,12,26,128,5,100
1327,3/24/2018 1:35,25,33,38,16,29,141,5,100
1328,3/24/2018 1:40,25,37,37,19,23,141,5,100
1329,3/24/2018 1:45,20,26,36,14,19,115,5,100
1330,3/24/2018 1:50,31,24,40,12,29,136,5,100
1331,3/24/2018 1:55,24,35,27,15,29,130,5,100
1332,3/24/2018 2:00,21,36,24,14,30,125,5,100
1333,3/24/2018 2:05,30,25,27,17,28,127,5,100
1334,3/24/2018 2:10,23,44,29,10,26,132,5,100
1335,3/24/2018 2:15,27,27,36,13,22,125,5,100
1336,3/24/2018 2:20,14,28,28,17,21,108,5,100
1337,3/24/2018 2:25,20,32,26,11,22,111,5,100
1338,3/24/2018 2:30,23,24,20,10,23,100,5,100
1339,3/24/2018 2:35,21,28,30,12,22,113,5,100
1340,3/24/2018 2:40,15,31,30,14,22,112,5,100
1341,3/24/2018 2:45,15,22,30,11,15,93,5,100
1342,3/24/2018 2:50,17,23,21,10,20,91,5,100
1343,3/24/2018 2:55,12,23,22,6,10,73,5,100
1344,3/24/2018 3:00,13,24,21,7,19,84,5,100
1345,3/24/2018 3:05,11,20,18,12,18,79,5,100
1346,3/24/2018 3:10,8,9,15,6,19,57,5,100
1347,3/24/2018 3:15,9,14,18,5,15,61,5,100
1348,3/24/2018 3:20,8,18,16,1,10,53,5,100
1349,3/24/2018 3:25,11,14,17,8,11,61,5,100
1350,3/24/2018 3:30,17,15,20,14,20,86,5,100
1351,3/24/2018 3:35,18,17,16,5,13,69,5,100
1352,3/24/2018 3:40,16,14,11,7,17,65,5,100
1353,3/24/2018 3:45,16,17,17,8,14,72,5,100
1354,3/24/2018 3:50,14,13,17,3,17,64,5,100
1355,3/24/2018 3:55,13,18,20,4,15,70,5,100
1356,3/24/2018 4:00,8,13,14,12,7,54,5,100
1357,3/24/2018 4:05,8,21,15,5,16,65,5,100
1358,3/24/2018 4:10,16,13,19,4,10,62,5,100
1359,3/24/2018 4:15,15,15,16,8,18,72,5,100
1360,3/24/2018 4:20,11,19,10,6,8,54,5,100
1361,3/24/2018 4:25,15,18,17,8,18,76,5,100
1362,3/24/2018 4:30,15,22,22,8,16,83,5,100
1363,3/24/2018 4:35,14,19,16,8,12,69,5,100
1364,3/24/2018 4:40,18,17,32,7,10,84,5,100
1365,3/24/2018 4:45,14,17,19,6,16,72,5,100
1366,3/24/2018 4:50,13,15,23,7,16,74,5,100
1367,3/24/2018 4:55,12,16,10,9,24,71,5,100
1368,3/24/2018 5:00,18,23,23,4,17,85,5,100
1369,3/24/2018 5:05,16,21,22,11,16,86,5,100
1370,3/24/2018 5:10,19,27,28,17,23,114,5,100
1371,3/24/2018 5:15,12,24,25,12,16,89,5,100
1372,3/24/2018 5:20,19,16,28,7,15,85,5,100
1373,3/24/2018 5:25,25,37,42,11,22,137,5,100
1374,3/24/2018 5:30,23,34,29,9,26,121,5,100
1375,3/24/2018 5:35,27,36,37,11,26,137,5,100
1376,3/24/2018 5:40,35,37,42,15,25,154,5,100
1377,3/24/2018 5:45,34,34,33,11,25,137,5,100
1378,3/24/2018 5:50,31,36,35,17,29,148,5,100
1379,3/24/2018 5:55,29,34,31,9,21,124,5,100
1380,3/24/2018 6:00,26,32,38,17,26,139,5,100
1381,3/24/2018 6:05,39,34,42,18,26,159,5,100
1382,3/24/2018 6:10,31,35,42,14,34,156,5,100
1383,3/24/2018 6:15,48,43,45,16,27,179,5,100
1384,3/24/2018 6:20,38,39,39,18,24,158,5,100
1385,3/24/2018 6:25,41,37,50,16,31,175,5,100
1386,3/24/2018 6:30,44,39,52,15,35,185,5,100
1387,3/24/2018 6:35,41,36,46,15,41,179,5,100
1388,3/24/2018 6:40,50,45,61,25,36,217,5,100
1389,3/24/2018 6:45,54,52,62,21,37,226,5,100
1390,3/24/2018 6:50,34,42,49,22,42,189,5,100
1391,3/24/2018 6:55,52,41,55,17,46,211,5,100
1392,3/24/2018 7:00,56,50,65,19,46,236,5,100
1393,3/24/2018 7:05,57,48,71,24,38,238,5,100
1394,3/24/2018 7:10,68,52,66,25,46,257,5,100
1395,3/24/2018 7:15,67,63,78,19,46,273,5,100
1396,3/24/2018 7:20,71,58,79,29,52,289,5,100
1397,3/24/2018 7:25,91,66,83,25,63,328,5,100
1398,3/24/2018 7:30,92,65,90,29,56,332,5,100
1399,3/24/2018 7:35,90,68,83,32,59,332,5,100
1400,3/24/2018 7:40,87,63,93,33,63,339,5,100
1401,3/24/2018 7:45,94,66,84,33,60,337,5,100
1402,3/24/2018 7:50,83,80,91,26,67,347,5,100
1403,3/24/2018 7:55,98,67,93,32,67,357,5,100
1404,3/24/2018 8:00,83,74,88,38,72,355,5,100
1405,3/24/2018 8:05,99,66,84,28,55,332,5,100
1406,3/24/2018 8:10,94,75,92,30,65,356,5,100
1407,3/24/2018 8:15,118,86,110,37,66,417,5,100
1408,3/24/2018 8:20,92,73,111,42,71,389,5,100
1409,3/24/2018 8:25,103,77,101,45,80,406,5,100
1410,3/24/2018 8:30,115,92,119,38,81,445,5,100
1411,3/24/2018 8:35,140,101,114,47,78,480,5,100
1412,3/24/2018 8:40,143,105,121,59,82,510,5,100
1413,3/24/2018 8:45,127,93,117,52,77,466,5,100
1414,3/24/2018 8:50,118,97,129,50,70,464,5,100
1415,3/24/2018 8:55,117,89,124,50,78,458,5,100
1416,3/24/2018 9:00,110,91,114,35,64,414,5,100
1417,3/24/2018 9:05,123,84,111,50,76,444,5,100
1418,3/24/2018 9:10,121,89,112,36,91,449,5,100
1419,3/24/2018 9:15,132,104,113,30,71,450,5,100
1420,3/24/2018 9:20,128,94,115,39,88,464,5,100
1421,3/24/2018 9:25,140,111,126,47,79,503,5,100
1422,3/24/2018 9:30,133,94,124,39,84,474,5,100
1423,3/24/2018 9:35,145,102,129,44,93,513,5,100
1424,3/24/2018 9:40,142,102,120,54,82,500,5,100
1425,3/24/2018 9:45,132,113,128,35,87,495,5,100
1426,3/24/2018 9:50,142,103,123,48,86,502,5,100
1427,3/24/2018 9:55,127,84,129,46,88,474,5,100
1428,3/24/2018 10:00,133,112,120,52,94,511,5,100
1429,3/24/2018 10:05,142,100,132,52,83,509,5,100
1430,3/24/2018 10:10,129,108,123,48,84,492,5,100
1431,3/24/2018 10:15,135,118,118,52,88,511,5,100
1432,3/24/2018 10:20,149,113,146,49,91,548,5,100
1433,3/24/2018 10:25,136,123,128,38,92,517,5,100
1434,3/24/2018 10:30,140,95,133,43,95,506,5,100
1435,3/24/2018 10:35,133,109,138,55,93,528,5,100
1436,3/24/2018 10:40,143,105,139,47,90,524,5,100
1437,3/24/2018 10:45,138,109,128,57,97,529,5,100
1438,3/24/2018 10:50,141,109,137,62,92,541,5,100
1439,3/24/2018 10:55,130,89,130,49,104,502,5,100
1440,3/24/2018 11:00,130,103,117,46,90,486,5,100
1441,3/24/2018 11:05,139,91,123,51,91,495,5,100
1442,3/24/2018 11:10,129,104,131,45,76,485,5,100
1443,3/24/2018 11:15,131,104,126,50,80,491,5,100
1444,3/24/2018 11:20,139,118,122,42,94,515,5,100
1445,3/24/2018 11:25,129,122,132,61,91,535,5,100
1446,3/24/2018 11:30,154,115,133,57,108,567,5,100
1447,3/24/2018 11:35,141,120,138,61,81,541,5,100
1448,3/24/2018 11:40,123,111,125,55,88,502,5,100
1449,3/24/2018 11:45,129,112,143,52,94,530,5,100
1450,3/24/2018 11:50,144,115,139,66,105,569,5,100
1451,3/24/2018 11:55,101,89,93,77,92,452,5,100
1452,3/24/2018 12:00,109,98,102,88,109,506,5,100
1453,3/24/2018 12:05,106,94,99,96,100,495,5,100
1454,3/24/2018 12:10,112,114,119,77,98,520,5,100
1455,3/24/2018 12:15,117,95,131,64,81,488,5,100
1456,3/24/2018 12:20,131,103,127,62,85,508,5,100
1457,3/24/2018 12:25,137,110,119,71,86,523,5,100
1458,3/24/2018 12:30,137,107,124,65,94,527,5,100
1459,3/24/2018 12:35,111,106,116,69,93,495,5,100
1460,3/24/2018 12:40,114,105,124,83,92,518,5,100
1461,3/24/2018 12:45,130,113,117,73,99,532,5,100
1462,3/24/2018 12:50,113,99,120,58,92,482,5,100
1463,3/24/2018 12:55,140,97,125,75,87,524,5,100
1464,3/24/2018 13:00,130,112,134,80,101,557,5,100
1465,3/24/2018 13:05,114,108,110,89,108,529,5,100
1466,3/24/2018 13:10,118,99,117,77,100,511,5,100
1467,3/24/2018 13:15,114,104,129,67,89,503,5,100
1468,3/24/2018 13:20,119,97,122,66,97,501,5,100
1469,3/24/2018 13:25,105,113,107,66,82,473,5,100
1470,3/24/2018 13:30,118,104,117,78,104,521,5,100
1471,3/24/2018 13:35,109,99,97,76,106,487,5,100
1472,3/24/2018 13:40,125,103,122,59,106,515,5,100
1473,3/24/2018 13:45,130,101,120,68,86,505,5,100
1474,3/24/2018 13:50,113,101,125,71,96,506,5,100
1475,3/24/2018 13:55,110,97,114,70,83,474,5,100
1476,3/24/2018 14:00,132,108,125,72,91,528,5,100
1477,3/24/2018 14:05,125,112,134,69,93,533,5,100
1478,3/24/2018 14:10,133,126,135,66,90,550,5,100
1479,3/24/2018 14:15,114,96,118,68,94,490,5,100
1480,3/24/2018 14:20,118,92,116,61,121,508,5,100
1481,3/24/2018 14:25,125,101,129,60,100,515,5,100
1482,3/24/2018 14:30,118,99,133,72,95,517,5,100
1483,3/24/2018 14:35,115,104,119,68,101,507,5,100
1484,3/24/2018 14:40,121,109,110,77,103,520,5,100
1485,3/24/2018 14:45,100,102,113,62,94,471,5,100
1486,3/24/2018 14:50,125,109,118,67,97,516,5,100
1487,3/24/2018 14:55,106,106,122,76,101,511,5,100
1488,3/24/2018 15:00,95,99,104,70,79,447,5,100
1489,3/24/2018 15:05,114,102,118,79,92,505,5,100
1490,3/24/2018 15:10,120,112,128,87,87,534,5,100
1491,3/24/2018 15:15,127,94,117,77,99,514,5,100
1492,3/24/2018 15:20,114,103,128,78,102,525,5,100
1493,3/24/2018 15:25,101,107,126,75,97,506,5,100
1494,3/24/2018 15:30,101,108,109,84,78,480,5,100
1495,3/24/2018 15:35,106,96,115,66,93,476,5,100
1496,3/24/2018 15:40,123,100,131,48,93,495,5,100
1497,3/24/2018 15:45,109,101,107,58,95,470,5,100
1498,3/24/2018 15:50,116,97,118,58,78,467,5,100
1499,3/24/2018 15:55,126,111,124,54,82,497,5,100
1500,3/24/2018 16:00,117,94,109,61,85,466,5,100
1501,3/24/2018 16:05,129,99,126,58,91,503,5,100
1502,3/24/2018 16:10,111,98,115,62,75,461,5,100
1503,3/24/2018 16:15,134,109,120,62,87,512,5,100
1504,3/24/2018 16:20,127,119,127,74,92,539,5,100
1505,3/24/2018 16:25,112,96,120,51,79,458,5,100
1506,3/24/2018 16:30,109,104,118,72,102,505,5,100
1507,3/24/2018 16:35,103,101,118,80,88,490,5,100
1508,3/24/2018 16:40,97,89,98,82,108,474,5,100
1509,3/24/2018 16:45,93,90,96,100,106,485,5,100
1510,3/24/2018 16:50,106,106,101,110,100,523,5,100
1511,3/24/2018 16:55,106,98,101,93,100,498,5,100
1512,3/24/2018 17:00,105,102,106,90,97,500,5,100
1513,3/24/2018 17:05,110,102,109,81,103,505,5,100
1514,3/24/2018 17:10,105,101,113,76,95,490,5,100
1515,3/24/2018 17:15,105,96,97,82,96,476,5,100
1516,3/24/2018 17:20,103,95,119,85,101,503,5,100
1517,3/24/2018 17:25,110,99,125,57,96,487,5,100
1518,3/24/2018 17:30,112,100,112,53,83,460,5,100
1519,3/24/2018 17:35,127,91,119,63,77,477,5,100
1520,3/24/2018 17:40,122,93,127,70,80,492,5,100
1521,3/24/2018 17:45,120,110,121,46,74,471,5,100
1522,3/24/2018 17:50,105,95,100,54,78,432,5,100
1523,3/24/2018 17:55,127,98,117,61,83,486,5,100
1524,3/24/2018 18:00,122,95,122,59,79,477,5,100
1525,3/24/2018 18:05,119,103,114,55,85,476,5,100
1526,3/24/2018 18:10,125,101,122,64,90,502,5,100
1527,3/24/2018 18:15,114,96,114,55,83,462,5,100
1528,3/24/2018 18:20,125,93,127,61,90,496,5,100
1529,3/24/2018 18:25,135,101,126,65,90,517,5,100
1530,3/24/2018 18:30,131,100,129,49,85,494,5,100
1531,3/24/2018 18:35,121,95,130,50,95,491,5,100
1532,3/24/2018 18:40,132,110,132,72,85,531,5,100
1533,3/24/2018 18:45,122,100,122,60,99,503,5,100
1534,3/24/2018 18:50,111,97,115,55,96,474,5,100
1535,3/24/2018 18:55,116,94,121,46,85,462,5,100
1536,3/24/2018 19:00,115,95,116,69,81,476,5,100
1537,3/24/2018 19:05,124,89,116,46,69,444,5,100
1538,3/24/2018 19:10,123,96,122,67,78,486,5,100
1539,3/24/2018 19:15,123,95,126,54,89,487,5,100
1540,3/24/2018 19:20,123,95,118,55,74,465,5,100
1541,3/24/2018 19:25,126,93,125,43,85,472,5,100
1542,3/24/2018 19:30,119,99,121,59,89,487,5,100
1543,3/24/2018 19:35,128,84,126,51,77,466,5,100
1544,3/24/2018 19:40,118,97,105,59,70,449,5,100
1545,3/24/2018 19:45,125,102,112,40,85,464,5,100
1546,3/24/2018 19:50,136,100,110,50,87,483,5,100
1547,3/24/2018 19:55,125,106,122,68,102,523,5,100
1548,3/24/2018 20:00,128,94,117,53,73,465,5,100
1549,3/24/2018 20:05,130,98,112,52,85,477,5,100
1550,3/24/2018 20:10,108,98,121,52,79,458,5,100
1551,3/24/2018 20:15,122,92,111,40,78,443,5,100
1552,3/24/2018 20:20,123,91,116,48,90,468,5,100
1553,3/24/2018 20:25,123,91,111,57,82,464,5,100
1554,3/24/2018 20:30,114,91,112,47,74,438,5,100
1555,3/24/2018 20:35,102,90,101,46,69,408,5,100
1556,3/24/2018 20:40,115,97,114,30,77,433,5,100
1557,3/24/2018 20:45,95,80,111,36,68,390,5,100
1558,3/24/2018 20:50,108,86,109,45,71,419,5,100
1559,3/24/2018 20:55,111,86,111,39,64,411,5,100
1560,3/24/2018 21:00,99,94,106,48,76,423,5,100
1561,3/24/2018 21:05,107,83,105,26,56,377,5,100
1562,3/24/2018 21:10,110,81,109,46,70,416,5,100
1563,3/24/2018 21:15,117,88,109,41,64,419,5,100
1564,3/24/2018 21:20,110,90,104,35,68,407,5,100
1565,3/24/2018 21:25,106,95,114,40,62,417,5,100
1566,3/24/2018 21:30,114,88,97,48,78,425,5,100
1567,3/24/2018 21:35,84,67,103,40,56,350,5,100
1568,3/24/2018 21:40,111,85,103,55,68,422,5,100
1569,3/24/2018 21:45,99,78,94,38,56,365,5,100
1570,3/24/2018 21:50,111,86,95,47,78,417,5,100
1571,3/24/2018 21:55,88,77,109,37,70,381,5,100
1572,3/24/2018 22:00,85,73,95,32,59,344,5,100
1573,3/24/2018 22:05,95,88,91,30,68,372,5,100
1574,3/24/2018 22:10,113,81,104,37,60,395,5,100
1575,3/24/2018 22:15,104,83,98,51,61,397,5,100
1576,3/24/2018 22:20,95,71,99,39,72,376,5,100
1577,3/24/2018 22:25,101,74,96,35,77,383,5,100
1578,3/24/2018 22:30,94,88,99,47,76,404,5,100
1579,3/24/2018 22:35,97,95,91,41,77,401,5,100
1580,3/24/2018 22:40,96,72,88,37,65,358,5,100
1581,3/24/2018 22:45,88,83,94,46,79,390,5,100
1582,3/24/2018 22:50,89,72,87,43,66,357,5,100
1583,3/24/2018 22:55,91,66,77,36,57,327,5,100
1584,3/24/2018 23:00,84,74,90,37,70,355,5,100
1585,3/24/2018 23:05,85,77,87,36,61,346,5,100
1586,3/24/2018 23:10,74,57,76,31,53,291,5,100
1587,3/24/2018 23:15,77,64,72,35,56,304,5,100
1588,3/24/2018 23:20,79,73,85,30,51,318,5,100
1589,3/24/2018 23:25,77,63,73,27,55,295,5,100
1590,3/24/2018 23:30,74,63,62,29,45,273,5,100
1591,3/24/2018 23:35,79,66,76,26,48,295,5,100
1592,3/24/2018 23:40,71,56,64,27,45,263,5,100
1593,3/24/2018 23:45,56,53,70,25,49,253,5,100
1594,3/24/2018 23:50,68,53,66,30,44,261,5,100
1595,3/24/2018 23:55,54,60,66,26,35,241,5,100
1596,3/25/2018 0:00,60,45,69,28,57,259,5,100
1597,3/25/2018 0:05,58,49,57,22,48,234,5,100
1598,3/25/2018 0:10,47,55,66,30,43,241,5,100
1599,3/25/2018 0:15,65,59,65,24,52,265,5,100
1600,3/25/2018 0:20,47,51,51,32,42,223,5,100
1601,3/25/2018 0:25,47,51,56,19,40,213,5,100
1602,3/25/2018 0:30,38,45,61,22,32,198,5,100
1603,3/25/2018 0:35,49,49,53,24,36,211,5,100
1604,3/25/2018 0:40,43,45,46,16,37,187,5,100
1605,3/25/2018 0:45,47,45,50,23,44,209,5,100
1606,3/25/2018 0:50,53,40,47,21,41,202,5,100
1607,3/25/2018 0:55,35,42,43,14,37,171,5,100
1608,3/25/2018 1:00,40,44,51,8,37,180,5,100
1609,3/25/2018 1:05,34,44,46,14,36,174,5,100
1610,3/25/2018 1:10,33,34,33,10,27,137,5,100
1611,3/25/2018 1:15,27,30,32,10,31,130,5,100
1612,3/25/2018 1:20,31,38,44,16,33,162,5,100
1613,3/25/2018 1:25,27,36,43,21,43,170,5,100
1614,3/25/2018 1:30,34,35,35,13,28,145,5,100
1615,3/25/2018 1:35,27,29,32,9,27,124,5,100
1616,3/25/2018 1:40,21,27,34,14,17,113,5,100
1617,3/25/2018 1:45,28,34,38,13,28,141,5,100
1618,3/25/2018 1:50,21,28,30,10,27,116,5,100
1619,3/25/2018 1:55,23,41,28,10,25,127,5,100
1620,3/25/2018 2:00,29,32,39,13,28,141,5,100
1621,3/25/2018 2:05,18,26,34,8,19,105,5,100
1622,3/25/2018 2:10,20,30,27,9,19,105,5,100
1623,3/25/2018 2:15,31,38,24,12,22,127,5,100
1624,3/25/2018 2:20,19,26,27,9,20,101,5,100
1625,3/25/2018 2:25,16,27,32,10,21,106,5,100
1626,3/25/2018 2:30,21,31,27,5,21,105,5,100
1627,3/25/2018 2:35,14,24,23,11,24,96,5,100
1628,3/25/2018 2:40,20,25,24,5,20,94,5,100
1629,3/25/2018 2:45,17,20,20,6,22,85,5,100
1630,3/25/2018 2:50,19,20,17,7,20,83,5,100
1631,3/25/2018 2:55,11,19,21,6,13,70,5,100
1632,3/25/2018 3:00,13,24,28,3,16,84,5,100
1633,3/25/2018 3:05,8,13,17,4,11,53,5,100
1634,3/25/2018 3:10,9,23,22,6,11,71,5,100
1635,3/25/2018 3:15,14,23,27,11,11,86,5,100
1636,3/25/2018 3:20,14,16,26,8,14,78,5,100
1637,3/25/2018 3:25,15,25,22,5,11,78,5,100
1638,3/25/2018 3:30,13,16,18,6,13,66,5,100
1639,3/25/2018 3:35,7,11,14,7,10,49,5,100
1640,3/25/2018 3:40,8,16,14,6,10,54,5,100
1641,3/25/2018 3:45,12,19,19,8,11,69,5,100
1642,3/25/2018 3:50,5,11,17,7,10,50,5,100
1643,3/25/2018 3:55,10,12,14,3,7,46,5,100
1644,3/25/2018 4:00,12,12,17,9,16,66,5,100
1645,3/25/2018 4:05,8,17,12,8,5,50,5,100
1646,3/25/2018 4:10,7,10,6,6,11,40,5,100
1647,3/25/2018 4:15,6,14,20,5,11,56,5,100
1648,3/25/2018 4:20,10,15,12,7,7,51,5,100
1649,3/25/2018 4:25,11,13,14,6,13,57,5,100
1650,3/25/2018 4:30,11,14,18,6,5,54,5,100
1651,3/25/2018 4:35,5,19,16,7,13,60,5,100
1652,3/25/2018 4:40,9,20,14,10,13,66,5,100
1653,3/25/2018 4:45,9,9,11,2,16,47,5,100
1654,3/25/2018 4:50,13,11,13,3,10,50,5,100
1655,3/25/2018 4:55,9,17,12,7,11,56,5,100
1656,3/25/2018 5:00,7,15,15,5,15,57,5,100
1657,3/25/2018 5:05,3,15,13,4,9,44,5,100
1658,3/25/2018 5:10,7,17,13,6,14,57,5,100
1659,3/25/2018 5:15,14,19,16,10,16,75,5,100
1660,3/25/2018 5:20,13,28,22,4,16,83,5,100
1661,3/25/2018 5:25,11,8,17,5,8,49,5,100
1662,3/25/2018 5:30,11,9,23,10,18,71,5,100
1663,3/25/2018 5:35,12,18,20,9,22,81,5,100
1664,3/25/2018 5:40,8,19,22,5,18,72,5,100
1665,3/25/2018 5:45,15,20,24,9,17,85,5,100
1666,3/25/2018 5:50,11,17,17,8,20,73,5,100
1667,3/25/2018 5:55,17,20,19,10,16,82,5,100
1668,3/25/2018 6:00,16,20,24,11,13,84,5,100
1669,3/25/2018 6:05,20,22,26,9,13,90,5,100
1670,3/25/2018 6:10,27,25,27,14,11,104,5,100
1671,3/25/2018 6:15,31,30,31,9,17,118,5,100
1672,3/25/2018 6:20,21,28,33,7,19,108,5,100
1673,3/25/2018 6:25,26,30,34,12,18,120,5,100
1674,3/25/2018 6:30,25,29,42,17,28,141,5,100
1675,3/25/2018 6:35,28,24,33,9,21,115,5,100
1676,3/25/2018 6:40,31,38,43,14,22,148,5,100
1677,3/25/2018 6:45,27,41,39,13,30,150,5,100
1678,3/25/2018 6:50,41,31,38,15,31,156,5,100
1679,3/25/2018 6:55,34,29,45,16,21,145,5,100
1680,3/25/2018 7:00,37,39,44,18,25,163,5,100
1681,3/25/2018 7:05,43,34,63,17,31,188,5,100
1682,3/25/2018 7:10,37,39,48,11,32,167,5,100
1683,3/25/2018 7:15,33,30,41,15,25,144,5,100
1684,3/25/2018 7:20,54,41,54,15,51,215,5,100
1685,3/25/2018 7:25,50,36,63,16,34,199,5,100
1686,3/25/2018 7:30,40,55,55,24,32,206,5,100
1687,3/25/2018 7:35,60,50,63,15,43,231,5,100
1688,3/25/2018 7:40,49,61,53,16,35,214,5,100
1689,3/25/2018 7:45,59,51,61,16,46,233,5,100
1690,3/25/2018 7:50,60,53,66,25,52,256,5,100
1691,3/25/2018 7:55,55,41,72,23,46,237,5,100
1692,3/25/2018 8:00,57,46,57,17,38,215,5,100
1693,3/25/2018 8:05,58,59,65,19,51,252,5,100
1694,3/25/2018 8:10,71,61,75,19,49,275,5,100
1695,3/25/2018 8:15,55,52,72,28,54,261,5,100
1696,3/25/2018 8:20,62,66,73,33,50,284,5,100
1697,3/25/2018 8:25,71,55,76,20,48,270,5,100
1698,3/25/2018 8:30,66,64,79,20,47,276,5,100
1699,3/25/2018 8:35,71,74,78,32,51,306,5,100
1700,3/25/2018 8:40,67,62,86,23,46,284,5,100
1701,3/25/2018 8:45,64,64,71,24,60,283,5,100
1702,3/25/2018 8:50,90,61,94,21,60,326,5,100
1703,3/25/2018 8:55,71,81,89,29,66,336,5,100
1704,3/25/2018 9:00,77,69,69,29,51,295,5,100
1705,3/25/2018 9:05,77,65,87,27,56,312,5,100
1706,3/25/2018 9:10,79,64,94,22,60,319,5,100
1707,3/25/2018 9:15,81,71,93,36,55,336,5,100
1708,3/25/2018 9:20,89,76,103,44,54,366,5,100
1709,3/25/2018 9:25,97,81,88,34,68,368,5,100
1710,3/25/2018 9:30,77,71,90,38,57,333,5,100
1711,3/25/2018 9:35,87,75,92,44,71,369,5,100
1712,3/25/2018 9:40,98,84,93,33,62,370,5,100
1713,3/25/2018 9:45,93,86,104,41,73,397,5,100
1714,3/25/2018 9:50,115,96,110,43,84,448,5,100
1715,3/25/2018 9:55,114,103,115,45,82,459,5,100
1716,3/25/2018 10:00,113,85,98,37,63,396,5,100
1717,3/25/2018 10:05,101,92,101,39,70,403,5,100
1718,3/25/2018 10:10,110,99,104,43,74,430,5,100
1719,3/25/2018 10:15,123,103,122,47,83,478,5,100
1720,3/25/2018 10:20,124,87,117,48,81,457,5,100
1721,3/25/2018 10:25,150,107,118,56,76,507,5,100
1722,3/25/2018 10:30,121,102,110,51,77,461,5,100
1723,3/25/2018 10:35,118,90,110,44,79,441,5,100
1724,3/25/2018 10:40,128,97,111,52,79,467,5,100
1725,3/25/2018 10:45,114,87,99,44,82,426,5,100
1726,3/25/2018 10:50,119,94,120,49,85,467,5,100
1727,3/25/2018 10:55,126,96,116,57,90,485,5,100
1728,3/25/2018 11:00,147,119,129,49,84,528,5,100
1729,3/25/2018 11:05,139,115,140,64,88,546,5,100
1730,3/25/2018 11:10,120,101,120,56,83,480,5,100
1731,3/25/2018 11:15,127,101,123,48,92,491,5,100
1732,3/25/2018 11:20,130,114,127,46,82,499,5,100
1733,3/25/2018 11:25,147,111,140,65,92,555,5,100
1734,3/25/2018 11:30,151,116,137,55,90,549,5,100
1735,3/25/2018 11:35,141,105,127,52,98,523,5,100
1736,3/25/2018 11:40,110,95,122,52,85,464,5,100
1737,3/25/2018 11:45,131,108,123,55,91,508,5,100
1738,3/25/2018 11:50,123,104,120,58,93,498,5,100
1739,3/25/2018 11:55,134,113,134,54,92,527,5,100
0,3/25/2018 11:00,147,119,129,49,84,528,5,100
1,3/25/2018 11:05,139,115,140,64,88,546,5,100
2,3/25/2018 11:10,120,101,120,56,83,480,5,100
3,3/25/2018 11:15,127,101,123,48,92,491,5,100
4,3/25/2018 11:20,130,114,127,46,82,499,5,100
5,3/25/2018 11:25,147,111,140,65,92,555,5,100
6,3/25/2018 11:30,151,116,137,55,90,549,5,100
7,3/25/2018 11:35,141,105,127,52,98,523,5,100
8,3/25/2018 11:40,110,95,122,52,85,464,5,100
9,3/25/2018 11:45,131,108,123,55,91,508,5,100
10,3/25/2018 11:50,123,104,120,58,93,498,5,100
11,3/25/2018 11:55,134,113,134,54,92,527,5,100
12,3/25/2018 12:00,139,119,137,66,99,560,5,100
13,3/25/2018 12:05,125,91,121,62,80,479,5,100
14,3/25/2018 12:10,124,113,129,65,92,523,5,100
15,3/25/2018 12:15,142,108,127,48,97,522,5,100
16,3/25/2018 12:20,144,121,119,58,95,537,5,100
17,3/25/2018 12:25,145,123,125,62,113,568,5,100
18,3/25/2018 12:30,149,113,142,72,113,589,5,100
19,3/25/2018 12:35,144,117,128,52,105,546,5,100
20,3/25/2018 12:40,149,118,142,52,109,570,5,100
21,3/25/2018 12:45,134,110,127,55,104,530,5,100
22,3/25/2018 12:50,113,111,119,77,97,517,5,100
23,3/25/2018 12:55,109,108,106,73,108,504,5,100
24,3/25/2018 13:00,110,105,112,86,105,518,5,100
25,3/25/2018 13:05,100,106,114,70,105,495,5,100
26,3/25/2018 13:10,124,103,125,70,90,512,5,100
27,3/25/2018 13:15,124,107,127,54,90,502,5,100
28,3/25/2018 13:20,109,96,113,44,78,440,5,100
29,3/25/2018 13:25,97,72,103,51,75,398,5,100
30,3/25/2018 13:30,114,91,101,50,80,436,5,100
31,3/25/2018 13:35,112,88,110,60,82,452,5,100
32,3/25/2018 13:40,114,104,113,48,86,465,5,100
33,3/25/2018 13:45,106,84,106,53,78,427,5,100
34,3/25/2018 13:50,118,94,110,53,81,456,5,100
35,3/25/2018 13:55,111,99,121,44,87,462,5,100
36,3/25/2018 14:00,119,106,114,57,91,487,5,100
37,3/25/2018 14:05,134,107,116,53,107,517,5,100
38,3/25/2018 14:10,123,111,129,53,103,519,5,100
39,3/25/2018 14:15,136,103,134,52,102,527,5,100
40,3/25/2018 14:20,124,129,141,62,104,560,5,100
41,3/25/2018 14:25,130,106,126,49,99,510,5,100
42,3/25/2018 14:30,138,107,119,54,105,523,5,100
43,3/25/2018 14:35,126,106,125,60,86,503,5,100
44,3/25/2018 14:40,128,110,123,68,90,519,5,100
45,3/25/2018 14:45,117,102,125,65,90,499,5,100
46,3/25/2018 14:50,122,100,117,56,79,474,5,100
47,3/25/2018 14:55,136,118,119,60,88,521,5,100
48,3/25/2018 15:00,134,119,131,62,98,544,5,100
49,3/25/2018 15:05,136,106,124,62,81,509,5,100
50,3/25/2018 15:10,129,112,131,42,95,509,5,100
51,3/25/2018 15:15,131,101,127,49,103,511,5,100
52,3/25/2018 15:20,141,107,137,52,90,527,5,100
53,3/25/2018 15:25,149,115,139,46,100,549,5,100
54,3/25/2018 15:30,129,103,125,49,98,504,5,100
55,3/25/2018 15:35,126,111,137,65,92,531,5,100
56,3/25/2018 15:40,127,106,129,50,87,499,5,100
57,3/25/2018 15:45,121,100,127,63,90,501,5,100
58,3/25/2018 15:50,122,106,116,57,101,502,5,100
59,3/25/2018 15:55,122,95,114,47,80,458,5,100
60,3/25/2018 16:00,123,101,120,52,74,470,5,100
61,3/25/2018 16:05,107,87,117,63,91,465,5,100
62,3/25/2018 16:10,129,108,123,49,88,497,5,100
63,3/25/2018 16:15,128,98,123,51,96,496,5,100
64,3/25/2018 16:20,116,99,123,59,95,492,5,100
65,3/25/2018 16:25,128,113,128,52,103,524,5,100
66,3/25/2018 16:30,118,108,123,58,95,502,5,100
67,3/25/2018 16:35,132,113,132,67,98,542,5,100
68,3/25/2018 16:40,143,113,126,56,97,535,5,100
69,3/25/2018 16:45,132,108,134,59,102,535,5,100
70,3/25/2018 16:50,139,112,129,57,97,534,5,100
71,3/25/2018 16:55,149,101,129,71,99,549,5,100
72,3/25/2018 17:00,137,97,128,50,95,507,5,100
73,3/25/2018 17:05,125,110,134,59,102,530,5,100
74,3/25/2018 17:10,117,95,124,48,113,497,5,100
75,3/25/2018 17:15,133,106,124,53,85,501,5,100
76,3/25/2018 17:20,135,106,122,43,83,489,5,100
77,3/25/2018 17:25,133,106,129,59,89,516,5,100
78,3/25/2018 17:30,135,117,141,62,101,556,5,100
79,3/25/2018 17:35,135,101,134,71,89,530,5,100
80,3/25/2018 17:40,126,96,119,61,89,491,5,100
81,3/25/2018 17:45,138,98,131,47,84,498,5,100
82,3/25/2018 17:50,140,108,153,58,95,554,5,100
83,3/25/2018 17:55,123,103,130,57,87,500,5,100
84,3/25/2018 18:00,132,107,126,48,89,502,5,100
85,3/25/2018 18:05,135,110,125,53,99,522,5,100
86,3/25/2018 18:10,135,104,109,59,85,492,5,100
87,3/25/2018 18:15,128,107,124,47,81,487,5,100
88,3/25/2018 18:20,136,98,132,53,92,511,5,100
89,3/25/2018 18:25,123,99,112,39,83,456,5,100
90,3/25/2018 18:30,148,102,123,47,101,521,5,100
91,3/25/2018 18:35,126,102,113,53,81,475,5,100
92,3/25/2018 18:40,126,99,121,49,73,468,5,100
93,3/25/2018 18:45,136,97,114,46,86,479,5,100
94,3/25/2018 18:50,120,96,122,55,84,477,5,100
95,3/25/2018 18:55,119,92,112,42,73,438,5,100
96,3/25/2018 19:00,107,91,103,55,72,428,5,100
97,3/25/2018 19:05,132,85,113,47,74,451,5,100
98,3/25/2018 19:10,122,97,116,42,72,449,5,100
99,3/25/2018 19:15,108,90,103,55,64,420,5,100
100,3/25/2018 19:20,110,93,112,48,68,431,5,100
101,3/25/2018 19:25,113,90,108,39,65,415,5,100
102,3/25/2018 19:30,108,69,104,40,61,382,5,100
103,3/25/2018 19:35,116,83,95,48,69,411,5,100
104,3/25/2018 19:40,122,85,111,41,65,424,5,100
105,3/25/2018 19:45,106,85,110,53,73,427,5,100
106,3/25/2018 19:50,105,83,104,41,79,412,5,100
107,3/25/2018 19:55,102,79,99,43,63,386,5,100
108,3/25/2018 20:00,121,82,101,39,72,415,5,100
109,3/25/2018 20:05,118,84,110,44,87,443,5,100
110,3/25/2018 20:10,109,88,103,39,77,416,5,100
111,3/25/2018 20:15,122,82,106,47,60,417,5,100
112,3/25/2018 20:20,114,88,107,33,68,410,5,100
113,3/25/2018 20:25,113,90,116,49,58,426,5,100
114,3/25/2018 20:30,112,89,109,32,69,411,5,100
115,3/25/2018 20:35,113,86,105,48,67,419,5,100
116,3/25/2018 20:40,102,83,93,40,52,370,5,100
117,3/25/2018 20:45,112,82,111,39,58,402,5,100
118,3/25/2018 20:50,115,67,94,32,60,368,5,100
119,3/25/2018 20:55,111,78,111,46,53,399,5,100
120,3/25/2018 21:00,108,89,91,45,72,405,5,100
121,3/25/2018 21:05,107,78,92,40,80,397,5,100
122,3/25/2018 21:10,104,76,100,35,43,358,5,100
123,3/25/2018 21:15,110,77,98,33,64,382,5,100
124,3/25/2018 21:20,94,76,98,46,66,380,5,100
125,3/25/2018 21:25,109,81,104,43,66,403,5,100
126,3/25/2018 21:30,98,71,94,35,62,360,5,100
127,3/25/2018 21:35,99,68,94,33,66,360,5,100
128,3/25/2018 21:40,103,80,106,46,57,392,5,100
129,3/25/2018 21:45,111,88,96,41,69,405,5,100
130,3/25/2018 21:50,96,71,112,44,58,381,5,100
131,3/25/2018 21:55,82,68,92,32,65,339,5,100
132,3/25/2018 22:00,99,78,93,41,66,377,5,100
133,3/25/2018 22:05,92,77,105,36,47,357,5,100
134,3/25/2018 22:10,75,68,83,36,58,320,5,100
135,3/25/2018 22:15,91,72,93,34,67,357,5,100
136,3/25/2018 22:20,80,79,84,40,63,346,5,100
137,3/25/2018 22:25,76,60,77,20,48,281,5,100
138,3/25/2018 22:30,75,65,76,30,49,295,5,100
139,3/25/2018 22:35,69,60,78,32,54,293,5,100
140,3/25/2018 22:40,69,60,72,26,48,275,5,100
141,3/25/2018 22:45,66,60,73,27,60,286,5,100
142,3/25/2018 22:50,63,53,64,33,54,267,5,100
143,3/25/2018 22:55,69,53,71,32,44,269,5,100
144,3/25/2018 23:00,64,48,65,26,49,252,5,100
145,3/25/2018 23:05,61,49,62,22,46,240,5,100
146,3/25/2018 23:10,64,60,57,30,45,256,5,100
147,3/25/2018 23:15,51,52,62,28,44,237,5,100
148,3/25/2018 23:20,59,53,62,28,52,254,5,100
149,3/25/2018 23:25,56,42,58,17,40,213,5,100
150,3/25/2018 23:30,50,42,53,30,42,217,5,100
151,3/25/2018 23:35,36,44,55,24,44,203,5,100
152,3/25/2018 23:40,53,52,61,19,40,225,5,100
153,3/25/2018 23:45,44,44,59,20,35,202,5,100
154,3/25/2018 23:50,44,40,45,23,39,191,5,100
155,3/25/2018 23:55,33,39,47,21,47,187,5,100
156,3/26/2018 0:00,36,36,39,19,26,156,5,100
157,3/26/2018 0:05,39,41,38,18,32,168,5,100
158,3/26/2018 0:10,31,32,46,15,38,162,5,100
159,3/26/2018 0:15,30,34,35,15,46,160,5,100
160,3/26/2018 0:20,33,35,47,16,21,152,5,100
161,3/26/2018 0:25,24,26,28,10,24,112,5,100
162,3/26/2018 0:30,26,33,37,11,29,136,5,100
163,3/26/2018 0:35,21,28,31,15,25,120,5,100
164,3/26/2018 0:40,22,30,32,15,25,124,5,100
165,3/26/2018 0:45,22,29,30,12,27,120,5,100
166,3/26/2018 0:50,25,23,28,16,12,104,5,100
167,3/26/2018 0:55,21,27,24,11,19,102,5,100
168,3/26/2018 1:00,18,22,20,9,19,88,5,100
169,3/26/2018 1:05,17,22,17,10,24,90,5,100
170,3/26/2018 1:10,15,23,25,9,22,94,5,100
171,3/26/2018 1:15,15,29,21,12,21,98,5,100
172,3/26/2018 1:20,12,21,19,7,21,80,5,100
173,3/26/2018 1:25,13,21,13,10,23,80,5,100
174,3/26/2018 1:30,14,19,19,10,20,82,5,100
175,3/26/2018 1:35,8,15,23,10,19,75,5,100
176,3/26/2018 1:40,9,21,15,9,22,76,5,100
177,3/26/2018 1:45,11,11,13,6,19,60,5,100
178,3/26/2018 1:50,12,17,20,12,17,78,5,100
179,3/26/2018 1:55,10,17,17,4,14,62,5,100
180,3/26/2018 2:00,11,20,18,10,15,74,5,100
181,3/26/2018 2:05,8,18,16,4,12,58,5,100
182,3/26/2018 2:10,5,12,10,7,9,43,5,100
183,3/26/2018 2:15,9,12,16,7,12,56,5,100
184,3/26/2018 2:20,12,21,15,6,13,67,5,100
185,3/26/2018 2:25,9,17,9,4,18,57,5,100
186,3/26/2018 2:30,9,12,12,2,10,45,5,100
187,3/26/2018 2:35,5,17,12,3,7,44,5,100
188,3/26/2018 2:40,7,10,10,3,11,41,5,100
189,3/26/2018 2:45,6,16,12,4,13,51,5,100
190,3/26/2018 2:50,5,9,14,6,9,43,5,100
191,3/26/2018 2:55,5,10,10,2,5,32,5,100
192,3/26/2018 3:00,7,7,9,5,10,38,5,100
193,3/26/2018 3:05,8,8,10,5,12,43,5,100
194,3/26/2018 3:10,6,15,10,2,7,40,5,100
195,3/26/2018 3:15,10,11,13,4,9,47,5,100
196,3/26/2018 3:20,11,12,6,4,11,44,5,100
197,3/26/2018 3:25,7,11,5,3,4,30,5,100
198,3/26/2018 3:30,12,10,15,0,12,49,5,100
199,3/26/2018 3:35,9,11,16,4,13,53,5,100
200,3/26/2018 3:40,12,13,10,8,11,54,5,100
201,3/26/2018 3:45,10,18,14,5,14,61,5,100
202,3/26/2018 3:50,14,18,22,11,24,89,5,100
203,3/26/2018 3:55,9,11,15,12,12,59,5,100
204,3/26/2018 4:00,7,19,18,3,7,54,5,100
205,3/26/2018 4:05,8,21,18,7,22,76,5,100
206,3/26/2018 4:10,15,13,23,2,14,67,5,100
207,3/26/2018 4:15,17,20,21,8,17,83,5,100
208,3/26/2018 4:20,16,19,27,4,16,82,5,100
209,3/26/2018 4:25,23,29,25,11,18,106,5,100
210,3/26/2018 4:30,27,34,25,11,20,117,5,100
211,3/26/2018 4:35,21,26,29,11,22,109,5,100
212,3/26/2018 4:40,30,31,39,16,29,145,5,100
213,3/26/2018 4:45,35,29,43,12,30,149,5,100
214,3/26/2018 4:50,43,29,31,17,23,143,5,100
215,3/26/2018 4:55,41,37,45,24,33,180,5,100
216,3/26/2018 5:00,46,35,50,19,30,180,5,100
217,3/26/2018 5:05,46,32,53,17,26,174,5,100
218,3/26/2018 5:10,51,35,64,20,30,200,5,100
219,3/26/2018 5:15,66,48,64,20,38,236,5,100
220,3/26/2018 5:20,72,48,55,20,39,234,5,100
221,3/26/2018 5:25,58,46,57,17,30,208,5,100
222,3/26/2018 5:30,73,60,72,23,52,280,5,100
223,3/26/2018 5:35,93,57,84,28,43,305,5,100
224,3/26/2018 5:40,92,60,88,34,54,328,5,100
225,3/26/2018 5:45,89,73,86,39,56,343,5,100
226,3/26/2018 5:50,91,73,79,30,57,330,5,100
227,3/26/2018 5:55,87,57,76,27,57,304,5,100
228,3/26/2018 6:00,74,63,73,33,41,284,5,100
229,3/26/2018 6:05,79,59,79,29,50,296,5,100
230,3/26/2018 6:10,88,55,77,34,57,311,5,100
231,3/26/2018 6:15,99,71,88,40,54,352,5,100
232,3/26/2018 6:20,79,70,79,48,53,329,5,100
233,3/26/2018 6:25,91,76,76,44,53,340,5,100
234,3/26/2018 6:30,106,68,94,49,71,388,5,100
235,3/26/2018 6:35,116,84,93,51,67,411,5,100
236,3/26/2018 6:40,113,92,108,55,79,447,5,100
237,3/26/2018 6:45,124,97,115,53,76,465,5,100
238,3/26/2018 6:50,111,86,107,47,74,425,5,100
239,3/26/2018 6:55,113,83,100,56,69,421,5,100
240,3/26/2018 7:00,115,88,105,43,81,432,5,100
241,3/26/2018 7:05,113,81,116,48,87,445,5,100
242,3/26/2018 7:10,135,102,110,61,79,487,5,100
243,3/26/2018 7:15,148,101,137,66,84,536,5,100
244,3/26/2018 7:20,137,107,120,74,93,531,5,100
245,3/26/2018 7:25,147,115,140,75,102,579,5,100
246,3/26/2018 7:30,154,111,162,73,113,613,5,100
247,3/26/2018 7:35,139,96,121,71,85,512,5,100
248,3/26/2018 7:40,163,134,147,76,100,620,5,100
249,3/26/2018 7:45,156,102,138,67,92,555,5,100
250,3/26/2018 7:50,138,110,127,88,98,561,5,100
251,3/26/2018 7:55,131,106,131,84,100,552,5,100
252,3/26/2018 8:00,128,99,116,66,81,490,5,100
253,3/26/2018 8:05,137,108,117,69,88,519,5,100
254,3/26/2018 8:10,138,92,130,84,87,531,5,100
255,3/26/2018 8:15,130,101,124,69,91,515,5,100
256,3/26/2018 8:20,140,104,125,73,97,539,5,100
257,3/26/2018 8:25,109,81,116,48,85,439,5,100
258,3/26/2018 8:30,136,90,143,58,95,522,5,100
259,3/26/2018 8:35,149,102,122,66,95,534,5,100
260,3/26/2018 8:40,148,101,127,61,83,520,5,100
261,3/26/2018 8:45,138,109,117,72,76,512,5,100
262,3/26/2018 8:50,121,101,126,60,93,501,5,100
263,3/26/2018 8:55,107,79,117,74,80,457,5,100
264,3/26/2018 9:00,125,85,116,69,80,475,5,100
265,3/26/2018 9:05,112,78,112,70,70,442,5,100
266,3/26/2018 9:10,104,89,103,57,67,420,5,100
267,3/26/2018 9:15,129,92,111,50,69,451,5,100
268,3/26/2018 9:20,113,89,97,68,81,448,5,100
269,3/26/2018 9:25,122,94,103,64,76,459,5,100
270,3/26/2018 9:30,124,81,115,72,70,462,5,100
271,3/26/2018 9:35,133,104,119,57,88,501,5,100
272,3/26/2018 9:40,122,93,111,59,84,469,5,100
273,3/26/2018 9:45,124,87,109,52,91,463,5,100
274,3/26/2018 9:50,111,89,111,57,91,459,5,100
275,3/26/2018 9:55,109,84,92,54,85,424,5,100
276,3/26/2018 10:00,119,97,118,52,80,466,5,100
277,3/26/2018 10:05,107,94,104,61,92,458,5,100
278,3/26/2018 10:10,112,101,117,56,83,469,5,100
279,3/26/2018 10:15,107,73,107,50,88,425,5,100
280,3/26/2018 10:20,130,106,121,52,73,482,5,100
281,3/26/2018 10:25,116,96,107,59,82,460,5,100
282,3/26/2018 10:30,117,105,107,61,82,472,5,100
283,3/26/2018 10:35,119,94,111,61,94,479,5,100
284,3/26/2018 10:40,132,103,122,63,81,501,5,100
285,3/26/2018 10:45,134,108,146,66,99,553,5,100
286,3/26/2018 10:50,121,101,119,52,84,477,5,100
287,3/26/2018 10:55,128,100,115,56,86,485,5,100
288,3/26/2018 11:00,128,93,118,63,79,481,5,100
289,3/26/2018 11:05,141,102,122,53,77,495,5,100
290,3/26/2018 11:10,134,110,124,54,86,508,5,100
291,3/26/2018 11:15,132,99,117,52,84,484,5,100
292,3/26/2018 11:20,123,92,108,58,79,460,5,100
293,3/26/2018 11:25,125,98,114,55,80,472,5,100
294,3/26/2018 11:30,128,103,116,43,84,474,5,100
295,3/26/2018 11:35,132,91,118,61,93,495,5,100
296,3/26/2018 11:40,142,105,135,61,78,521,5,100
297,3/26/2018 11:45,140,98,135,64,81,518,5,100
298,3/26/2018 11:50,120,97,110,72,85,484,5,100
299,3/26/2018 11:55,116,91,106,58,79,450,5,100
300,3/26/2018 12:00,125,95,106,50,71,447,5,100
301,3/26/2018 12:05,129,99,124,71,93,516,5,100
302,3/26/2018 12:10,135,96,141,70,112,554,5,100
303,3/26/2018 12:15,135,95,113,53,89,485,5,100
304,3/26/2018 12:20,138,102,125,58,92,515,5,100
305,3/26/2018 12:25,130,106,128,73,99,536,5,100
306,3/26/2018 12:30,125,110,120,65,86,506,5,100
307,3/26/2018 12:35,144,103,137,58,93,535,5,100
308,3/26/2018 12:40,135,110,130,68,91,534,5,100
309,3/26/2018 12:45,136,101,136,58,90,521,5,100
310,3/26/2018 12:50,130,89,128,61,90,498,5,100
311,3/26/2018 12:55,129,97,133,68,86,513,5,100
312,3/26/2018 13:00,131,105,130,55,90,511,5,100
313,3/26/2018 13:05,132,96,127,77,102,534,5,100
314,3/26/2018 13:10,119,104,111,63,78,475,5,100
315,3/26/2018 13:15,130,105,117,60,93,505,5,100
316,3/26/2018 13:20,119,104,129,79,95,526,5,100
317,3/26/2018 13:25,118,105,119,76,102,520,5,100
318,3/26/2018 13:30,127,116,124,62,92,521,5,100
319,3/26/2018 13:35,131,116,109,67,107,530,5,100
320,3/26/2018 13:40,142,111,137,77,109,576,5,100
321,3/26/2018 13:45,127,107,119,71,102,526,5,100
322,3/26/2018 13:50,123,99,123,66,85,496,5,100
323,3/26/2018 13:55,126,121,123,78,98,546,5,100
324,3/26/2018 14:00,120,97,115,85,86,503,5,100
325,3/26/2018 14:05,125,88,133,79,96,521,5,100
326,3/26/2018 14:10,118,96,112,73,84,483,5,100
327,3/26/2018 14:15,120,107,124,97,99,547,5,100
328,3/26/2018 14:20,116,103,111,86,101,517,5,100
329,3/26/2018 14:25,111,110,111,113,102,547,5,100
330,3/26/2018 14:30,110,94,106,124,99,533,5,100
331,3/26/2018 14:35,106,86,100,110,97,499,5,100
332,3/26/2018 14:40,95,86,94,114,87,476,5,100
333,3/26/2018 14:45,85,90,88,113,82,458,5,100
334,3/26/2018 14:50,112,100,104,116,90,522,5,100
335,3/26/2018 14:55,85,86,99,111,95,476,5,100
336,3/26/2018 15:00,108,102,124,91,81,506,5,100
337,3/26/2018 15:05,84,87,85,106,85,447,5,100
338,3/26/2018 15:10,96,94,103,109,93,495,5,100
339,3/26/2018 15:15,78,79,73,112,82,424,5,100
340,3/26/2018 15:20,91,83,88,112,85,459,5,100
341,3/26/2018 15:25,87,87,81,115,90,460,5,100
342,3/26/2018 15:30,91,80,84,113,89,457,5,100
343,3/26/2018 15:35,91,86,81,99,89,446,5,100
344,3/26/2018 15:40,92,75,86,106,88,447,5,100
345,3/26/2018 15:45,96,84,93,101,95,469,5,100
346,3/26/2018 15:50,85,77,81,111,93,447,5,100
347,3/26/2018 15:55,89,84,88,107,92,460,5,100
348,3/26/2018 16:00,89,81,99,83,69,421,5,100
349,3/26/2018 16:05,79,98,86,115,84,462,5,100
350,3/26/2018 16:10,87,96,97,112,81,473,5,100
351,3/26/2018 16:15,87,89,77,109,82,444,5,100
352,3/26/2018 16:20,96,94,88,113,98,489,5,100
353,3/26/2018 16:25,87,92,90,96,73,438,5,100
354,3/26/2018 16:30,76,87,82,98,80,423,5,100
355,3/26/2018 16:35,77,66,65,105,84,397,5,100
356,3/26/2018 16:40,87,80,88,119,97,471,5,100
357,3/26/2018 16:45,81,89,82,111,84,447,5,100
358,3/26/2018 16:50,77,73,74,124,90,438,5,100
359,3/26/2018 16:55,58,48,48,76,61,291,5,100
360,3/26/2018 17:00,80,82,78,116,85,441,5,100
361,3/26/2018 17:05,80,69,72,109,84,414,5,100
362,3/26/2018 17:10,76,79,73,102,89,419,5,100
363,3/26/2018 17:15,93,83,86,117,96,475,5,100
364,3/26/2018 17:20,70,68,64,73,72,347,5,100
365,3/26/2018 17:25,85,73,81,112,89,440,5,100
366,3/26/2018 17:30,77,70,75,108,86,416,5,100
367,3/26/2018 17:35,89,73,81,111,98,452,5,100
368,3/26/2018 17:40,84,84,82,124,89,463,5,100
369,3/26/2018 17:45,88,94,85,112,89,468,5,100
370,3/26/2018 17:50,90,85,87,113,86,461,5,100
371,3/26/2018 17:55,82,75,76,110,73,416,5,100
372,3/26/2018 18:00,80,80,82,115,80,437,5,100
373,3/26/2018 18:05,76,87,75,113,87,438,5,100
374,3/26/2018 18:10,94,87,101,104,81,467,5,100
375,3/26/2018 18:15,95,91,98,102,90,476,5,100
376,3/26/2018 18:20,96,78,102,106,94,476,5,100
377,3/26/2018 18:25,94,96,100,101,86,477,5,100
378,3/26/2018 18:30,99,100,103,99,86,487,5,100
379,3/26/2018 18:35,106,88,118,80,95,487,5,100
380,3/26/2018 18:40,116,80,115,80,84,475,5,100
381,3/26/2018 18:45,111,100,110,77,90,488,5,100
382,3/26/2018 18:50,105,98,105,78,69,455,5,100
383,3/26/2018 18:55,115,89,119,70,81,474,5,100
384,3/26/2018 19:00,125,101,104,66,83,479,5,100
385,3/26/2018 19:05,112,98,118,58,84,470,5,100
386,3/26/2018 19:10,126,103,121,73,77,500,5,100
387,3/26/2018 19:15,134,96,131,64,96,521,5,100
388,3/26/2018 19:20,128,104,118,74,89,513,5,100
389,3/26/2018 19:25,130,102,118,82,95,527,5,100
390,3/26/2018 19:30,133,115,126,85,95,554,5,100
391,3/26/2018 19:35,122,96,121,71,86,496,5,100
392,3/26/2018 19:40,128,114,127,67,88,524,5,100
393,3/26/2018 19:45,126,115,110,57,92,500,5,100
394,3/26/2018 19:50,114,103,120,59,88,484,5,100
395,3/26/2018 19:55,123,99,105,59,96,482,5,100
396,3/26/2018 20:00,110,93,99,43,76,421,5,100
397,3/26/2018 20:05,106,77,100,48,81,412,5,100
398,3/26/2018 20:10,113,101,106,62,88,470,5,100
399,3/26/2018 20:15,135,90,114,45,76,460,5,100
400,3/26/2018 20:20,111,93,107,44,90,445,5,100
401,3/26/2018 20:25,113,85,105,44,82,429,5,100
402,3/26/2018 20:30,102,78,114,54,82,430,5,100
403,3/26/2018 20:35,107,80,107,54,77,425,5,100
404,3/26/2018 20:40,123,88,113,40,80,444,5,100
405,3/26/2018 20:45,97,92,109,43,78,419,5,100
406,3/26/2018 20:50,92,81,95,32,72,372,5,100
407,3/26/2018 20:55,82,81,101,47,69,380,5,100
408,3/26/2018 21:00,99,80,100,46,75,400,5,100
409,3/26/2018 21:05,98,71,100,38,63,370,5,100
410,3/26/2018 21:10,91,68,82,34,68,343,5,100
411,3/26/2018 21:15,97,79,103,36,66,381,5,100
412,3/26/2018 21:20,108,76,101,41,70,396,5,100
413,3/26/2018 21:25,95,83,98,41,75,392,5,100
414,3/26/2018 21:30,100,77,89,35,67,368,5,100
415,3/26/2018 21:35,71,66,75,27,52,291,5,100
416,3/26/2018 21:40,92,71,86,43,60,352,5,100
417,3/26/2018 21:45,84,73,89,43,56,345,5,100
418,3/26/2018 21:50,74,70,67,42,59,312,5,100
419,3/26/2018 21:55,82,71,88,47,55,343,5,100
420,3/26/2018 22:00,86,72,87,35,56,336,5,100
421,3/26/2018 22:05,74,67,88,43,56,328,5,100
422,3/26/2018 22:10,95,73,77,39,53,337,5,100
423,3/26/2018 22:15,90,62,76,33,50,311,5,100
424,3/26/2018 22:20,81,62,82,40,71,336,5,100
425,3/26/2018 22:25,84,82,83,39,59,347,5,100
426,3/26/2018 22:30,70,62,77,28,49,286,5,100
427,3/26/2018 22:35,63,68,65,40,57,293,5,100
428,3/26/2018 22:40,63,55,71,26,47,262,5,100
429,3/26/2018 22:45,59,51,71,31,42,254,5,100
430,3/26/2018 22:50,59,64,74,35,43,275,5,100
431,3/26/2018 22:55,54,49,60,21,38,222,5,100
432,3/26/2018 23:00,61,57,79,26,43,266,5,100
433,3/26/2018 23:05,51,53,57,30,36,227,5,100
434,3/26/2018 23:10,52,58,66,32,52,260,5,100
435,3/26/2018 23:15,53,50,63,24,35,225,5,100
436,3/26/2018 23:20,60,44,57,33,46,240,5,100
437,3/26/2018 23:25,42,51,54,22,43,212,5,100
438,3/26/2018 23:30,51,40,60,19,43,213,5,100
439,3/26/2018 23:35,46,53,50,26,43,218,5,100
440,3/26/2018 23:40,36,47,44,24,37,188,5,100
441,3/26/2018 23:45,44,50,46,17,38,195,5,100
442,3/26/2018 23:50,36,35,48,21,32,172,5,100
443,3/26/2018 23:55,43,36,49,27,40,195,5,100
444,3/27/2018 0:00,20,30,35,18,40,143,5,100
445,3/27/2018 0:05,30,37,46,17,22,152,5,100
446,3/27/2018 0:10,22,36,35,14,19,126,5,100
447,3/27/2018 0:15,31,36,37,14,34,152,5,100
448,3/27/2018 0:20,29,32,38,12,27,138,5,100
449,3/27/2018 0:25,23,28,27,10,35,123,5,100
450,3/27/2018 0:30,13,32,30,10,26,111,5,100
451,3/27/2018 0:35,25,26,30,11,28,120,5,100
452,3/27/2018 0:40,21,26,27,13,24,111,5,100
453,3/27/2018 0:45,21,20,27,6,20,94,5,100
454,3/27/2018 0:50,16,27,28,12,22,105,5,100
455,3/27/2018 0:55,18,34,23,20,30,125,5,100
456,3/27/2018 1:00,8,29,20,12,26,95,5,100
457,3/27/2018 1:05,15,24,25,8,22,94,5,100
458,3/27/2018 1:10,22,24,19,13,24,102,5,100
459,3/27/2018 1:15,11,26,25,7,16,85,5,100
460,3/27/2018 1:20,11,20,19,14,16,80,5,100
461,3/27/2018 1:25,15,23,24,9,17,88,5,100
462,3/27/2018 1:30,7,21,12,9,20,69,5,100
463,3/27/2018 1:35,11,14,17,12,19,73,5,100
464,3/27/2018 1:40,11,17,22,8,17,75,5,100
465,3/27/2018 1:45,15,17,21,7,9,69,5,100
466,3/27/2018 1:50,7,22,18,7,18,72,5,100
467,3/27/2018 1:55,9,12,15,8,15,59,5,100
468,3/27/2018 2:00,10,20,14,14,15,73,5,100
469,3/27/2018 2:05,6,14,13,6,15,54,5,100
470,3/27/2018 2:10,11,22,15,10,19,77,5,100
471,3/27/2018 2:15,13,19,10,1,16,59,5,100
472,3/27/2018 2:20,8,13,15,6,11,53,5,100
473,3/27/2018 2:25,15,14,11,9,13,62,5,100
474,3/27/2018 2:30,6,13,13,3,10,45,5,100
475,3/27/2018 2:35,7,16,21,7,12,63,5,100
476,3/27/2018 2:40,6,11,8,3,14,42,5,100
477,3/27/2018 2:45,6,17,17,3,11,54,5,100
478,3/27/2018 2:50,10,10,12,2,14,48,5,100
479,3/27/2018 2:55,6,10,14,5,9,44,5,100
480,3/27/2018 3:00,2,16,10,3,8,39,5,100
481,3/27/2018 3:05,6,11,8,4,10,39,5,100
482,3/27/2018 3:10,5,15,9,5,9,43,5,100
483,3/27/2018 3:15,4,12,10,2,11,39,5,100
484,3/27/2018 3:20,9,14,8,1,10,42,5,100
485,3/27/2018 3:25,6,11,12,6,14,49,5,100
486,3/27/2018 3:30,7,22,10,5,18,62,5,100
487,3/27/2018 3:35,6,20,16,6,11,59,5,100
488,3/27/2018 3:40,10,13,15,6,10,54,5,100
489,3/27/2018 3:45,12,10,18,4,16,60,5,100
490,3/27/2018 3:50,9,17,17,5,11,59,5,100
491,3/27/2018 3:55,13,19,21,4,4,61,5,100
492,3/27/2018 4:00,11,18,11,11,11,62,5,100
493,3/27/2018 4:05,6,12,16,1,17,52,5,100
494,3/27/2018 4:10,11,15,15,9,13,63,5,100
495,3/27/2018 4:15,24,22,21,7,14,88,5,100
496,3/27/2018 4:20,15,21,28,12,17,93,5,100
497,3/27/2018 4:25,23,22,23,11,23,102,5,100
498,3/27/2018 4:30,21,18,23,9,18,89,5,100
499,3/27/2018 4:35,22,34,31,14,27,128,5,100
500,3/27/2018 4:40,33,20,32,4,17,106,5,100
501,3/27/2018 4:45,44,34,48,21,41,188,5,100
502,3/27/2018 4:50,31,32,42,17,29,151,5,100
503,3/27/2018 4:55,38,36,37,19,23,153,5,100
504,3/27/2018 5:00,35,29,43,9,29,145,5,100
505,3/27/2018 5:05,54,49,46,13,30,192,5,100
506,3/27/2018 5:10,49,27,49,16,23,164,5,100
507,3/27/2018 5:15,53,35,52,14,30,184,5,100
508,3/27/2018 5:20,65,55,63,25,36,244,5,100
509,3/27/2018 5:25,58,48,62,14,48,230,5,100
510,3/27/2018 5:30,81,55,76,24,34,270,5,100
511,3/27/2018 5:35,61,64,78,35,45,283,5,100
512,3/27/2018 5:40,87,58,80,41,53,319,5,100
513,3/27/2018 5:45,78,65,86,36,53,318,5,100
514,3/27/2018 5:50,77,62,91,31,49,310,5,100
515,3/27/2018 5:55,80,54,72,34,43,283,5,100
516,3/27/2018 6:00,89,60,74,22,41,286,5,100
517,3/27/2018 6:05,81,65,71,40,50,307,5,100
518,3/27/2018 6:10,89,67,91,35,62,344,5,100
519,3/27/2018 6:15,81,67,86,41,55,330,5,100
520,3/27/2018 6:20,96,73,90,35,71,365,5,100
521,3/27/2018 6:25,111,73,87,38,52,361,5,100
522,3/27/2018 6:30,97,75,92,50,66,380,5,100
523,3/27/2018 6:35,118,71,84,54,85,412,5,100
524,3/27/2018 6:40,117,77,107,57,78,436,5,100
525,3/27/2018 6:45,108,79,111,38,79,415,5,100
526,3/27/2018 6:50,125,83,102,73,69,452,5,100
527,3/27/2018 6:55,120,94,117,57,79,467,5,100
528,3/27/2018 7:00,112,87,118,48,74,439,5,100
529,3/27/2018 7:05,104,81,95,65,83,428,5,100
530,3/27/2018 7:10,133,93,114,75,83,498,5,100
531,3/27/2018 7:15,144,98,133,72,82,529,5,100
532,3/27/2018 7:20,144,118,132,62,108,564,5,100
533,3/27/2018 7:25,151,98,137,72,91,549,5,100
534,3/27/2018 7:30,144,123,137,74,106,584,5,100
535,3/27/2018 7:35,140,102,143,79,105,569,5,100
536,3/27/2018 7:40,152,109,138,72,94,565,5,100
537,3/27/2018 7:45,145,109,131,81,111,577,5,100
538,3/27/2018 7:50,136,109,132,73,88,538,5,100
539,3/27/2018 7:55,130,98,128,78,100,534,5,100
540,3/27/2018 8:00,153,106,119,81,82,541,5,100
541,3/27/2018 8:05,140,107,127,76,97,547,5,100
542,3/27/2018 8:10,154,120,137,73,93,577,5,100
543,3/27/2018 8:15,146,93,128,76,92,535,5,100
544,3/27/2018 8:20,136,101,134,64,96,531,5,100
545,3/27/2018 8:25,137,102,134,78,92,543,5,100
546,3/27/2018 8:30,130,104,122,71,92,519,5,100
547,3/27/2018 8:35,146,96,123,68,90,523,5,100
548,3/27/2018 8:40,165,108,134,81,104,592,5,100
549,3/27/2018 8:45,140,104,125,68,103,540,5,100
550,3/27/2018 8:50,154,91,134,69,70,518,5,100
551,3/27/2018 8:55,129,110,119,65,86,509,5,100
552,3/27/2018 9:00,114,96,107,61,80,458,5,100
553,3/27/2018 9:05,129,86,120,61,82,478,5,100
554,3/27/2018 9:10,125,87,113,63,73,461,5,100
555,3/27/2018 9:15,143,101,132,69,85,530,5,100
556,3/27/2018 9:20,121,99,128,61,76,485,5,100
557,3/27/2018 9:25,142,104,115,72,74,507,5,100
558,3/27/2018 9:30,118,83,117,58,89,465,5,100
559,3/27/2018 9:35,123,91,115,65,80,474,5,100
560,3/27/2018 9:40,122,95,119,49,85,470,5,100
561,3/27/2018 9:45,114,84,120,66,85,469,5,100
562,3/27/2018 9:50,116,97,111,63,82,469,5,100
563,3/27/2018 9:55,110,97,104,59,77,447,5,100
564,3/27/2018 10:00,110,86,107,53,94,450,5,100
565,3/27/2018 10:05,114,91,111,45,81,442,5,100
566,3/27/2018 10:10,119,89,98,52,83,441,5,100
567,3/27/2018 10:15,123,95,113,54,89,474,5,100
568,3/27/2018 10:20,117,86,117,51,84,455,5,100
569,3/27/2018 10:25,113,95,110,51,70,439,5,100
570,3/27/2018 10:30,119,86,112,55,75,447,5,100
571,3/27/2018 10:35,114,89,106,32,90,431,5,100
572,3/27/2018 10:40,122,98,122,57,82,481,5,100
573,3/27/2018 10:45,115,113,121,50,78,477,5,100
574,3/27/2018 10:50,139,117,121,56,104,537,5,100
575,3/27/2018 10:55,120,100,105,64,85,474,5,100
576,3/27/2018 11:00,111,89,112,51,68,431,5,100
577,3/27/2018 11:05,104,90,118,57,87,456,5,100
578,3/27/2018 11:10,110,95,113,69,87,474,5,100
579,3/27/2018 11:15,138,104,139,66,102,549,5,100
580,3/27/2018 11:20,137,98,128,53,81,497,5,100
581,3/27/2018 11:25,122,95,115,47,82,461,5,100
582,3/27/2018 11:30,121,93,121,52,77,464,5,100
583,3/27/2018 11:35,119,99,128,47,88,481,5,100
584,3/27/2018 11:40,141,108,123,49,94,515,5,100
585,3/27/2018 11:45,129,92,126,61,91,499,5,100
586,3/27/2018 11:50,133,103,137,58,91,522,5,100
587,3/27/2018 11:55,136,100,113,63,84,496,5,100
588,3/27/2018 12:00,132,101,116,54,96,499,5,100
589,3/27/2018 12:05,117,82,126,53,81,459,5,100
590,3/27/2018 12:10,121,96,123,76,80,496,5,100
591,3/27/2018 12:15,138,93,125,61,79,496,5,100
592,3/27/2018 12:20,139,102,126,58,89,514,5,100
593,3/27/2018 12:25,125,93,110,58,72,458,5,100
594,3/27/2018 12:30,118,100,113,48,78,457,5,100
595,3/27/2018 12:35,135,95,135,59,81,505,5,100
596,3/27/2018 12:40,117,94,132,64,91,498,5,100
597,3/27/2018 12:45,127,103,122,59,90,501,5,100
598,3/27/2018 12:50,126,105,110,66,91,498,5,100
599,3/27/2018 12:55,137,102,125,71,92,527,5,100
600,3/27/2018 13:00,141,96,143,61,92,533,5,100
601,3/27/2018 13:05,147,101,148,80,90,566,5,100
602,3/27/2018 13:10,127,99,121,62,92,501,5,100
603,3/27/2018 13:15,130,100,120,76,90,516,5,100
604,3/27/2018 13:20,133,109,130,67,90,529,5,100
605,3/27/2018 13:25,132,100,117,74,90,513,5,100
606,3/27/2018 13:30,138,101,130,68,91,528,5,100
607,3/27/2018 13:35,128,106,124,69,90,517,5,100
608,3/27/2018 13:40,128,101,118,71,103,521,5,100
609,3/27/2018 13:45,108,98,115,89,92,502,5,100
610,3/27/2018 13:50,115,104,108,90,100,517,5,100
611,3/27/2018 13:55,121,98,120,86,98,523,5,100
612,3/27/2018 14:00,90,85,98,86,96,455,5,100
613,3/27/2018 14:05,112,98,116,119,107,552,5,100
614,3/27/2018 14:10,94,91,95,112,94,486,5,100
615,3/27/2018 14:15,103,96,101,110,93,503,5,100
616,3/27/2018 14:20,105,99,102,123,97,526,5,100
617,3/27/2018 14:25,108,108,110,110,95,531,5,100
618,3/27/2018 14:30,98,98,101,120,99,516,5,100
619,3/27/2018 14:35,92,84,101,111,84,472,5,100
620,3/27/2018 14:40,97,97,94,134,104,526,5,100
621,3/27/2018 14:45,110,92,104,105,86,497,5,100
622,3/27/2018 14:50,91,102,93,111,95,492,5,100
623,3/27/2018 14:55,95,90,101,90,83,459,5,100
624,3/27/2018 15:00,87,84,88,94,78,431,5,100
625,3/27/2018 15:05,77,69,73,97,89,405,5,100
626,3/27/2018 15:10,87,76,81,118,95,457,5,100
627,3/27/2018 15:15,98,92,101,108,95,494,5,100
628,3/27/2018 15:20,86,82,94,122,87,471,5,100
629,3/27/2018 15:25,83,88,79,109,78,437,5,100
630,3/27/2018 15:30,72,66,68,88,76,370,5,100
631,3/27/2018 15:35,78,71,77,104,91,421,5,100
632,3/27/2018 15:40,91,87,87,122,95,482,5,100
633,3/27/2018 15:45,87,87,96,113,92,475,5,100
634,3/27/2018 15:50,76,58,65,106,80,385,5,100
635,3/27/2018 15:55,76,59,72,96,70,373,5,100
636,3/27/2018 16:00,80,64,81,113,83,421,5,100
637,3/27/2018 16:05,80,76,82,109,87,434,5,100
638,3/27/2018 16:10,68,45,54,70,56,293,5,100
639,3/27/2018 16:15,70,64,59,87,76,356,5,100
640,3/27/2018 16:20,83,83,83,93,87,429,5,100
641,3/27/2018 16:25,60,46,49,81,63,299,5,100
642,3/27/2018 16:30,73,65,70,80,71,359,5,100
643,3/27/2018 16:35,74,68,69,97,87,395,5,100
644,3/27/2018 16:40,68,61,61,91,74,355,5,100
645,3/27/2018 16:45,64,66,68,92,73,363,5,100
646,3/27/2018 16:50,71,60,67,97,77,372,5,100
647,3/27/2018 16:55,70,47,60,99,58,334,5,100
648,3/27/2018 17:00,57,53,52,85,58,305,5,100
649,3/27/2018 17:05,81,72,72,105,79,409,5,100
650,3/27/2018 17:10,69,58,63,91,81,362,5,100
651,3/27/2018 17:15,77,56,60,94,75,362,5,100
652,3/27/2018 17:20,73,61,64,114,83,395,5,100
653,3/27/2018 17:25,64,59,59,92,72,346,5,100
654,3/27/2018 17:30,59,52,54,81,67,313,5,100
655,3/27/2018 17:35,75,59,62,110,84,390,5,100
656,3/27/2018 17:40,71,78,69,114,90,422,5,100
657,3/27/2018 17:45,72,51,61,97,77,358,5,100
658,3/27/2018 17:50,68,61,56,69,77,331,5,100
659,3/27/2018 17:55,70,60,67,84,87,368,5,100
660,3/27/2018 18:00,57,48,48,80,64,297,5,100
661,3/27/2018 18:05,72,60,69,103,71,375,5,100
662,3/27/2018 18:10,67,55,58,100,58,338,5,100
663,3/27/2018 18:15,64,55,60,79,62,320,5,100
664,3/27/2018 18:20,75,69,71,114,91,420,5,100
665,3/27/2018 18:25,82,70,73,96,72,393,5,100
666,3/27/2018 18:30,73,72,80,113,90,428,5,100
667,3/27/2018 18:35,72,66,80,106,91,415,5,100
668,3/27/2018 18:40,69,60,68,114,84,395,5,100
669,3/27/2018 18:45,65,62,55,95,67,344,5,100
670,3/27/2018 18:50,86,81,86,108,98,459,5,100
671,3/27/2018 18:55,102,92,88,111,84,477,5,100
672,3/27/2018 19:00,31,35,44,48,50,208,5,100
673,3/27/2018 19:05,121,91,104,94,77,487,5,100
674,3/27/2018 19:10,87,85,100,105,90,467,5,100
675,3/27/2018 19:15,77,88,92,110,76,443,5,100
676,3/27/2018 19:20,80,63,80,83,78,384,5,100
677,3/27/2018 19:25,92,75,80,100,82,429,5,100
678,3/27/2018 19:30,93,94,87,111,83,468,5,100
679,3/27/2018 19:35,95,84,95,99,71,444,5,100
680,3/27/2018 19:40,61,69,55,96,70,351,5,100
681,3/27/2018 19:45,69,60,69,91,66,355,5,100
682,3/27/2018 19:50,104,86,98,104,92,484,5,100
683,3/27/2018 19:55,97,96,96,91,90,470,5,100
684,3/27/2018 20:00,112,93,110,91,89,495,5,100
685,3/27/2018 20:05,106,107,99,103,98,513,5,100
686,3/27/2018 20:10,115,93,103,92,93,496,5,100
687,3/27/2018 20:15,103,86,89,83,92,453,5,100
688,3/27/2018 20:20,113,91,110,62,84,460,5,100
689,3/27/2018 20:25,122,91,114,52,72,451,5,100
690,3/27/2018 20:30,117,85,100,40,67,409,5,100
691,3/27/2018 20:35,121,91,119,48,83,462,5,100
692,3/27/2018 20:40,99,86,109,53,64,411,5,100
693,3/27/2018 20:45,117,78,126,49,83,453,5,100
694,3/27/2018 20:50,114,88,122,42,69,435,5,100
695,3/27/2018 20:55,111,88,96,46,76,417,5,100
696,3/27/2018 21:00,102,77,108,47,75,409,5,100
697,3/27/2018 21:05,111,80,91,38,58,378,5,100
698,3/27/2018 21:10,116,76,107,42,67,408,5,100
699,3/27/2018 21:15,120,92,94,56,84,446,5,100
700,3/27/2018 21:20,113,78,102,44,75,412,5,100
701,3/27/2018 21:25,111,81,95,45,71,403,5,100
702,3/27/2018 21:30,113,96,102,50,71,432,5,100
703,3/27/2018 21:35,99,82,92,42,59,374,5,100
704,3/27/2018 21:40,106,79,101,62,63,411,5,100
705,3/27/2018 21:45,89,64,103,68,62,386,5,100
706,3/27/2018 21:50,95,88,91,46,65,385,5,100
707,3/27/2018 21:55,89,65,85,35,60,334,5,100
708,3/27/2018 22:00,70,78,86,40,58,332,5,100
709,3/27/2018 22:05,78,76,83,37,65,339,5,100
710,3/27/2018 22:10,92,74,97,42,62,367,5,100
711,3/27/2018 22:15,88,74,94,53,61,370,5,100
712,3/27/2018 22:20,82,81,84,48,62,357,5,100
713,3/27/2018 22:25,73,77,80,58,63,351,5,100
714,3/27/2018 22:30,72,63,88,33,64,320,5,100
715,3/27/2018 22:35,61,56,71,49,54,291,5,100
716,3/27/2018 22:40,73,67,63,43,57,303,5,100
717,3/27/2018 22:45,76,77,73,35,60,321,5,100
718,3/27/2018 22:50,58,58,56,39,43,254,5,100
719,3/27/2018 22:55,54,54,72,23,60,263,5,100
720,3/27/2018 23:00,61,49,66,40,60,276,5,100
721,3/27/2018 23:05,56,61,68,42,54,281,5,100
722,3/27/2018 23:10,51,48,64,38,48,249,5,100
723,3/27/2018 23:15,60,44,70,30,55,259,5,100
724,3/27/2018 23:20,58,57,58,27,52,252,5,100
725,3/27/2018 23:25,58,46,59,32,42,237,5,100
726,3/27/2018 23:30,51,54,59,34,42,240,5,100
727,3/27/2018 23:35,41,58,54,30,56,239,5,100
728,3/27/2018 23:40,44,41,48,18,34,185,5,100
729,3/27/2018 23:45,34,47,41,18,28,168,5,100
730,3/27/2018 23:50,41,58,52,28,39,218,5,100
731,3/27/2018 23:55,34,43,48,17,42,184,5,100
732,3/28/2018 0:00,45,36,43,27,40,191,5,100
733,3/28/2018 0:05,39,51,50,21,27,188,5,100
734,3/28/2018 0:10,37,40,30,15,37,159,5,100
735,3/28/2018 0:15,37,37,52,21,32,179,5,100
736,3/28/2018 0:20,34,40,43,22,34,173,5,100
737,3/28/2018 0:25,15,37,33,20,22,127,5,100
738,3/28/2018 0:30,32,31,34,20,33,150,5,100
739,3/28/2018 0:35,24,34,26,21,30,135,5,100
740,3/28/2018 0:40,20,30,25,19,25,119,5,100
741,3/28/2018 0:45,20,33,30,13,29,125,5,100
742,3/28/2018 0:50,20,18,24,14,24,100,5,100
743,3/28/2018 0:55,15,27,24,10,26,102,5,100
744,3/28/2018 1:00,16,21,30,13,31,111,5,100
745,3/28/2018 1:05,17,29,26,16,26,114,5,100
746,3/28/2018 1:10,16,30,26,12,30,114,5,100
747,3/28/2018 1:15,10,20,17,8,20,75,5,100
748,3/28/2018 1:20,16,27,20,15,20,98,5,100
749,3/28/2018 1:25,17,26,25,11,23,102,5,100
750,3/28/2018 1:30,15,25,19,8,18,85,5,100
751,3/28/2018 1:35,10,26,21,6,12,75,5,100
752,3/28/2018 1:40,17,22,29,7,21,96,5,100
753,3/28/2018 1:45,11,10,19,14,19,73,5,100
754,3/28/2018 1:50,12,17,20,11,20,80,5,100
755,3/28/2018 1:55,11,23,16,11,22,83,5,100
756,3/28/2018 2:00,10,17,19,6,17,69,5,100
757,3/28/2018 2:05,7,18,19,8,17,69,5,100
758,3/28/2018 2:10,18,20,19,8,14,79,5,100
759,3/28/2018 2:15,15,21,18,5,7,66,5,100
760,3/28/2018 2:20,11,12,15,7,15,60,5,100
761,3/28/2018 2:25,7,10,16,11,13,57,5,100
762,3/28/2018 2:30,8,19,12,3,12,54,5,100
763,3/28/2018 2:35,5,23,20,6,18,72,5,100
764,3/28/2018 2:40,6,11,13,7,11,48,5,100
765,3/28/2018 2:45,7,16,17,6,10,56,5,100
766,3/28/2018 2:50,1,6,3,1,10,21,5,100
767,3/28/2018 2:55,0,4,4,5,11,24,5,100
768,3/28/2018 3:00,1,7,3,2,8,21,5,100
769,3/28/2018 3:05,7,10,15,5,14,51,5,100
770,3/28/2018 3:10,22,38,30,11,17,118,5,100
771,3/28/2018 3:15,3,13,13,5,10,44,5,100
772,3/28/2018 3:20,3,11,12,6,8,40,5,100
773,3/28/2018 3:25,7,13,7,4,13,44,5,100
774,3/28/2018 3:30,7,18,13,0,9,47,5,100
775,3/28/2018 3:35,9,16,13,13,14,65,5,100
776,3/28/2018 3:40,7,13,12,14,17,63,5,100
777,3/28/2018 3:45,13,20,15,8,20,76,5,100
778,3/28/2018 3:50,10,18,16,8,14,66,5,100
779,3/28/2018 3:55,12,16,7,4,12,51,5,100
780,3/28/2018 4:00,10,10,11,7,10,48,5,100
781,3/28/2018 4:05,8,18,19,6,13,64,5,100
782,3/28/2018 4:10,12,18,17,6,15,68,5,100
783,3/28/2018 4:15,14,21,21,6,17,79,5,100
784,3/28/2018 4:20,16,16,25,6,21,84,5,100
785,3/28/2018 4:25,15,25,23,7,16,86,5,100
786,3/28/2018 4:30,23,37,28,19,20,127,5,100
787,3/28/2018 4:35,19,28,27,20,28,122,5,100
788,3/28/2018 4:40,29,39,33,10,28,139,5,100
789,3/28/2018 4:45,35,22,43,14,29,143,5,100
790,3/28/2018 4:50,27,33,40,22,23,145,5,100
791,3/28/2018 4:55,36,32,39,28,29,164,5,100
792,3/28/2018 5:00,38,39,48,20,33,178,5,100
793,3/28/2018 5:05,35,33,47,21,28,164,5,100
794,3/28/2018 5:10,45,43,55,18,31,192,5,100
795,3/28/2018 5:15,51,54,57,29,43,234,5,100
796,3/28/2018 5:20,71,48,66,30,36,251,5,100
797,3/28/2018 5:25,92,57,68,30,48,295,5,100
798,3/28/2018 5:30,74,66,80,29,52,301,5,100
799,3/28/2018 5:35,71,54,82,32,38,277,5,100
800,3/28/2018 5:40,81,70,83,40,64,338,5,100
801,3/28/2018 5:45,82,69,75,35,52,313,5,100
802,3/28/2018 5:50,91,66,84,39,64,344,5,100
803,3/28/2018 5:55,76,63,74,29,50,292,5,100
804,3/28/2018 6:00,97,72,70,43,60,342,5,100
805,3/28/2018 6:05,86,68,94,38,57,343,5,100
806,3/28/2018 6:10,80,76,84,38,47,325,5,100
807,3/28/2018 6:15,91,90,87,59,49,376,5,100
808,3/28/2018 6:20,100,72,85,38,68,363,5,100
809,3/28/2018 6:25,91,72,80,48,58,349,5,100
810,3/28/2018 6:30,93,83,97,51,62,386,5,100
811,3/28/2018 6:35,120,89,109,72,85,475,5,100
812,3/28/2018 6:40,120,78,101,70,62,431,5,100
813,3/28/2018 6:45,124,84,104,60,82,454,5,100
814,3/28/2018 6:50,120,83,118,72,90,483,5,100
815,3/28/2018 6:55,119,94,122,60,84,479,5,100
816,3/28/2018 7:00,117,79,107,51,91,445,5,100
817,3/28/2018 7:05,121,80,108,47,86,442,5,100
818,3/28/2018 7:10,128,101,120,51,83,483,5,100
819,3/28/2018 7:15,158,109,138,66,91,562,5,100
820,3/28/2018 7:20,146,98,131,78,87,540,5,100
821,3/28/2018 7:25,137,103,125,73,89,527,5,100
822,3/28/2018 7:30,173,126,146,79,103,627,5,100
823,3/28/2018 7:35,150,119,141,86,128,624,5,100
824,3/28/2018 7:40,155,116,157,89,92,609,5,100
825,3/28/2018 7:45,155,127,158,85,102,627,5,100
826,3/28/2018 7:50,151,114,147,84,106,602,5,100
827,3/28/2018 7:55,147,103,139,85,82,556,5,100
828,3/28/2018 8:00,139,111,141,69,102,562,5,100
829,3/28/2018 8:05,118,103,123,73,82,499,5,100
830,3/28/2018 8:10,135,110,122,69,115,551,5,100
831,3/28/2018 8:15,127,102,107,71,89,496,5,100
832,3/28/2018 8:20,145,116,125,63,102,551,5,100
833,3/28/2018 8:25,143,97,127,71,89,527,5,100
834,3/28/2018 8:30,142,107,143,69,97,558,5,100
835,3/28/2018 8:35,118,100,111,80,79,488,5,100
836,3/28/2018 8:40,159,108,138,77,98,580,5,100
837,3/28/2018 8:45,140,94,122,80,99,535,5,100
838,3/28/2018 8:50,136,104,118,82,89,529,5,100
839,3/28/2018 8:55,128,97,116,68,75,484,5,100
840,3/28/2018 9:00,125,101,107,68,75,476,5,100
841,3/28/2018 9:05,119,85,112,67,79,462,5,100
842,3/28/2018 9:10,131,98,115,61,89,494,5,100
843,3/28/2018 9:15,127,105,126,63,81,502,5,100
844,3/28/2018 9:20,136,92,112,65,77,482,5,100
845,3/28/2018 9:25,118,87,103,50,71,429,5,100
846,3/28/2018 9:30,126,104,112,44,89,475,5,100
847,3/28/2018 9:35,129,94,113,64,78,478,5,100
848,3/28/2018 9:40,111,101,111,50,78,451,5,100
849,3/28/2018 9:45,131,92,126,56,80,485,5,100
850,3/28/2018 9:50,130,98,101,56,83,468,5,100
851,3/28/2018 9:55,127,99,113,59,81,479,5,100
852,3/28/2018 10:00,131,96,114,64,91,496,5,100
853,3/28/2018 10:05,111,96,113,62,82,464,5,100
854,3/28/2018 10:10,107,91,105,48,79,430,5,100
855,3/28/2018 10:15,115,100,102,63,96,476,5,100
856,3/28/2018 10:20,124,87,107,57,82,457,5,100
857,3/28/2018 10:25,106,89,103,53,86,437,5,100
858,3/28/2018 10:30,109,84,124,54,85,456,5,100
859,3/28/2018 10:35,120,79,111,49,78,437,5,100
860,3/28/2018 10:40,117,85,114,45,95,456,5,100
861,3/28/2018 10:45,121,107,106,59,79,472,5,100
862,3/28/2018 10:50,117,114,125,58,93,507,5,100
863,3/28/2018 10:55,121,100,113,50,83,467,5,100
864,3/28/2018 11:00,127,82,110,58,86,463,5,100
865,3/28/2018 11:05,122,102,121,53,87,485,5,100
866,3/28/2018 11:10,119,93,129,70,90,501,5,100
867,3/28/2018 11:15,121,97,116,50,90,474,5,100
868,3/28/2018 11:20,131,103,126,58,76,494,5,100
869,3/28/2018 11:25,130,98,126,66,100,520,5,100
870,3/28/2018 11:30,112,99,125,54,89,479,5,100
871,3/28/2018 11:35,119,90,120,47,86,462,5,100
872,3/28/2018 11:40,139,106,117,56,88,506,5,100
873,3/28/2018 11:45,116,101,117,57,82,473,5,100
874,3/28/2018 11:50,122,102,119,51,94,488,5,100
875,3/28/2018 11:55,123,96,118,65,92,494,5,100
876,3/28/2018 12:00,121,90,125,43,82,461,5,100
877,3/28/2018 12:05,124,86,121,58,90,479,5,100
878,3/28/2018 12:10,143,101,128,63,90,525,5,100
879,3/28/2018 12:15,133,100,124,63,85,505,5,100
880,3/28/2018 12:20,139,99,130,58,99,525,5,100
881,3/28/2018 12:25,143,105,127,55,99,529,5,100
882,3/28/2018 12:30,135,109,135,74,92,545,5,100
883,3/28/2018 12:35,130,100,125,55,80,490,5,100
884,3/28/2018 12:40,123,99,108,55,79,464,5,100
885,3/28/2018 12:45,141,96,132,68,96,533,5,100
886,3/28/2018 12:50,131,101,114,64,87,497,5,100
887,3/28/2018 12:55,120,95,121,51,86,473,5,100
888,3/28/2018 13:00,132,99,128,69,75,503,5,100
889,3/28/2018 13:05,140,87,123,48,100,498,5,100
890,3/28/2018 13:10,124,84,133,45,82,468,5,100
891,3/28/2018 13:15,138,103,122,55,88,506,5,100
892,3/28/2018 13:20,147,102,130,87,97,563,5,100
893,3/28/2018 13:25,126,107,124,55,91,503,5,100
894,3/28/2018 13:30,144,108,130,56,90,528,5,100
895,3/28/2018 13:35,131,99,122,57,86,495,5,100
896,3/28/2018 13:40,105,94,110,95,101,505,5,100
897,3/28/2018 13:45,103,93,101,92,99,488,5,100
898,3/28/2018 13:50,115,102,109,105,92,523,5,100
899,3/28/2018 13:55,107,94,93,99,88,481,5,100
900,3/28/2018 14:00,104,85,108,109,99,505,5,100
901,3/28/2018 14:05,110,96,98,105,97,506,5,100
902,3/28/2018 14:10,113,103,116,111,102,545,5,100
903,3/28/2018 14:15,103,101,111,103,96,514,5,100
904,3/28/2018 14:20,119,94,117,112,106,548,5,100
905,3/28/2018 14:25,111,102,113,107,100,533,5,100
906,3/28/2018 14:30,118,99,108,109,91,525,5,100
907,3/28/2018 14:35,82,78,93,105,91,449,5,100
908,3/28/2018 14:40,107,100,106,122,97,532,5,100
909,3/28/2018 14:45,84,95,101,105,94,479,5,100
910,3/28/2018 14:50,103,93,99,122,100,517,5,100
911,3/28/2018 14:55,81,72,67,82,79,381,5,100
912,3/28/2018 15:00,66,59,62,88,74,349,5,100
913,3/28/2018 15:05,86,86,89,102,90,453,5,100
914,3/28/2018 15:10,90,79,86,111,88,454,5,100
915,3/28/2018 15:15,62,55,61,91,56,325,5,100
916,3/28/2018 15:20,76,67,70,114,88,415,5,100
917,3/28/2018 15:25,70,57,61,94,71,353,5,100
918,3/28/2018 15:30,75,64,70,93,75,377,5,100
919,3/28/2018 15:35,74,66,68,105,86,399,5,100
920,3/28/2018 15:40,75,63,76,93,79,386,5,100
921,3/28/2018 15:45,75,67,71,100,88,401,5,100
922,3/28/2018 15:50,68,67,63,78,83,359,5,100
923,3/28/2018 15:55,77,65,74,101,84,401,5,100
924,3/28/2018 16:00,78,77,77,123,91,446,5,100
925,3/28/2018 16:05,75,73,74,114,84,420,5,100
926,3/28/2018 16:10,71,64,63,96,73,367,5,100
927,3/28/2018 16:15,55,47,54,79,61,296,5,100
928,3/28/2018 16:20,63,62,56,75,62,318,5,100
929,3/28/2018 16:25,74,78,78,90,76,396,5,100
930,3/28/2018 16:30,67,42,55,78,65,307,5,100
931,3/28/2018 16:35,58,56,56,75,67,312,5,100
932,3/28/2018 16:40,62,58,61,85,69,335,5,100
933,3/28/2018 16:45,81,80,73,110,89,433,5,100
934,3/28/2018 16:50,72,52,60,82,73,339,5,100
935,3/28/2018 16:55,76,61,73,98,83,391,5,100
936,3/28/2018 17:00,66,54,51,77,61,309,5,100
937,3/28/2018 17:05,64,52,67,73,49,305,5,100
938,3/28/2018 17:10,72,59,71,84,79,365,5,100
939,3/28/2018 17:15,74,78,74,103,79,408,5,100
940,3/28/2018 17:20,68,52,56,83,61,320,5,100
941,3/28/2018 17:25,68,49,54,88,71,330,5,100
942,3/28/2018 17:30,72,48,62,92,76,350,5,100
943,3/28/2018 17:35,67,50,59,88,71,335,5,100
944,3/28/2018 17:40,59,47,56,81,65,308,5,100
945,3/28/2018 17:45,74,57,66,88,72,357,5,100
946,3/28/2018 17:50,77,74,70,109,71,401,5,100
947,3/28/2018 17:55,78,75,72,108,90,423,5,100
948,3/28/2018 18:00,77,79,75,103,77,411,5,100
949,3/28/2018 18:05,88,76,74,79,77,394,5,100
950,3/28/2018 18:10,76,71,75,91,87,400,5,100
951,3/28/2018 18:15,87,83,82,116,89,457,5,100
952,3/28/2018 18:20,61,63,68,112,73,377,5,100
953,3/28/2018 18:25,73,59,71,107,74,384,5,100
954,3/28/2018 18:30,80,69,72,118,79,418,5,100
955,3/28/2018 18:35,87,76,80,109,89,441,5,100
956,3/28/2018 18:40,82,73,80,112,88,435,5,100
957,3/28/2018 18:45,87,81,78,103,92,441,5,100
958,3/28/2018 18:50,85,68,67,123,82,425,5,100
959,3/28/2018 18:55,96,93,83,120,95,487,5,100
960,3/28/2018 19:00,70,76,73,119,85,423,5,100
961,3/28/2018 19:05,83,76,73,114,97,443,5,100
962,3/28/2018 19:10,110,101,104,123,109,547,5,100
963,3/28/2018 19:15,90,85,93,81,89,438,5,100
964,3/28/2018 19:20,96,79,97,104,83,459,5,100
965,3/28/2018 19:25,101,87,113,82,75,458,5,100
966,3/28/2018 19:30,116,101,118,77,75,487,5,100
967,3/28/2018 19:35,125,84,117,84,96,506,5,100
968,3/28/2018 19:40,124,96,106,78,80,484,5,100
969,3/28/2018 19:45,110,97,124,68,80,479,5,100
970,3/28/2018 19:50,131,91,118,82,88,510,5,100
971,3/28/2018 19:55,124,109,118,81,88,520,5,100
972,3/28/2018 20:00,108,95,111,87,82,483,5,100
973,3/28/2018 20:05,102,100,120,94,90,506,5,100
974,3/28/2018 20:10,110,101,119,85,91,506,5,100
975,3/28/2018 20:15,115,97,117,76,101,506,5,100
976,3/28/2018 20:20,128,103,128,88,90,537,5,100
977,3/28/2018 20:25,119,105,114,71,95,504,5,100
978,3/28/2018 20:30,112,91,95,63,82,443,5,100
979,3/28/2018 20:35,137,93,122,57,83,492,5,100
980,3/28/2018 20:40,126,85,112,53,70,446,5,100
981,3/28/2018 20:45,105,97,110,44,70,426,5,100
982,3/28/2018 20:50,131,101,100,53,80,465,5,100
983,3/28/2018 20:55,130,81,113,35,77,436,5,100
984,3/28/2018 21:00,118,87,110,53,88,456,5,100
985,3/28/2018 21:05,123,98,122,52,76,471,5,100
986,3/28/2018 21:10,114,86,101,58,69,428,5,100
987,3/28/2018 21:15,127,95,121,51,79,473,5,100
988,3/28/2018 21:20,128,89,108,51,72,448,5,100
989,3/28/2018 21:25,118,89,103,63,79,452,5,100
990,3/28/2018 21:30,114,83,119,41,73,430,5,100
991,3/28/2018 21:35,110,86,114,51,76,437,5,100
992,3/28/2018 21:40,102,78,105,54,67,406,5,100
993,3/28/2018 21:45,104,87,111,53,80,435,5,100
994,3/28/2018 21:50,111,96,105,52,72,436,5,100
995,3/28/2018 21:55,103,89,110,42,68,412,5,100
996,3/28/2018 22:00,109,85,108,46,71,419,5,100
997,3/28/2018 22:05,111,91,101,47,73,423,5,100
998,3/28/2018 22:10,100,78,103,39,72,392,5,100
999,3/28/2018 22:15,100,85,101,45,66,397,5,100
1000,3/28/2018 22:20,97,63,98,43,65,366,5,100
1001,3/28/2018 22:25,91,71,97,28,58,345,5,100
1002,3/28/2018 22:30,79,74,76,40,52,321,5,100
1003,3/28/2018 22:35,75,60,86,47,46,314,5,100
1004,3/28/2018 22:40,79,63,77,33,47,299,5,100
1005,3/28/2018 22:45,78,52,77,46,60,313,5,100
1006,3/28/2018 22:50,82,62,83,36,58,321,5,100
1007,3/28/2018 22:55,60,59,81,36,53,289,5,100
1008,3/28/2018 23:00,60,54,70,35,43,262,5,100
1009,3/28/2018 23:05,62,59,76,26,48,271,5,100
1010,3/28/2018 23:10,74,62,76,28,49,289,5,100
1011,3/28/2018 23:15,66,56,66,25,50,263,5,100
1012,3/28/2018 23:20,73,57,78,27,44,279,5,100
1013,3/28/2018 23:25,56,52,61,26,45,240,5,100
1014,3/28/2018 23:30,46,54,43,18,45,206,5,100
1015,3/28/2018 23:35,69,57,67,24,46,263,5,100
1016,3/28/2018 23:40,42,49,49,33,32,205,5,100
1017,3/28/2018 23:45,49,49,55,29,34,216,5,100
1018,3/28/2018 23:50,39,42,47,19,33,180,5,100
1019,3/28/2018 23:55,34,44,41,25,37,181,5,100
1020,3/29/2018 0:00,38,38,46,23,22,167,5,100
1021,3/29/2018 0:05,35,44,50,21,34,184,5,100
1022,3/29/2018 0:10,33,41,43,21,33,171,5,100
1023,3/29/2018 0:15,33,27,46,15,32,153,5,100
1024,3/29/2018 0:20,32,36,40,20,23,151,5,100
1025,3/29/2018 0:25,32,24,31,12,24,123,5,100
1026,3/29/2018 0:30,21,30,24,11,25,111,5,100
1027,3/29/2018 0:35,26,34,37,14,24,135,5,100
1028,3/29/2018 0:40,29,32,38,19,31,149,5,100
1029,3/29/2018 0:45,26,35,36,14,29,140,5,100
1030,3/29/2018 0:50,23,38,33,14,22,130,5,100
1031,3/29/2018 0:55,19,34,24,13,21,111,5,100
1032,3/29/2018 1:00,22,21,29,10,32,114,5,100
1033,3/29/2018 1:05,21,26,23,12,27,109,5,100
1034,3/29/2018 1:10,15,28,27,14,28,112,5,100
1035,3/29/2018 1:15,13,24,22,10,13,82,5,100
1036,3/29/2018 1:20,13,31,27,12,23,106,5,100
1037,3/29/2018 1:25,19,28,23,19,22,111,5,100
1038,3/29/2018 1:30,14,19,21,7,23,84,5,100
1039,3/29/2018 1:35,7,15,16,10,7,55,5,100
1040,3/29/2018 1:40,13,28,23,8,24,96,5,100
1041,3/29/2018 1:45,15,12,27,10,15,79,5,100
1042,3/29/2018 1:50,12,22,19,6,8,67,5,100
1043,3/29/2018 1:55,16,19,18,9,25,87,5,100
1044,3/29/2018 2:00,9,19,25,9,18,80,5,100
1045,3/29/2018 2:05,11,19,23,8,8,69,5,100
1046,3/29/2018 2:10,9,12,18,9,14,62,5,100
1047,3/29/2018 2:15,14,18,17,11,18,78,5,100
1048,3/29/2018 2:20,12,15,15,16,20,78,5,100
1049,3/29/2018 2:25,7,13,16,6,21,63,5,100
1050,3/29/2018 2:30,9,13,16,5,11,54,5,100
1051,3/29/2018 2:35,6,20,16,8,11,61,5,100
1052,3/29/2018 2:40,13,16,15,8,7,59,5,100
1053,3/29/2018 2:45,12,16,19,4,10,61,5,100
1054,3/29/2018 2:50,9,12,15,4,13,53,5,100
1055,3/29/2018 2:55,6,9,6,8,11,40,5,100
1056,3/29/2018 3:00,6,9,13,6,9,43,5,100
1057,3/29/2018 3:05,4,9,8,4,9,34,5,100
1058,3/29/2018 3:10,5,9,7,5,12,38,5,100
1059,3/29/2018 3:15,7,17,7,5,13,49,5,100
1060,3/29/2018 3:20,8,14,12,4,6,44,5,100
1061,3/29/2018 3:25,9,10,5,5,10,39,5,100
1062,3/29/2018 3:30,11,20,15,4,17,67,5,100
1063,3/29/2018 3:35,7,16,15,4,13,55,5,100
1064,3/29/2018 3:40,13,17,17,7,17,71,5,100
1065,3/29/2018 3:45,11,10,13,5,13,52,5,100
1066,3/29/2018 3:50,9,13,14,13,20,69,5,100
1067,3/29/2018 3:55,13,15,24,5,12,69,5,100
1068,3/29/2018 4:00,11,11,14,6,17,59,5,100
1069,3/29/2018 4:05,11,22,13,5,18,69,5,100
1070,3/29/2018 4:10,16,17,18,6,11,68,5,100
1071,3/29/2018 4:15,17,19,22,11,18,87,5,100
1072,3/29/2018 4:20,15,19,22,11,16,83,5,100
1073,3/29/2018 4:25,16,24,26,3,14,83,5,100
1074,3/29/2018 4:30,19,21,26,11,22,99,5,100
1075,3/29/2018 4:35,21,26,33,12,18,110,5,100
1076,3/29/2018 4:40,30,36,35,9,29,139,5,100
1077,3/29/2018 4:45,37,31,36,11,28,143,5,100
1078,3/29/2018 4:50,29,29,38,12,24,132,5,100
1079,3/29/2018 4:55,32,33,34,17,28,144,5,100
1080,3/29/2018 5:00,35,35,39,15,31,155,5,100
1081,3/29/2018 5:05,42,36,37,13,32,160,5,100
1082,3/29/2018 5:10,44,40,43,19,28,174,5,100
1083,3/29/2018 5:15,56,49,52,16,37,210,5,100
1084,3/29/2018 5:20,55,45,50,25,35,210,5,100
1085,3/29/2018 5:25,61,51,65,18,37,232,5,100
1086,3/29/2018 5:30,81,56,71,24,45,277,5,100
1087,3/29/2018 5:35,86,67,79,24,53,309,5,100
1088,3/29/2018 5:40,71,57,75,27,45,275,5,100
1089,3/29/2018 5:45,84,63,78,47,50,322,5,100
1090,3/29/2018 5:50,67,61,68,32,37,265,5,100
1091,3/29/2018 5:55,60,60,68,28,48,264,5,100
1092,3/29/2018 6:00,59,56,65,35,51,266,5,100
1093,3/29/2018 6:05,79,63,77,37,52,308,5,100
1094,3/29/2018 6:10,84,71,77,33,68,333,5,100
1095,3/29/2018 6:15,94,73,90,39,54,350,5,100
1096,3/29/2018 6:20,79,64,81,38,55,317,5,100
1097,3/29/2018 6:25,104,82,93,50,67,396,5,100
1098,3/29/2018 6:30,97,65,87,36,64,349,5,100
1099,3/29/2018 6:35,102,82,106,60,69,419,5,100
1100,3/29/2018 6:40,125,105,119,58,68,475,5,100
1101,3/29/2018 6:45,123,83,105,59,70,440,5,100
1102,3/29/2018 6:50,105,87,121,68,86,467,5,100
1103,3/29/2018 6:55,107,75,102,44,82,410,5,100
1104,3/29/2018 7:00,120,84,104,58,84,450,5,100
1105,3/29/2018 7:05,119,79,115,52,80,445,5,100
1106,3/29/2018 7:10,138,99,131,62,82,512,5,100
1107,3/29/2018 7:15,126,91,123,55,86,481,5,100
1108,3/29/2018 7:20,151,103,132,69,83,538,5,100
1109,3/29/2018 7:25,161,97,139,73,95,565,5,100
1110,3/29/2018 7:30,165,119,147,70,103,604,5,100
1111,3/29/2018 7:35,159,124,151,85,107,626,5,100
1112,3/29/2018 7:40,157,107,145,62,113,584,5,100
1113,3/29/2018 7:45,155,111,142,90,108,606,5,100
1114,3/29/2018 7:50,129,96,133,89,93,540,5,100
1115,3/29/2018 7:55,155,112,139,85,93,584,5,100
1116,3/29/2018 8:00,144,110,143,67,82,546,5,100
1117,3/29/2018 8:05,134,112,130,65,96,537,5,100
1118,3/29/2018 8:10,160,108,130,90,101,589,5,100
1119,3/29/2018 8:15,139,98,137,62,85,521,5,100
1120,3/29/2018 8:20,147,104,133,77,100,561,5,100
1121,3/29/2018 8:25,136,100,134,80,98,548,5,100
1122,3/29/2018 8:30,151,94,116,61,86,508,5,100
1123,3/29/2018 8:35,141,104,121,66,84,516,5,100
1124,3/29/2018 8:40,146,106,123,68,87,530,5,100
1125,3/29/2018 8:45,129,96,111,57,85,478,5,100
1126,3/29/2018 8:50,132,97,136,59,89,513,5,100
1127,3/29/2018 8:55,125,81,113,62,75,456,5,100
1128,3/29/2018 9:00,127,91,97,73,79,467,5,100
1129,3/29/2018 9:05,118,103,108,63,89,481,5,100
1130,3/29/2018 9:10,117,74,111,54,78,434,5,100
1131,3/29/2018 9:15,129,91,129,59,86,494,5,100
1132,3/29/2018 9:20,132,96,113,58,70,469,5,100
1133,3/29/2018 9:25,127,88,127,58,82,482,5,100
1134,3/29/2018 9:30,129,96,119,64,81,489,5,100
1135,3/29/2018 9:35,120,100,113,56,82,471,5,100
1136,3/29/2018 9:40,142,109,122,77,89,539,5,100
1137,3/29/2018 9:45,113,104,121,63,93,494,5,100
1138,3/29/2018 9:50,107,93,114,61,77,452,5,100
1139,3/29/2018 9:55,126,82,129,57,80,474,5,100
1140,3/29/2018 10:00,116,99,109,61,65,450,5,100
1141,3/29/2018 10:05,126,103,117,63,75,484,5,100
1142,3/29/2018 10:10,112,85,107,68,83,455,5,100
1143,3/29/2018 10:15,118,95,110,62,71,456,5,100
1144,3/29/2018 10:20,118,89,120,52,85,464,5,100
1145,3/29/2018 10:25,131,88,131,56,92,498,5,100
1146,3/29/2018 10:30,106,96,106,48,77,433,5,100
1147,3/29/2018 10:35,107,87,117,61,98,470,5,100
1148,3/29/2018 10:40,131,90,112,62,77,472,5,100
1149,3/29/2018 10:45,131,109,114,48,84,486,5,100
1150,3/29/2018 10:50,111,98,116,41,82,448,5,100
1151,3/29/2018 10:55,134,101,128,59,99,521,5,100
1152,3/29/2018 11:00,121,94,123,54,91,483,5,100
1153,3/29/2018 11:05,128,102,116,51,79,476,5,100
1154,3/29/2018 11:10,118,94,117,59,89,477,5,100
1155,3/29/2018 11:15,143,99,133,70,95,540,5,100
1156,3/29/2018 11:20,132,94,113,58,88,485,5,100
1157,3/29/2018 11:25,130,91,136,57,88,502,5,100
1158,3/29/2018 11:30,130,98,123,69,81,501,5,100
1159,3/29/2018 11:35,133,114,131,72,97,547,5,100
1160,3/29/2018 11:40,124,89,108,53,89,463,5,100
1161,3/29/2018 11:45,123,104,115,78,89,509,5,100
1162,3/29/2018 11:50,132,108,135,61,92,528,5,100
1163,3/29/2018 11:55,130,106,132,62,96,526,5,100
1164,3/29/2018 12:00,115,113,127,73,90,518,5,100
1165,3/29/2018 12:05,129,97,130,66,105,527,5,100
1166,3/29/2018 12:10,143,106,135,70,79,533,5,100
1167,3/29/2018 12:15,133,106,131,63,95,528,5,100
1168,3/29/2018 12:20,116,96,126,65,92,495,5,100
1169,3/29/2018 12:25,125,106,134,61,85,511,5,100
1170,3/29/2018 12:30,154,101,126,63,101,545,5,100
1171,3/29/2018 12:35,143,88,127,63,88,509,5,100
1172,3/29/2018 12:40,140,98,128,71,92,529,5,100
1173,3/29/2018 12:45,113,103,115,77,92,500,5,100
1174,3/29/2018 12:50,140,105,132,70,87,534,5,100
1175,3/29/2018 12:55,129,106,119,58,91,503,5,100
1176,3/29/2018 13:00,121,91,126,58,85,481,5,100
1177,3/29/2018 13:05,125,86,122,62,92,487,5,100
1178,3/29/2018 13:10,135,90,122,64,94,505,5,100
1179,3/29/2018 13:15,135,97,130,78,89,529,5,100
1180,3/29/2018 13:20,129,94,118,66,79,486,5,100
1181,3/29/2018 13:25,140,103,139,63,87,532,5,100
1182,3/29/2018 13:30,128,93,129,76,105,531,5,100
1183,3/29/2018 13:35,135,113,130,92,96,566,5,100
1184,3/29/2018 13:40,131,108,119,88,94,540,5,100
1185,3/29/2018 13:45,135,109,122,83,90,539,5,100
1186,3/29/2018 13:50,113,86,111,106,100,516,5,100
1187,3/29/2018 13:55,88,85,83,107,93,456,5,100
1188,3/29/2018 14:00,115,101,115,92,98,521,5,100
1189,3/29/2018 14:05,118,96,127,78,77,496,5,100
1190,3/29/2018 14:10,95,89,91,89,89,453,5,100
1191,3/29/2018 14:15,87,81,85,108,82,443,5,100
1192,3/29/2018 14:20,95,81,98,126,93,493,5,100
1193,3/29/2018 14:25,81,71,81,109,73,415,5,100
1194,3/29/2018 14:30,105,96,103,107,104,515,5,100
1195,3/29/2018 14:35,104,90,103,96,108,501,5,100
1196,3/29/2018 14:40,67,79,76,92,67,381,5,100
1197,3/29/2018 14:45,80,79,84,109,85,437,5,100
1198,3/29/2018 14:50,66,59,62,79,65,331,5,100
1199,3/29/2018 14:55,65,77,74,86,75,377,5,100
1200,3/29/2018 15:00,82,81,73,98,90,424,5,100
1201,3/29/2018 15:05,76,58,60,96,68,358,5,100
1202,3/29/2018 15:10,85,74,71,113,79,422,5,100
1203,3/29/2018 15:15,70,61,65,86,73,355,5,100
1204,3/29/2018 15:20,63,43,49,67,57,279,5,100
1205,3/29/2018 15:25,73,69,75,94,79,390,5,100
1206,3/29/2018 15:30,56,46,52,76,63,293,5,100
1207,3/29/2018 15:35,76,68,73,112,86,415,5,100
1208,3/29/2018 15:40,76,66,75,109,74,400,5,100
1209,3/29/2018 15:45,67,50,60,91,80,348,5,100
1210,3/29/2018 15:50,69,52,62,72,72,327,5,100
1211,3/29/2018 15:55,50,68,59,66,68,311,5,100
1212,3/29/2018 16:00,66,67,66,70,80,349,5,100
1213,3/29/2018 16:05,77,67,81,86,87,398,5,100
1214,3/29/2018 16:10,84,86,73,102,85,430,5,100
1215,3/29/2018 16:15,60,57,56,83,73,329,5,100
1216,3/29/2018 16:20,64,53,56,69,61,303,5,100
1217,3/29/2018 16:25,71,63,72,80,78,364,5,100
1218,3/29/2018 16:30,79,73,71,106,91,420,5,100
1219,3/29/2018 16:35,79,65,70,85,65,364,5,100
1220,3/29/2018 16:40,74,68,62,106,83,393,5,100
1221,3/29/2018 16:45,61,51,53,80,69,314,5,100
1222,3/29/2018 16:50,63,66,55,97,86,367,5,100
1223,3/29/2018 16:55,65,63,62,96,82,368,5,100
1224,3/29/2018 17:00,73,62,63,96,76,370,5,100
1225,3/29/2018 17:05,59,53,52,91,69,324,5,100
1226,3/29/2018 17:10,60,35,46,63,56,260,5,100
1227,3/29/2018 17:15,65,55,59,105,74,358,5,100
1228,3/29/2018 17:20,64,50,57,105,68,344,5,100
1229,3/29/2018 17:25,63,49,56,90,64,322,5,100
1230,3/29/2018 17:30,72,56,62,107,65,362,5,100
1231,3/29/2018 17:35,66,56,69,95,75,361,5,100
1232,3/29/2018 17:40,68,56,61,83,68,336,5,100
1233,3/29/2018 17:45,60,54,59,73,61,307,5,100
1234,3/29/2018 17:50,74,57,66,88,68,353,5,0
1235,3/29/2018 17:55,72,55,67,95,66,355,5,0
1236,3/29/2018 18:00,71,61,67,108,69,376,5,0
1237,3/29/2018 18:05,85,77,80,103,81,426,5,0
1238,3/29/2018 18:10,79,61,74,96,76,386,5,0
1239,3/29/2018 18:15,74,65,78,95,70,382,5,0
1240,3/29/2018 18:20,84,65,81,93,73,396,5,0
1241,3/29/2018 18:25,88,74,95,106,78,441,5,0
1242,3/29/2018 18:30,91,75,86,93,76,421,5,0
1243,3/29/2018 18:35,89,74,90,90,73,416,5,0
1244,3/29/2018 18:40,85,86,88,96,79,434,5,0
1245,3/29/2018 18:45,88,88,89,94,73,432,5,0
1246,3/29/2018 18:50,95,83,96,87,77,438,5,0
1247,3/29/2018 18:55,99,87,101,90,74,451,5,0
1248,3/29/2018 19:00,89,86,92,77,74,418,5,0
1249,3/29/2018 19:05,88,76,89,75,76,404,5,0
1250,3/29/2018 19:10,103,86,100,66,81,436,5,0
1251,3/29/2018 19:15,119,94,117,75,86,491,5,0
1252,3/29/2018 19:20,105,94,109,92,90,490,5,0
1253,3/29/2018 19:25,113,96,118,69,84,480,5,0
1254,3/29/2018 19:30,105,91,102,81,84,463,5,0
1255,3/29/2018 19:35,107,94,93,77,88,459,5,0
1256,3/29/2018 19:40,96,90,105,86,87,464,5,0
1257,3/29/2018 19:45,92,78,93,85,79,427,5,0
1258,3/29/2018 19:50,104,85,97,90,83,459,5,0
1259,3/29/2018 19:55,103,89,101,84,87,464,5,0
1260,3/29/2018 20:00,103,78,90,78,85,434,5,0
1261,3/29/2018 20:05,107,94,104,91,94,490,5,0
1262,3/29/2018 20:10,101,89,106,69,85,450,5,0
1263,3/29/2018 20:15,113,97,113,55,73,451,5,0
1264,3/29/2018 20:20,101,85,109,53,74,422,5,0
1265,3/29/2018 20:25,107,88,111,56,69,431,5,0
1266,3/29/2018 20:30,88,72,92,45,67,364,5,0
1267,3/29/2018 20:35,124,96,121,64,78,483,5,0
1268,3/29/2018 20:40,132,108,117,50,93,500,5,100
1269,3/29/2018 20:45,119,96,119,49,71,454,5,100
1270,3/29/2018 20:50,135,92,122,45,86,480,5,100
1271,3/29/2018 20:55,99,82,102,37,69,389,5,100
1272,3/29/2018 21:00,130,95,125,63,80,493,5,100
1273,3/29/2018 21:05,118,86,107,38,84,433,5,100
1274,3/29/2018 21:10,117,92,116,50,69,444,5,100
1275,3/29/2018 21:15,123,77,111,50,68,429,5,100
1276,3/29/2018 21:20,128,83,108,43,71,433,5,100
1277,3/29/2018 21:25,118,92,122,54,83,469,5,100
1278,3/29/2018 21:30,126,111,109,56,77,479,5,100
1279,3/29/2018 21:35,118,81,107,46,75,427,5,100
1280,3/29/2018 21:40,128,91,117,50,87,473,5,100
1281,3/29/2018 21:45,119,89,117,53,87,465,5,100
1282,3/29/2018 21:50,119,91,108,52,66,436,5,100
1283,3/29/2018 21:55,133,98,115,45,55,446,5,100
1284,3/29/2018 22:00,127,89,123,49,68,456,5,100
1285,3/29/2018 22:05,118,92,120,53,76,459,5,100
1286,3/29/2018 22:10,120,87,111,54,75,447,5,100
1287,3/29/2018 22:15,108,87,95,48,65,403,5,100
1288,3/29/2018 22:20,110,76,108,51,63,408,5,100
1289,3/29/2018 22:25,96,78,83,39,64,360,5,100
1290,3/29/2018 22:30,85,61,83,38,56,323,5,100
1291,3/29/2018 22:35,93,69,84,46,63,355,5,100
1292,3/29/2018 22:40,82,68,88,33,66,337,5,100
1293,3/29/2018 22:45,75,70,75,33,58,311,5,100
1294,3/29/2018 22:50,83,70,72,36,44,305,5,100
1295,3/29/2018 22:55,65,71,74,40,68,318,5,100
1296,3/29/2018 23:00,73,59,74,40,53,299,5,100
1297,3/29/2018 23:05,69,53,75,43,50,290,5,100
1298,3/29/2018 23:10,70,58,68,42,44,282,5,100
1299,3/29/2018 23:15,81,70,80,35,44,310,5,100
1300,3/29/2018 23:20,89,70,84,41,52,336,5,100
1301,3/29/2018 23:25,71,57,71,30,44,273,5,100
1302,3/29/2018 23:30,61,48,69,25,42,245,5,100
1303,3/29/2018 23:35,57,48,61,25,38,229,5,100
1304,3/29/2018 23:40,64,54,70,36,49,273,5,100
1305,3/29/2018 23:45,61,59,76,36,50,282,5,100
1306,3/29/2018 23:50,48,51,63,27,38,227,5,100
1307,3/29/2018 23:55,50,44,62,24,34,214,5,100
1308,3/30/2018 0:00,62,59,67,18,47,253,5,100
1309,3/30/2018 0:05,55,48,56,19,40,218,5,100
1310,3/30/2018 0:10,56,46,55,21,42,220,5,100
1311,3/30/2018 0:15,46,34,48,21,43,192,5,100
1312,3/30/2018 0:20,42,40,48,27,32,189,5,100
1313,3/30/2018 0:25,40,30,48,15,33,166,5,100
1314,3/30/2018 0:30,38,31,44,22,35,170,5,100
1315,3/30/2018 0:35,40,33,48,17,38,176,5,100
1316,3/30/2018 0:40,30,32,39,20,27,148,5,100
1317,3/30/2018 0:45,32,37,46,19,30,164,5,100
1318,3/30/2018 0:50,27,36,31,14,24,132,5,100
1319,3/30/2018 0:55,37,45,38,22,29,171,5,100
1320,3/30/2018 1:00,32,31,40,25,32,160,5,100
1321,3/30/2018 1:05,30,27,30,18,29,134,5,100
1322,3/30/2018 1:10,34,24,44,15,31,148,5,100
1323,3/30/2018 1:15,24,25,30,6,18,103,5,100
1324,3/30/2018 1:20,22,37,28,11,27,125,5,100
1325,3/30/2018 1:25,24,31,33,12,24,124,5,100
1326,3/30/2018 1:30,15,17,33,14,28,107,5,100
1327,3/30/2018 1:35,20,26,33,17,22,118,5,100
1328,3/30/2018 1:40,25,34,32,13,20,124,5,100
1329,3/30/2018 1:45,20,25,26,13,19,103,5,100
1330,3/30/2018 1:50,19,26,27,10,18,100,5,100
1331,3/30/2018 1:55,18,24,22,9,21,94,5,100
1332,3/30/2018 2:00,20,22,24,6,18,90,5,100
1333,3/30/2018 2:05,16,22,30,9,20,97,5,100
1334,3/30/2018 2:10,10,22,22,7,14,75,5,100
1335,3/30/2018 2:15,19,21,22,11,11,84,5,100
1336,3/30/2018 2:20,21,18,22,5,13,79,5,100
1337,3/30/2018 2:25,12,16,8,6,14,56,5,100
1338,3/30/2018 2:30,14,12,18,10,12,66,5,100
1339,3/30/2018 2:35,9,21,16,10,13,69,5,100
1340,3/30/2018 2:40,13,18,16,14,11,72,5,100
1341,3/30/2018 2:45,18,18,20,4,12,72,5,100
1342,3/30/2018 2:50,14,24,20,5,17,80,5,100
1343,3/30/2018 2:55,13,15,15,5,12,60,5,100
1344,3/30/2018 3:00,10,13,16,9,11,59,5,100
1345,3/30/2018 3:05,13,12,23,4,13,65,5,100
1346,3/30/2018 3:10,5,15,15,5,10,50,5,100
1347,3/30/2018 3:15,9,20,21,12,23,85,5,100
1348,3/30/2018 3:20,12,18,13,7,13,63,5,100
1349,3/30/2018 3:25,7,16,11,6,12,52,5,100
1350,3/30/2018 3:30,11,18,13,3,13,58,5,100
1351,3/30/2018 3:35,10,20,24,9,12,75,5,100
1352,3/30/2018 3:40,14,21,18,2,14,69,5,100
1353,3/30/2018 3:45,14,18,20,5,16,73,5,100
1354,3/30/2018 3:50,8,21,27,9,16,81,5,100
1355,3/30/2018 3:55,13,23,19,7,16,78,5,100
1356,3/30/2018 4:00,3,18,3,3,8,35,5,100
1357,3/30/2018 4:05,9,25,14,10,13,71,5,100
1358,3/30/2018 4:10,18,15,12,4,12,61,5,100
1359,3/30/2018 4:15,17,28,20,10,16,91,5,100
1360,3/30/2018 4:20,25,28,32,8,19,112,5,100
1361,3/30/2018 4:25,14,21,23,9,18,85,5,100
1362,3/30/2018 4:30,14,21,26,9,18,88,5,100
1363,3/30/2018 4:35,21,24,25,14,27,111,5,100
1364,3/30/2018 4:40,28,28,35,14,21,126,5,100
1365,3/30/2018 4:45,29,28,34,12,26,129,5,100
1366,3/30/2018 4:50,25,28,36,16,25,130,5,100
1367,3/30/2018 4:55,12,17,20,13,16,78,5,100
1368,3/30/2018 5:00,28,25,33,22,29,137,5,100
1369,3/30/2018 5:05,59,52,63,20,29,223,5,100
1370,3/30/2018 5:10,44,32,53,14,24,167,5,100
1371,3/30/2018 5:15,42,38,53,10,39,182,5,100
1372,3/30/2018 5:20,47,43,60,17,38,205,5,100
1373,3/30/2018 5:25,37,36,56,16,22,167,5,100
1374,3/30/2018 5:30,50,49,45,19,29,192,5,100
1375,3/30/2018 5:35,66,54,71,21,32,244,5,100
1376,3/30/2018 5:40,69,53,65,33,46,266,5,100
1377,3/30/2018 5:45,72,49,63,32,45,261,5,100
1378,3/30/2018 5:50,65,59,63,30,54,271,5,100
1379,3/30/2018 5:55,63,43,50,22,46,224,5,100
1380,3/30/2018 6:00,59,46,67,29,53,254,5,100
1381,3/30/2018 6:05,68,62,74,28,45,277,5,100
1382,3/30/2018 6:10,61,62,74,31,51,279,5,100
1383,3/30/2018 6:15,93,66,89,35,56,339,5,100
1384,3/30/2018 6:20,75,64,76,39,37,291,5,100
1385,3/30/2018 6:25,84,59,72,34,50,299,5,100
1386,3/30/2018 6:30,87,63,91,38,63,342,5,100
1387,3/30/2018 6:35,86,75,81,32,62,336,5,100
1388,3/30/2018 6:40,99,78,91,47,67,382,5,100
1389,3/30/2018 6:45,92,68,81,55,59,355,5,100
1390,3/30/2018 6:50,100,77,107,39,77,400,5,100
1391,3/30/2018 6:55,99,76,98,41,76,390,5,100
1392,3/30/2018 7:00,104,67,94,35,68,368,5,100
1393,3/30/2018 7:05,104,73,90,37,59,363,5,100
1394,3/30/2018 7:10,122,78,111,47,83,441,5,100
1395,3/30/2018 7:15,126,94,109,49,75,453,5,100
1396,3/30/2018 7:20,106,78,108,57,73,422,5,100
1397,3/30/2018 7:25,120,98,117,63,76,474,5,100
1398,3/30/2018 7:30,129,99,120,70,73,491,5,100
1399,3/30/2018 7:35,125,76,110,62,79,452,5,100
1400,3/30/2018 7:40,137,93,123,51,80,484,5,100
1401,3/30/2018 7:45,139,94,120,57,72,482,5,100
1402,3/30/2018 7:50,145,114,127,65,77,528,5,100
1403,3/30/2018 7:55,114,90,107,51,85,447,5,100
1404,3/30/2018 8:00,116,86,106,60,83,451,5,100
1405,3/30/2018 8:05,121,88,98,52,76,435,5,100
1406,3/30/2018 8:10,119,86,98,53,98,454,5,100
1407,3/30/2018 8:15,141,112,129,60,78,520,5,100
1408,3/30/2018 8:20,147,93,132,53,84,509,5,100
1409,3/30/2018 8:25,120,98,126,75,81,500,5,100
1410,3/30/2018 8:30,128,101,121,59,96,505,5,100
1411,3/30/2018 8:35,123,75,115,66,85,464,5,100
1412,3/30/2018 8:40,160,108,119,68,92,547,5,100
1413,3/30/2018 8:45,134,100,126,90,87,537,5,100
1414,3/30/2018 8:50,124,99,112,66,92,493,5,100
1415,3/30/2018 8:55,126,85,119,62,81,473,5,100
1416,3/30/2018 9:00,114,88,111,58,70,441,5,100
1417,3/30/2018 9:05,118,85,120,49,73,445,5,100
1418,3/30/2018 9:10,136,96,118,59,85,494,5,100
1419,3/30/2018 9:15,119,80,120,44,76,439,5,100
1420,3/30/2018 9:20,140,94,120,57,89,500,5,100
1421,3/30/2018 9:25,120,91,108,70,75,464,5,100
1422,3/30/2018 9:30,145,90,123,56,89,503,5,100
1423,3/30/2018 9:35,124,110,111,63,81,489,5,100
1424,3/30/2018 9:40,123,98,125,66,84,496,5,100
1425,3/30/2018 9:45,129,109,130,53,82,503,5,100
1426,3/30/2018 9:50,136,104,117,61,89,507,5,100
1427,3/30/2018 9:55,111,92,110,60,89,462,5,100
1428,3/30/2018 10:00,144,97,121,64,89,515,5,100
1429,3/30/2018 10:05,104,103,109,41,84,441,5,100
1430,3/30/2018 10:10,122,95,125,53,78,473,5,100
1431,3/30/2018 10:15,129,104,125,57,82,497,5,100
1432,3/30/2018 10:20,133,107,122,64,96,522,5,100
1433,3/30/2018 10:25,137,114,132,60,91,534,5,100
1434,3/30/2018 10:30,141,93,138,60,102,534,5,100
1435,3/30/2018 10:35,127,92,130,58,93,500,5,100
1436,3/30/2018 10:40,150,104,129,61,95,539,5,100
1437,3/30/2018 10:45,123,96,123,59,105,506,5,100
1438,3/30/2018 10:50,123,93,121,54,92,483,5,100
1439,3/30/2018 10:55,122,96,97,58,76,449,5,100
1440,3/30/2018 11:00,136,96,130,54,83,499,5,100
1441,3/30/2018 11:05,124,89,109,43,84,449,5,100
1442,3/30/2018 11:10,125,93,108,65,80,471,5,100
1443,3/30/2018 11:15,145,95,136,63,96,535,5,100
1444,3/30/2018 11:20,139,106,141,68,98,552,5,100
1445,3/30/2018 11:25,149,102,124,51,79,505,5,100
1446,3/30/2018 11:30,131,118,130,54,98,531,5,100
1447,3/30/2018 11:35,143,111,127,68,90,539,5,100
1448,3/30/2018 11:40,134,103,130,76,102,545,5,100
1449,3/30/2018 11:45,132,97,113,55,93,490,5,100
1450,3/30/2018 11:50,122,96,112,49,84,463,5,100
1451,3/30/2018 11:55,120,88,124,53,91,476,5,100
1452,3/30/2018 12:00,95,94,88,55,76,408,5,100
1453,3/30/2018 12:05,96,78,109,54,75,412,5,100
1454,3/30/2018 12:10,117,86,112,59,90,464,5,100
1455,3/30/2018 12:15,111,101,119,53,87,471,5,100
1456,3/30/2018 12:20,98,92,101,59,75,425,5,100
1457,3/30/2018 12:25,133,100,118,55,90,496,5,100
1458,3/30/2018 12:30,145,117,132,50,92,536,5,100
1459,3/30/2018 12:35,146,110,144,64,89,553,5,100
1460,3/30/2018 12:40,141,112,115,82,91,541,5,100
1461,3/30/2018 12:45,146,109,151,88,95,589,5,100
1462,3/30/2018 12:50,140,100,136,81,93,550,5,100
1463,3/30/2018 12:55,131,100,140,75,87,533,5,100
1464,3/30/2018 13:00,108,103,125,88,102,526,5,100
1465,3/30/2018 13:05,107,106,113,99,98,523,5,100
1466,3/30/2018 13:10,92,89,88,100,103,472,5,100
1467,3/30/2018 13:15,103,104,98,109,94,508,5,100
1468,3/30/2018 13:20,91,94,95,109,104,493,5,100
1469,3/30/2018 13:25,118,100,113,111,90,532,5,100
1470,3/30/2018 13:30,103,97,106,109,97,512,5,100
1471,3/30/2018 13:35,73,88,78,105,88,432,5,100
1472,3/30/2018 13:40,90,94,96,104,87,471,5,100
1473,3/30/2018 13:45,97,90,104,101,76,468,5,100
1474,3/30/2018 13:50,122,102,112,93,87,516,5,100
1475,3/30/2018 13:55,121,98,118,93,95,525,5,100
1476,3/30/2018 14:00,84,73,84,98,75,414,5,100
1477,3/30/2018 14:05,64,60,65,91,64,344,5,100
1478,3/30/2018 14:10,106,98,101,115,95,515,5,100
1479,3/30/2018 14:15,86,74,84,111,90,445,5,100
1480,3/30/2018 14:20,78,75,83,113,91,440,5,100
1481,3/30/2018 14:25,82,70,71,96,89,408,5,100
1482,3/30/2018 14:30,80,75,75,98,79,407,5,100
1483,3/30/2018 14:35,72,74,70,64,72,352,5,100
1484,3/30/2018 14:40,80,78,80,96,85,419,5,100
1485,3/30/2018 14:45,82,68,81,97,79,407,5,100
1486,3/30/2018 14:50,76,68,71,95,73,383,5,100
1487,3/30/2018 14:55,67,57,67,92,72,355,5,100
1488,3/30/2018 15:00,70,60,61,103,85,379,5,100
1489,3/30/2018 15:05,73,61,68,88,62,352,5,100
1490,3/30/2018 15:10,75,61,68,98,71,373,5,100
1491,3/30/2018 15:15,79,66,58,95,84,382,5,100
1492,3/30/2018 15:20,65,56,62,90,69,342,5,100
1493,3/30/2018 15:25,69,60,65,70,69,333,5,100
1494,3/30/2018 15:30,66,61,68,103,72,370,5,100
1495,3/30/2018 15:35,71,69,86,74,54,354,5,100
1496,3/30/2018 15:40,79,82,85,85,74,405,5,100
1497,3/30/2018 15:45,86,75,95,82,65,403,5,100
1498,3/30/2018 15:50,76,75,86,70,78,385,5,100
1499,3/30/2018 15:55,78,71,90,91,68,398,5,100
1500,3/30/2018 16:00,101,88,101,109,76,475,5,100
1501,3/30/2018 16:05,87,86,90,108,81,452,5,100
1502,3/30/2018 16:10,78,88,86,115,74,441,5,100
1503,3/30/2018 16:15,95,93,93,107,78,466,5,100
1504,3/30/2018 16:20,79,80,71,117,88,435,5,100
1505,3/30/2018 16:25,65,66,66,94,73,364,5,100
1506,3/30/2018 16:30,70,61,68,103,75,377,5,100
1507,3/30/2018 16:35,80,83,83,112,92,450,5,100
1508,3/30/2018 16:40,86,91,81,104,92,454,5,100
1509,3/30/2018 16:45,94,80,87,109,71,441,5,100
1510,3/30/2018 16:50,89,80,92,89,68,418,5,100
1511,3/30/2018 16:55,92,80,102,80,76,430,5,100
1512,3/30/2018 17:00,94,80,97,60,87,418,5,100
1513,3/30/2018 17:05,96,73,101,86,82,438,5,100
1514,3/30/2018 17:10,103,82,119,71,81,456,5,100
1515,3/30/2018 17:15,105,85,108,89,72,459,5,100
1516,3/30/2018 17:20,82,73,90,45,68,358,5,100
1517,3/30/2018 17:25,111,80,105,76,71,443,5,100
1518,3/30/2018 17:30,109,98,109,82,91,489,5,100
1519,3/30/2018 17:35,120,92,121,84,85,502,5,100
1520,3/30/2018 17:40,111,100,121,98,74,504,5,100
1521,3/30/2018 17:45,118,88,110,69,77,462,5,100
1522,3/30/2018 17:50,129,100,108,75,89,501,5,100
1523,3/30/2018 17:55,113,98,109,83,78,481,5,100
1524,3/30/2018 18:00,103,84,111,67,78,443,5,100
1525,3/30/2018 18:05,110,98,116,79,82,485,5,100
1526,3/30/2018 18:10,93,91,93,103,83,463,5,100
1527,3/30/2018 18:15,100,99,114,108,101,522,5,100
1528,3/30/2018 18:20,96,111,110,101,86,504,5,100
1529,3/30/2018 18:25,92,103,105,111,99,510,5,100
1530,3/30/2018 18:30,93,102,111,109,105,520,5,100
1531,3/30/2018 18:35,74,98,94,122,101,489,5,100
1532,3/30/2018 18:40,99,94,104,122,101,520,5,100
1533,3/30/2018 18:45,121,100,116,84,103,524,5,100
1534,3/30/2018 18:50,133,91,119,66,69,478,5,100
1535,3/30/2018 18:55,124,100,117,72,83,496,5,100
1536,3/30/2018 19:00,136,90,123,65,85,499,5,100
1537,3/30/2018 19:05,144,98,133,52,90,517,5,100
1538,3/30/2018 19:10,124,95,109,46,77,451,5,100
1539,3/30/2018 19:15,127,95,119,52,91,484,5,100
1540,3/30/2018 19:20,91,81,92,51,84,399,5,100
1541,3/30/2018 19:25,126,110,109,74,86,505,5,100
1542,3/30/2018 19:30,129,100,115,62,89,495,5,100
1543,3/30/2018 19:35,116,92,118,41,83,450,5,100
1544,3/30/2018 19:40,126,93,112,51,82,464,5,100
1545,3/30/2018 19:45,133,94,118,56,85,486,5,100
1546,3/30/2018 19:50,127,99,132,64,81,503,5,100
1547,3/30/2018 19:55,122,84,101,58,93,458,5,100
1548,3/30/2018 20:00,138,96,122,66,83,505,5,100
1549,3/30/2018 20:05,123,109,118,53,86,489,5,100
1550,3/30/2018 20:10,122,100,127,63,82,494,5,100
1551,3/30/2018 20:15,106,94,115,51,95,461,5,100
1552,3/30/2018 20:20,121,84,108,45,72,430,5,100
1553,3/30/2018 20:25,108,87,109,32,75,411,5,100
1554,3/30/2018 20:30,112,87,94,38,69,400,5,100
1555,3/30/2018 20:35,123,91,116,56,64,450,5,100
1556,3/30/2018 20:40,116,89,114,58,86,463,5,100
1557,3/30/2018 20:45,120,81,112,40,82,435,5,100
1558,3/30/2018 20:50,101,79,114,55,88,437,5,100
1559,3/30/2018 20:55,118,87,112,58,81,456,5,100
1560,3/30/2018 21:00,106,84,104,47,76,417,5,100
1561,3/30/2018 21:05,110,72,96,37,61,376,5,100
1562,3/30/2018 21:10,111,77,101,45,76,410,5,100
1563,3/30/2018 21:15,111,95,102,47,69,424,5,100
1564,3/30/2018 21:20,43,57,63,32,49,244,5,100
1565,3/30/2018 21:25,48,66,69,47,57,287,5,100
1566,3/30/2018 21:30,50,53,64,32,49,248,5,100
1567,3/30/2018 21:35,48,46,60,24,53,231,5,100
1568,3/30/2018 21:40,53,67,64,33,54,271,5,100
1569,3/30/2018 21:45,56,65,67,31,60,279,5,100
1570,3/30/2018 21:50,44,48,59,28,54,233,5,100
1571,3/30/2018 21:55,64,67,67,36,60,294,5,100
1572,3/30/2018 22:00,58,73,81,38,58,308,5,100
1573,3/30/2018 22:05,69,77,91,46,59,342,5,100
1574,3/30/2018 22:10,76,71,90,24,54,315,5,100
1575,3/30/2018 22:15,119,81,114,48,75,437,5,100
1576,3/30/2018 22:20,136,105,130,58,77,506,5,100
1577,3/30/2018 22:25,136,94,122,44,88,484,5,100
1578,3/30/2018 22:30,115,90,110,52,69,436,5,100
1579,3/30/2018 22:35,107,83,99,43,73,405,5,100
1580,3/30/2018 22:40,86,86,92,33,58,355,5,100
1581,3/30/2018 22:45,76,57,91,32,47,303,5,100
1582,3/30/2018 22:50,73,55,74,29,55,286,5,100
1583,3/30/2018 22:55,87,63,74,27,57,308,5,100
1584,3/30/2018 23:00,74,64,66,33,50,287,5,100
1585,3/30/2018 23:05,73,62,70,41,58,304,5,100
1586,3/30/2018 23:10,67,63,74,36,52,292,5,100
1587,3/30/2018 23:15,70,50,71,31,53,275,5,100
1588,3/30/2018 23:20,85,65,75,43,56,324,5,100
1589,3/30/2018 23:25,75,68,70,36,45,294,5,100
1590,3/30/2018 23:30,86,69,78,38,47,318,5,100
1591,3/30/2018 23:35,72,66,80,26,49,293,5,100
1592,3/30/2018 23:40,75,70,76,42,49,312,5,100
1593,3/30/2018 23:45,69,55,74,38,51,287,5,100
1594,3/30/2018 23:50,69,59,79,22,43,272,5,100
1595,3/30/2018 23:55,68,56,76,18,46,264,5,100
1596,3/31/2018 0:00,62,60,72,32,39,265,5,100
1597,3/31/2018 0:05,58,58,58,24,47,245,5,100
1598,3/31/2018 0:10,53,48,72,34,49,256,5,100
1599,3/31/2018 0:15,60,54,62,20,44,240,5,100
1600,3/31/2018 0:20,53,57,63,25,38,236,5,100
1601,3/31/2018 0:25,43,46,61,30,38,218,5,100
1602,3/31/2018 0:30,50,46,49,23,43,211,5,100
1603,3/31/2018 0:35,42,44,58,24,38,206,5,100
1604,3/31/2018 0:40,48,39,56,21,36,200,5,100
1605,3/31/2018 0:45,38,39,42,21,39,179,5,100
1606,3/31/2018 0:50,36,36,47,28,29,176,5,100
1607,3/31/2018 0:55,42,40,42,9,38,171,5,100
1608,3/31/2018 1:00,33,42,46,17,37,175,5,100
1609,3/31/2018 1:05,29,32,45,19,28,153,5,100
1610,3/31/2018 1:10,28,26,33,18,25,130,5,100
1611,3/31/2018 1:15,29,38,27,18,24,136,5,100
1612,3/31/2018 1:20,28,38,31,20,30,147,5,100
1613,3/31/2018 1:25,22,37,38,17,35,149,5,100
1614,3/31/2018 1:30,29,32,43,14,23,141,5,100
1615,3/31/2018 1:35,37,41,32,16,27,153,5,100
1616,3/31/2018 1:40,25,41,30,13,28,137,5,100
1617,3/31/2018 1:45,27,31,40,17,28,143,5,100
1618,3/31/2018 1:50,23,29,31,11,21,115,5,100
1619,3/31/2018 1:55,22,27,25,14,28,116,5,100
1620,3/31/2018 2:00,23,24,25,17,25,114,5,100
1621,3/31/2018 2:05,16,27,19,18,22,102,5,100
1622,3/31/2018 2:10,22,38,24,16,28,128,5,100
1623,3/31/2018 2:15,17,31,34,8,18,108,5,100
1624,3/31/2018 2:20,17,25,23,12,16,93,5,100
1625,3/31/2018 2:25,23,24,28,11,9,95,5,100
1626,3/31/2018 2:30,22,23,33,4,15,97,5,100
1627,3/31/2018 2:35,14,25,21,5,20,85,5,100
1628,3/31/2018 2:40,19,22,21,8,22,92,5,100
1629,3/31/2018 2:45,17,32,31,4,15,99,5,100
1630,3/31/2018 2:50,7,17,20,5,11,60,5,100
1631,3/31/2018 2:55,16,24,27,7,17,91,5,100
1632,3/31/2018 3:00,11,23,17,2,14,67,5,100
1633,3/31/2018 3:05,18,16,14,7,9,64,5,100
1634,3/31/2018 3:10,15,15,18,5,12,65,5,100
1635,3/31/2018 3:15,15,19,25,6,18,83,5,100
1636,3/31/2018 3:20,11,16,13,9,11,60,5,100
1637,3/31/2018 3:25,9,25,24,3,8,69,5,100
1638,3/31/2018 3:30,8,18,12,7,9,54,5,100
1639,3/31/2018 3:35,10,20,22,10,17,79,5,100
1640,3/31/2018 3:40,10,21,18,3,11,63,5,100
1641,3/31/2018 3:45,9,18,16,5,10,58,5,100
1642,3/31/2018 3:50,15,14,20,10,15,74,5,100
1643,3/31/2018 3:55,5,16,14,3,19,57,5,100
1644,3/31/2018 4:00,8,17,14,7,15,61,5,100
1645,3/31/2018 4:05,12,11,10,5,12,50,5,100
1646,3/31/2018 4:10,10,13,12,4,7,46,5,100
1647,3/31/2018 4:15,12,12,18,6,14,62,5,100
1648,3/31/2018 4:20,16,24,22,8,15,85,5,100
1649,3/31/2018 4:25,11,22,16,5,14,68,5,100
1650,3/31/2018 4:30,7,12,16,7,13,55,5,100
1651,3/31/2018 4:35,13,9,18,2,18,60,5,100
1652,3/31/2018 4:40,14,14,21,3,12,64,5,100
1653,3/31/2018 4:45,18,25,24,6,13,86,5,100
1654,3/31/2018 4:50,14,16,17,9,21,77,5,100
1655,3/31/2018 4:55,19,18,17,7,16,77,5,100
1656,3/31/2018 5:00,9,17,21,4,16,67,5,100
1657,3/31/2018 5:05,18,21,21,6,15,81,5,100
1658,3/31/2018 5:10,16,13,23,13,19,84,5,100
1659,3/31/2018 5:15,14,14,18,3,23,72,5,100
1660,3/31/2018 5:20,13,20,25,4,22,84,5,100
1661,3/31/2018 5:25,20,18,29,10,16,93,5,100
1662,3/31/2018 5:30,22,21,28,14,15,100,5,100
1663,3/31/2018 5:35,32,26,32,13,19,122,5,100
1664,3/31/2018 5:40,18,23,30,6,26,103,5,100
1665,3/31/2018 5:45,25,31,40,17,30,143,5,100
1666,3/31/2018 5:50,25,34,33,14,25,131,5,100
1667,3/31/2018 5:55,27,30,31,10,28,126,5,100
1668,3/31/2018 6:00,19,35,29,10,17,110,5,100
1669,3/31/2018 6:05,23,29,31,15,22,120,5,100
1670,3/31/2018 6:10,32,39,40,13,29,153,5,100
1671,3/31/2018 6:15,40,38,49,19,29,175,5,100
1672,3/31/2018 6:20,32,35,44,8,22,141,5,100
1673,3/31/2018 6:25,35,42,51,13,24,165,5,100
1674,3/31/2018 6:30,34,36,55,15,26,166,5,100
1675,3/31/2018 6:35,37,39,51,14,37,178,5,100
1676,3/31/2018 6:40,51,33,46,30,39,199,5,100
1677,3/31/2018 6:45,45,50,40,25,39,199,5,100
1678,3/31/2018 6:50,48,39,55,30,46,218,5,100
1679,3/31/2018 6:55,51,51,59,28,44,233,5,100
1680,3/31/2018 7:00,41,48,51,18,39,197,5,100
1681,3/31/2018 7:05,56,51,68,33,58,266,5,100
1682,3/31/2018 7:10,58,60,63,22,41,244,5,100
1683,3/31/2018 7:15,75,61,65,27,52,280,5,100
1684,3/31/2018 7:20,61,52,79,23,50,265,5,100
1685,3/31/2018 7:25,71,66,71,38,62,308,5,100
1686,3/31/2018 7:30,71,59,78,29,60,297,5,100
1687,3/31/2018 7:35,75,63,86,22,65,311,5,100
1688,3/31/2018 7:40,95,64,85,34,63,341,5,100
1689,3/31/2018 7:45,98,83,94,40,68,383,5,100
1690,3/31/2018 7:50,95,82,92,46,64,379,5,100
1691,3/31/2018 7:55,96,62,96,32,77,363,5,100
1692,3/31/2018 8:00,90,77,79,28,54,328,5,100
1693,3/31/2018 8:05,82,62,83,34,64,325,5,100
1694,3/31/2018 8:10,88,79,86,34,64,351,5,100
1695,3/31/2018 8:15,106,67,97,34,61,365,5,100
1696,3/31/2018 8:20,100,99,99,44,77,419,5,100
1697,3/31/2018 8:25,103,83,85,40,67,378,5,100
1698,3/31/2018 8:30,121,80,110,44,80,435,5,100
1699,3/31/2018 8:35,108,81,109,45,75,418,5,100
1700,3/31/2018 8:40,112,89,117,43,82,443,5,100
1701,3/31/2018 8:45,121,89,120,50,75,455,5,100
1702,3/31/2018 8:50,118,101,115,38,78,450,5,100
1703,3/31/2018 8:55,103,82,108,44,64,401,5,100
1704,3/31/2018 9:00,92,74,86,40,69,361,5,100
1705,3/31/2018 9:05,125,96,119,35,81,456,5,100
1706,3/31/2018 9:10,140,104,130,50,87,511,5,100
1707,3/31/2018 9:15,142,89,127,41,80,479,5,100
1708,3/31/2018 9:20,132,102,117,64,90,505,5,100
1709,3/31/2018 9:25,92,88,102,43,85,410,5,100
1710,3/31/2018 9:30,130,101,125,43,90,489,5,100
1711,3/31/2018 9:35,135,119,131,46,92,523,5,100
1712,3/31/2018 9:40,113,92,115,47,77,444,5,100
1713,3/31/2018 9:45,164,110,142,65,104,585,5,100
1714,3/31/2018 9:50,159,117,126,60,97,559,5,100
1715,3/31/2018 9:55,154,93,119,57,83,506,5,100
1716,3/31/2018 10:00,144,102,131,39,93,509,5,100
1717,3/31/2018 10:05,142,112,134,49,86,523,5,100
1718,3/31/2018 10:10,145,112,121,58,89,525,5,100
1719,3/31/2018 10:15,146,110,125,49,95,525,5,100
1720,3/31/2018 10:20,154,120,132,63,89,558,5,100
1721,3/31/2018 10:25,154,117,139,46,89,545,5,100
1722,3/31/2018 10:30,137,113,139,45,98,532,5,100
1723,3/31/2018 10:35,151,113,138,51,95,548,5,100
1724,3/31/2018 10:40,140,101,135,57,91,524,5,100
1725,3/31/2018 10:45,164,110,134,62,97,567,5,100
1726,3/31/2018 10:50,158,112,142,56,97,565,5,100
1727,3/31/2018 10:55,147,116,138,55,80,536,5,100
1728,3/31/2018 11:00,154,119,143,52,88,556,5,100
1729,3/31/2018 11:05,140,115,132,47,87,521,5,100
1730,3/31/2018 11:10,146,103,131,54,103,537,5,100
1731,3/31/2018 11:15,151,111,128,54,106,550,5,100
1732,3/31/2018 11:20,144,121,141,73,96,575,5,100
1733,3/31/2018 11:25,142,111,127,56,76,512,5,100
1734,3/31/2018 11:30,142,104,137,60,86,529,5,100
1735,3/31/2018 11:35,152,116,144,67,101,580,5,100
1736,3/31/2018 11:40,140,104,138,67,116,565,5,100
1737,3/31/2018 11:45,146,118,136,71,100,571,5,100
1738,3/31/2018 11:50,126,111,113,57,103,510,5,100
1739,3/31/2018 11:55,137,108,132,68,100,545,5,100
