,5 Minutes,Lane 1 Flow (Veh/5 Minutes),Lane 2 Flow (Veh/5 Minutes),Lane 3 Flow (Veh/5 Minutes),Flow (Veh/5 Minutes),# Lane Points,% Observed
1407,3/23/2018 21:15,50,82,58,190,3,0
1408,3/23/2018 21:20,49,80,56,185,3,0
1409,3/23/2018 21:25,49,80,56,185,3,0
1410,3/23/2018 21:30,47,77,54,178,3,0
1411,3/23/2018 21:35,47,76,54,177,3,0
1412,3/23/2018 21:40,46,75,52,173,3,0
1413,3/23/2018 21:45,47,76,53,176,3,0
1414,3/23/2018 21:50,46,75,52,173,3,0
1415,3/23/2018 21:55,45,72,51,168,3,0
1416,3/23/2018 22:00,44,72,51,167,3,0
1417,3/23/2018 22:05,45,73,52,170,3,0
1418,3/23/2018 22:10,46,74,52,172,3,0
1419,3/23/2018 22:15,45,73,51,169,3,0
1420,3/23/2018 22:20,45,73,51,169,3,0
1421,3/23/2018 22:25,42,69,48,159,3,0
1422,3/23/2018 22:30,41,67,47,155,3,0
1423,3/23/2018 22:35,40,65,46,151,3,0
1424,3/23/2018 22:40,40,65,45,150,3,0
1425,3/23/2018 22:45,40,64,45,149,3,0
1426,3/23/2018 22:50,37,61,43,141,3,0
1427,3/23/2018 22:55,36,59,42,137,3,0
1428,3/23/2018 23:00,35,56,39,130,3,0
1429,3/23/2018 23:05,34,55,39,128,3,0
1430,3/23/2018 23:10,34,55,39,128,3,0
1431,3/23/2018 23:15,35,56,39,130,3,0
1432,3/23/2018 23:20,32,52,36,120,3,0
1433,3/23/2018 23:25,30,49,35,114,3,0
1434,3/23/2018 23:30,30,49,34,113,3,0
1435,3/23/2018 23:35,30,48,34,112,3,0
1436,3/23/2018 23:40,29,47,33,109,3,0
1437,3/23/2018 23:45,28,45,32,105,3,0
1438,3/23/2018 23:50,27,43,30,100,3,0
1439,3/23/2018 23:55,25,41,29,95,3,0
1440,3/24/2018 0:00,24,39,27,90,3,0
1441,3/24/2018 0:05,24,39,28,91,3,0
1442,3/24/2018 0:10,24,39,27,90,3,0
1443,3/24/2018 0:15,23,38,26,87,3,0
1444,3/24/2018 0:20,23,37,26,86,3,0
1445,3/24/2018 0:25,21,34,24,79,3,0
1446,3/24/2018 0:30,20,32,23,75,3,0
1447,3/24/2018 0:35,20,32,22,74,3,0
1448,3/24/2018 0:40,19,31,22,72,3,0
1449,3/24/2018 0:45,19,30,21,70,3,0
1450,3/24/2018 0:50,18,29,21,68,3,0
1451,3/24/2018 0:55,18,29,20,67,3,0
1452,3/24/2018 1:00,17,27,19,63,3,0
1453,3/24/2018 1:05,16,27,19,62,3,0
1454,3/24/2018 1:10,16,27,19,62,3,0
1455,3/24/2018 1:15,16,26,18,60,3,0
1456,3/24/2018 1:20,16,26,18,60,3,0
1457,3/24/2018 1:25,15,24,17,56,3,0
1458,3/24/2018 1:30,3,4,3,10,3,0
1459,3/24/2018 1:35,15,24,17,56,3,0
1460,3/24/2018 1:40,15,24,17,56,3,0
1461,3/24/2018 1:45,14,22,16,52,3,0
1462,3/24/2018 1:50,14,23,16,53,3,0
1463,3/24/2018 1:55,14,22,15,51,3,0
1464,3/24/2018 2:00,14,22,16,52,3,0
1465,3/24/2018 2:05,14,22,15,51,3,0
1466,3/24/2018 2:10,14,22,16,52,3,0
1467,3/24/2018 2:15,13,22,15,50,3,0
1468,3/24/2018 2:20,13,21,15,49,3,0
1469,3/24/2018 2:25,12,20,14,46,3,0
1470,3/24/2018 2:30,12,19,13,44,3,0
1471,3/24/2018 2:35,11,18,13,42,3,0
1472,3/24/2018 2:40,11,18,13,42,3,0
1473,3/24/2018 2:45,11,17,12,40,3,0
1474,3/24/2018 2:50,11,17,12,40,3,0
1475,3/24/2018 2:55,10,16,11,37,3,0
1476,3/24/2018 3:00,9,15,11,35,3,0
1477,3/24/2018 3:05,9,15,10,34,3,0
1478,3/24/2018 3:10,9,15,11,35,3,0
1479,3/24/2018 3:15,9,15,11,35,3,0
1480,3/24/2018 3:20,9,15,10,34,3,0
1481,3/24/2018 3:25,9,14,10,33,3,0
1482,3/24/2018 3:30,9,15,10,34,3,0
1483,3/24/2018 3:35,9,15,11,35,3,0
1484,3/24/2018 3:40,10,16,11,37,3,0
1485,3/24/2018 3:45,9,15,11,35,3,0
1486,3/24/2018 3:50,8,14,10,32,3,0
1487,3/24/2018 3:55,8,13,9,30,3,0
1488,3/24/2018 4:00,8,13,9,30,3,0
1489,3/24/2018 4:05,8,13,9,30,3,0
1490,3/24/2018 4:10,9,15,11,35,3,0
1491,3/24/2018 4:15,10,16,11,37,3,0
1492,3/24/2018 4:20,11,17,12,40,3,0
1493,3/24/2018 4:25,11,17,12,40,3,0
1494,3/24/2018 4:30,11,18,13,42,3,0
1495,3/24/2018 4:35,12,19,14,45,3,0
1496,3/24/2018 4:40,13,21,15,49,3,0
1497,3/24/2018 4:45,13,21,15,49,3,0
1498,3/24/2018 4:50,12,20,14,46,3,0
1499,3/24/2018 4:55,12,19,14,45,3,0
1500,3/24/2018 5:00,12,20,14,46,3,0
1501,3/24/2018 5:05,14,22,16,52,3,0
1502,3/24/2018 5:10,15,25,18,58,3,0
1503,3/24/2018 5:15,17,28,19,64,3,0
1504,3/24/2018 5:20,18,29,21,68,3,0
1505,3/24/2018 5:25,20,32,22,74,3,0
1506,3/24/2018 5:30,21,34,24,79,3,0
1507,3/24/2018 5:35,23,37,26,86,3,0
1508,3/24/2018 5:40,25,40,28,93,3,0
1509,3/24/2018 5:45,25,41,29,95,3,0
1510,3/24/2018 5:50,24,39,28,91,3,0
1511,3/24/2018 5:55,23,37,26,86,3,0
1512,3/24/2018 6:00,23,37,26,86,3,0
1513,3/24/2018 6:05,24,38,27,89,3,0
1514,3/24/2018 6:10,25,41,29,95,3,0
1515,3/24/2018 6:15,27,44,31,102,3,0
1516,3/24/2018 6:20,28,46,32,106,3,0
1517,3/24/2018 6:25,29,48,34,111,3,0
1518,3/24/2018 6:30,32,51,36,119,3,0
1519,3/24/2018 6:35,33,54,38,125,3,0
1520,3/24/2018 6:40,36,58,41,135,3,0
1521,3/24/2018 6:45,36,59,42,137,3,0
1522,3/24/2018 6:50,36,59,42,137,3,0
1523,3/24/2018 6:55,35,56,39,130,3,0
1524,3/24/2018 7:00,34,56,39,129,3,0
1525,3/24/2018 7:05,35,57,40,132,3,0
1526,3/24/2018 7:10,37,60,42,139,3,0
1527,3/24/2018 7:15,39,63,45,147,3,0
1528,3/24/2018 7:20,40,66,46,152,3,0
1529,3/24/2018 7:25,43,69,49,161,3,0
1530,3/24/2018 7:30,43,70,49,162,3,0
1531,3/24/2018 7:35,46,75,53,174,3,0
1532,3/24/2018 7:40,50,82,58,190,3,0
1533,3/24/2018 7:45,52,84,59,195,3,0
1534,3/24/2018 7:50,51,84,59,194,3,0
1535,3/24/2018 7:55,50,82,58,190,3,0
1536,3/24/2018 8:00,49,79,55,183,3,0
1537,3/24/2018 8:05,49,79,55,183,3,0
1538,3/24/2018 8:10,50,81,57,188,3,0
1539,3/24/2018 8:15,51,83,59,193,3,0
1540,3/24/2018 8:20,52,84,59,195,3,0
1541,3/24/2018 8:25,53,86,61,200,3,0
1542,3/24/2018 8:30,55,89,63,207,3,0
1543,3/24/2018 8:35,58,94,66,218,3,0
1544,3/24/2018 8:40,60,97,69,226,3,0
1545,3/24/2018 8:45,62,101,71,234,3,0
1546,3/24/2018 8:50,62,101,71,234,3,0
1547,3/24/2018 8:55,59,97,68,224,3,0
1548,3/24/2018 9:00,59,95,67,221,3,0
1549,3/24/2018 9:05,56,91,64,211,3,0
1550,3/24/2018 9:10,57,93,65,215,3,0
1551,3/24/2018 9:15,59,97,68,224,3,0
1552,3/24/2018 9:20,62,101,71,234,3,0
1553,3/24/2018 9:25,62,101,71,234,3,0
1554,3/24/2018 9:30,64,105,74,243,3,0
1555,3/24/2018 9:35,65,105,74,244,3,0
1556,3/24/2018 9:40,67,109,76,252,3,0
1557,3/24/2018 9:45,68,111,78,257,3,0
1558,3/24/2018 9:50,66,107,75,248,3,0
1559,3/24/2018 9:55,64,104,73,241,3,0
1560,3/24/2018 10:00,65,105,74,244,3,0
1561,3/24/2018 10:05,65,106,75,246,3,0
1562,3/24/2018 10:10,66,107,75,248,3,0
1563,3/24/2018 10:15,66,107,75,248,3,0
1564,3/24/2018 10:20,66,107,75,248,3,0
1565,3/24/2018 10:25,66,108,76,250,3,0
1566,3/24/2018 10:30,68,111,78,257,3,0
1567,3/24/2018 10:35,70,113,79,262,3,0
1568,3/24/2018 10:40,70,113,80,263,3,0
1569,3/24/2018 10:45,70,114,80,264,3,0
1570,3/24/2018 10:50,71,115,81,267,3,0
1571,3/24/2018 10:55,69,113,79,261,3,0
1572,3/24/2018 11:00,69,113,79,261,3,0
1573,3/24/2018 11:05,70,114,80,264,3,0
1574,3/24/2018 11:10,71,116,82,269,3,0
1575,3/24/2018 11:15,72,117,82,271,3,0
1576,3/24/2018 11:20,72,118,83,273,3,0
1577,3/24/2018 11:25,72,117,82,271,3,0
1578,3/24/2018 11:30,73,118,83,274,3,0
1579,3/24/2018 11:35,74,120,85,279,3,0
1580,3/24/2018 11:40,73,119,84,276,3,0
1581,3/24/2018 11:45,74,120,84,278,3,0
1582,3/24/2018 11:50,74,120,85,279,3,0
1583,3/24/2018 11:55,73,118,83,274,3,0
1584,3/24/2018 12:00,73,119,83,275,3,0
1585,3/24/2018 12:05,75,122,86,283,3,0
1586,3/24/2018 12:10,76,123,86,285,3,0
1587,3/24/2018 12:15,76,124,87,287,3,0
1588,3/24/2018 12:20,76,124,87,287,3,0
1589,3/24/2018 12:25,75,122,86,283,3,0
1590,3/24/2018 12:30,75,121,85,281,3,0
1591,3/24/2018 12:35,74,120,85,279,3,0
1592,3/24/2018 12:40,74,121,85,280,3,0
1593,3/24/2018 12:45,75,122,86,283,3,0
1594,3/24/2018 12:50,75,122,86,283,3,0
1595,3/24/2018 12:55,74,120,85,279,3,0
1596,3/24/2018 13:00,73,119,83,275,3,0
1597,3/24/2018 13:05,74,120,85,279,3,0
1598,3/24/2018 13:10,74,120,85,279,3,0
1599,3/24/2018 13:15,75,122,86,283,3,0
1600,3/24/2018 13:20,75,121,85,281,3,0
1601,3/24/2018 13:25,75,123,86,284,3,0
1602,3/24/2018 13:30,75,123,86,284,3,0
1603,3/24/2018 13:35,74,120,85,279,3,0
1604,3/24/2018 13:40,75,122,86,283,3,0
1605,3/24/2018 13:45,74,121,85,280,3,0
1606,3/24/2018 13:50,75,122,86,283,3,0
1607,3/24/2018 13:55,73,118,83,274,3,0
1608,3/24/2018 14:00,73,119,83,275,3,0
1609,3/24/2018 14:05,74,119,84,277,3,0
1610,3/24/2018 14:10,74,121,85,280,3,0
1611,3/24/2018 14:15,75,122,86,283,3,0
1612,3/24/2018 14:20,74,120,85,279,3,0
1613,3/24/2018 14:25,75,122,86,283,3,0
1614,3/24/2018 14:30,74,119,84,277,3,0
1615,3/24/2018 14:35,76,123,86,285,3,0
1616,3/24/2018 14:40,75,122,86,283,3,0
1617,3/24/2018 14:45,76,124,87,287,3,0
1618,3/24/2018 14:50,76,124,87,287,3,0
1619,3/24/2018 14:55,74,121,85,280,3,0
1620,3/24/2018 15:00,74,121,85,280,3,0
1621,3/24/2018 15:05,75,121,85,281,3,0
1622,3/24/2018 15:10,76,124,87,287,3,0
1623,3/24/2018 15:15,76,124,87,287,3,0
1624,3/24/2018 15:20,78,127,89,294,3,0
1625,3/24/2018 15:25,76,123,87,286,3,0
1626,3/24/2018 15:30,76,123,87,286,3,0
1627,3/24/2018 15:35,77,125,88,290,3,0
1628,3/24/2018 15:40,76,124,87,287,3,0
1629,3/24/2018 15:45,76,124,87,287,3,0
1630,3/24/2018 15:50,77,125,88,290,3,0
1631,3/24/2018 15:55,76,123,86,285,3,0
1632,3/24/2018 16:00,76,123,86,285,3,0
1633,3/24/2018 16:05,76,123,86,285,3,0
1634,3/24/2018 16:10,76,123,87,286,3,0
1635,3/24/2018 16:15,77,125,88,290,3,0
1636,3/24/2018 16:20,77,126,89,292,3,0
1637,3/24/2018 16:25,76,124,87,287,3,0
1638,3/24/2018 16:30,76,124,87,287,3,0
1639,3/24/2018 16:35,76,124,87,287,3,0
1640,3/24/2018 16:40,76,123,87,286,3,0
1641,3/24/2018 16:45,76,123,87,286,3,0
1642,3/24/2018 16:50,77,125,88,290,3,0
1643,3/24/2018 16:55,74,120,85,279,3,0
1644,3/24/2018 17:00,74,121,85,280,3,0
1645,3/24/2018 17:05,75,121,85,281,3,0
1646,3/24/2018 17:10,76,124,87,287,3,0
1647,3/24/2018 17:15,76,124,87,287,3,0
1648,3/24/2018 17:20,79,128,90,297,3,0
1649,3/24/2018 17:25,75,123,86,284,3,0
1650,3/24/2018 17:30,74,120,85,279,3,0
1651,3/24/2018 17:35,74,120,84,278,3,0
1652,3/24/2018 17:40,73,119,84,276,3,0
1653,3/24/2018 17:45,72,117,82,271,3,0
1654,3/24/2018 17:50,72,118,83,273,3,0
1655,3/24/2018 17:55,71,116,81,268,3,0
1656,3/24/2018 18:00,70,113,80,263,3,0
1657,3/24/2018 18:05,71,115,81,267,3,0
1658,3/24/2018 18:10,71,115,81,267,3,0
1659,3/24/2018 18:15,70,113,80,263,3,0
1660,3/24/2018 18:20,70,113,80,263,3,0
1661,3/24/2018 18:25,67,109,77,253,3,0
1662,3/24/2018 18:30,67,110,77,254,3,0
1663,3/24/2018 18:35,66,107,75,248,3,0
1664,3/24/2018 18:40,64,105,74,243,3,0
1665,3/24/2018 18:45,64,104,73,241,3,0
1666,3/24/2018 18:50,63,102,72,237,3,0
1667,3/24/2018 18:55,62,101,71,234,3,0
1668,3/24/2018 19:00,61,99,69,229,3,0
1669,3/24/2018 19:05,61,99,70,230,3,0
1670,3/24/2018 19:10,60,97,68,225,3,0
1671,3/24/2018 19:15,61,98,69,228,3,0
1672,3/24/2018 19:20,59,95,67,221,3,0
1673,3/24/2018 19:25,57,92,65,214,3,0
1674,3/24/2018 19:30,56,91,64,211,3,0
1675,3/24/2018 19:35,54,88,62,204,3,0
1676,3/24/2018 19:40,55,89,63,207,3,0
1677,3/24/2018 19:45,53,87,61,201,3,0
1678,3/24/2018 19:50,53,85,60,198,3,0
1679,3/24/2018 19:55,51,82,58,191,3,0
1680,3/24/2018 20:00,51,84,59,194,3,0
1681,3/24/2018 20:05,50,82,57,189,3,0
1682,3/24/2018 20:10,50,81,57,188,3,0
1683,3/24/2018 20:15,50,81,57,188,3,0
1684,3/24/2018 20:20,49,79,56,184,3,0
1685,3/24/2018 20:25,48,79,55,182,3,0
1686,3/24/2018 20:30,48,77,54,179,3,0
1687,3/24/2018 20:35,48,77,54,179,3,0
1688,3/24/2018 20:40,48,78,55,181,3,0
1689,3/24/2018 20:45,47,76,54,177,3,0
1690,3/24/2018 20:50,46,74,52,172,3,0
1691,3/24/2018 20:55,46,75,53,174,3,0
1692,3/24/2018 21:00,45,73,52,170,3,0
1693,3/24/2018 21:05,46,74,52,172,3,0
1694,3/24/2018 21:10,45,73,51,169,3,0
1695,3/24/2018 21:15,46,75,52,173,3,0
1696,3/24/2018 21:20,45,73,52,170,3,0
1697,3/24/2018 21:25,45,72,51,168,3,0
1698,3/24/2018 21:30,44,72,51,167,3,0
1699,3/24/2018 21:35,45,72,51,168,3,0
1700,3/24/2018 21:40,45,73,52,170,3,0
1701,3/24/2018 21:45,45,73,52,170,3,0
1702,3/24/2018 21:50,44,71,50,165,3,0
1703,3/24/2018 21:55,43,70,49,162,3,0
1704,3/24/2018 22:00,43,70,49,162,3,0
1705,3/24/2018 22:05,44,72,50,166,3,0
1706,3/24/2018 22:10,45,73,52,170,3,0
1707,3/24/2018 22:15,44,71,50,165,3,0
1708,3/24/2018 22:20,44,72,50,166,3,0
1709,3/24/2018 22:25,43,70,49,162,3,0
1710,3/24/2018 22:30,43,69,49,161,3,0
1711,3/24/2018 22:35,42,69,48,159,3,0
1712,3/24/2018 22:40,42,68,48,158,3,0
1713,3/24/2018 22:45,40,66,46,152,3,0
1714,3/24/2018 22:50,40,64,45,149,3,0
1715,3/24/2018 22:55,37,60,42,139,3,0
1716,3/24/2018 23:00,36,58,41,135,3,0
1717,3/24/2018 23:05,37,60,42,139,3,0
1718,3/24/2018 23:10,37,60,42,139,3,0
1719,3/24/2018 23:15,36,58,41,135,3,0
1720,3/24/2018 23:20,37,60,42,139,3,0
1721,3/24/2018 23:25,35,56,39,130,3,0
1722,3/24/2018 23:30,35,56,39,130,3,0
1723,3/24/2018 23:35,33,53,37,123,3,0
1724,3/24/2018 23:40,32,52,37,121,3,0
1725,3/24/2018 23:45,31,51,36,118,3,0
1726,3/24/2018 23:50,30,49,34,113,3,0
1727,3/24/2018 23:55,29,47,33,109,3,0
1728,3/25/2018 0:00,27,44,31,102,3,0
1729,3/25/2018 0:05,27,44,31,102,3,0
1730,3/25/2018 0:10,26,43,30,99,3,0
1731,3/25/2018 0:15,25,41,29,95,3,0
1732,3/25/2018 0:20,25,40,28,93,3,0
1733,3/25/2018 0:25,24,38,27,89,3,0
1734,3/25/2018 0:30,22,35,25,82,3,0
1735,3/25/2018 0:35,22,35,25,82,3,0
1736,3/25/2018 0:40,21,34,24,79,3,0
1737,3/25/2018 0:45,20,33,23,76,3,0
1738,3/25/2018 0:50,20,32,23,75,3,0
1739,3/25/2018 0:55,18,30,21,69,3,0
1740,3/25/2018 1:00,18,29,21,68,3,0
1741,3/25/2018 1:05,17,28,20,65,3,0
1742,3/25/2018 1:10,17,28,20,65,3,0
1743,3/25/2018 1:15,17,28,19,64,3,0
1744,3/25/2018 1:20,17,28,20,65,3,0
1745,3/25/2018 1:25,16,25,18,59,3,0
1746,3/25/2018 1:30,15,25,18,58,3,0
1747,3/25/2018 1:35,15,25,18,58,3,0
1748,3/25/2018 1:40,15,25,18,58,3,0
1749,3/25/2018 1:45,15,25,17,57,3,0
1750,3/25/2018 1:50,15,24,17,56,3,0
1751,3/25/2018 1:55,14,23,16,53,3,0
1752,3/25/2018 2:00,15,24,17,56,3,0
1753,3/25/2018 2:05,15,24,17,56,3,0
1754,3/25/2018 2:10,14,23,16,53,3,0
1755,3/25/2018 2:15,14,22,15,51,3,0
1756,3/25/2018 2:20,14,22,15,51,3,0
1757,3/25/2018 2:25,12,20,14,46,3,0
1758,3/25/2018 2:30,11,19,13,43,3,0
1759,3/25/2018 2:35,11,18,13,42,3,0
1760,3/25/2018 2:40,10,16,12,38,3,0
1761,3/25/2018 2:45,10,16,11,37,3,0
1762,3/25/2018 2:50,10,16,11,37,3,0
1763,3/25/2018 2:55,9,15,10,34,3,0
1764,3/25/2018 3:00,9,14,10,33,3,0
1765,3/25/2018 3:05,8,14,10,32,3,0
1766,3/25/2018 3:10,8,13,9,30,3,0
1767,3/25/2018 3:15,8,13,9,30,3,0
1768,3/25/2018 3:20,8,13,9,30,3,0
1769,3/25/2018 3:25,7,12,8,27,3,0
1770,3/25/2018 3:30,7,12,8,27,3,0
1771,3/25/2018 3:35,7,12,8,27,3,0
1772,3/25/2018 3:40,7,11,8,26,3,0
1773,3/25/2018 3:45,7,11,8,26,3,0
1774,3/25/2018 3:50,7,11,8,26,3,0
1775,3/25/2018 3:55,6,10,7,23,3,0
1776,3/25/2018 4:00,6,10,7,23,3,0
1777,3/25/2018 4:05,6,10,7,23,3,0
1778,3/25/2018 4:10,6,10,7,23,3,0
1779,3/25/2018 4:15,6,10,7,23,3,0
1780,3/25/2018 4:20,6,10,7,23,3,0
1781,3/25/2018 4:25,6,10,7,23,3,0
1782,3/25/2018 4:30,6,10,7,23,3,0
1783,3/25/2018 4:35,7,11,8,26,3,0
1784,3/25/2018 4:40,7,11,8,26,3,0
1785,3/25/2018 4:45,7,12,8,27,3,0
1786,3/25/2018 4:50,7,12,8,27,3,0
1787,3/25/2018 4:55,7,12,8,27,3,0
1788,3/25/2018 5:00,7,12,8,27,3,0
1789,3/25/2018 5:05,8,13,9,30,3,0
1790,3/25/2018 5:10,8,13,9,30,3,0
1791,3/25/2018 5:15,9,15,10,34,3,0
1792,3/25/2018 5:20,9,15,11,35,3,0
1793,3/25/2018 5:25,10,16,11,37,3,0
1794,3/25/2018 5:30,11,18,12,41,3,0
1795,3/25/2018 5:35,11,19,13,43,3,0
1796,3/25/2018 5:40,12,20,14,46,3,0
1797,3/25/2018 5:45,12,20,14,46,3,0
1798,3/25/2018 5:50,12,20,14,46,3,0
1799,3/25/2018 5:55,12,19,13,44,3,0
1800,3/25/2018 6:00,12,19,14,45,3,0
1801,3/25/2018 6:05,13,21,15,49,3,0
1802,3/25/2018 6:10,14,22,15,51,3,0
1803,3/25/2018 6:15,15,24,17,56,3,0
1804,3/25/2018 6:20,15,25,18,58,3,0
1805,3/25/2018 6:25,16,26,18,60,3,0
1806,3/25/2018 6:30,16,27,19,62,3,0
1807,3/25/2018 6:35,18,28,20,66,3,0
1808,3/25/2018 6:40,19,30,21,70,3,0
1809,3/25/2018 6:45,19,30,21,70,3,0
1810,3/25/2018 6:50,19,31,22,72,3,0
1811,3/25/2018 6:55,18,29,21,68,3,0
1812,3/25/2018 7:00,18,28,20,66,3,0
1813,3/25/2018 7:05,18,29,21,68,3,0
1814,3/25/2018 7:10,19,31,22,72,3,0
1815,3/25/2018 7:15,20,33,23,76,3,0
1816,3/25/2018 7:20,21,35,25,81,3,0
1817,3/25/2018 7:25,22,36,25,83,3,0
1818,3/25/2018 7:30,23,37,26,86,3,0
1819,3/25/2018 7:35,25,40,28,93,3,0
1820,3/25/2018 7:40,26,43,30,99,3,0
1821,3/25/2018 7:45,27,44,31,102,3,0
1822,3/25/2018 7:50,28,45,32,105,3,0
1823,3/25/2018 7:55,27,44,31,102,3,0
1824,3/25/2018 8:00,27,43,30,100,3,0
1825,3/25/2018 8:05,27,44,31,102,3,0
1826,3/25/2018 8:10,28,46,32,106,3,0
1827,3/25/2018 8:15,30,49,34,113,3,0
1828,3/25/2018 8:20,33,53,37,123,3,0
1829,3/25/2018 8:25,33,53,37,123,3,0
1830,3/25/2018 8:30,33,54,38,125,3,0
1831,3/25/2018 8:35,35,57,40,132,3,0
1832,3/25/2018 8:40,37,60,42,139,3,0
1833,3/25/2018 8:45,39,63,44,146,3,0
1834,3/25/2018 8:50,40,64,45,149,3,0
1835,3/25/2018 8:55,40,64,45,149,3,0
1836,3/25/2018 9:00,38,62,44,144,3,0
1837,3/25/2018 9:05,38,62,44,144,3,0
1838,3/25/2018 9:10,40,65,45,150,3,0
1839,3/25/2018 9:15,42,68,48,158,3,0
1840,3/25/2018 9:20,44,71,50,165,3,0
1841,3/25/2018 9:25,45,72,51,168,3,0
1842,3/25/2018 9:30,47,76,53,176,3,0
1843,3/25/2018 9:35,49,80,56,185,3,0
1844,3/25/2018 9:40,51,82,58,191,3,0
1845,3/25/2018 9:45,53,85,60,198,3,0
1846,3/25/2018 9:50,53,85,60,198,3,0
1847,3/25/2018 9:55,52,85,59,196,3,0
1848,3/25/2018 10:00,51,84,59,194,3,0
1849,3/25/2018 10:05,51,82,58,191,3,0
1850,3/25/2018 10:10,52,85,59,196,3,0
1851,3/25/2018 10:15,54,88,62,204,3,0
1852,3/25/2018 10:20,54,88,62,204,3,0
1853,3/25/2018 10:25,56,91,64,211,3,0
1854,3/25/2018 10:30,57,92,65,214,3,0
1855,3/25/2018 10:35,57,92,65,214,3,0
1856,3/25/2018 10:40,59,96,68,223,3,0
1857,3/25/2018 10:45,60,97,68,225,3,0
1858,3/25/2018 10:50,59,97,68,224,3,0
1859,3/25/2018 10:55,59,97,68,224,3,0
1860,3/25/2018 11:00,58,94,66,218,3,0
1861,3/25/2018 11:05,58,94,66,218,3,0
1862,3/25/2018 11:10,58,94,66,218,3,0
1863,3/25/2018 11:15,59,95,67,221,3,0
1864,3/25/2018 11:20,61,98,69,228,3,0
1865,3/25/2018 11:25,61,99,69,229,3,0
1866,3/25/2018 11:30,61,100,70,231,3,0
1867,3/25/2018 11:35,61,100,70,231,3,0
1868,3/25/2018 11:40,63,102,72,237,3,0
1869,3/25/2018 11:45,63,103,72,238,3,0
1870,3/25/2018 11:50,63,102,72,237,3,0
1871,3/25/2018 11:55,63,102,72,237,3,0
0,3/25/2018 0:00,27,44,31,102,3,0
1,3/25/2018 0:05,27,44,31,102,3,0
2,3/25/2018 0:10,26,43,30,99,3,0
3,3/25/2018 0:15,25,41,29,95,3,0
4,3/25/2018 0:20,25,40,28,93,3,0
5,3/25/2018 0:25,24,38,27,89,3,0
6,3/25/2018 0:30,22,35,25,82,3,0
7,3/25/2018 0:35,22,35,25,82,3,0
8,3/25/2018 0:40,21,34,24,79,3,0
9,3/25/2018 0:45,20,33,23,76,3,0
10,3/25/2018 0:50,20,32,23,75,3,0
11,3/25/2018 0:55,18,30,21,69,3,0
12,3/25/2018 1:00,18,29,21,68,3,0
13,3/25/2018 1:05,17,28,20,65,3,0
14,3/25/2018 1:10,17,28,20,65,3,0
15,3/25/2018 1:15,17,28,19,64,3,0
16,3/25/2018 1:20,17,28,20,65,3,0
17,3/25/2018 1:25,16,25,18,59,3,0
18,3/25/2018 1:30,15,25,18,58,3,0
19,3/25/2018 1:35,15,25,18,58,3,0
20,3/25/2018 1:40,15,25,18,58,3,0
21,3/25/2018 1:45,15,25,17,57,3,0
22,3/25/2018 1:50,15,24,17,56,3,0
23,3/25/2018 1:55,14,23,16,53,3,0
24,3/25/2018 2:00,15,24,17,56,3,0
25,3/25/2018 2:05,15,24,17,56,3,0
26,3/25/2018 2:10,14,23,16,53,3,0
27,3/25/2018 2:15,14,22,15,51,3,0
28,3/25/2018 2:20,14,22,15,51,3,0
29,3/25/2018 2:25,12,20,14,46,3,0
30,3/25/2018 2:30,11,19,13,43,3,0
31,3/25/2018 2:35,11,18,13,42,3,0
32,3/25/2018 2:40,10,16,12,38,3,0
33,3/25/2018 2:45,10,16,11,37,3,0
34,3/25/2018 2:50,10,16,11,37,3,0
35,3/25/2018 2:55,9,15,10,34,3,0
36,3/25/2018 3:00,9,14,10,33,3,0
37,3/25/2018 3:05,8,14,10,32,3,0
38,3/25/2018 3:10,8,13,9,30,3,0
39,3/25/2018 3:15,8,13,9,30,3,0
40,3/25/2018 3:20,8,13,9,30,3,0
41,3/25/2018 3:25,7,12,8,27,3,0
42,3/25/2018 3:30,7,12,8,27,3,0
43,3/25/2018 3:35,7,12,8,27,3,0
44,3/25/2018 3:40,7,11,8,26,3,0
45,3/25/2018 3:45,7,11,8,26,3,0
46,3/25/2018 3:50,7,11,8,26,3,0
47,3/25/2018 3:55,6,10,7,23,3,0
48,3/25/2018 4:00,6,10,7,23,3,0
49,3/25/2018 4:05,6,10,7,23,3,0
50,3/25/2018 4:10,6,10,7,23,3,0
51,3/25/2018 4:15,6,10,7,23,3,0
52,3/25/2018 4:20,6,10,7,23,3,0
53,3/25/2018 4:25,6,10,7,23,3,0
54,3/25/2018 4:30,6,10,7,23,3,0
55,3/25/2018 4:35,7,11,8,26,3,0
56,3/25/2018 4:40,7,11,8,26,3,0
57,3/25/2018 4:45,7,12,8,27,3,0
58,3/25/2018 4:50,7,12,8,27,3,0
59,3/25/2018 4:55,7,12,8,27,3,0
60,3/25/2018 5:00,7,12,8,27,3,0
61,3/25/2018 5:05,8,13,9,30,3,0
62,3/25/2018 5:10,8,13,9,30,3,0
63,3/25/2018 5:15,9,15,10,34,3,0
64,3/25/2018 5:20,9,15,11,35,3,0
65,3/25/2018 5:25,10,16,11,37,3,0
66,3/25/2018 5:30,11,18,12,41,3,0
67,3/25/2018 5:35,11,19,13,43,3,0
68,3/25/2018 5:40,12,20,14,46,3,0
69,3/25/2018 5:45,12,20,14,46,3,0
70,3/25/2018 5:50,12,20,14,46,3,0
71,3/25/2018 5:55,12,19,13,44,3,0
72,3/25/2018 6:00,12,19,14,45,3,0
73,3/25/2018 6:05,13,21,15,49,3,0
74,3/25/2018 6:10,14,22,15,51,3,0
75,3/25/2018 6:15,15,24,17,56,3,0
76,3/25/2018 6:20,15,25,18,58,3,0
77,3/25/2018 6:25,16,26,18,60,3,0
78,3/25/2018 6:30,16,27,19,62,3,0
79,3/25/2018 6:35,18,28,20,66,3,0
80,3/25/2018 6:40,19,30,21,70,3,0
81,3/25/2018 6:45,19,30,21,70,3,0
82,3/25/2018 6:50,19,31,22,72,3,0
83,3/25/2018 6:55,18,29,21,68,3,0
84,3/25/2018 7:00,18,28,20,66,3,0
85,3/25/2018 7:05,18,29,21,68,3,0
86,3/25/2018 7:10,19,31,22,72,3,0
87,3/25/2018 7:15,20,33,23,76,3,0
88,3/25/2018 7:20,21,35,25,81,3,0
89,3/25/2018 7:25,22,36,25,83,3,0
90,3/25/2018 7:30,23,37,26,86,3,0
91,3/25/2018 7:35,25,40,28,93,3,0
92,3/25/2018 7:40,26,43,30,99,3,0
93,3/25/2018 7:45,27,44,31,102,3,0
94,3/25/2018 7:50,28,45,32,105,3,0
95,3/25/2018 7:55,27,44,31,102,3,0
96,3/25/2018 8:00,27,43,30,100,3,0
97,3/25/2018 8:05,27,44,31,102,3,0
98,3/25/2018 8:10,28,46,32,106,3,0
99,3/25/2018 8:15,30,49,34,113,3,0
100,3/25/2018 8:20,33,53,37,123,3,0
101,3/25/2018 8:25,33,53,37,123,3,0
102,3/25/2018 8:30,33,54,38,125,3,0
103,3/25/2018 8:35,35,57,40,132,3,0
104,3/25/2018 8:40,37,60,42,139,3,0
105,3/25/2018 8:45,39,63,44,146,3,0
106,3/25/2018 8:50,40,64,45,149,3,0
107,3/25/2018 8:55,40,64,45,149,3,0
108,3/25/2018 9:00,38,62,44,144,3,0
109,3/25/2018 9:05,38,62,44,144,3,0
110,3/25/2018 9:10,40,65,45,150,3,0
111,3/25/2018 9:15,42,68,48,158,3,0
112,3/25/2018 9:20,44,71,50,165,3,0
113,3/25/2018 9:25,45,72,51,168,3,0
114,3/25/2018 9:30,47,76,53,176,3,0
115,3/25/2018 9:35,49,80,56,185,3,0
116,3/25/2018 9:40,51,82,58,191,3,0
117,3/25/2018 9:45,53,85,60,198,3,0
118,3/25/2018 9:50,53,85,60,198,3,0
119,3/25/2018 9:55,52,85,59,196,3,0
120,3/25/2018 10:00,51,84,59,194,3,0
121,3/25/2018 10:05,51,82,58,191,3,0
122,3/25/2018 10:10,52,85,59,196,3,0
123,3/25/2018 10:15,54,88,62,204,3,0
124,3/25/2018 10:20,54,88,62,204,3,0
125,3/25/2018 10:25,56,91,64,211,3,0
126,3/25/2018 10:30,57,92,65,214,3,0
127,3/25/2018 10:35,57,92,65,214,3,0
128,3/25/2018 10:40,59,96,68,223,3,0
129,3/25/2018 10:45,60,97,68,225,3,0
130,3/25/2018 10:50,59,97,68,224,3,0
131,3/25/2018 10:55,59,97,68,224,3,0
132,3/25/2018 11:00,58,94,66,218,3,0
133,3/25/2018 11:05,58,94,66,218,3,0
134,3/25/2018 11:10,58,94,66,218,3,0
135,3/25/2018 11:15,59,95,67,221,3,0
136,3/25/2018 11:20,61,98,69,228,3,0
137,3/25/2018 11:25,61,99,69,229,3,0
138,3/25/2018 11:30,61,100,70,231,3,0
139,3/25/2018 11:35,61,100,70,231,3,0
140,3/25/2018 11:40,63,102,72,237,3,0
141,3/25/2018 11:45,63,103,72,238,3,0
142,3/25/2018 11:50,63,102,72,237,3,0
143,3/25/2018 11:55,63,102,72,237,3,0
144,3/25/2018 12:00,62,100,70,232,3,0
145,3/25/2018 12:05,62,100,70,232,3,0
146,3/25/2018 12:10,63,103,72,238,3,0
147,3/25/2018 12:15,64,104,73,241,3,0
148,3/25/2018 12:20,64,104,73,241,3,0
149,3/25/2018 12:25,63,103,72,238,3,0
150,3/25/2018 12:30,65,106,74,245,3,0
151,3/25/2018 12:35,65,106,74,245,3,0
152,3/25/2018 12:40,66,108,76,250,3,0
153,3/25/2018 12:45,69,112,79,260,3,0
154,3/25/2018 12:50,68,110,77,255,3,0
155,3/25/2018 12:55,69,112,79,260,3,0
156,3/25/2018 13:00,66,107,75,248,3,0
157,3/25/2018 13:05,67,109,76,252,3,0
158,3/25/2018 13:10,67,109,77,253,3,0
159,3/25/2018 13:15,67,109,77,253,3,0
160,3/25/2018 13:20,67,110,77,254,3,0
161,3/25/2018 13:25,67,110,77,254,3,0
162,3/25/2018 13:30,67,109,77,253,3,0
163,3/25/2018 13:35,67,110,77,254,3,0
164,3/25/2018 13:40,66,107,75,248,3,0
165,3/25/2018 13:45,66,107,75,248,3,0
166,3/25/2018 13:50,66,108,76,250,3,0
167,3/25/2018 13:55,67,109,76,252,3,0
168,3/25/2018 14:00,66,107,75,248,3,0
169,3/25/2018 14:05,67,108,76,251,3,0
170,3/25/2018 14:10,67,108,76,251,3,0
171,3/25/2018 14:15,67,109,76,252,3,0
172,3/25/2018 14:20,67,110,77,254,3,0
173,3/25/2018 14:25,67,109,77,253,3,0
174,3/25/2018 14:30,66,107,75,248,3,0
175,3/25/2018 14:35,67,109,77,253,3,0
176,3/25/2018 14:40,67,108,76,251,3,0
177,3/25/2018 14:45,67,109,76,252,3,0
178,3/25/2018 14:50,66,108,76,250,3,0
179,3/25/2018 14:55,67,109,77,253,3,0
180,3/25/2018 15:00,66,107,75,248,3,0
181,3/25/2018 15:05,67,108,76,251,3,0
182,3/25/2018 15:10,67,110,77,254,3,0
183,3/25/2018 15:15,68,111,78,257,3,0
184,3/25/2018 15:20,67,109,77,253,3,0
185,3/25/2018 15:25,67,109,77,253,3,0
186,3/25/2018 15:30,66,108,76,250,3,0
187,3/25/2018 15:35,67,108,76,251,3,0
188,3/25/2018 15:40,66,107,75,248,3,0
189,3/25/2018 15:45,65,106,75,246,3,0
190,3/25/2018 15:50,63,103,72,238,3,0
191,3/25/2018 15:55,64,104,73,241,3,0
192,3/25/2018 16:00,64,104,73,241,3,0
193,3/25/2018 16:05,66,107,75,248,3,0
194,3/25/2018 16:10,69,112,79,260,3,0
195,3/25/2018 16:15,69,112,79,260,3,0
196,3/25/2018 16:20,66,108,76,250,3,0
197,3/25/2018 16:25,66,108,76,250,3,0
198,3/25/2018 16:30,66,107,75,248,3,0
199,3/25/2018 16:35,66,108,76,250,3,0
200,3/25/2018 16:40,67,109,76,252,3,0
201,3/25/2018 16:45,66,108,76,250,3,0
202,3/25/2018 16:50,67,110,77,254,3,0
203,3/25/2018 16:55,67,109,77,253,3,0
204,3/25/2018 17:00,65,106,74,245,3,0
205,3/25/2018 17:05,66,107,75,248,3,0
206,3/25/2018 17:10,68,110,77,255,3,0
207,3/25/2018 17:15,67,109,76,252,3,0
208,3/25/2018 17:20,68,110,78,256,3,0
209,3/25/2018 17:25,66,108,76,250,3,0
210,3/25/2018 17:30,66,107,75,248,3,0
211,3/25/2018 17:35,66,107,75,248,3,0
212,3/25/2018 17:40,66,107,75,248,3,0
213,3/25/2018 17:45,64,105,74,243,3,0
214,3/25/2018 17:50,65,105,74,244,3,0
215,3/25/2018 17:55,63,103,72,238,3,0
216,3/25/2018 18:00,62,100,70,232,3,0
217,3/25/2018 18:05,61,99,70,230,3,0
218,3/25/2018 18:10,61,99,70,230,3,0
219,3/25/2018 18:15,64,104,73,241,3,0
220,3/25/2018 18:20,64,104,73,241,3,0
221,3/25/2018 18:25,60,97,69,226,3,0
222,3/25/2018 18:30,59,96,68,223,3,0
223,3/25/2018 18:35,58,94,66,218,3,0
224,3/25/2018 18:40,58,94,66,218,3,0
225,3/25/2018 18:45,57,93,65,215,3,0
226,3/25/2018 18:50,57,92,65,214,3,0
227,3/25/2018 18:55,56,91,64,211,3,0
228,3/25/2018 19:00,54,88,62,204,3,0
229,3/25/2018 19:05,54,88,62,204,3,0
230,3/25/2018 19:10,54,88,62,204,3,0
231,3/25/2018 19:15,54,88,62,204,3,0
232,3/25/2018 19:20,54,88,62,204,3,0
233,3/25/2018 19:25,53,87,61,201,3,0
234,3/25/2018 19:30,52,85,60,197,3,0
235,3/25/2018 19:35,51,83,59,193,3,0
236,3/25/2018 19:40,50,82,58,190,3,0
237,3/25/2018 19:45,50,82,58,190,3,0
238,3/25/2018 19:50,49,79,56,184,3,0
239,3/25/2018 19:55,49,79,55,183,3,0
240,3/25/2018 20:00,48,78,55,181,3,0
241,3/25/2018 20:05,49,80,56,185,3,0
242,3/25/2018 20:10,48,78,55,181,3,0
243,3/25/2018 20:15,48,78,55,181,3,0
244,3/25/2018 20:20,49,79,56,184,3,0
245,3/25/2018 20:25,48,79,55,182,3,0
246,3/25/2018 20:30,47,76,54,177,3,0
247,3/25/2018 20:35,45,72,51,168,3,0
248,3/25/2018 20:40,45,72,51,168,3,0
249,3/25/2018 20:45,43,70,49,162,3,0
250,3/25/2018 20:50,44,71,50,165,3,0
251,3/25/2018 20:55,42,68,48,158,3,0
252,3/25/2018 21:00,40,66,46,152,3,0
253,3/25/2018 21:05,41,66,46,153,3,0
254,3/25/2018 21:10,41,66,46,153,3,0
255,3/25/2018 21:15,41,66,46,153,3,0
256,3/25/2018 21:20,41,67,47,155,3,0
257,3/25/2018 21:25,40,64,45,149,3,0
258,3/25/2018 21:30,39,64,45,148,3,0
259,3/25/2018 21:35,38,63,44,145,3,0
260,3/25/2018 21:40,39,63,44,146,3,0
261,3/25/2018 21:45,38,61,43,142,3,0
262,3/25/2018 21:50,37,60,42,139,3,0
263,3/25/2018 21:55,35,57,40,132,3,0
264,3/25/2018 22:00,35,57,40,132,3,0
265,3/25/2018 22:05,35,56,39,130,3,0
266,3/25/2018 22:10,34,55,39,128,3,0
267,3/25/2018 22:15,34,55,39,128,3,0
268,3/25/2018 22:20,32,53,37,122,3,0
269,3/25/2018 22:25,31,51,36,118,3,0
270,3/25/2018 22:30,29,47,33,109,3,0
271,3/25/2018 22:35,29,47,33,109,3,0
272,3/25/2018 22:40,29,47,33,109,3,0
273,3/25/2018 22:45,28,46,32,106,3,0
274,3/25/2018 22:50,25,41,29,95,3,0
275,3/25/2018 22:55,24,38,27,89,3,0
276,3/25/2018 23:00,23,38,26,87,3,0
277,3/25/2018 23:05,23,37,26,86,3,0
278,3/25/2018 23:10,23,37,26,86,3,0
279,3/25/2018 23:15,22,36,25,83,3,0
280,3/25/2018 23:20,22,35,25,82,3,0
281,3/25/2018 23:25,20,33,23,76,3,0
282,3/25/2018 23:30,19,31,22,72,3,0
283,3/25/2018 23:35,19,30,21,70,3,0
284,3/25/2018 23:40,18,29,21,68,3,0
285,3/25/2018 23:45,17,28,19,64,3,0
286,3/25/2018 23:50,16,26,18,60,3,0
287,3/25/2018 23:55,15,25,17,57,3,0
288,3/26/2018 0:00,14,23,16,53,3,0
289,3/26/2018 0:05,14,22,16,52,3,0
290,3/26/2018 0:10,14,22,15,51,3,0
291,3/26/2018 0:15,13,22,15,50,3,0
292,3/26/2018 0:20,13,21,15,49,3,0
293,3/26/2018 0:25,12,19,14,45,3,0
294,3/26/2018 0:30,11,19,13,43,3,0
295,3/26/2018 0:35,11,17,12,40,3,0
296,3/26/2018 0:40,10,17,12,39,3,0
297,3/26/2018 0:45,10,16,12,38,3,0
298,3/26/2018 0:50,10,16,11,37,3,0
299,3/26/2018 0:55,9,15,11,35,3,0
300,3/26/2018 1:00,8,13,9,30,3,0
301,3/26/2018 1:05,8,13,9,30,3,0
302,3/26/2018 1:10,8,13,9,30,3,0
303,3/26/2018 1:15,8,13,9,30,3,0
304,3/26/2018 1:20,8,13,9,30,3,0
305,3/26/2018 1:25,7,12,8,27,3,0
306,3/26/2018 1:30,7,12,8,27,3,0
307,3/26/2018 1:35,7,12,8,27,3,0
308,3/26/2018 1:40,7,12,8,27,3,0
309,3/26/2018 1:45,7,12,8,27,3,0
310,3/26/2018 1:50,7,11,8,26,3,0
311,3/26/2018 1:55,7,11,8,26,3,0
312,3/26/2018 2:00,7,11,8,26,3,0
313,3/26/2018 2:05,7,11,8,26,3,0
314,3/26/2018 2:10,7,11,8,26,3,0
315,3/26/2018 2:15,7,11,8,26,3,0
316,3/26/2018 2:20,7,11,8,26,3,0
317,3/26/2018 2:25,6,10,7,23,3,0
318,3/26/2018 2:30,6,10,7,23,3,0
319,3/26/2018 2:35,6,10,7,23,3,0
320,3/26/2018 2:40,6,10,7,23,3,0
321,3/26/2018 2:45,6,10,7,23,3,0
322,3/26/2018 2:50,6,10,7,23,3,0
323,3/26/2018 2:55,6,10,7,23,3,0
324,3/26/2018 3:00,6,10,7,23,3,0
325,3/26/2018 3:05,6,10,7,23,3,0
326,3/26/2018 3:10,6,10,7,23,3,0
327,3/26/2018 3:15,6,10,7,23,3,0
328,3/26/2018 3:20,7,11,8,26,3,0
329,3/26/2018 3:25,7,11,8,26,3,0
330,3/26/2018 3:30,7,12,8,27,3,0
331,3/26/2018 3:35,8,13,9,30,3,0
332,3/26/2018 3:40,9,14,10,33,3,0
333,3/26/2018 3:45,8,14,10,32,3,0
334,3/26/2018 3:50,8,13,9,30,3,0
335,3/26/2018 3:55,8,13,9,30,3,0
336,3/26/2018 4:00,9,14,10,33,3,0
337,3/26/2018 4:05,9,15,11,35,3,0
338,3/26/2018 4:10,10,16,12,38,3,0
339,3/26/2018 4:15,11,19,13,43,3,0
340,3/26/2018 4:20,13,21,15,49,3,0
341,3/26/2018 4:25,14,23,16,53,3,0
342,3/26/2018 4:30,15,25,18,58,3,0
343,3/26/2018 4:35,19,30,21,70,3,0
344,3/26/2018 4:40,19,31,22,72,3,0
345,3/26/2018 4:45,20,33,23,76,3,0
346,3/26/2018 4:50,21,35,24,80,3,0
347,3/26/2018 4:55,22,35,25,82,3,0
348,3/26/2018 5:00,23,38,26,87,3,0
349,3/26/2018 5:05,27,44,31,102,3,0
350,3/26/2018 5:10,31,51,36,118,3,0
351,3/26/2018 5:15,36,58,41,135,3,0
352,3/26/2018 5:20,40,65,46,151,3,0
353,3/26/2018 5:25,42,69,49,160,3,0
354,3/26/2018 5:30,49,79,55,183,3,0
355,3/26/2018 5:35,53,86,61,200,3,0
356,3/26/2018 5:40,56,91,64,211,3,0
357,3/26/2018 5:45,58,94,66,218,3,0
358,3/26/2018 5:50,59,97,68,224,3,0
359,3/26/2018 5:55,59,96,67,222,3,0
360,3/26/2018 6:00,55,89,63,207,3,0
361,3/26/2018 6:05,58,95,67,220,3,0
362,3/26/2018 6:10,63,102,72,237,3,0
363,3/26/2018 6:15,68,110,77,255,3,0
364,3/26/2018 6:20,71,116,81,268,3,0
365,3/26/2018 6:25,73,118,83,274,3,0
366,3/26/2018 6:30,75,123,86,284,3,0
367,3/26/2018 6:35,79,128,90,297,3,0
368,3/26/2018 6:40,86,140,98,324,3,0
369,3/26/2018 6:45,87,142,100,329,3,0
370,3/26/2018 6:50,87,142,100,329,3,0
371,3/26/2018 6:55,80,131,92,303,3,0
372,3/26/2018 7:00,79,128,90,297,3,0
373,3/26/2018 7:05,80,129,91,300,3,0
374,3/26/2018 7:10,84,136,96,316,3,0
375,3/26/2018 7:15,85,139,98,322,3,0
376,3/26/2018 7:20,88,143,101,332,3,0
377,3/26/2018 7:25,88,142,100,330,3,0
378,3/26/2018 7:30,93,151,106,350,3,0
379,3/26/2018 7:35,93,151,106,350,3,0
380,3/26/2018 7:40,89,145,102,336,3,0
381,3/26/2018 7:45,87,142,100,329,3,0
382,3/26/2018 7:50,86,140,99,325,3,0
383,3/26/2018 7:55,85,138,97,320,3,0
384,3/26/2018 8:00,82,133,93,308,3,0
385,3/26/2018 8:05,82,134,94,310,3,0
386,3/26/2018 8:10,83,135,95,313,3,0
387,3/26/2018 8:15,88,143,100,331,3,0
388,3/26/2018 8:20,88,144,101,333,3,0
389,3/26/2018 8:25,84,137,96,317,3,0
390,3/26/2018 8:30,78,127,89,294,3,0
391,3/26/2018 8:35,77,126,88,291,3,0
392,3/26/2018 8:40,77,126,88,291,3,0
393,3/26/2018 8:45,76,124,87,287,3,0
394,3/26/2018 8:50,74,120,85,279,3,0
395,3/26/2018 8:55,71,116,81,268,3,0
396,3/26/2018 9:00,69,112,79,260,3,0
397,3/26/2018 9:05,67,110,77,254,3,0
398,3/26/2018 9:10,67,109,77,253,3,0
399,3/26/2018 9:15,67,109,76,252,3,0
400,3/26/2018 9:20,68,110,78,256,3,0
401,3/26/2018 9:25,69,112,79,260,3,0
402,3/26/2018 9:30,69,112,79,260,3,0
403,3/26/2018 9:35,67,110,77,254,3,0
404,3/26/2018 9:40,68,110,78,256,3,0
405,3/26/2018 9:45,67,110,77,254,3,0
406,3/26/2018 9:50,67,109,76,252,3,0
407,3/26/2018 9:55,66,107,75,248,3,0
408,3/26/2018 10:00,65,105,74,244,3,0
409,3/26/2018 10:05,65,105,74,244,3,0
410,3/26/2018 10:10,65,105,74,244,3,0
411,3/26/2018 10:15,64,105,74,243,3,0
412,3/26/2018 10:20,64,104,73,241,3,0
413,3/26/2018 10:25,66,107,75,248,3,0
414,3/26/2018 10:30,64,104,73,241,3,0
415,3/26/2018 10:35,64,105,74,243,3,0
416,3/26/2018 10:40,65,106,75,246,3,0
417,3/26/2018 10:45,65,106,74,245,3,0
418,3/26/2018 10:50,65,105,74,244,3,0
419,3/26/2018 10:55,65,106,74,245,3,0
420,3/26/2018 11:00,64,104,73,241,3,0
421,3/26/2018 11:05,64,105,74,243,3,0
422,3/26/2018 11:10,64,104,73,241,3,0
423,3/26/2018 11:15,64,104,73,241,3,0
424,3/26/2018 11:20,64,104,73,241,3,0
425,3/26/2018 11:25,65,105,74,244,3,0
426,3/26/2018 11:30,66,107,75,248,3,0
427,3/26/2018 11:35,66,108,76,250,3,0
428,3/26/2018 11:40,68,110,77,255,3,0
429,3/26/2018 11:45,67,108,76,251,3,0
430,3/26/2018 11:50,66,108,76,250,3,0
431,3/26/2018 11:55,66,107,75,248,3,0
432,3/26/2018 12:00,65,106,75,246,3,0
433,3/26/2018 12:05,66,108,76,250,3,0
434,3/26/2018 12:10,66,108,76,250,3,0
435,3/26/2018 12:15,68,110,78,256,3,0
436,3/26/2018 12:20,67,110,77,254,3,0
437,3/26/2018 12:25,67,109,76,252,3,0
438,3/26/2018 12:30,66,108,76,250,3,0
439,3/26/2018 12:35,68,110,77,255,3,0
440,3/26/2018 12:40,68,111,78,257,3,0
441,3/26/2018 12:45,68,111,78,257,3,0
442,3/26/2018 12:50,68,110,77,255,3,0
443,3/26/2018 12:55,67,110,77,254,3,0
444,3/26/2018 13:00,67,108,76,251,3,0
445,3/26/2018 13:05,67,108,76,251,3,0
446,3/26/2018 13:10,68,110,78,256,3,0
447,3/26/2018 13:15,66,107,75,248,3,0
448,3/26/2018 13:20,68,110,78,256,3,0
449,3/26/2018 13:25,68,110,77,255,3,0
450,3/26/2018 13:30,68,111,78,257,3,0
451,3/26/2018 13:35,70,113,79,262,3,0
452,3/26/2018 13:40,70,113,80,263,3,0
453,3/26/2018 13:45,71,116,82,269,3,0
454,3/26/2018 13:50,70,114,80,264,3,0
455,3/26/2018 13:55,70,114,80,264,3,0
456,3/26/2018 14:00,70,114,80,264,3,0
457,3/26/2018 14:05,71,116,82,269,3,0
458,3/26/2018 14:10,73,119,84,276,3,0
459,3/26/2018 14:15,74,120,84,278,3,0
460,3/26/2018 14:20,73,119,84,276,3,0
461,3/26/2018 14:25,72,118,83,273,3,0
462,3/26/2018 14:30,76,123,86,285,3,0
463,3/26/2018 14:35,77,125,88,290,3,0
464,3/26/2018 14:40,81,132,93,306,3,0
465,3/26/2018 14:45,81,132,93,306,3,0
466,3/26/2018 14:50,81,132,93,306,3,0
467,3/26/2018 14:55,80,131,92,303,3,0
468,3/26/2018 15:00,80,130,92,302,3,0
469,3/26/2018 15:05,82,133,93,308,3,0
470,3/26/2018 15:10,82,134,94,310,3,0
471,3/26/2018 15:15,84,137,96,317,3,0
472,3/26/2018 15:20,83,135,95,313,3,0
473,3/26/2018 15:25,83,135,95,313,3,0
474,3/26/2018 15:30,83,135,95,313,3,0
475,3/26/2018 15:35,86,140,99,325,3,0
476,3/26/2018 15:40,92,150,105,347,3,0
477,3/26/2018 15:45,92,150,105,347,3,0
478,3/26/2018 15:50,90,147,103,340,3,0
479,3/26/2018 15:55,88,143,101,332,3,0
480,3/26/2018 16:00,85,138,97,320,3,0
481,3/26/2018 16:05,87,141,99,327,3,0
482,3/26/2018 16:10,90,146,103,339,3,0
483,3/26/2018 16:15,91,148,104,343,3,0
484,3/26/2018 16:20,90,147,103,340,3,0
485,3/26/2018 16:25,88,144,101,333,3,0
486,3/26/2018 16:30,87,141,99,327,3,0
487,3/26/2018 16:35,91,147,103,341,3,0
488,3/26/2018 16:40,93,151,106,350,3,0
489,3/26/2018 16:45,92,150,105,347,3,0
490,3/26/2018 16:50,91,148,104,343,3,0
491,3/26/2018 16:55,88,143,101,332,3,0
492,3/26/2018 17:00,87,142,100,329,3,0
493,3/26/2018 17:05,91,148,104,343,3,0
494,3/26/2018 17:10,96,155,109,360,3,0
495,3/26/2018 17:15,95,154,109,358,3,0
496,3/26/2018 17:20,94,152,107,353,3,0
497,3/26/2018 17:25,91,148,104,343,3,0
498,3/26/2018 17:30,88,143,100,331,3,0
499,3/26/2018 17:35,89,145,102,336,3,0
500,3/26/2018 17:40,89,145,102,336,3,0
501,3/26/2018 17:45,88,143,101,332,3,0
502,3/26/2018 17:50,86,140,98,324,3,0
503,3/26/2018 17:55,84,137,96,317,3,0
504,3/26/2018 18:00,82,134,94,310,3,0
505,3/26/2018 18:05,81,132,93,306,3,0
506,3/26/2018 18:10,82,134,94,310,3,0
507,3/26/2018 18:15,81,132,93,306,3,0
508,3/26/2018 18:20,80,129,91,300,3,0
509,3/26/2018 18:25,78,126,89,293,3,0
510,3/26/2018 18:30,77,125,88,290,3,0
511,3/26/2018 18:35,74,120,85,279,3,0
512,3/26/2018 18:40,73,119,83,275,3,0
513,3/26/2018 18:45,71,116,81,268,3,0
514,3/26/2018 18:50,68,111,78,257,3,0
515,3/26/2018 18:55,65,106,74,245,3,0
516,3/26/2018 19:00,62,101,71,234,3,0
517,3/26/2018 19:05,63,103,72,238,3,0
518,3/26/2018 19:10,63,102,72,237,3,0
519,3/26/2018 19:15,62,101,71,234,3,0
520,3/26/2018 19:20,60,97,68,225,3,0
521,3/26/2018 19:25,60,97,68,225,3,0
522,3/26/2018 19:30,59,96,67,222,3,0
523,3/26/2018 19:35,57,92,65,214,3,0
524,3/26/2018 19:40,52,85,59,196,3,0
525,3/26/2018 19:45,51,83,58,192,3,0
526,3/26/2018 19:50,49,79,55,183,3,0
527,3/26/2018 19:55,46,74,52,172,3,0
528,3/26/2018 20:00,44,71,50,165,3,0
529,3/26/2018 20:05,46,75,53,174,3,0
530,3/26/2018 20:10,46,74,52,172,3,0
531,3/26/2018 20:15,45,74,52,171,3,0
532,3/26/2018 20:20,44,71,50,165,3,0
533,3/26/2018 20:25,42,69,48,159,3,0
534,3/26/2018 20:30,41,67,47,155,3,0
535,3/26/2018 20:35,41,66,47,154,3,0
536,3/26/2018 20:40,41,66,47,154,3,0
537,3/26/2018 20:45,41,67,47,155,3,0
538,3/26/2018 20:50,36,59,41,136,3,0
539,3/26/2018 20:55,36,58,41,135,3,0
540,3/26/2018 21:00,37,60,42,139,3,0
541,3/26/2018 21:05,39,63,45,147,3,0
542,3/26/2018 21:10,40,65,45,150,3,0
543,3/26/2018 21:15,40,65,46,151,3,0
544,3/26/2018 21:20,39,63,45,147,3,0
545,3/26/2018 21:25,38,63,44,145,3,0
546,3/26/2018 21:30,37,60,42,139,3,0
547,3/26/2018 21:35,37,60,42,139,3,0
548,3/26/2018 21:40,37,60,42,139,3,0
549,3/26/2018 21:45,36,58,41,135,3,0
550,3/26/2018 21:50,35,57,40,132,3,0
551,3/26/2018 21:55,35,57,40,132,3,0
552,3/26/2018 22:00,33,54,38,125,3,0
553,3/26/2018 22:05,33,54,38,125,3,0
554,3/26/2018 22:10,34,55,39,128,3,0
555,3/26/2018 22:15,33,53,37,123,3,0
556,3/26/2018 22:20,31,50,35,116,3,0
557,3/26/2018 22:25,29,47,33,109,3,0
558,3/26/2018 22:30,28,45,32,105,3,0
559,3/26/2018 22:35,28,45,32,105,3,0
560,3/26/2018 22:40,27,44,31,102,3,0
561,3/26/2018 22:45,25,41,29,95,3,0
562,3/26/2018 22:50,24,39,27,90,3,0
563,3/26/2018 22:55,22,36,25,83,3,0
564,3/26/2018 23:00,21,34,24,79,3,0
565,3/26/2018 23:05,21,35,24,80,3,0
566,3/26/2018 23:10,22,35,25,82,3,0
567,3/26/2018 23:15,21,35,24,80,3,0
568,3/26/2018 23:20,19,31,22,72,3,0
569,3/26/2018 23:25,18,29,20,67,3,0
570,3/26/2018 23:30,18,28,20,66,3,0
571,3/26/2018 23:35,18,28,20,66,3,0
572,3/26/2018 23:40,17,28,20,65,3,0
573,3/26/2018 23:45,16,27,19,62,3,0
574,3/26/2018 23:50,16,25,18,59,3,0
575,3/26/2018 23:55,14,23,16,53,3,0
576,3/27/2018 0:00,13,21,15,49,3,0
577,3/27/2018 0:05,12,20,14,46,3,0
578,3/27/2018 0:10,13,22,15,50,3,0
579,3/27/2018 0:15,14,23,16,53,3,0
580,3/27/2018 0:20,15,24,17,56,3,0
581,3/27/2018 0:25,14,23,16,53,3,0
582,3/27/2018 0:30,13,22,15,50,3,0
583,3/27/2018 0:35,13,21,15,49,3,0
584,3/27/2018 0:40,13,21,15,49,3,0
585,3/27/2018 0:45,12,20,14,46,3,0
586,3/27/2018 0:50,11,19,13,43,3,0
587,3/27/2018 0:55,11,18,13,42,3,0
588,3/27/2018 1:00,10,17,12,39,3,0
589,3/27/2018 1:05,10,17,12,39,3,0
590,3/27/2018 1:10,10,17,12,39,3,0
591,3/27/2018 1:15,10,16,11,37,3,0
592,3/27/2018 1:20,10,16,12,38,3,0
593,3/27/2018 1:25,9,15,11,35,3,0
594,3/27/2018 1:30,10,16,11,37,3,0
595,3/27/2018 1:35,10,17,12,39,3,0
596,3/27/2018 1:40,11,17,12,40,3,0
597,3/27/2018 1:45,10,16,12,38,3,0
598,3/27/2018 1:50,10,16,11,37,3,0
599,3/27/2018 1:55,9,15,11,35,3,0
600,3/27/2018 2:00,9,15,11,35,3,0
601,3/27/2018 2:05,12,20,14,46,3,0
602,3/27/2018 2:10,14,22,16,52,3,0
603,3/27/2018 2:15,10,16,11,37,3,0
604,3/27/2018 2:20,9,15,11,35,3,0
605,3/27/2018 2:25,9,14,10,33,3,0
606,3/27/2018 2:30,9,14,10,33,3,0
607,3/27/2018 2:35,9,14,10,33,3,0
608,3/27/2018 2:40,9,15,10,34,3,0
609,3/27/2018 2:45,9,15,10,34,3,0
610,3/27/2018 2:50,8,13,9,30,3,0
611,3/27/2018 2:55,8,13,9,30,3,0
612,3/27/2018 3:00,8,13,9,30,3,0
613,3/27/2018 3:05,8,13,9,30,3,0
614,3/27/2018 3:10,8,13,9,30,3,0
615,3/27/2018 3:15,9,14,10,33,3,0
616,3/27/2018 3:20,9,15,11,35,3,0
617,3/27/2018 3:25,9,15,11,35,3,0
618,3/27/2018 3:30,10,16,12,38,3,0
619,3/27/2018 3:35,10,16,11,37,3,0
620,3/27/2018 3:40,10,16,12,38,3,0
621,3/27/2018 3:45,10,16,11,37,3,0
622,3/27/2018 3:50,10,16,11,37,3,0
623,3/27/2018 3:55,10,16,11,37,3,0
624,3/27/2018 4:00,10,16,11,37,3,0
625,3/27/2018 4:05,10,17,12,39,3,0
626,3/27/2018 4:10,11,18,12,41,3,0
627,3/27/2018 4:15,12,19,14,45,3,0
628,3/27/2018 4:20,12,20,14,46,3,0
629,3/27/2018 4:25,13,21,15,49,3,0
630,3/27/2018 4:30,14,22,16,52,3,0
631,3/27/2018 4:35,15,24,17,56,3,0
632,3/27/2018 4:40,14,22,16,52,3,0
633,3/27/2018 4:45,15,25,17,57,3,0
634,3/27/2018 4:50,15,24,17,56,3,0
635,3/27/2018 4:55,17,27,19,63,3,0
636,3/27/2018 5:00,17,28,20,65,3,0
637,3/27/2018 5:05,19,31,22,72,3,0
638,3/27/2018 5:10,21,35,24,80,3,0
639,3/27/2018 5:15,24,39,28,91,3,0
640,3/27/2018 5:20,27,44,31,102,3,0
641,3/27/2018 5:25,31,50,35,116,3,0
642,3/27/2018 5:30,36,58,41,135,3,0
643,3/27/2018 5:35,38,63,44,145,3,0
644,3/27/2018 5:40,42,68,48,158,3,0
645,3/27/2018 5:45,43,70,49,162,3,0
646,3/27/2018 5:50,46,74,52,172,3,0
647,3/27/2018 5:55,48,79,55,182,3,0
648,3/27/2018 6:00,48,79,55,182,3,0
649,3/27/2018 6:05,47,77,54,178,3,0
650,3/27/2018 6:10,52,84,59,195,3,0
651,3/27/2018 6:15,55,90,63,208,3,0
652,3/27/2018 6:20,66,107,75,248,3,0
653,3/27/2018 6:25,66,108,76,250,3,0
654,3/27/2018 6:30,69,112,79,260,3,0
655,3/27/2018 6:35,70,113,79,262,3,0
656,3/27/2018 6:40,73,119,83,275,3,0
657,3/27/2018 6:45,75,123,86,284,3,0
658,3/27/2018 6:50,75,122,86,283,3,0
659,3/27/2018 6:55,66,107,75,248,3,0
660,3/27/2018 7:00,65,106,75,246,3,0
661,3/27/2018 7:05,76,124,87,287,3,0
662,3/27/2018 7:10,78,127,89,294,3,0
663,3/27/2018 7:15,80,130,92,302,3,0
664,3/27/2018 7:20,80,131,92,303,3,0
665,3/27/2018 7:25,83,135,95,313,3,0
666,3/27/2018 7:30,82,133,94,309,3,0
667,3/27/2018 7:35,83,135,95,313,3,0
668,3/27/2018 7:40,84,136,96,316,3,0
669,3/27/2018 7:45,84,136,96,316,3,0
670,3/27/2018 7:50,84,136,96,316,3,0
671,3/27/2018 7:55,81,132,92,305,3,0
672,3/27/2018 8:00,78,127,89,294,3,0
673,3/27/2018 8:05,71,115,81,267,3,0
674,3/27/2018 8:10,69,112,79,260,3,0
675,3/27/2018 8:15,66,107,75,248,3,0
676,3/27/2018 8:20,76,124,87,287,3,0
677,3/27/2018 8:25,69,113,79,261,3,0
678,3/27/2018 8:30,67,110,77,254,3,0
679,3/27/2018 8:35,68,110,78,256,3,0
680,3/27/2018 8:40,71,116,82,269,3,0
681,3/27/2018 8:45,72,117,82,271,3,0
682,3/27/2018 8:50,71,115,81,267,3,0
683,3/27/2018 8:55,68,110,77,255,3,0
684,3/27/2018 9:00,64,104,73,241,3,0
685,3/27/2018 9:05,63,102,72,237,3,0
686,3/27/2018 9:10,62,101,71,234,3,0
687,3/27/2018 9:15,56,91,64,211,3,0
688,3/27/2018 9:20,58,94,66,218,3,0
689,3/27/2018 9:25,61,99,70,230,3,0
690,3/27/2018 9:30,61,99,70,230,3,0
691,3/27/2018 9:35,62,101,71,234,3,0
692,3/27/2018 9:40,62,100,70,232,3,0
693,3/27/2018 9:45,61,98,69,228,3,0
694,3/27/2018 9:50,59,95,67,221,3,0
695,3/27/2018 9:55,54,88,62,204,3,0
696,3/27/2018 10:00,54,88,62,204,3,0
697,3/27/2018 10:05,55,89,62,206,3,0
698,3/27/2018 10:10,56,91,64,211,3,0
699,3/27/2018 10:15,56,91,64,211,3,0
700,3/27/2018 10:20,56,91,64,211,3,0
701,3/27/2018 10:25,55,90,63,208,3,0
702,3/27/2018 10:30,57,93,65,215,3,0
703,3/27/2018 10:35,58,94,66,218,3,0
704,3/27/2018 10:40,58,94,66,218,3,0
705,3/27/2018 10:45,56,91,64,211,3,0
706,3/27/2018 10:50,56,91,64,211,3,0
707,3/27/2018 10:55,56,91,64,211,3,0
708,3/27/2018 11:00,55,89,63,207,3,0
709,3/27/2018 11:05,56,91,64,211,3,0
710,3/27/2018 11:10,59,96,67,222,3,0
711,3/27/2018 11:15,59,95,67,221,3,0
712,3/27/2018 11:20,59,97,68,224,3,0
713,3/27/2018 11:25,60,98,69,227,3,0
714,3/27/2018 11:30,61,100,70,231,3,0
715,3/27/2018 11:35,61,99,69,229,3,0
716,3/27/2018 11:40,61,100,70,231,3,0
717,3/27/2018 11:45,62,101,71,234,3,0
718,3/27/2018 11:50,61,100,70,231,3,0
719,3/27/2018 11:55,61,99,69,229,3,0
720,3/27/2018 12:00,62,101,71,234,3,0
721,3/27/2018 12:05,63,102,72,237,3,0
722,3/27/2018 12:10,63,102,72,237,3,0
723,3/27/2018 12:15,63,102,72,237,3,0
724,3/27/2018 12:20,64,104,73,241,3,0
725,3/27/2018 12:25,64,104,73,241,3,0
726,3/27/2018 12:30,63,103,72,238,3,0
727,3/27/2018 12:35,64,104,73,241,3,0
728,3/27/2018 12:40,64,104,73,241,3,0
729,3/27/2018 12:45,66,107,75,248,3,0
730,3/27/2018 12:50,64,104,73,241,3,0
731,3/27/2018 12:55,65,106,75,246,3,0
732,3/27/2018 13:00,65,105,74,244,3,0
733,3/27/2018 13:05,65,105,74,244,3,0
734,3/27/2018 13:10,64,104,73,241,3,0
735,3/27/2018 13:15,65,106,74,245,3,0
736,3/27/2018 13:20,66,108,76,250,3,0
737,3/27/2018 13:25,67,108,76,251,3,0
738,3/27/2018 13:30,67,108,76,251,3,0
739,3/27/2018 13:35,67,109,76,252,3,0
740,3/27/2018 13:40,68,111,78,257,3,0
741,3/27/2018 13:45,69,112,79,260,3,0
742,3/27/2018 13:50,68,110,77,255,3,0
743,3/27/2018 13:55,68,110,78,256,3,0
744,3/27/2018 14:00,67,110,77,254,3,0
745,3/27/2018 14:05,68,111,78,257,3,0
746,3/27/2018 14:10,69,112,79,260,3,0
747,3/27/2018 14:15,72,117,82,271,3,0
748,3/27/2018 14:20,72,116,82,270,3,0
749,3/27/2018 14:25,72,117,82,271,3,0
750,3/27/2018 14:30,73,119,84,276,3,0
751,3/27/2018 14:35,77,125,88,290,3,0
752,3/27/2018 14:40,79,129,90,298,3,0
753,3/27/2018 14:45,79,128,90,297,3,0
754,3/27/2018 14:50,77,126,88,291,3,0
755,3/27/2018 14:55,77,125,88,290,3,0
756,3/27/2018 15:00,76,124,87,287,3,0
757,3/27/2018 15:05,74,121,85,280,3,0
758,3/27/2018 15:10,75,122,86,283,3,0
759,3/27/2018 15:15,74,120,85,279,3,0
760,3/27/2018 15:20,80,129,91,300,3,0
761,3/27/2018 15:25,80,129,91,300,3,0
762,3/27/2018 15:30,81,132,93,306,3,0
763,3/27/2018 15:35,85,138,97,320,3,0
764,3/27/2018 15:40,84,137,96,317,3,0
765,3/27/2018 15:45,84,136,96,316,3,0
766,3/27/2018 15:50,81,132,93,306,3,0
767,3/27/2018 15:55,80,130,91,301,3,0
768,3/27/2018 16:00,81,131,92,304,3,0
769,3/27/2018 16:05,82,133,94,309,3,0
770,3/27/2018 16:10,83,135,95,313,3,0
771,3/27/2018 16:15,84,136,96,316,3,0
772,3/27/2018 16:20,84,136,96,316,3,0
773,3/27/2018 16:25,83,135,95,313,3,0
774,3/27/2018 16:30,79,129,90,298,3,0
775,3/27/2018 16:35,82,133,94,309,3,0
776,3/27/2018 16:40,84,136,96,316,3,0
777,3/27/2018 16:45,85,138,97,320,3,0
778,3/27/2018 16:50,85,138,97,320,3,0
779,3/27/2018 16:55,80,131,92,303,3,0
780,3/27/2018 17:00,79,128,90,297,3,0
781,3/27/2018 17:05,85,138,97,320,3,0
782,3/27/2018 17:10,86,140,99,325,3,0
783,3/27/2018 17:15,85,138,97,320,3,0
784,3/27/2018 17:20,84,137,96,317,3,0
785,3/27/2018 17:25,84,137,96,317,3,0
786,3/27/2018 17:30,93,151,106,350,3,0
787,3/27/2018 17:35,92,150,106,348,3,0
788,3/27/2018 17:40,91,148,104,343,3,0
789,3/27/2018 17:45,80,131,92,303,3,0
790,3/27/2018 17:50,80,130,91,301,3,0
791,3/27/2018 17:55,79,128,90,297,3,0
792,3/27/2018 18:00,77,125,88,290,3,0
793,3/27/2018 18:05,73,119,83,275,3,0
794,3/27/2018 18:10,74,119,84,277,3,0
795,3/27/2018 18:15,73,119,84,276,3,0
796,3/27/2018 18:20,76,123,86,285,3,0
797,3/27/2018 18:25,74,120,84,278,3,0
798,3/27/2018 18:30,72,117,82,271,3,0
799,3/27/2018 18:35,71,116,82,269,3,0
800,3/27/2018 18:40,69,112,79,260,3,0
801,3/27/2018 18:45,65,106,74,245,3,0
802,3/27/2018 18:50,62,101,71,234,3,0
803,3/27/2018 18:55,58,94,66,218,3,0
804,3/27/2018 19:00,64,104,73,241,3,0
805,3/27/2018 19:05,64,104,73,241,3,0
806,3/27/2018 19:10,63,103,72,238,3,0
807,3/27/2018 19:15,59,96,67,222,3,0
808,3/27/2018 19:20,56,91,64,211,3,0
809,3/27/2018 19:25,54,88,62,204,3,0
810,3/27/2018 19:30,52,85,59,196,3,0
811,3/27/2018 19:35,51,83,59,193,3,0
812,3/27/2018 19:40,50,81,57,188,3,0
813,3/27/2018 19:45,48,77,54,179,3,0
814,3/27/2018 19:50,46,75,53,174,3,0
815,3/27/2018 19:55,45,74,52,171,3,0
816,3/27/2018 20:00,44,71,50,165,3,0
817,3/27/2018 20:05,45,72,51,168,3,0
818,3/27/2018 20:10,44,71,50,165,3,0
819,3/27/2018 20:15,44,71,50,165,3,0
820,3/27/2018 20:20,43,69,49,161,3,0
821,3/27/2018 20:25,42,68,48,158,3,0
822,3/27/2018 20:30,41,67,47,155,3,0
823,3/27/2018 20:35,41,66,46,153,3,0
824,3/27/2018 20:40,40,66,46,152,3,0
825,3/27/2018 20:45,40,65,45,150,3,0
826,3/27/2018 20:50,39,63,44,146,3,0
827,3/27/2018 20:55,37,61,43,141,3,0
828,3/27/2018 21:00,38,62,43,143,3,0
829,3/27/2018 21:05,40,64,45,149,3,0
830,3/27/2018 21:10,40,65,46,151,3,0
831,3/27/2018 21:15,40,66,46,152,3,0
832,3/27/2018 21:20,40,65,45,150,3,0
833,3/27/2018 21:25,38,63,44,145,3,0
834,3/27/2018 21:30,37,60,42,139,3,0
835,3/27/2018 21:35,36,59,41,136,3,0
836,3/27/2018 21:40,37,60,42,139,3,0
837,3/27/2018 21:45,36,59,42,137,3,0
838,3/27/2018 21:50,35,57,40,132,3,0
839,3/27/2018 21:55,34,55,39,128,3,0
840,3/27/2018 22:00,33,54,38,125,3,0
841,3/27/2018 22:05,33,54,38,125,3,0
842,3/27/2018 22:10,33,53,38,124,3,0
843,3/27/2018 22:15,33,54,38,125,3,0
844,3/27/2018 22:20,31,50,35,116,3,0
845,3/27/2018 22:25,29,47,33,109,3,0
846,3/27/2018 22:30,28,46,32,106,3,0
847,3/27/2018 22:35,28,45,32,105,3,0
848,3/27/2018 22:40,27,43,30,100,3,0
849,3/27/2018 22:45,25,41,29,95,3,0
850,3/27/2018 22:50,24,39,28,91,3,0
851,3/27/2018 22:55,23,37,26,86,3,0
852,3/27/2018 23:00,22,36,25,83,3,0
853,3/27/2018 23:05,22,36,25,83,3,0
854,3/27/2018 23:10,23,37,26,86,3,0
855,3/27/2018 23:15,21,35,24,80,3,0
856,3/27/2018 23:20,20,32,23,75,3,0
857,3/27/2018 23:25,19,31,22,72,3,0
858,3/27/2018 23:30,18,29,21,68,3,0
859,3/27/2018 23:35,18,28,20,66,3,0
860,3/27/2018 23:40,17,28,19,64,3,0
861,3/27/2018 23:45,17,28,19,64,3,0
862,3/27/2018 23:50,16,25,18,59,3,0
863,3/27/2018 23:55,15,24,17,56,3,0
864,3/28/2018 0:00,39,38,21,98,3,0
865,3/28/2018 0:05,30,32,16,78,3,0
866,3/28/2018 0:10,32,33,17,82,3,0
867,3/28/2018 0:15,39,38,21,98,3,0
868,3/28/2018 0:20,33,34,18,85,3,0
869,3/28/2018 0:25,32,33,17,82,3,0
870,3/28/2018 0:30,35,36,19,90,3,0
871,3/28/2018 0:35,37,37,20,94,3,0
872,3/28/2018 0:40,31,33,17,81,3,0
873,3/28/2018 0:45,30,32,16,78,3,0
874,3/28/2018 0:50,24,27,12,63,3,0
875,3/28/2018 0:55,30,32,16,78,3,0
876,3/28/2018 1:00,28,31,15,74,3,0
877,3/28/2018 1:05,21,26,11,58,3,0
878,3/28/2018 1:10,21,26,11,58,3,0
879,3/28/2018 1:15,28,30,15,73,3,0
880,3/28/2018 1:20,24,28,12,64,3,0
881,3/28/2018 1:25,26,29,13,68,3,0
882,3/28/2018 1:30,17,23,17,57,3,0
883,3/28/2018 1:35,28,31,15,74,3,0
884,3/28/2018 1:40,25,28,13,66,3,0
885,3/28/2018 1:45,22,26,23,71,3,0
886,3/28/2018 1:50,24,28,13,65,3,0
887,3/28/2018 1:55,18,24,19,61,3,0
888,3/28/2018 2:00,12,20,12,44,3,0
889,3/28/2018 2:05,19,24,20,63,3,0
890,3/28/2018 2:10,20,25,10,55,3,0
891,3/28/2018 2:15,21,25,11,57,3,0
892,3/28/2018 2:20,24,28,25,77,3,0
893,3/28/2018 2:25,23,27,12,62,3,0
894,3/28/2018 2:30,19,24,10,53,3,0
895,3/28/2018 2:35,16,22,16,54,3,0
896,3/28/2018 2:40,21,26,22,69,3,0
897,3/28/2018 2:45,18,24,9,51,3,0
898,3/28/2018 2:50,16,22,17,55,3,0
899,3/28/2018 2:55,17,23,17,57,3,0
900,3/28/2018 3:00,13,20,13,46,3,0
901,3/28/2018 3:05,18,23,19,60,3,0
902,3/28/2018 3:10,20,25,10,55,3,0
903,3/28/2018 3:15,23,27,12,62,3,0
904,3/28/2018 3:20,18,24,9,51,3,0
905,3/28/2018 3:25,23,27,12,62,3,0
906,3/28/2018 3:30,17,23,18,58,3,0
907,3/28/2018 3:35,17,23,17,57,3,0
908,3/28/2018 3:40,26,29,14,69,3,0
909,3/28/2018 3:45,23,27,12,62,3,0
910,3/28/2018 3:50,27,30,14,71,3,0
911,3/28/2018 3:55,22,27,12,61,3,0
912,3/28/2018 4:00,24,28,13,65,3,0
913,3/28/2018 4:05,29,31,16,76,3,0
914,3/28/2018 4:10,25,28,13,66,3,0
915,3/28/2018 4:15,31,33,17,81,3,0
916,3/28/2018 4:20,36,36,20,92,3,0
917,3/28/2018 4:25,38,38,21,97,3,0
918,3/28/2018 4:30,38,37,21,96,3,0
919,3/28/2018 4:35,40,39,22,101,3,0
920,3/28/2018 4:40,55,49,30,134,3,0
921,3/28/2018 4:45,47,44,26,117,3,0
922,3/28/2018 4:50,59,52,33,144,3,0
923,3/28/2018 4:55,44,41,24,109,3,0
924,3/28/2018 5:00,45,43,25,113,3,0
925,3/28/2018 5:05,55,49,30,134,3,0
926,3/28/2018 5:10,60,53,33,146,3,0
927,3/28/2018 5:15,64,56,36,156,3,0
928,3/28/2018 5:20,61,53,34,148,3,0
929,3/28/2018 5:25,81,67,45,193,3,0
930,3/28/2018 5:30,83,69,47,199,3,0
931,3/28/2018 5:35,80,67,45,192,3,0
932,3/28/2018 5:40,87,72,49,208,3,0
933,3/28/2018 5:45,84,69,47,200,3,0
934,3/28/2018 5:50,81,68,46,195,3,0
935,3/28/2018 5:55,70,60,39,169,3,0
936,3/28/2018 6:00,77,64,43,184,3,0
937,3/28/2018 6:05,74,62,41,177,3,0
938,3/28/2018 6:10,79,66,44,189,3,0
939,3/28/2018 6:15,89,73,50,212,3,0
940,3/28/2018 6:20,80,67,45,192,3,0
941,3/28/2018 6:25,83,69,46,198,3,0
942,3/28/2018 6:30,89,73,50,212,3,0
943,3/28/2018 6:35,86,71,48,205,3,0
944,3/28/2018 6:40,90,74,51,215,3,0
945,3/28/2018 6:45,87,72,49,208,3,0
946,3/28/2018 6:50,85,70,47,202,3,0
947,3/28/2018 6:55,83,69,47,199,3,0
948,3/28/2018 7:00,79,66,44,189,3,0
949,3/28/2018 7:05,91,74,51,216,3,0
950,3/28/2018 7:10,83,69,47,199,3,0
951,3/28/2018 7:15,72,61,41,174,3,0
952,3/28/2018 7:20,94,76,53,223,3,0
953,3/28/2018 7:25,86,71,48,205,3,0
954,3/28/2018 7:30,83,69,47,199,3,0
955,3/28/2018 7:35,97,78,54,229,3,0
956,3/28/2018 7:40,85,71,48,204,3,0
957,3/28/2018 7:45,78,65,44,187,3,0
958,3/28/2018 7:50,87,71,49,207,3,0
959,3/28/2018 7:55,90,73,50,213,3,0
960,3/28/2018 8:00,90,73,50,213,3,0
961,3/28/2018 8:05,84,70,47,201,3,0
962,3/28/2018 8:10,75,63,42,180,3,0
963,3/28/2018 8:15,75,63,42,180,3,0
964,3/28/2018 8:20,78,65,44,187,3,0
965,3/28/2018 8:25,76,64,42,182,3,0
966,3/28/2018 8:30,76,64,42,182,3,0
967,3/28/2018 8:35,78,65,44,187,3,0
968,3/28/2018 8:40,81,67,45,193,3,0
969,3/28/2018 8:45,69,59,39,167,3,0
970,3/28/2018 8:50,81,67,45,193,3,0
971,3/28/2018 8:55,74,62,41,177,3,0
972,3/28/2018 9:00,72,61,40,173,3,0
973,3/28/2018 9:05,78,66,44,188,3,0
974,3/28/2018 9:10,56,50,31,137,3,0
975,3/28/2018 9:15,73,62,41,176,3,0
976,3/28/2018 9:20,87,72,49,208,3,0
977,3/28/2018 9:25,86,71,48,205,3,0
978,3/28/2018 9:30,80,67,45,192,3,0
979,3/28/2018 9:35,84,69,47,200,3,0
980,3/28/2018 9:40,81,67,45,193,3,0
981,3/28/2018 9:45,78,65,44,187,3,0
982,3/28/2018 9:50,76,64,43,183,3,0
983,3/28/2018 9:55,80,67,45,192,3,0
984,3/28/2018 10:00,77,65,43,185,3,0
985,3/28/2018 10:05,82,68,46,196,3,0
986,3/28/2018 10:10,83,69,46,198,3,0
987,3/28/2018 10:15,83,69,47,199,3,0
988,3/28/2018 10:20,83,69,47,199,3,0
989,3/28/2018 10:25,85,70,48,203,3,0
990,3/28/2018 10:30,78,65,44,187,3,0
991,3/28/2018 10:35,80,67,45,192,3,0
992,3/28/2018 10:40,89,73,50,212,3,0
993,3/28/2018 10:45,82,69,46,197,3,0
994,3/28/2018 10:50,77,65,43,185,3,0
995,3/28/2018 10:55,86,71,48,205,3,0
996,3/28/2018 11:00,80,67,45,192,3,0
997,3/28/2018 11:05,102,82,58,242,3,0
998,3/28/2018 11:10,83,69,47,199,3,0
999,3/28/2018 11:15,84,70,47,201,3,0
1000,3/28/2018 11:20,83,69,46,198,3,0
1001,3/28/2018 11:25,80,67,45,192,3,0
1002,3/28/2018 11:30,80,67,45,192,3,0
1003,3/28/2018 11:35,75,63,42,180,3,0
1004,3/28/2018 11:40,75,63,42,180,3,0
1005,3/28/2018 11:45,73,62,41,176,3,0
1006,3/28/2018 11:50,68,58,38,164,3,0
1007,3/28/2018 11:55,83,69,47,199,3,0
1008,3/28/2018 12:00,75,64,42,181,3,0
1009,3/28/2018 12:05,78,65,44,187,3,0
1010,3/28/2018 12:10,85,70,47,202,3,0
1011,3/28/2018 12:15,80,66,45,191,3,0
1012,3/28/2018 12:20,87,72,49,208,3,0
1013,3/28/2018 12:25,72,61,40,173,3,0
1014,3/28/2018 12:30,71,60,39,170,3,0
1015,3/28/2018 12:35,74,62,41,177,3,0
1016,3/28/2018 12:40,72,61,40,173,3,0
1017,3/28/2018 12:45,76,64,42,182,3,0
1018,3/28/2018 12:50,78,66,44,188,3,0
1019,3/28/2018 12:55,76,64,42,182,3,0
1020,3/28/2018 13:00,77,65,43,185,3,0
1021,3/28/2018 13:05,81,67,45,193,3,0
1022,3/28/2018 13:10,80,67,45,192,3,0
1023,3/28/2018 13:15,89,73,50,212,3,0
1024,3/28/2018 13:20,83,69,47,199,3,0
1025,3/28/2018 13:25,75,63,42,180,3,0
1026,3/28/2018 13:30,93,76,53,222,3,0
1027,3/28/2018 13:35,83,69,47,199,3,0
1028,3/28/2018 13:40,87,72,49,208,3,0
1029,3/28/2018 13:45,82,69,46,197,3,0
1030,3/28/2018 13:50,83,69,47,199,3,0
1031,3/28/2018 13:55,86,71,49,206,3,0
1032,3/28/2018 14:00,88,72,49,209,3,0
1033,3/28/2018 14:05,73,62,41,176,3,0
1034,3/28/2018 14:10,79,66,44,189,3,0
1035,3/28/2018 14:15,89,73,50,212,3,0
1036,3/28/2018 14:20,81,67,45,193,3,0
1037,3/28/2018 14:25,87,72,49,208,3,0
1038,3/28/2018 14:30,81,68,46,195,3,0
1039,3/28/2018 14:35,81,68,46,195,3,0
1040,3/28/2018 14:40,77,65,43,185,3,0
1041,3/28/2018 14:45,81,68,46,195,3,0
1042,3/28/2018 14:50,85,70,48,203,3,0
1043,3/28/2018 14:55,78,65,43,186,3,0
1044,3/28/2018 15:00,80,67,45,192,3,0
1045,3/28/2018 15:05,87,72,49,208,3,0
1046,3/28/2018 15:10,83,69,47,199,3,0
1047,3/28/2018 15:15,83,69,47,199,3,0
1048,3/28/2018 15:20,87,72,49,208,3,0
1049,3/28/2018 15:25,77,64,43,184,3,0
1050,3/28/2018 15:30,88,72,49,209,3,0
1051,3/28/2018 15:35,84,70,47,201,3,0
1052,3/28/2018 15:40,88,72,49,209,3,0
1053,3/28/2018 15:45,80,67,45,192,3,0
1054,3/28/2018 15:50,82,69,46,197,3,0
1055,3/28/2018 15:55,83,69,47,199,3,0
1056,3/28/2018 16:00,77,64,43,184,3,0
1057,3/28/2018 16:05,80,67,45,192,3,0
1058,3/28/2018 16:10,90,74,51,215,3,0
1059,3/28/2018 16:15,86,71,49,206,3,0
1060,3/28/2018 16:20,86,71,48,205,3,0
1061,3/28/2018 16:25,82,68,46,196,3,0
1062,3/28/2018 16:30,81,68,46,195,3,0
1063,3/28/2018 16:35,74,63,41,178,3,0
1064,3/28/2018 16:40,87,71,49,207,3,0
1065,3/28/2018 16:45,87,71,49,207,3,0
1066,3/28/2018 16:50,86,71,48,205,3,0
1067,3/28/2018 16:55,82,68,46,196,3,0
1068,3/28/2018 17:00,93,76,53,222,3,0
1069,3/28/2018 17:05,84,70,48,202,3,0
1070,3/28/2018 17:10,86,71,49,206,3,0
1071,3/28/2018 17:15,86,71,48,205,3,0
1072,3/28/2018 17:20,89,73,50,212,3,0
1073,3/28/2018 17:25,87,72,49,208,3,0
1074,3/28/2018 17:30,82,69,46,197,3,0
1075,3/28/2018 17:35,81,68,46,195,3,0
1076,3/28/2018 17:40,88,73,50,211,3,0
1077,3/28/2018 17:45,86,71,48,205,3,0
1078,3/28/2018 17:50,83,69,47,199,3,0
1079,3/28/2018 17:55,85,70,48,203,3,0
1080,3/28/2018 18:00,82,68,46,196,3,0
1081,3/28/2018 18:05,88,72,50,210,3,0
1082,3/28/2018 18:10,85,71,48,204,3,0
1083,3/28/2018 18:15,98,80,56,234,3,0
1084,3/28/2018 18:20,89,73,50,212,3,0
1085,3/28/2018 18:25,85,71,48,204,3,0
1086,3/28/2018 18:30,86,71,48,205,3,0
1087,3/28/2018 18:35,83,69,46,198,3,0
1088,3/28/2018 18:40,79,66,44,189,3,0
1089,3/28/2018 18:45,84,70,48,202,3,0
1090,3/28/2018 18:50,77,65,43,185,3,0
1091,3/28/2018 18:55,76,64,43,183,3,0
1092,3/28/2018 19:00,85,71,48,204,3,0
1093,3/28/2018 19:05,87,72,49,208,3,0
1094,3/28/2018 19:10,84,70,47,201,3,0
1095,3/28/2018 19:15,91,74,51,216,3,0
1096,3/28/2018 19:20,82,68,46,196,3,0
1097,3/28/2018 19:25,80,66,45,191,3,0
1098,3/28/2018 19:30,87,72,49,208,3,0
1099,3/28/2018 19:35,77,65,43,185,3,0
1100,3/28/2018 19:40,85,70,48,203,3,0
1101,3/28/2018 19:45,82,68,46,196,3,0
1102,3/28/2018 19:50,81,68,46,195,3,0
1103,3/28/2018 19:55,73,62,41,176,3,0
1104,3/28/2018 20:00,82,68,46,196,3,0
1105,3/28/2018 20:05,80,67,45,192,3,0
1106,3/28/2018 20:10,85,70,48,203,3,0
1107,3/28/2018 20:15,83,69,46,198,3,0
1108,3/28/2018 20:20,85,70,48,203,3,0
1109,3/28/2018 20:25,76,64,43,183,3,0
1110,3/28/2018 20:30,44,71,50,165,3,0
1111,3/28/2018 20:35,43,69,49,161,3,0
1112,3/28/2018 20:40,43,69,49,161,3,0
1113,3/28/2018 20:45,42,69,48,159,3,0
1114,3/28/2018 20:50,41,66,47,154,3,0
1115,3/28/2018 20:55,41,66,47,154,3,0
1116,3/28/2018 21:00,40,64,45,149,3,0
1117,3/28/2018 21:05,41,67,47,155,3,0
1118,3/28/2018 21:10,42,68,48,158,3,0
1119,3/28/2018 21:15,44,71,50,165,3,0
1120,3/28/2018 21:20,43,70,49,162,3,0
1121,3/28/2018 21:25,42,68,48,158,3,0
1122,3/28/2018 21:30,41,66,46,153,3,0
1123,3/28/2018 21:35,40,65,45,150,3,0
1124,3/28/2018 21:40,39,63,44,146,3,0
1125,3/28/2018 21:45,38,61,43,142,3,0
1126,3/28/2018 21:50,36,59,41,136,3,0
1127,3/28/2018 21:55,36,59,42,137,3,0
1128,3/28/2018 22:00,36,58,41,135,3,0
1129,3/28/2018 22:05,36,58,41,135,3,0
1130,3/28/2018 22:10,35,57,40,132,3,0
1131,3/28/2018 22:15,35,57,40,132,3,0
1132,3/28/2018 22:20,34,55,39,128,3,0
1133,3/28/2018 22:25,32,51,36,119,3,0
1134,3/28/2018 22:30,31,50,35,116,3,0
1135,3/28/2018 22:35,30,49,34,113,3,0
1136,3/28/2018 22:40,29,48,34,111,3,0
1137,3/28/2018 22:45,28,46,32,106,3,0
1138,3/28/2018 22:50,27,44,31,102,3,0
1139,3/28/2018 22:55,26,42,30,98,3,0
1140,3/28/2018 23:00,24,39,27,90,3,0
1141,3/28/2018 23:05,24,39,27,90,3,0
1142,3/28/2018 23:10,25,40,28,93,3,0
1143,3/28/2018 23:15,24,38,27,89,3,0
1144,3/28/2018 23:20,23,38,26,87,3,0
1145,3/28/2018 23:25,21,35,24,80,3,0
1146,3/28/2018 23:30,21,34,24,79,3,0
1147,3/28/2018 23:35,20,33,23,76,3,0
1148,3/28/2018 23:40,20,33,23,76,3,0
1149,3/28/2018 23:45,19,31,22,72,3,0
1150,3/28/2018 23:50,18,29,20,67,3,0
1151,3/28/2018 23:55,17,27,19,63,3,0
1152,3/29/2018 0:00,16,25,18,59,3,0
1153,3/29/2018 0:05,16,26,18,60,3,0
1154,3/29/2018 0:10,16,25,18,59,3,0
1155,3/29/2018 0:15,15,25,17,57,3,0
1156,3/29/2018 0:20,14,23,16,53,3,0
1157,3/29/2018 0:25,13,21,15,49,3,0
1158,3/29/2018 0:30,12,20,14,46,3,0
1159,3/29/2018 0:35,12,20,14,46,3,0
1160,3/29/2018 0:40,12,20,14,46,3,0
1161,3/29/2018 0:45,12,19,13,44,3,0
1162,3/29/2018 0:50,11,18,12,41,3,0
1163,3/29/2018 0:55,10,16,11,37,3,0
1164,3/29/2018 1:00,9,15,11,35,3,0
1165,3/29/2018 1:05,9,15,11,35,3,0
1166,3/29/2018 1:10,10,16,11,37,3,0
1167,3/29/2018 1:15,9,15,11,35,3,0
1168,3/29/2018 1:20,9,14,10,33,3,0
1169,3/29/2018 1:25,8,14,10,32,3,0
1170,3/29/2018 1:30,8,13,9,30,3,0
1171,3/29/2018 1:35,8,13,9,30,3,0
1172,3/29/2018 1:40,9,14,10,33,3,0
1173,3/29/2018 1:45,8,13,9,30,3,0
1174,3/29/2018 1:50,8,13,9,30,3,0
1175,3/29/2018 1:55,7,12,8,27,3,0
1176,3/29/2018 2:00,7,12,8,27,3,0
1177,3/29/2018 2:05,7,12,8,27,3,0
1178,3/29/2018 2:10,8,13,9,30,3,0
1179,3/29/2018 2:15,7,12,8,27,3,0
1180,3/29/2018 2:20,8,13,9,30,3,0
1181,3/29/2018 2:25,7,12,8,27,3,0
1182,3/29/2018 2:30,7,12,8,27,3,0
1183,3/29/2018 2:35,7,12,8,27,3,0
1184,3/29/2018 2:40,7,12,8,27,3,0
1185,3/29/2018 2:45,7,11,8,26,3,0
1186,3/29/2018 2:50,7,11,8,26,3,0
1187,3/29/2018 2:55,6,10,7,23,3,0
1188,3/29/2018 3:00,6,10,7,23,3,0
1189,3/29/2018 3:05,7,11,8,26,3,0
1190,3/29/2018 3:10,7,12,8,27,3,0
1191,3/29/2018 3:15,7,11,8,26,3,0
1192,3/29/2018 3:20,7,12,8,27,3,0
1193,3/29/2018 3:25,8,13,9,30,3,0
1194,3/29/2018 3:30,8,13,9,30,3,0
1195,3/29/2018 3:35,8,14,10,32,3,0
1196,3/29/2018 3:40,9,15,10,34,3,0
1197,3/29/2018 3:45,9,15,11,35,3,0
1198,3/29/2018 3:50,9,14,10,33,3,0
1199,3/29/2018 3:55,8,14,10,32,3,0
1200,3/29/2018 4:00,9,14,10,33,3,0
1201,3/29/2018 4:05,9,15,11,35,3,0
1202,3/29/2018 4:10,11,17,12,40,3,0
1203,3/29/2018 4:15,12,19,14,45,3,0
1204,3/29/2018 4:20,13,21,15,49,3,0
1205,3/29/2018 4:25,14,23,16,53,3,0
1206,3/29/2018 4:30,16,26,18,60,3,0
1207,3/29/2018 4:35,18,29,21,68,3,0
1208,3/29/2018 4:40,20,33,23,76,3,0
1209,3/29/2018 4:45,21,34,24,79,3,0
1210,3/29/2018 4:50,22,35,25,82,3,0
1211,3/29/2018 4:55,22,36,25,83,3,0
1212,3/29/2018 5:00,24,39,27,90,3,0
1213,3/29/2018 5:05,28,46,32,106,3,0
1214,3/29/2018 5:10,33,53,38,124,3,0
1215,3/29/2018 5:15,37,60,42,139,3,0
1216,3/29/2018 5:20,42,68,48,158,3,0
1217,3/29/2018 5:25,46,74,52,172,3,0
1218,3/29/2018 5:30,52,84,59,195,3,0
1219,3/29/2018 5:35,56,91,64,211,3,0
1220,3/29/2018 5:40,60,97,69,226,3,0
1221,3/29/2018 5:45,61,100,70,231,3,0
1222,3/29/2018 5:50,59,96,67,222,3,0
1223,3/29/2018 5:55,57,92,65,214,3,0
1224,3/29/2018 6:00,57,93,65,215,3,0
1225,3/29/2018 6:05,61,98,69,228,3,0
1226,3/29/2018 6:10,67,109,76,252,3,0
1227,3/29/2018 6:15,71,115,81,267,3,0
1228,3/29/2018 6:20,74,121,85,280,3,0
1229,3/29/2018 6:25,76,124,87,287,3,0
1230,3/29/2018 6:30,79,128,90,297,3,0
1231,3/29/2018 6:35,81,132,93,306,3,0
1232,3/29/2018 6:40,85,138,97,320,3,0
1233,3/29/2018 6:45,85,138,97,320,3,0
1234,3/29/2018 6:50,85,138,97,320,3,0
1235,3/29/2018 6:55,83,135,95,313,3,0
1236,3/29/2018 7:00,83,134,94,311,3,0
1237,3/29/2018 7:05,84,136,96,316,3,0
1238,3/29/2018 7:10,87,141,99,327,3,0
1239,3/29/2018 7:15,89,145,102,336,3,0
1240,3/29/2018 7:20,91,148,104,343,3,0
1241,3/29/2018 7:25,90,147,103,340,3,0
1242,3/29/2018 7:30,90,147,103,340,3,0
1243,3/29/2018 7:35,92,150,105,347,3,0
1244,3/29/2018 7:40,93,151,106,350,3,0
1245,3/29/2018 7:45,93,151,106,350,3,0
1246,3/29/2018 7:50,94,153,107,354,3,0
1247,3/29/2018 7:55,91,147,103,341,3,0
1248,3/29/2018 8:00,88,143,101,332,3,0
1249,3/29/2018 8:05,86,139,98,323,3,0
1250,3/29/2018 8:10,85,139,98,322,3,0
1251,3/29/2018 8:15,84,137,96,317,3,0
1252,3/29/2018 8:20,85,138,97,320,3,0
1253,3/29/2018 8:25,83,134,94,311,3,0
1254,3/29/2018 8:30,80,131,92,303,3,0
1255,3/29/2018 8:35,80,130,91,301,3,0
1256,3/29/2018 8:40,80,129,91,300,3,0
1257,3/29/2018 8:45,80,129,91,300,3,0
1258,3/29/2018 8:50,78,127,89,294,3,0
1259,3/29/2018 8:55,74,120,85,279,3,0
1260,3/29/2018 9:00,72,116,82,270,3,0
1261,3/29/2018 9:05,71,115,81,267,3,0
1262,3/29/2018 9:10,70,114,80,264,3,0
1263,3/29/2018 9:15,71,115,81,267,3,0
1264,3/29/2018 9:20,70,114,80,264,3,0
1265,3/29/2018 9:25,70,113,80,263,3,0
1266,3/29/2018 9:30,70,113,79,262,3,0
1267,3/29/2018 9:35,70,114,80,264,3,0
1268,3/29/2018 9:40,70,114,80,264,3,0
1269,3/29/2018 9:45,70,113,79,262,3,0
1270,3/29/2018 9:50,70,113,80,263,3,0
1271,3/29/2018 9:55,68,111,78,257,3,0
1272,3/29/2018 10:00,65,106,74,245,3,0
1273,3/29/2018 10:05,66,107,75,248,3,0
1274,3/29/2018 10:10,66,107,75,248,3,0
1275,3/29/2018 10:15,67,109,76,252,3,0
1276,3/29/2018 10:20,67,108,76,251,3,0
1277,3/29/2018 10:25,67,108,76,251,3,0
1278,3/29/2018 10:30,66,107,75,248,3,0
1279,3/29/2018 10:35,65,105,74,244,3,0
1280,3/29/2018 10:40,66,108,76,250,3,0
1281,3/29/2018 10:45,67,110,77,254,3,0
1282,3/29/2018 10:50,67,109,77,253,3,0
1283,3/29/2018 10:55,66,108,76,250,3,0
1284,3/29/2018 11:00,65,106,74,245,3,0
1285,3/29/2018 11:05,66,107,75,248,3,0
1286,3/29/2018 11:10,66,107,75,248,3,0
1287,3/29/2018 11:15,65,106,75,246,3,0
1288,3/29/2018 11:20,66,108,76,250,3,0
1289,3/29/2018 11:25,67,108,76,251,3,0
1290,3/29/2018 11:30,67,109,77,253,3,0
1291,3/29/2018 11:35,68,111,78,257,3,0
1292,3/29/2018 11:40,68,111,78,257,3,0
1293,3/29/2018 11:45,67,110,77,254,3,0
1294,3/29/2018 11:50,68,111,78,257,3,0
1295,3/29/2018 11:55,67,109,76,252,3,0
1296,3/29/2018 12:00,67,109,77,253,3,0
1297,3/29/2018 12:05,68,110,78,256,3,0
1298,3/29/2018 12:10,68,110,78,256,3,0
1299,3/29/2018 12:15,68,111,78,257,3,0
1300,3/29/2018 12:20,69,113,79,261,3,0
1301,3/29/2018 12:25,69,112,79,260,3,0
1302,3/29/2018 12:30,68,111,78,257,3,0
1303,3/29/2018 12:35,68,110,78,256,3,0
1304,3/29/2018 12:40,68,111,78,257,3,0
1305,3/29/2018 12:45,70,113,80,263,3,0
1306,3/29/2018 12:50,70,113,79,262,3,0
1307,3/29/2018 12:55,69,112,79,260,3,0
1308,3/29/2018 13:00,68,110,78,256,3,0
1309,3/29/2018 13:05,68,111,78,257,3,0
1310,3/29/2018 13:10,70,113,80,263,3,0
1311,3/29/2018 13:15,70,113,80,263,3,0
1312,3/29/2018 13:20,70,114,80,264,3,0
1313,3/29/2018 13:25,70,113,80,263,3,0
1314,3/29/2018 13:30,70,114,80,264,3,0
1315,3/29/2018 13:35,71,115,81,267,3,0
1316,3/29/2018 13:40,71,115,81,267,3,0
1317,3/29/2018 13:45,72,116,82,270,3,0
1318,3/29/2018 13:50,71,116,82,269,3,0
1319,3/29/2018 13:55,71,116,82,269,3,0
1320,3/29/2018 14:00,72,116,82,270,3,0
1321,3/29/2018 14:05,73,118,83,274,3,0
1322,3/29/2018 14:10,74,121,85,280,3,0
1323,3/29/2018 14:15,76,123,86,285,3,0
1324,3/29/2018 14:20,76,124,87,287,3,0
1325,3/29/2018 14:25,76,123,86,285,3,0
1326,3/29/2018 14:30,76,124,87,287,3,0
1327,3/29/2018 14:35,79,129,91,299,3,0
1328,3/29/2018 14:40,83,135,95,313,3,0
1329,3/29/2018 14:45,84,136,96,316,3,0
1330,3/29/2018 14:50,82,134,94,310,3,0
1331,3/29/2018 14:55,81,132,93,306,3,0
1332,3/29/2018 15:00,81,132,92,305,3,0
1333,3/29/2018 15:05,82,133,94,309,3,0
1334,3/29/2018 15:10,84,136,96,316,3,0
1335,3/29/2018 15:15,84,136,96,316,3,0
1336,3/29/2018 15:20,84,137,96,317,3,0
1337,3/29/2018 15:25,84,137,96,317,3,0
1338,3/29/2018 15:30,84,137,96,317,3,0
1339,3/29/2018 15:35,89,145,102,336,3,0
1340,3/29/2018 15:40,92,150,106,348,3,0
1341,3/29/2018 15:45,92,150,105,347,3,0
1342,3/29/2018 15:50,91,148,104,343,3,0
1343,3/29/2018 15:55,88,142,100,330,3,0
1344,3/29/2018 16:00,87,141,99,327,3,0
1345,3/29/2018 16:05,88,143,100,331,3,0
1346,3/29/2018 16:10,91,147,103,341,3,0
1347,3/29/2018 16:15,90,146,102,338,3,0
1348,3/29/2018 16:20,91,148,104,343,3,0
1349,3/29/2018 16:25,88,143,100,331,3,0
1350,3/29/2018 16:30,90,146,102,338,3,0
1351,3/29/2018 16:35,91,148,104,343,3,0
1352,3/29/2018 16:40,94,152,107,353,3,0
1353,3/29/2018 16:45,94,152,107,353,3,0
1354,3/29/2018 16:50,95,154,109,358,3,0
1355,3/29/2018 16:55,92,149,105,346,3,0
1356,3/29/2018 17:00,91,148,104,343,3,0
1357,3/29/2018 17:05,94,152,107,353,3,0
1358,3/29/2018 17:10,97,157,110,364,3,0
1359,3/29/2018 17:15,96,157,110,363,3,0
1360,3/29/2018 17:20,98,160,112,370,3,0
1361,3/29/2018 17:25,92,150,105,347,3,0
1362,3/29/2018 17:30,91,148,104,343,3,0
1363,3/29/2018 17:35,91,148,104,343,3,0
1364,3/29/2018 17:40,91,148,104,343,3,0
1365,3/29/2018 17:45,91,147,103,341,3,0
1366,3/29/2018 17:50,91,147,103,341,3,0
1367,3/29/2018 17:55,87,142,100,329,3,0
1368,3/29/2018 18:00,85,138,97,320,3,0
1369,3/29/2018 18:05,85,138,97,320,3,0
1370,3/29/2018 18:10,85,138,97,320,3,0
1371,3/29/2018 18:15,84,137,96,317,3,0
1372,3/29/2018 18:20,85,138,97,320,3,0
1373,3/29/2018 18:25,82,133,93,308,3,0
1374,3/29/2018 18:30,80,130,92,302,3,0
1375,3/29/2018 18:35,78,127,89,294,3,0
1376,3/29/2018 18:40,76,124,87,287,3,0
1377,3/29/2018 18:45,75,123,86,284,3,0
1378,3/29/2018 18:50,72,118,83,273,3,0
1379,3/29/2018 18:55,70,114,80,264,3,0
1380,3/29/2018 19:00,69,113,79,261,3,0
1381,3/29/2018 19:05,68,111,78,257,3,0
1382,3/29/2018 19:10,69,112,79,260,3,0
1383,3/29/2018 19:15,65,106,75,246,3,0
1384,3/29/2018 19:20,63,103,72,238,3,0
1385,3/29/2018 19:25,61,100,70,231,3,0
1386,3/29/2018 19:30,60,97,68,225,3,0
1387,3/29/2018 19:35,58,95,67,220,3,0
1388,3/29/2018 19:40,58,94,66,218,3,0
1389,3/29/2018 19:45,55,89,63,207,3,0
1390,3/29/2018 19:50,54,87,61,202,3,0
1391,3/29/2018 19:55,51,83,58,192,3,0
1392,3/29/2018 20:00,50,82,57,189,3,0
1393,3/29/2018 20:05,49,79,56,184,3,0
1394,3/29/2018 20:10,48,78,55,181,3,0
1395,3/29/2018 20:15,48,78,55,181,3,0
1396,3/29/2018 20:20,48,79,55,182,3,0
1397,3/29/2018 20:25,47,76,53,176,3,0
1398,3/29/2018 20:30,44,72,51,167,3,0
1399,3/29/2018 20:35,45,72,51,168,3,0
1400,3/29/2018 20:40,45,73,51,169,3,0
1401,3/29/2018 20:45,44,71,50,165,3,0
1402,3/29/2018 20:50,44,71,50,165,3,0
1403,3/29/2018 20:55,42,69,48,159,3,0
1404,3/29/2018 21:00,42,68,48,158,3,0
1405,3/29/2018 21:05,43,70,49,162,3,0
1406,3/29/2018 21:10,45,73,51,169,3,0
1407,3/29/2018 21:15,45,74,52,171,3,0
1408,3/29/2018 21:20,45,73,52,170,3,0
1409,3/29/2018 21:25,44,72,50,166,3,0
1410,3/29/2018 21:30,42,69,48,159,3,0
1411,3/29/2018 21:35,42,69,49,160,3,0
1412,3/29/2018 21:40,42,69,48,159,3,0
1413,3/29/2018 21:45,41,66,46,153,3,0
1414,3/29/2018 21:50,40,65,45,150,3,0
1415,3/29/2018 21:55,38,63,44,145,3,0
1416,3/29/2018 22:00,38,61,43,142,3,0
1417,3/29/2018 22:05,37,60,42,139,3,0
1418,3/29/2018 22:10,38,62,43,143,3,0
1419,3/29/2018 22:15,37,60,42,139,3,0
1420,3/29/2018 22:20,37,61,43,141,3,0
1421,3/29/2018 22:25,35,57,40,132,3,0
1422,3/29/2018 22:30,35,56,39,130,3,0
1423,3/29/2018 22:35,33,53,37,123,3,0
1424,3/29/2018 22:40,32,51,36,119,3,0
1425,3/29/2018 22:45,31,51,36,118,3,0
1426,3/29/2018 22:50,29,47,33,109,3,0
1427,3/29/2018 22:55,27,44,31,102,3,0
1428,3/29/2018 23:00,26,42,29,97,3,0
1429,3/29/2018 23:05,26,43,30,99,3,0
1430,3/29/2018 23:10,27,43,30,100,3,0
1431,3/29/2018 23:15,24,40,28,92,3,0
1432,3/29/2018 23:20,24,38,27,89,3,0
1433,3/29/2018 23:25,23,37,26,86,3,0
1434,3/29/2018 23:30,21,35,25,81,3,0
1435,3/29/2018 23:35,21,35,24,80,3,0
1436,3/29/2018 23:40,20,33,23,76,3,0
1437,3/29/2018 23:45,20,32,23,75,3,0
1438,3/29/2018 23:50,19,31,22,72,3,0
1439,3/29/2018 23:55,18,29,20,67,3,0
1440,3/30/2018 0:00,16,26,18,60,3,0
1441,3/30/2018 0:05,16,26,18,60,3,0
1442,3/30/2018 0:10,16,27,19,62,3,0
1443,3/30/2018 0:15,15,25,18,58,3,0
1444,3/30/2018 0:20,15,24,17,56,3,0
1445,3/30/2018 0:25,13,22,15,50,3,0
1446,3/30/2018 0:30,14,22,15,51,3,0
1447,3/30/2018 0:35,14,22,15,51,3,0
1448,3/30/2018 0:40,13,22,15,50,3,0
1449,3/30/2018 0:45,12,20,14,46,3,0
1450,3/30/2018 0:50,12,19,13,44,3,0
1451,3/30/2018 0:55,11,18,13,42,3,0
1452,3/30/2018 1:00,10,16,12,38,3,0
1453,3/30/2018 1:05,10,17,12,39,3,0
1454,3/30/2018 1:10,10,16,12,38,3,0
1455,3/30/2018 1:15,10,17,12,39,3,0
1456,3/30/2018 1:20,10,16,12,38,3,0
1457,3/30/2018 1:25,9,15,11,35,3,0
1458,3/30/2018 1:30,9,15,11,35,3,0
1459,3/30/2018 1:35,9,15,11,35,3,0
1460,3/30/2018 1:40,10,16,11,37,3,0
1461,3/30/2018 1:45,9,15,11,35,3,0
1462,3/30/2018 1:50,9,15,10,34,3,0
1463,3/30/2018 1:55,9,14,10,33,3,0
1464,3/30/2018 2:00,8,14,10,32,3,0
1465,3/30/2018 2:05,9,14,10,33,3,0
1466,3/30/2018 2:10,9,14,10,33,3,0
1467,3/30/2018 2:15,9,14,10,33,3,0
1468,3/30/2018 2:20,8,13,9,30,3,0
1469,3/30/2018 2:25,8,13,9,30,3,0
1470,3/30/2018 2:30,8,13,9,30,3,0
1471,3/30/2018 2:35,8,13,9,30,3,0
1472,3/30/2018 2:40,8,14,10,32,3,0
1473,3/30/2018 2:45,8,13,9,30,3,0
1474,3/30/2018 2:50,8,13,9,30,3,0
1475,3/30/2018 2:55,7,12,8,27,3,0
1476,3/30/2018 3:00,7,12,8,27,3,0
1477,3/30/2018 3:05,7,12,8,27,3,0
1478,3/30/2018 3:10,7,12,8,27,3,0
1479,3/30/2018 3:15,8,13,9,30,3,0
1480,3/30/2018 3:20,8,13,9,30,3,0
1481,3/30/2018 3:25,8,14,10,32,3,0
1482,3/30/2018 3:30,9,14,10,33,3,0
1483,3/30/2018 3:35,9,15,11,35,3,0
1484,3/30/2018 3:40,10,16,11,37,3,0
1485,3/30/2018 3:45,10,16,11,37,3,0
1486,3/30/2018 3:50,9,15,10,34,3,0
1487,3/30/2018 3:55,9,15,10,34,3,0
1488,3/30/2018 4:00,9,15,11,35,3,0
1489,3/30/2018 4:05,10,17,12,39,3,0
1490,3/30/2018 4:10,11,18,13,42,3,0
1491,3/30/2018 4:15,12,20,14,46,3,0
1492,3/30/2018 4:20,14,23,16,53,3,0
1493,3/30/2018 4:25,14,23,16,53,3,0
1494,3/30/2018 4:30,16,26,18,60,3,0
1495,3/30/2018 4:35,19,30,21,70,3,0
1496,3/30/2018 4:40,20,33,23,76,3,0
1497,3/30/2018 4:45,21,35,24,80,3,0
1498,3/30/2018 4:50,21,35,25,81,3,0
1499,3/30/2018 4:55,21,35,25,81,3,0
1500,3/30/2018 5:00,24,39,28,91,3,0
1501,3/30/2018 5:05,27,44,31,102,3,0
1502,3/30/2018 5:10,32,52,36,120,3,0
1503,3/30/2018 5:15,36,59,41,136,3,0
1504,3/30/2018 5:20,41,66,46,153,3,0
1505,3/30/2018 5:25,44,71,50,165,3,0
1506,3/30/2018 5:30,48,79,55,182,3,0
1507,3/30/2018 5:35,53,87,61,201,3,0
1508,3/30/2018 5:40,56,91,64,211,3,0
1509,3/30/2018 5:45,57,92,65,214,3,0
1510,3/30/2018 5:50,58,94,66,218,3,0
1511,3/30/2018 5:55,56,91,64,211,3,0
1512,3/30/2018 6:00,56,91,64,211,3,0
1513,3/30/2018 6:05,60,97,68,225,3,0
1514,3/30/2018 6:10,64,105,74,243,3,0
1515,3/30/2018 6:15,70,113,80,263,3,0
1516,3/30/2018 6:20,72,118,83,273,3,0
1517,3/30/2018 6:25,75,121,85,281,3,0
1518,3/30/2018 6:30,77,126,89,292,3,0
1519,3/30/2018 6:35,80,130,91,301,3,0
1520,3/30/2018 6:40,83,135,95,313,3,0
1521,3/30/2018 6:45,84,137,96,317,3,0
1522,3/30/2018 6:50,85,138,97,320,3,0
1523,3/30/2018 6:55,81,132,93,306,3,0
1524,3/30/2018 7:00,82,133,93,308,3,0
1525,3/30/2018 7:05,84,136,96,316,3,0
1526,3/30/2018 7:10,87,141,99,327,3,0
1527,3/30/2018 7:15,89,145,102,336,3,0
1528,3/30/2018 7:20,92,150,105,347,3,0
1529,3/30/2018 7:25,92,150,105,347,3,0
1530,3/30/2018 7:30,92,149,105,346,3,0
1531,3/30/2018 7:35,92,150,106,348,3,0
1532,3/30/2018 7:40,93,151,106,350,3,0
1533,3/30/2018 7:45,95,154,109,358,3,0
1534,3/30/2018 7:50,94,153,107,354,3,0
1535,3/30/2018 7:55,91,148,104,343,3,0
1536,3/30/2018 8:00,88,143,100,331,3,0
1537,3/30/2018 8:05,87,141,99,327,3,0
1538,3/30/2018 8:10,87,141,99,327,3,0
1539,3/30/2018 8:15,87,141,99,327,3,0
1540,3/30/2018 8:20,87,141,99,327,3,0
1541,3/30/2018 8:25,84,137,96,317,3,0
1542,3/30/2018 8:30,82,133,93,308,3,0
1543,3/30/2018 8:35,81,132,92,305,3,0
1544,3/30/2018 8:40,82,133,93,308,3,0
1545,3/30/2018 8:45,79,129,90,298,3,0
1546,3/30/2018 8:50,78,127,89,294,3,0
1547,3/30/2018 8:55,75,123,86,284,3,0
1548,3/30/2018 9:00,73,119,83,275,3,0
1549,3/30/2018 9:05,72,116,82,270,3,0
1550,3/30/2018 9:10,72,117,82,271,3,0
1551,3/30/2018 9:15,70,114,80,264,3,0
1552,3/30/2018 9:20,72,116,82,270,3,0
1553,3/30/2018 9:25,71,115,81,267,3,0
1554,3/30/2018 9:30,71,115,81,267,3,0
1555,3/30/2018 9:35,71,116,81,268,3,0
1556,3/30/2018 9:40,72,117,82,271,3,0
1557,3/30/2018 9:45,72,116,82,270,3,0
1558,3/30/2018 9:50,71,115,81,267,3,0
1559,3/30/2018 9:55,69,112,79,260,3,0
1560,3/30/2018 10:00,67,110,77,254,3,0
1561,3/30/2018 10:05,69,112,79,260,3,0
1562,3/30/2018 10:10,69,112,79,260,3,0
1563,3/30/2018 10:15,70,113,79,262,3,0
1564,3/30/2018 10:20,71,115,81,267,3,0
1565,3/30/2018 10:25,70,113,80,263,3,0
1566,3/30/2018 10:30,70,113,80,263,3,0
1567,3/30/2018 10:35,70,113,80,263,3,0
1568,3/30/2018 10:40,71,115,81,267,3,0
1569,3/30/2018 10:45,71,115,81,267,3,0
1570,3/30/2018 10:50,70,113,79,262,3,0
1571,3/30/2018 10:55,68,111,78,257,3,0
1572,3/30/2018 11:00,69,112,79,260,3,0
1573,3/30/2018 11:05,68,111,78,257,3,0
1574,3/30/2018 11:10,69,112,79,260,3,0
1575,3/30/2018 11:15,69,112,79,260,3,0
1576,3/30/2018 11:20,70,114,80,264,3,0
1577,3/30/2018 11:25,70,114,80,264,3,0
1578,3/30/2018 11:30,72,117,82,271,3,0
1579,3/30/2018 11:35,71,116,81,268,3,0
1580,3/30/2018 11:40,73,119,83,275,3,0
1581,3/30/2018 11:45,72,118,83,273,3,0
1582,3/30/2018 11:50,74,119,84,277,3,0
1583,3/30/2018 11:55,71,115,81,267,3,0
1584,3/30/2018 12:00,71,116,81,268,3,0
1585,3/30/2018 12:05,73,119,83,275,3,0
1586,3/30/2018 12:10,72,117,82,271,3,0
1587,3/30/2018 12:15,74,120,84,278,3,0
1588,3/30/2018 12:20,74,120,85,279,3,0
1589,3/30/2018 12:25,74,120,84,278,3,0
1590,3/30/2018 12:30,74,120,84,278,3,0
1591,3/30/2018 12:35,74,119,84,277,3,0
1592,3/30/2018 12:40,74,121,85,280,3,0
1593,3/30/2018 12:45,75,121,85,281,3,0
1594,3/30/2018 12:50,74,120,85,279,3,0
1595,3/30/2018 12:55,74,121,85,280,3,0
1596,3/30/2018 13:00,74,120,84,278,3,0
1597,3/30/2018 13:05,74,121,85,280,3,0
1598,3/30/2018 13:10,74,120,85,279,3,0
1599,3/30/2018 13:15,75,122,86,283,3,0
1600,3/30/2018 13:20,76,124,87,287,3,0
1601,3/30/2018 13:25,76,124,87,287,3,0
1602,3/30/2018 13:30,75,121,85,281,3,0
1603,3/30/2018 13:35,76,123,87,286,3,0
1604,3/30/2018 13:40,77,126,88,291,3,0
1605,3/30/2018 13:45,77,125,88,290,3,0
1606,3/30/2018 13:50,77,126,88,291,3,0
1607,3/30/2018 13:55,77,126,89,292,3,0
1608,3/30/2018 14:00,77,125,88,290,3,0
1609,3/30/2018 14:05,77,126,89,292,3,0
1610,3/30/2018 14:10,80,129,91,300,3,0
1611,3/30/2018 14:15,80,130,92,302,3,0
1612,3/30/2018 14:20,81,132,93,306,3,0
1613,3/30/2018 14:25,81,132,93,306,3,0
1614,3/30/2018 14:30,82,133,94,309,3,0
1615,3/30/2018 14:35,82,134,94,310,3,0
1616,3/30/2018 14:40,86,139,98,323,3,0
1617,3/30/2018 14:45,88,144,101,333,3,0
1618,3/30/2018 14:50,85,138,97,320,3,0
1619,3/30/2018 14:55,84,137,96,317,3,0
1620,3/30/2018 15:00,85,138,97,320,3,0
1621,3/30/2018 15:05,88,142,100,330,3,0
1622,3/30/2018 15:10,88,144,101,333,3,0
1623,3/30/2018 15:15,88,143,101,332,3,0
1624,3/30/2018 15:20,89,145,102,336,3,0
1625,3/30/2018 15:25,87,141,99,327,3,0
1626,3/30/2018 15:30,86,140,99,325,3,0
1627,3/30/2018 15:35,89,145,102,336,3,0
1628,3/30/2018 15:40,91,148,104,343,3,0
1629,3/30/2018 15:45,92,150,105,347,3,0
1630,3/30/2018 15:50,91,148,104,343,3,0
1631,3/30/2018 15:55,89,145,102,336,3,0
1632,3/30/2018 16:00,89,145,102,336,3,0
1633,3/30/2018 16:05,90,147,103,340,3,0
1634,3/30/2018 16:10,92,149,105,346,3,0
1635,3/30/2018 16:15,92,150,106,348,3,0
1636,3/30/2018 16:20,92,150,106,348,3,0
1637,3/30/2018 16:25,91,148,104,343,3,0
1638,3/30/2018 16:30,90,147,103,340,3,0
1639,3/30/2018 16:35,91,148,104,343,3,0
1640,3/30/2018 16:40,94,153,107,354,3,0
1641,3/30/2018 16:45,93,152,107,352,3,0
1642,3/30/2018 16:50,94,153,108,355,3,0
1643,3/30/2018 16:55,92,149,105,346,3,0
1644,3/30/2018 17:00,92,149,105,346,3,0
1645,3/30/2018 17:05,94,153,107,354,3,0
1646,3/30/2018 17:10,96,156,109,361,3,0
1647,3/30/2018 17:15,96,156,109,361,3,0
1648,3/30/2018 17:20,96,157,110,363,3,0
1649,3/30/2018 17:25,94,153,108,355,3,0
1650,3/30/2018 17:30,92,150,105,347,3,0
1651,3/30/2018 17:35,92,149,105,346,3,0
1652,3/30/2018 17:40,92,150,106,348,3,0
1653,3/30/2018 17:45,91,148,104,343,3,0
1654,3/30/2018 17:50,89,145,102,336,3,0
1655,3/30/2018 17:55,89,145,102,336,3,0
1656,3/30/2018 18:00,87,142,100,329,3,0
1657,3/30/2018 18:05,87,141,99,327,3,0
1658,3/30/2018 18:10,87,141,99,327,3,0
1659,3/30/2018 18:15,87,141,99,327,3,0
1660,3/30/2018 18:20,86,140,98,324,3,0
1661,3/30/2018 18:25,84,136,96,316,3,0
1662,3/30/2018 18:30,82,133,93,308,3,0
1663,3/30/2018 18:35,82,133,93,308,3,0
1664,3/30/2018 18:40,80,129,91,300,3,0
1665,3/30/2018 18:45,78,127,89,294,3,0
1666,3/30/2018 18:50,77,126,89,292,3,0
1667,3/30/2018 18:55,75,122,86,283,3,0
1668,3/30/2018 19:00,73,119,83,275,3,0
1669,3/30/2018 19:05,72,118,83,273,3,0
1670,3/30/2018 19:10,73,118,83,274,3,0
1671,3/30/2018 19:15,71,116,82,269,3,0
1672,3/30/2018 19:20,70,113,80,263,3,0
1673,3/30/2018 19:25,68,110,78,256,3,0
1674,3/30/2018 19:30,66,108,76,250,3,0
1675,3/30/2018 19:35,65,106,74,245,3,0
1676,3/30/2018 19:40,64,105,74,243,3,0
1677,3/30/2018 19:45,62,101,71,234,3,0
1678,3/30/2018 19:50,62,101,71,234,3,0
1679,3/30/2018 19:55,59,97,68,224,3,0
1680,3/30/2018 20:00,61,98,69,228,3,0
1681,3/30/2018 20:05,58,94,66,218,3,0
1682,3/30/2018 20:10,58,94,66,218,3,0
1683,3/30/2018 20:15,57,93,65,215,3,0
1684,3/30/2018 20:20,55,90,63,208,3,0
1685,3/30/2018 20:25,55,90,63,208,3,0
1686,3/30/2018 20:30,54,88,62,204,3,0
1687,3/30/2018 20:35,52,85,59,196,3,0
1688,3/30/2018 20:40,51,84,59,194,3,0
1689,3/30/2018 20:45,50,82,58,190,3,0
1690,3/30/2018 20:50,49,79,56,184,3,0
1691,3/30/2018 20:55,49,80,56,185,3,0
1692,3/30/2018 21:00,49,79,56,184,3,0
1693,3/30/2018 21:05,50,81,57,188,3,0
1694,3/30/2018 21:10,50,82,57,189,3,0
1695,3/30/2018 21:15,50,82,58,190,3,0
1696,3/30/2018 21:20,49,80,56,185,3,0
1697,3/30/2018 21:25,49,80,56,185,3,0
1698,3/30/2018 21:30,47,77,54,178,3,0
1699,3/30/2018 21:35,47,76,54,177,3,0
1700,3/30/2018 21:40,46,75,52,173,3,0
1701,3/30/2018 21:45,47,76,53,176,3,0
1702,3/30/2018 21:50,46,75,52,173,3,0
1703,3/30/2018 21:55,45,72,51,168,3,0
1704,3/30/2018 22:00,44,72,51,167,3,0
1705,3/30/2018 22:05,45,73,52,170,3,0
1706,3/30/2018 22:10,46,74,52,172,3,0
1707,3/30/2018 22:15,45,73,51,169,3,0
1708,3/30/2018 22:20,45,73,51,169,3,0
1709,3/30/2018 22:25,42,69,48,159,3,0
1710,3/30/2018 22:30,41,67,47,155,3,0
1711,3/30/2018 22:35,40,65,46,151,3,0
1712,3/30/2018 22:40,40,65,45,150,3,0
1713,3/30/2018 22:45,40,64,45,149,3,0
1714,3/30/2018 22:50,37,61,43,141,3,0
1715,3/30/2018 22:55,36,59,42,137,3,0
1716,3/30/2018 23:00,35,56,39,130,3,0
1717,3/30/2018 23:05,34,55,39,128,3,0
1718,3/30/2018 23:10,34,55,39,128,3,0
1719,3/30/2018 23:15,35,56,39,130,3,0
1720,3/30/2018 23:20,32,52,36,120,3,0
1721,3/30/2018 23:25,30,49,35,114,3,0
1722,3/30/2018 23:30,30,49,34,113,3,0
1723,3/30/2018 23:35,30,48,34,112,3,0
1724,3/30/2018 23:40,29,47,33,109,3,0
1725,3/30/2018 23:45,28,45,32,105,3,0
1726,3/30/2018 23:50,27,43,30,100,3,0
1727,3/30/2018 23:55,25,41,29,95,3,0
1728,3/31/2018 0:00,24,39,27,90,3,0
1729,3/31/2018 0:05,24,39,28,91,3,0
1730,3/31/2018 0:10,24,39,27,90,3,0
1731,3/31/2018 0:15,23,38,26,87,3,0
1732,3/31/2018 0:20,23,37,26,86,3,0
1733,3/31/2018 0:25,21,34,24,79,3,0
1734,3/31/2018 0:30,20,32,23,75,3,0
1735,3/31/2018 0:35,20,32,22,74,3,0
1736,3/31/2018 0:40,19,31,22,72,3,0
1737,3/31/2018 0:45,19,30,21,70,3,0
1738,3/31/2018 0:50,18,29,21,68,3,0
1739,3/31/2018 0:55,18,29,20,67,3,0
1740,3/31/2018 1:00,17,27,19,63,3,0
1741,3/31/2018 1:05,16,27,19,62,3,0
1742,3/31/2018 1:10,16,27,19,62,3,0
1743,3/31/2018 1:15,16,26,18,60,3,0
1744,3/31/2018 1:20,16,26,18,60,3,0
1745,3/31/2018 1:25,15,24,17,56,3,0
1746,3/31/2018 1:30,3,4,3,10,3,0
1747,3/31/2018 1:35,15,24,17,56,3,0
1748,3/31/2018 1:40,15,24,17,56,3,0
1749,3/31/2018 1:45,14,22,16,52,3,0
1750,3/31/2018 1:50,14,23,16,53,3,0
1751,3/31/2018 1:55,14,22,15,51,3,0
1752,3/31/2018 2:00,14,22,16,52,3,0
1753,3/31/2018 2:05,14,22,15,51,3,0
1754,3/31/2018 2:10,14,22,16,52,3,0
1755,3/31/2018 2:15,13,22,15,50,3,0
1756,3/31/2018 2:20,13,21,15,49,3,0
1757,3/31/2018 2:25,12,20,14,46,3,0
1758,3/31/2018 2:30,12,19,13,44,3,0
1759,3/31/2018 2:35,11,18,13,42,3,0
1760,3/31/2018 2:40,11,18,13,42,3,0
1761,3/31/2018 2:45,11,17,12,40,3,0
1762,3/31/2018 2:50,11,17,12,40,3,0
1763,3/31/2018 2:55,10,16,11,37,3,0
1764,3/31/2018 3:00,9,15,11,35,3,0
1765,3/31/2018 3:05,9,15,10,34,3,0
1766,3/31/2018 3:10,9,15,11,35,3,0
1767,3/31/2018 3:15,9,15,11,35,3,0
1768,3/31/2018 3:20,9,15,10,34,3,0
1769,3/31/2018 3:25,9,14,10,33,3,0
1770,3/31/2018 3:30,9,15,10,34,3,0
1771,3/31/2018 3:35,9,15,11,35,3,0
1772,3/31/2018 3:40,10,16,11,37,3,0
1773,3/31/2018 3:45,9,15,11,35,3,0
1774,3/31/2018 3:50,8,14,10,32,3,0
1775,3/31/2018 3:55,8,13,9,30,3,0
1776,3/31/2018 4:00,8,13,9,30,3,0
1777,3/31/2018 4:05,8,13,9,30,3,0
1778,3/31/2018 4:10,9,15,11,35,3,0
1779,3/31/2018 4:15,10,16,11,37,3,0
1780,3/31/2018 4:20,11,17,12,40,3,0
1781,3/31/2018 4:25,11,17,12,40,3,0
1782,3/31/2018 4:30,11,18,13,42,3,0
1783,3/31/2018 4:35,12,19,14,45,3,0
1784,3/31/2018 4:40,13,21,15,49,3,0
1785,3/31/2018 4:45,13,21,15,49,3,0
1786,3/31/2018 4:50,12,20,14,46,3,0
1787,3/31/2018 4:55,12,19,14,45,3,0
1788,3/31/2018 5:00,12,20,14,46,3,0
1789,3/31/2018 5:05,14,22,16,52,3,0
1790,3/31/2018 5:10,15,25,18,58,3,0
1791,3/31/2018 5:15,17,28,19,64,3,0
1792,3/31/2018 5:20,18,29,21,68,3,0
1793,3/31/2018 5:25,20,32,22,74,3,0
1794,3/31/2018 5:30,21,34,24,79,3,0
1795,3/31/2018 5:35,23,37,26,86,3,0
1796,3/31/2018 5:40,25,40,28,93,3,0
1797,3/31/2018 5:45,25,41,29,95,3,0
1798,3/31/2018 5:50,24,39,28,91,3,0
1799,3/31/2018 5:55,23,37,26,86,3,0
1800,3/31/2018 6:00,23,37,26,86,3,0
1801,3/31/2018 6:05,24,38,27,89,3,0
1802,3/31/2018 6:10,25,41,29,95,3,0
1803,3/31/2018 6:15,27,44,31,102,3,0
1804,3/31/2018 6:20,28,46,32,106,3,0
1805,3/31/2018 6:25,29,48,34,111,3,0
1806,3/31/2018 6:30,32,51,36,119,3,0
1807,3/31/2018 6:35,33,54,38,125,3,0
1808,3/31/2018 6:40,36,58,41,135,3,0
1809,3/31/2018 6:45,36,59,42,137,3,0
1810,3/31/2018 6:50,36,59,42,137,3,0
1811,3/31/2018 6:55,35,56,39,130,3,0
1812,3/31/2018 7:00,34,56,39,129,3,0
1813,3/31/2018 7:05,35,57,40,132,3,0
1814,3/31/2018 7:10,37,60,42,139,3,0
1815,3/31/2018 7:15,39,63,45,147,3,0
1816,3/31/2018 7:20,40,66,46,152,3,0
1817,3/31/2018 7:25,43,69,49,161,3,0
1818,3/31/2018 7:30,43,70,49,162,3,0
1819,3/31/2018 7:35,46,75,53,174,3,0
1820,3/31/2018 7:40,50,82,58,190,3,0
1821,3/31/2018 7:45,52,84,59,195,3,0
1822,3/31/2018 7:50,51,84,59,194,3,0
1823,3/31/2018 7:55,50,82,58,190,3,0
1824,3/31/2018 8:00,49,79,55,183,3,0
1825,3/31/2018 8:05,49,79,55,183,3,0
1826,3/31/2018 8:10,50,81,57,188,3,0
1827,3/31/2018 8:15,51,83,59,193,3,0
1828,3/31/2018 8:20,52,84,59,195,3,0
1829,3/31/2018 8:25,53,86,61,200,3,0
1830,3/31/2018 8:30,55,89,63,207,3,0
1831,3/31/2018 8:35,58,94,66,218,3,0
1832,3/31/2018 8:40,60,97,69,226,3,0
1833,3/31/2018 8:45,62,101,71,234,3,0
1834,3/31/2018 8:50,62,101,71,234,3,0
1835,3/31/2018 8:55,59,97,68,224,3,0
1836,3/31/2018 9:00,59,95,67,221,3,0
1837,3/31/2018 9:05,56,91,64,211,3,0
1838,3/31/2018 9:10,57,93,65,215,3,0
1839,3/31/2018 9:15,59,97,68,224,3,0
1840,3/31/2018 9:20,62,101,71,234,3,0
1841,3/31/2018 9:25,62,101,71,234,3,0
1842,3/31/2018 9:30,64,105,74,243,3,0
1843,3/31/2018 9:35,65,105,74,244,3,0
1844,3/31/2018 9:40,67,109,76,252,3,0
1845,3/31/2018 9:45,68,111,78,257,3,0
1846,3/31/2018 9:50,66,107,75,248,3,0
1847,3/31/2018 9:55,64,104,73,241,3,0
1848,3/31/2018 10:00,65,105,74,244,3,0
1849,3/31/2018 10:05,65,106,75,246,3,0
1850,3/31/2018 10:10,66,107,75,248,3,0
1851,3/31/2018 10:15,66,107,75,248,3,0
1852,3/31/2018 10:20,66,107,75,248,3,0
1853,3/31/2018 10:25,66,108,76,250,3,0
1854,3/31/2018 10:30,68,111,78,257,3,0
1855,3/31/2018 10:35,70,113,79,262,3,0
1856,3/31/2018 10:40,70,113,80,263,3,0
1857,3/31/2018 10:45,70,114,80,264,3,0
1858,3/31/2018 10:50,71,115,81,267,3,0
1859,3/31/2018 10:55,69,113,79,261,3,0
1860,3/31/2018 11:00,69,113,79,261,3,0
1861,3/31/2018 11:05,70,114,80,264,3,0
1862,3/31/2018 11:10,71,116,82,269,3,0
1863,3/31/2018 11:15,72,117,82,271,3,0
1864,3/31/2018 11:20,72,118,83,273,3,0
1865,3/31/2018 11:25,72,117,82,271,3,0
1866,3/31/2018 11:30,73,118,83,274,3,0
1867,3/31/2018 11:35,74,120,85,279,3,0
1868,3/31/2018 11:40,73,119,84,276,3,0
1869,3/31/2018 11:45,74,120,84,278,3,0
1870,3/31/2018 11:50,74,120,85,279,3,0
1871,3/31/2018 11:55,73,118,83,274,3,0
