,5 Minutes,Lane 1 Flow (Veh/5 Minutes),Lane 2 Flow (Veh/5 Minutes),Lane 3 Flow (Veh/5 Minutes),Lane 4 Flow (Veh/5 Minutes),Flow (Veh/5 Minutes),# Lane Points,% Observed
0,3/01/2018 0:00,26,49,26,21,122,4,50
1,3/01/2018 0:05,23,30,26,21,100,4,50
2,3/01/2018 0:10,26,28,27,22,103,4,50
3,3/01/2018 0:15,15,32,31,25,103,4,50
4,3/01/2018 0:20,22,33,20,15,90,4,50
5,3/01/2018 0:25,19,26,23,17,85,4,50
6,3/01/2018 0:30,14,28,27,21,90,4,50
7,3/01/2018 0:35,15,26,22,16,79,4,50
8,3/01/2018 0:40,6,20,22,16,64,4,50
9,3/01/2018 0:45,20,24,19,14,77,4,50
10,3/01/2018 0:50,14,18,16,10,58,4,50
11,3/01/2018 0:55,15,21,17,12,65,4,50
12,3/01/2018 1:00,10,23,21,16,70,4,50
13,3/01/2018 1:05,9,19,17,12,57,4,50
14,3/01/2018 1:10,6,15,13,8,42,4,50
15,3/01/2018 1:15,9,15,18,13,55,4,50
16,3/01/2018 1:20,9,15,18,13,55,4,50
17,3/01/2018 1:25,5,10,17,12,44,4,50
18,3/01/2018 1:30,11,12,18,13,54,4,50
19,3/01/2018 1:35,5,18,16,11,50,4,50
20,3/01/2018 1:40,5,13,17,12,47,4,50
21,3/01/2018 1:45,7,22,17,12,58,4,50
22,3/01/2018 1:50,8,9,17,12,46,4,50
23,3/01/2018 1:55,3,17,16,11,47,4,50
24,3/01/2018 2:00,4,13,15,9,41,4,50
25,3/01/2018 2:05,2,12,15,9,38,4,50
26,3/01/2018 2:10,7,24,17,12,60,4,50
27,3/01/2018 2:15,5,10,12,8,35,4,50
28,3/01/2018 2:20,11,12,16,11,50,4,50
29,3/01/2018 2:25,7,12,12,7,38,4,50
30,3/01/2018 2:30,9,20,19,14,62,4,50
31,3/01/2018 2:35,8,20,15,10,53,4,50
32,3/01/2018 2:40,9,12,16,11,48,4,50
33,3/01/2018 2:45,9,10,15,10,44,4,50
34,3/01/2018 2:50,6,15,17,11,49,4,50
35,3/01/2018 2:55,8,15,16,11,50,4,50
36,3/01/2018 3:00,7,14,17,12,50,4,50
37,3/01/2018 3:05,9,11,15,9,44,4,50
38,3/01/2018 3:10,9,13,15,10,47,4,50
39,3/01/2018 3:15,5,13,12,8,38,4,50
40,3/01/2018 3:20,7,18,18,13,56,4,50
41,3/01/2018 3:25,9,18,19,14,60,4,50
42,3/01/2018 3:30,10,16,14,8,48,4,50
43,3/01/2018 3:35,15,22,22,17,76,4,50
44,3/01/2018 3:40,12,20,19,14,65,4,50
45,3/01/2018 3:45,14,22,24,18,78,4,50
46,3/01/2018 3:50,10,20,20,14,64,4,50
47,3/01/2018 3:55,16,15,23,18,72,4,50
48,3/01/2018 4:00,10,22,24,19,75,4,50
49,3/01/2018 4:05,16,25,29,23,93,4,50
50,3/01/2018 4:10,23,30,33,27,113,4,50
51,3/01/2018 4:15,30,30,36,30,126,4,50
52,3/01/2018 4:20,37,36,34,28,135,4,50
53,3/01/2018 4:25,33,50,35,29,147,4,50
54,3/01/2018 4:30,36,47,49,42,174,4,50
55,3/01/2018 4:35,39,44,43,36,162,4,50
56,3/01/2018 4:40,64,53,46,40,203,4,50
57,3/01/2018 4:45,56,61,53,47,217,4,50
58,3/01/2018 4:50,43,54,48,41,186,4,50
59,3/01/2018 4:55,57,56,55,47,215,4,50
60,3/01/2018 5:00,56,61,53,46,216,4,50
61,3/01/2018 5:05,74,80,52,45,251,4,50
62,3/01/2018 5:10,73,77,62,55,267,4,50
63,3/01/2018 5:15,98,88,67,59,312,4,50
64,3/01/2018 5:20,92,89,59,52,292,4,50
65,3/01/2018 5:25,112,94,74,66,346,4,50
66,3/01/2018 5:30,120,103,82,73,378,4,50
67,3/01/2018 5:35,114,99,80,72,365,4,50
68,3/01/2018 5:40,106,102,83,75,366,4,50
69,3/01/2018 5:45,114,107,89,80,390,4,50
70,3/01/2018 5:50,120,110,90,81,401,4,50
71,3/01/2018 5:55,117,113,87,78,395,4,50
72,3/01/2018 6:00,125,113,81,73,392,4,50
73,3/01/2018 6:05,137,118,73,65,393,4,50
74,3/01/2018 6:10,134,101,91,82,408,4,50
75,3/01/2018 6:15,140,109,94,85,428,4,50
76,3/01/2018 6:20,144,114,100,91,449,4,50
77,3/01/2018 6:25,130,123,90,81,424,4,50
78,3/01/2018 6:30,153,124,100,90,467,4,50
79,3/01/2018 6:35,151,140,98,88,477,4,50
80,3/01/2018 6:40,167,156,96,86,505,4,50
81,3/01/2018 6:45,167,152,116,105,540,4,50
82,3/01/2018 6:50,150,138,99,90,477,4,50
83,3/01/2018 6:55,134,131,102,92,459,4,50
84,3/01/2018 7:00,141,132,102,93,468,4,50
85,3/01/2018 7:05,156,133,106,96,491,4,50
86,3/01/2018 7:10,162,148,112,101,523,4,50
87,3/01/2018 7:15,163,146,114,103,526,4,50
88,3/01/2018 7:20,161,130,110,100,501,4,50
89,3/01/2018 7:25,155,155,113,103,526,4,50
90,3/01/2018 7:30,162,137,117,107,523,4,50
91,3/01/2018 7:35,162,147,117,106,532,4,50
92,3/01/2018 7:40,130,127,99,90,446,4,50
93,3/01/2018 7:45,130,135,106,97,468,4,50
94,3/01/2018 7:50,144,138,99,90,471,4,50
95,3/01/2018 7:55,130,133,106,97,466,4,50
96,3/01/2018 8:00,153,139,112,102,506,4,50
97,3/01/2018 8:05,144,144,104,94,486,4,50
98,3/01/2018 8:10,145,141,93,84,463,4,50
99,3/01/2018 8:15,156,141,108,98,503,4,50
100,3/01/2018 8:20,146,143,95,86,470,4,50
101,3/01/2018 8:25,159,139,100,90,488,4,50
102,3/01/2018 8:30,155,139,109,99,502,4,50
103,3/01/2018 8:35,153,147,95,86,481,4,50
104,3/01/2018 8:40,150,144,112,101,507,4,50
105,3/01/2018 8:45,155,139,93,84,471,4,50
106,3/01/2018 8:50,141,142,98,88,469,4,50
107,3/01/2018 8:55,159,143,107,97,506,4,50
108,3/01/2018 9:00,133,119,85,77,414,4,50
109,3/01/2018 9:05,118,119,85,77,399,4,50
110,3/01/2018 9:10,129,132,79,70,410,4,50
111,3/01/2018 9:15,124,134,82,74,414,4,50
112,3/01/2018 9:20,136,126,86,77,425,4,50
113,3/01/2018 9:25,114,124,93,84,415,4,50
114,3/01/2018 9:30,97,103,73,65,338,4,50
115,3/01/2018 9:35,83,96,68,60,307,4,50
116,3/01/2018 9:40,109,98,75,67,349,4,50
117,3/01/2018 9:45,124,107,81,73,385,4,50
118,3/01/2018 9:50,141,118,73,65,397,4,50
119,3/01/2018 9:55,126,116,88,79,409,4,50
120,3/01/2018 10:00,123,113,86,77,399,4,50
121,3/01/2018 10:05,115,109,87,79,390,4,50
122,3/01/2018 10:10,117,100,88,79,384,4,50
123,3/01/2018 10:15,117,115,90,81,403,4,50
124,3/01/2018 10:20,117,119,85,76,397,4,50
125,3/01/2018 10:25,130,121,80,72,403,4,50
126,3/01/2018 10:30,112,107,90,81,390,4,50
127,3/01/2018 10:35,131,133,100,90,454,4,50
128,3/01/2018 10:40,111,109,82,73,375,4,50
129,3/01/2018 10:45,108,106,87,78,379,4,50
130,3/01/2018 10:50,114,109,79,70,372,4,50
131,3/01/2018 10:55,116,110,86,77,389,4,50
132,3/01/2018 11:00,108,103,78,70,359,4,50
133,3/01/2018 11:05,99,92,78,70,339,4,50
134,3/01/2018 11:10,110,116,86,77,389,4,50
135,3/01/2018 11:15,109,111,69,62,351,4,50
136,3/01/2018 11:20,133,123,82,74,412,4,50
137,3/01/2018 11:25,126,116,94,85,421,4,50
138,3/01/2018 11:30,113,120,85,76,394,4,50
139,3/01/2018 11:35,132,121,88,79,420,4,50
140,3/01/2018 11:40,130,111,85,76,402,4,50
141,3/01/2018 11:45,117,108,81,73,379,4,50
142,3/01/2018 11:50,123,106,78,70,377,4,50
143,3/01/2018 11:55,122,114,75,66,377,4,50
144,3/01/2018 12:00,133,110,79,70,392,4,50
145,3/01/2018 12:05,105,103,82,73,363,4,50
146,3/01/2018 12:10,120,101,75,66,362,4,50
147,3/01/2018 12:15,106,107,71,63,347,4,50
148,3/01/2018 12:20,114,111,88,79,392,4,50
149,3/01/2018 12:25,103,119,75,67,364,4,50
150,3/01/2018 12:30,112,117,83,75,387,4,50
151,3/01/2018 12:35,106,108,81,72,367,4,50
152,3/01/2018 12:40,103,106,77,68,354,4,50
153,3/01/2018 12:45,101,119,82,73,375,4,50
154,3/01/2018 12:50,106,99,72,64,341,4,50
155,3/01/2018 12:55,116,108,76,68,368,4,50
156,3/01/2018 13:00,124,115,89,81,409,4,50
157,3/01/2018 13:05,117,124,80,71,392,4,50
158,3/01/2018 13:10,113,118,93,84,408,4,50
159,3/01/2018 13:15,124,121,81,73,399,4,50
160,3/01/2018 13:20,114,105,89,80,388,4,50
161,3/01/2018 13:25,133,116,89,80,418,4,50
162,3/01/2018 13:30,118,108,88,79,393,4,50
163,3/01/2018 13:35,120,128,85,76,409,4,50
164,3/01/2018 13:40,136,139,97,88,460,4,50
165,3/01/2018 13:45,119,108,85,77,389,4,50
166,3/01/2018 13:50,113,99,88,79,379,4,50
167,3/01/2018 13:55,121,103,89,80,393,4,50
168,3/01/2018 14:00,118,130,87,78,413,4,50
169,3/01/2018 14:05,98,99,87,78,362,4,50
170,3/01/2018 14:10,128,114,91,82,415,4,50
171,3/01/2018 14:15,110,102,89,81,382,4,50
172,3/01/2018 14:20,133,124,91,82,430,4,50
173,3/01/2018 14:25,142,135,101,91,469,4,50
174,3/01/2018 14:30,128,114,96,87,425,4,50
175,3/01/2018 14:35,122,129,89,80,420,4,50
176,3/01/2018 14:40,153,136,107,97,493,4,50
177,3/01/2018 14:45,156,130,101,91,478,4,50
178,3/01/2018 14:50,137,116,94,85,432,4,50
179,3/01/2018 14:55,146,133,88,79,446,4,50
180,3/01/2018 15:00,119,116,86,77,398,4,50
181,3/01/2018 15:05,129,133,104,94,460,4,50
182,3/01/2018 15:10,150,133,101,91,475,4,50
183,3/01/2018 15:15,152,141,104,94,491,4,50
184,3/01/2018 15:20,149,117,102,93,461,4,50
185,3/01/2018 15:25,150,127,106,96,479,4,50
186,3/01/2018 15:30,155,139,97,88,479,4,50
187,3/01/2018 15:35,152,144,112,101,509,4,50
188,3/01/2018 15:40,142,129,103,93,467,4,50
189,3/01/2018 15:45,147,139,100,90,476,4,50
190,3/01/2018 15:50,139,147,114,103,503,4,50
191,3/01/2018 15:55,148,136,111,101,496,4,50
192,3/01/2018 16:00,160,134,111,102,507,4,50
193,3/01/2018 16:05,156,131,112,102,501,4,50
194,3/01/2018 16:10,153,133,104,94,484,4,50
195,3/01/2018 16:15,151,143,97,88,479,4,50
196,3/01/2018 16:20,155,156,111,101,523,4,50
197,3/01/2018 16:25,165,139,117,107,528,4,50
198,3/01/2018 16:30,159,136,115,105,515,4,50
199,3/01/2018 16:35,151,160,114,103,528,4,50
200,3/01/2018 16:40,157,124,107,98,486,4,50
201,3/01/2018 16:45,167,143,113,103,526,4,50
202,3/01/2018 16:50,149,140,116,106,511,4,50
203,3/01/2018 16:55,148,146,114,104,512,4,50
204,3/01/2018 17:00,158,142,111,102,513,4,50
205,3/01/2018 17:05,146,134,108,98,486,4,50
206,3/01/2018 17:10,143,131,104,95,473,4,50
207,3/01/2018 17:15,144,152,118,107,521,4,50
208,3/01/2018 17:20,146,143,115,105,509,4,50
209,3/01/2018 17:25,168,139,96,86,489,4,50
210,3/01/2018 17:30,159,129,111,101,500,4,50
211,3/01/2018 17:35,153,129,107,97,486,4,50
212,3/01/2018 17:40,155,149,107,97,508,4,50
213,3/01/2018 17:45,147,150,109,99,505,4,50
214,3/01/2018 17:50,162,146,106,96,510,4,50
215,3/01/2018 17:55,147,150,111,101,509,4,50
216,3/01/2018 18:00,139,130,106,97,472,4,50
217,3/01/2018 18:05,140,136,107,98,481,4,50
218,3/01/2018 18:10,143,134,107,98,482,4,50
219,3/01/2018 18:15,151,143,119,108,521,4,50
220,3/01/2018 18:20,134,138,96,87,455,4,50
221,3/01/2018 18:25,127,130,95,86,438,4,50
222,3/01/2018 18:30,123,140,98,89,450,4,50
223,3/01/2018 18:35,130,109,97,87,423,4,50
224,3/01/2018 18:40,128,135,96,87,446,4,50
225,3/01/2018 18:45,123,120,90,81,414,4,50
226,3/01/2018 18:50,114,120,85,76,395,4,50
227,3/01/2018 18:55,103,103,92,83,381,4,50
228,3/01/2018 19:00,121,102,85,77,385,4,50
229,3/01/2018 19:05,109,100,90,81,380,4,50
230,3/01/2018 19:10,103,123,90,81,397,4,50
231,3/01/2018 19:15,107,105,86,78,376,4,50
232,3/01/2018 19:20,123,119,85,76,403,4,50
233,3/01/2018 19:25,112,92,84,76,364,4,50
234,3/01/2018 19:30,98,90,83,74,345,4,50
235,3/01/2018 19:35,85,97,86,77,345,4,50
236,3/01/2018 19:40,79,81,77,68,305,4,50
237,3/01/2018 19:45,94,91,80,71,336,4,50
238,3/01/2018 19:50,93,109,88,79,369,4,50
239,3/01/2018 19:55,98,86,80,72,336,4,50
240,3/01/2018 20:00,77,88,81,73,319,4,50
241,3/01/2018 20:05,81,82,77,69,309,4,50
242,3/01/2018 20:10,73,98,82,74,327,4,50
243,3/01/2018 20:15,86,91,81,72,330,4,50
244,3/01/2018 20:20,82,86,81,66,315,4,0
245,3/01/2018 20:25,84,89,78,64,315,4,0
246,3/01/2018 20:30,81,81,77,63,302,4,0
247,3/01/2018 20:35,73,85,75,61,294,4,0
248,3/01/2018 20:40,81,86,74,61,302,4,0
249,3/01/2018 20:45,73,85,73,60,291,4,0
250,3/01/2018 20:50,97,87,55,47,286,4,50
251,3/01/2018 20:55,71,91,60,53,275,4,50
252,3/01/2018 21:00,80,69,45,39,233,4,50
253,3/01/2018 21:05,69,81,59,51,260,4,50
254,3/01/2018 21:10,63,74,61,54,252,4,50
255,3/01/2018 21:15,75,77,62,55,269,4,50
256,3/01/2018 21:20,67,82,62,55,266,4,50
257,3/01/2018 21:25,73,80,65,57,275,4,50
258,3/01/2018 21:30,71,76,73,59,279,4,0
259,3/01/2018 21:35,40,65,67,59,231,4,50
260,3/01/2018 21:40,68,80,61,54,263,4,50
261,3/01/2018 21:45,68,72,59,51,250,4,50
262,3/01/2018 21:50,68,74,59,52,253,4,50
263,3/01/2018 21:55,49,66,64,56,235,4,50
264,3/01/2018 22:00,43,60,54,47,204,4,50
265,3/01/2018 22:05,57,75,52,45,229,4,50
266,3/01/2018 22:10,68,57,55,48,228,4,50
267,3/01/2018 22:15,56,67,54,47,224,4,50
268,3/01/2018 22:20,49,69,45,38,201,4,50
269,3/01/2018 22:25,59,51,55,48,213,4,50
270,3/01/2018 22:30,42,60,53,47,202,4,50
271,3/01/2018 22:35,51,51,50,43,195,4,50
272,3/01/2018 22:40,47,67,50,43,207,4,50
273,3/01/2018 22:45,48,48,42,36,174,4,50
274,3/01/2018 22:50,47,56,44,38,185,4,50
275,3/01/2018 22:55,27,49,47,40,163,4,50
276,3/01/2018 23:00,34,45,39,33,151,4,50
277,3/01/2018 23:05,31,49,38,32,150,4,50
278,3/01/2018 23:10,35,41,39,32,147,4,50
279,3/01/2018 23:15,27,48,37,31,143,4,50
280,3/01/2018 23:20,36,39,35,29,139,4,50
281,3/01/2018 23:25,35,48,34,28,145,4,50
282,3/01/2018 23:30,25,45,37,30,137,4,50
283,3/01/2018 23:35,21,44,35,29,129,4,50
284,3/01/2018 23:40,31,40,38,32,141,4,50
285,3/01/2018 23:45,24,48,28,23,123,4,50
286,3/01/2018 23:50,26,40,37,31,134,4,50
287,3/01/2018 23:55,31,34,29,23,117,4,50
288,3/02/2018 0:00,30,34,26,20,110,4,50
289,3/02/2018 0:05,11,28,34,28,101,4,50
290,3/02/2018 0:10,21,33,28,22,104,4,50
291,3/02/2018 0:15,21,34,27,21,103,4,50
292,3/02/2018 0:20,16,22,28,22,88,4,50
293,3/02/2018 0:25,13,24,25,20,82,4,50
294,3/02/2018 0:30,18,22,27,21,88,4,50
295,3/02/2018 0:35,9,21,26,21,77,4,50
296,3/02/2018 0:40,11,30,24,18,83,4,50
297,3/02/2018 0:45,15,16,30,23,84,4,50
298,3/02/2018 0:50,9,23,22,17,71,4,50
299,3/02/2018 0:55,4,26,24,18,72,4,50
300,3/02/2018 1:00,11,13,24,18,66,4,50
301,3/02/2018 1:05,17,25,20,15,77,4,50
302,3/02/2018 1:10,8,12,19,13,52,4,50
303,3/02/2018 1:15,10,17,16,11,54,4,50
304,3/02/2018 1:20,11,14,19,14,58,4,50
305,3/02/2018 1:25,8,16,17,11,52,4,50
306,3/02/2018 1:30,8,18,19,13,58,4,50
307,3/02/2018 1:35,8,21,14,9,52,4,50
308,3/02/2018 1:40,6,21,21,15,63,4,50
309,3/02/2018 1:45,10,17,15,9,51,4,50
310,3/02/2018 1:50,7,15,19,13,54,4,50
311,3/02/2018 1:55,6,19,12,7,44,4,50
312,3/02/2018 2:00,7,18,16,12,53,4,50
313,3/02/2018 2:05,9,18,16,11,54,4,50
314,3/02/2018 2:10,10,22,17,12,61,4,50
315,3/02/2018 2:15,2,16,14,9,41,4,50
316,3/02/2018 2:20,3,15,15,10,43,4,50
317,3/02/2018 2:25,7,16,16,11,50,4,50
318,3/02/2018 2:30,10,11,17,12,50,4,50
319,3/02/2018 2:35,7,6,16,11,40,4,50
320,3/02/2018 2:40,9,19,19,14,61,4,50
321,3/02/2018 2:45,8,15,20,15,58,4,50
322,3/02/2018 2:50,9,15,15,10,49,4,50
323,3/02/2018 2:55,6,12,15,9,42,4,50
324,3/02/2018 3:00,6,14,10,5,35,4,50
325,3/02/2018 3:05,6,15,16,11,48,4,50
326,3/02/2018 3:10,6,15,16,11,48,4,50
327,3/02/2018 3:15,10,17,21,15,63,4,50
328,3/02/2018 3:20,8,16,15,10,49,4,50
329,3/02/2018 3:25,14,16,16,11,57,4,50
330,3/02/2018 3:30,15,20,21,15,71,4,50
331,3/02/2018 3:35,10,17,18,13,58,4,50
332,3/02/2018 3:40,10,20,21,16,67,4,50
333,3/02/2018 3:45,16,22,20,15,73,4,50
334,3/02/2018 3:50,14,23,20,15,72,4,50
335,3/02/2018 3:55,11,18,19,13,61,4,50
336,3/02/2018 4:00,19,26,22,17,84,4,50
337,3/02/2018 4:05,14,19,24,19,76,4,50
338,3/02/2018 4:10,26,24,25,19,94,4,50
339,3/02/2018 4:15,15,34,37,31,117,4,50
340,3/02/2018 4:20,37,36,38,32,143,4,50
341,3/02/2018 4:25,39,36,41,35,151,4,50
342,3/02/2018 4:30,37,41,37,31,146,4,50
343,3/02/2018 4:35,41,33,43,37,154,4,50
344,3/02/2018 4:40,42,59,45,38,184,4,50
345,3/02/2018 4:45,51,49,51,44,195,4,50
346,3/02/2018 4:50,41,56,45,38,180,4,50
347,3/02/2018 4:55,43,50,45,39,177,4,50
348,3/02/2018 5:00,38,42,43,37,160,4,50
349,3/02/2018 5:05,65,56,56,49,226,4,50
350,3/02/2018 5:10,77,82,56,49,264,4,50
351,3/02/2018 5:15,87,77,59,51,274,4,50
352,3/02/2018 5:20,94,89,71,63,317,4,50
353,3/02/2018 5:25,91,81,77,68,317,4,50
354,3/02/2018 5:30,96,90,77,68,331,4,50
355,3/02/2018 5:35,118,95,85,76,374,4,50
356,3/02/2018 5:40,99,84,79,70,332,4,50
357,3/02/2018 5:45,114,114,77,68,373,4,50
358,3/02/2018 5:50,109,106,82,74,371,4,50
359,3/02/2018 5:55,108,106,89,80,383,4,50
360,3/02/2018 6:00,111,99,85,77,372,4,50
361,3/02/2018 6:05,117,97,80,72,366,4,50
362,3/02/2018 6:10,123,100,84,76,383,4,50
363,3/02/2018 6:15,120,98,88,79,385,4,50
364,3/02/2018 6:20,138,120,75,66,399,4,50
365,3/02/2018 6:25,144,107,95,86,432,4,50
366,3/02/2018 6:30,137,122,90,81,430,4,50
367,3/02/2018 6:35,142,122,96,87,447,4,50
368,3/02/2018 6:40,149,129,99,90,467,4,50
369,3/02/2018 6:45,154,133,88,79,454,4,50
370,3/02/2018 6:50,154,119,101,92,466,4,50
371,3/02/2018 6:55,130,128,79,70,407,4,50
372,3/02/2018 7:00,127,112,99,89,427,4,50
373,3/02/2018 7:05,151,128,93,84,456,4,50
374,3/02/2018 7:10,142,127,105,96,470,4,50
375,3/02/2018 7:15,143,132,99,90,464,4,50
376,3/02/2018 7:20,126,121,104,95,446,4,50
377,3/02/2018 7:25,147,128,101,92,468,4,50
378,3/02/2018 7:30,125,126,109,99,459,4,50
379,3/02/2018 7:35,138,131,98,89,456,4,50
380,3/02/2018 7:40,133,134,110,100,477,4,50
381,3/02/2018 7:45,129,110,96,87,422,4,50
382,3/02/2018 7:50,109,122,85,77,393,4,50
383,3/02/2018 7:55,121,129,93,84,427,4,50
384,3/02/2018 8:00,135,119,99,90,443,4,50
385,3/02/2018 8:05,119,115,91,82,407,4,50
386,3/02/2018 8:10,121,126,102,93,442,4,50
387,3/02/2018 8:15,137,123,96,87,443,4,50
388,3/02/2018 8:20,127,123,98,88,436,4,50
389,3/02/2018 8:25,133,140,94,85,452,4,50
390,3/02/2018 8:30,136,131,91,82,440,4,50
391,3/02/2018 8:35,128,116,102,92,438,4,50
392,3/02/2018 8:40,145,135,88,79,447,4,50
393,3/02/2018 8:45,130,121,96,86,433,4,50
394,3/02/2018 8:50,120,125,95,86,426,4,50
395,3/02/2018 8:55,132,110,88,79,409,4,50
396,3/02/2018 9:00,108,113,88,79,388,4,50
397,3/02/2018 9:05,99,106,76,68,349,4,50
398,3/02/2018 9:10,106,111,80,71,368,4,50
399,3/02/2018 9:15,107,102,89,81,379,4,50
400,3/02/2018 9:20,119,90,81,73,363,4,50
401,3/02/2018 9:25,106,96,85,76,363,4,50
402,3/02/2018 9:30,112,103,79,70,364,4,50
403,3/02/2018 9:35,117,108,84,75,384,4,50
404,3/02/2018 9:40,109,110,88,79,386,4,50
405,3/02/2018 9:45,109,97,83,74,363,4,50
406,3/02/2018 9:50,117,108,84,76,385,4,50
407,3/02/2018 9:55,115,97,80,72,364,4,50
408,3/02/2018 10:00,98,99,75,67,339,4,50
409,3/02/2018 10:05,117,103,79,70,369,4,50
410,3/02/2018 10:10,121,106,77,69,373,4,50
411,3/02/2018 10:15,131,116,79,70,396,4,50
412,3/02/2018 10:20,116,110,84,75,385,4,50
413,3/02/2018 10:25,116,101,77,68,362,4,50
414,3/02/2018 10:30,110,102,75,66,353,4,50
415,3/02/2018 10:35,97,98,73,65,333,4,50
416,3/02/2018 10:40,103,107,77,69,356,4,50
417,3/02/2018 10:45,116,108,80,72,376,4,50
418,3/02/2018 10:50,109,97,87,79,372,4,50
419,3/02/2018 10:55,99,108,85,76,368,4,50
420,3/02/2018 11:00,113,106,65,57,341,4,50
421,3/02/2018 11:05,93,103,75,67,338,4,50
422,3/02/2018 11:10,90,94,78,70,332,4,50
423,3/02/2018 11:15,116,103,80,71,370,4,50
424,3/02/2018 11:20,124,109,68,60,361,4,50
425,3/02/2018 11:25,92,88,77,68,325,4,50
426,3/02/2018 11:30,89,100,77,69,335,4,50
427,3/02/2018 11:35,101,115,81,73,370,4,50
428,3/02/2018 11:40,108,97,69,62,336,4,50
429,3/02/2018 11:45,91,99,76,68,334,4,50
430,3/02/2018 11:50,107,121,91,82,401,4,50
431,3/02/2018 11:55,112,109,80,72,373,4,50
432,3/02/2018 12:00,103,99,84,75,361,4,50
433,3/02/2018 12:05,104,103,78,70,355,4,50
434,3/02/2018 12:10,107,97,77,69,350,4,50
435,3/02/2018 12:15,99,112,81,73,365,4,50
436,3/02/2018 12:20,99,94,86,77,356,4,50
437,3/02/2018 12:25,94,106,79,70,349,4,50
438,3/02/2018 12:30,103,96,87,78,364,4,50
439,3/02/2018 12:35,113,108,68,60,349,4,50
440,3/02/2018 12:40,99,93,69,62,323,4,50
441,3/02/2018 12:45,108,108,87,78,381,4,50
442,3/02/2018 12:50,99,114,86,77,376,4,50
443,3/02/2018 12:55,106,101,76,68,351,4,50
444,3/02/2018 13:00,110,115,93,84,402,4,50
445,3/02/2018 13:05,91,100,80,71,342,4,50
446,3/02/2018 13:10,99,101,82,73,355,4,50
447,3/02/2018 13:15,113,112,85,77,387,4,50
448,3/02/2018 13:20,125,117,79,70,391,4,50
449,3/02/2018 13:25,122,100,89,80,391,4,50
450,3/02/2018 13:30,106,110,86,77,379,4,50
451,3/02/2018 13:35,109,109,87,78,383,4,50
452,3/02/2018 13:40,131,129,93,84,437,4,50
453,3/02/2018 13:45,114,134,96,87,431,4,50
454,3/02/2018 13:50,142,124,97,88,451,4,50
455,3/02/2018 13:55,113,108,96,87,404,4,50
456,3/02/2018 14:00,123,130,91,82,426,4,50
457,3/02/2018 14:05,135,130,100,91,456,4,50
458,3/02/2018 14:10,149,119,100,90,458,4,50
459,3/02/2018 14:15,124,123,101,91,439,4,50
460,3/02/2018 14:20,114,109,91,82,396,4,50
461,3/02/2018 14:25,143,111,96,86,436,4,50
462,3/02/2018 14:30,132,118,97,88,435,4,50
463,3/02/2018 14:35,133,126,93,84,436,4,50
464,3/02/2018 14:40,136,130,94,85,445,4,50
465,3/02/2018 14:45,149,137,97,88,471,4,50
466,3/02/2018 14:50,149,124,103,93,469,4,50
467,3/02/2018 14:55,139,127,98,89,453,4,50
468,3/02/2018 15:00,141,140,109,99,489,4,50
469,3/02/2018 15:05,133,137,90,81,441,4,50
470,3/02/2018 15:10,151,132,104,94,481,4,50
471,3/02/2018 15:15,150,136,105,96,487,4,50
472,3/02/2018 15:20,127,118,93,84,422,4,50
473,3/02/2018 15:25,145,144,108,98,495,4,50
474,3/02/2018 15:30,136,129,111,101,477,4,50
475,3/02/2018 15:35,161,135,104,94,494,4,50
476,3/02/2018 15:40,139,135,115,105,494,4,50
477,3/02/2018 15:45,136,126,108,98,468,4,50
478,3/02/2018 15:50,148,130,91,82,451,4,50
479,3/02/2018 15:55,149,133,98,88,468,4,50
480,3/02/2018 16:00,144,133,93,84,454,4,50
481,3/02/2018 16:05,151,131,109,99,490,4,50
482,3/02/2018 16:10,140,128,103,93,464,4,50
483,3/02/2018 16:15,125,123,97,88,433,4,50
484,3/02/2018 16:20,140,121,99,90,450,4,50
485,3/02/2018 16:25,111,118,96,87,412,4,50
486,3/02/2018 16:30,122,117,94,85,418,4,50
487,3/02/2018 16:35,129,143,93,84,449,4,50
488,3/02/2018 16:40,123,117,93,84,417,4,50
489,3/02/2018 16:45,104,109,97,87,397,4,50
490,3/02/2018 16:50,124,127,94,85,430,4,50
491,3/02/2018 16:55,121,112,99,89,421,4,50
492,3/02/2018 17:00,121,118,96,86,421,4,50
493,3/02/2018 17:05,131,137,101,92,461,4,50
494,3/02/2018 17:10,131,109,91,82,413,4,50
495,3/02/2018 17:15,126,120,93,84,423,4,50
496,3/02/2018 17:20,133,128,89,80,430,4,50
497,3/02/2018 17:25,131,118,85,76,410,4,50
498,3/02/2018 17:30,116,119,91,82,408,4,50
499,3/02/2018 17:35,129,132,89,80,430,4,50
500,3/02/2018 17:40,128,125,93,84,430,4,50
501,3/02/2018 17:45,107,118,93,84,402,4,50
502,3/02/2018 17:50,119,108,96,87,410,4,50
503,3/02/2018 17:55,110,90,83,74,357,4,50
504,3/02/2018 18:00,130,120,92,83,425,4,50
505,3/02/2018 18:05,116,114,94,85,409,4,50
506,3/02/2018 18:10,108,106,94,85,393,4,50
507,3/02/2018 18:15,111,105,92,83,391,4,50
508,3/02/2018 18:20,93,98,86,77,354,4,50
509,3/02/2018 18:25,110,98,84,75,367,4,50
510,3/02/2018 18:30,106,94,80,71,351,4,50
511,3/02/2018 18:35,103,107,80,71,361,4,50
512,3/02/2018 18:40,108,104,87,78,377,4,50
513,3/02/2018 18:45,101,102,87,78,368,4,50
514,3/02/2018 18:50,104,99,85,76,364,4,50
515,3/02/2018 18:55,106,98,80,72,356,4,50
516,3/02/2018 19:00,106,104,80,71,361,4,50
517,3/02/2018 19:05,85,96,78,70,329,4,50
518,3/02/2018 19:10,102,110,90,81,383,4,50
519,3/02/2018 19:15,118,103,92,83,396,4,50
520,3/02/2018 19:20,119,103,88,79,389,4,50
521,3/02/2018 19:25,91,94,76,68,329,4,50
522,3/02/2018 19:30,99,93,84,76,352,4,50
523,3/02/2018 19:35,91,107,82,73,353,4,50
524,3/02/2018 19:40,102,103,88,79,372,4,50
525,3/02/2018 19:45,99,114,90,81,384,4,50
526,3/02/2018 19:50,101,104,84,75,364,4,50
527,3/02/2018 19:55,108,90,77,68,343,4,50
528,3/02/2018 20:00,91,89,77,68,325,4,50
529,3/02/2018 20:05,63,87,79,70,299,4,50
530,3/02/2018 20:10,84,94,78,70,326,4,50
531,3/02/2018 20:15,98,95,78,70,341,4,50
532,3/02/2018 20:20,87,82,77,68,314,4,50
533,3/02/2018 20:25,86,96,78,70,330,4,50
534,3/02/2018 20:30,84,87,78,70,319,4,50
535,3/02/2018 20:35,90,77,56,48,271,4,50
536,3/02/2018 20:40,68,92,62,55,277,4,50
537,3/02/2018 20:45,83,93,62,55,293,4,50
538,3/02/2018 20:50,73,56,59,51,239,4,50
539,3/02/2018 20:55,81,87,64,56,288,4,50
540,3/02/2018 21:00,76,78,60,53,267,4,50
541,3/02/2018 21:05,83,96,57,50,286,4,50
542,3/02/2018 21:10,73,79,74,66,292,4,50
543,3/02/2018 21:15,68,82,62,55,267,4,50
544,3/02/2018 21:20,71,77,67,59,274,4,50
545,3/02/2018 21:25,68,79,64,56,267,4,50
546,3/02/2018 21:30,57,74,60,53,244,4,50
547,3/02/2018 21:35,63,73,61,53,250,4,50
548,3/02/2018 21:40,57,67,65,57,246,4,50
549,3/02/2018 21:45,54,64,61,53,232,4,50
550,3/02/2018 21:50,70,76,65,58,269,4,50
551,3/02/2018 21:55,57,63,56,49,225,4,50
552,3/02/2018 22:00,63,67,59,52,241,4,50
553,3/02/2018 22:05,58,78,62,54,252,4,50
554,3/02/2018 22:10,61,57,58,51,227,4,50
555,3/02/2018 22:15,69,75,59,51,254,4,50
556,3/02/2018 22:20,65,73,67,60,265,4,50
557,3/02/2018 22:25,58,66,60,52,236,4,50
558,3/02/2018 22:30,49,64,49,42,204,4,50
559,3/02/2018 22:35,64,66,50,44,224,4,50
560,3/02/2018 22:40,55,60,51,43,209,4,50
561,3/02/2018 22:45,52,65,58,51,226,4,50
562,3/02/2018 22:50,39,51,47,40,177,4,50
563,3/02/2018 22:55,53,69,50,43,215,4,50
564,3/02/2018 23:00,51,62,53,47,213,4,50
565,3/02/2018 23:05,49,66,45,38,198,4,50
566,3/02/2018 23:10,43,51,54,47,195,4,50
567,3/02/2018 23:15,33,45,45,38,161,4,50
568,3/02/2018 23:20,39,39,50,43,171,4,50
569,3/02/2018 23:25,41,39,45,38,163,4,50
570,3/02/2018 23:30,42,56,57,49,204,4,50
571,3/02/2018 23:35,26,46,48,41,161,4,50
572,3/02/2018 23:40,20,45,47,40,152,4,50
573,3/02/2018 23:45,24,38,43,36,141,4,50
574,3/02/2018 23:50,26,42,49,42,159,4,50
575,3/02/2018 23:55,26,26,38,31,121,4,50
576,3/03/2018 0:00,22,38,46,39,145,4,50
577,3/03/2018 0:05,17,43,40,33,133,4,50
578,3/03/2018 0:10,29,34,37,31,131,4,50
579,3/03/2018 0:15,24,37,38,31,130,4,50
580,3/03/2018 0:20,27,39,32,25,123,4,50
581,3/03/2018 0:25,28,33,34,28,123,4,50
582,3/03/2018 0:30,32,38,34,28,132,4,50
583,3/03/2018 0:35,23,29,34,28,114,4,50
584,3/03/2018 0:40,22,29,35,29,115,4,50
585,3/03/2018 0:45,15,32,36,30,113,4,50
586,3/03/2018 0:50,25,30,26,20,101,4,50
587,3/03/2018 0:55,21,36,24,18,99,4,50
588,3/03/2018 1:00,22,27,22,17,88,4,50
589,3/03/2018 1:05,21,19,31,26,97,4,50
590,3/03/2018 1:10,11,26,22,16,75,4,50
591,3/03/2018 1:15,18,30,24,18,90,4,50
592,3/03/2018 1:20,15,27,24,18,84,4,50
593,3/03/2018 1:25,14,24,21,15,74,4,50
594,3/03/2018 1:30,18,19,19,14,70,4,50
595,3/03/2018 1:35,14,22,23,18,77,4,50
596,3/03/2018 1:40,20,22,19,14,75,4,50
597,3/03/2018 1:45,12,21,20,15,68,4,50
598,3/03/2018 1:50,11,18,20,15,64,4,50
599,3/03/2018 1:55,14,26,25,19,84,4,50
600,3/03/2018 2:00,10,19,20,15,64,4,50
601,3/03/2018 2:05,16,24,24,18,82,4,50
602,3/03/2018 2:10,16,22,25,20,83,4,50
603,3/03/2018 2:15,11,24,17,11,63,4,50
604,3/03/2018 2:20,18,22,21,16,77,4,50
605,3/03/2018 2:25,17,18,25,20,80,4,50
606,3/03/2018 2:30,15,28,18,12,73,4,50
607,3/03/2018 2:35,11,21,23,18,73,4,50
608,3/03/2018 2:40,12,15,21,16,64,4,50
609,3/03/2018 2:45,14,15,20,15,64,4,50
610,3/03/2018 2:50,15,23,19,14,71,4,50
611,3/03/2018 2:55,12,23,15,10,60,4,50
612,3/03/2018 3:00,11,16,20,15,62,4,50
613,3/03/2018 3:05,10,14,17,12,53,4,50
614,3/03/2018 3:10,7,17,15,9,48,4,50
615,3/03/2018 3:15,7,12,17,11,47,4,50
616,3/03/2018 3:20,11,18,17,11,57,4,50
617,3/03/2018 3:25,10,17,17,12,56,4,50
618,3/03/2018 3:30,10,14,19,13,56,4,50
619,3/03/2018 3:35,9,19,21,16,65,4,50
620,3/03/2018 3:40,6,17,18,13,54,4,50
621,3/03/2018 3:45,6,15,14,9,44,4,50
622,3/03/2018 3:50,8,8,13,8,37,4,50
623,3/03/2018 3:55,17,13,17,12,59,4,50
624,3/03/2018 4:00,8,13,12,6,39,4,50
625,3/03/2018 4:05,11,10,13,8,42,4,50
626,3/03/2018 4:10,12,19,22,17,70,4,50
627,3/03/2018 4:15,12,24,17,12,65,4,50
628,3/03/2018 4:20,15,21,22,16,74,4,50
629,3/03/2018 4:25,18,25,25,19,87,4,50
630,3/03/2018 4:30,22,23,22,16,83,4,50
631,3/03/2018 4:35,19,21,22,16,78,4,50
632,3/03/2018 4:40,27,33,30,25,115,4,50
633,3/03/2018 4:45,22,35,24,19,100,4,50
634,3/03/2018 4:50,15,32,20,15,82,4,50
635,3/03/2018 4:55,14,24,20,15,73,4,50
636,3/03/2018 5:00,16,22,20,14,72,4,50
637,3/03/2018 5:05,22,26,22,17,87,4,50
638,3/03/2018 5:10,21,22,21,15,79,4,50
639,3/03/2018 5:15,30,38,30,23,121,4,50
640,3/03/2018 5:20,33,32,27,21,113,4,50
641,3/03/2018 5:25,24,42,32,26,124,4,50
642,3/03/2018 5:30,30,46,32,27,135,4,50
643,3/03/2018 5:35,29,41,29,23,122,4,50
644,3/03/2018 5:40,36,32,41,35,144,4,50
645,3/03/2018 5:45,36,51,40,34,161,4,50
646,3/03/2018 5:50,28,44,45,38,155,4,50
647,3/03/2018 5:55,30,42,40,33,145,4,50
648,3/03/2018 6:00,26,40,37,31,134,4,50
649,3/03/2018 6:05,26,30,32,26,114,4,50
650,3/03/2018 6:10,28,37,28,22,115,4,50
651,3/03/2018 6:15,39,49,43,37,168,4,50
652,3/03/2018 6:20,41,51,44,38,174,4,50
653,3/03/2018 6:25,43,52,47,40,182,4,50
654,3/03/2018 6:30,46,48,52,45,191,4,50
655,3/03/2018 6:35,51,64,56,49,220,4,50
656,3/03/2018 6:40,58,66,51,44,219,4,50
657,3/03/2018 6:45,67,72,60,53,252,4,50
658,3/03/2018 6:50,55,63,56,49,223,4,50
659,3/03/2018 6:55,60,67,59,52,238,4,50
660,3/03/2018 7:00,59,71,48,41,219,4,50
661,3/03/2018 7:05,56,66,54,47,223,4,50
662,3/03/2018 7:10,67,68,59,52,246,4,50
663,3/03/2018 7:15,72,74,59,51,256,4,50
664,3/03/2018 7:20,84,98,64,56,302,4,50
665,3/03/2018 7:25,71,79,59,52,261,4,50
666,3/03/2018 7:30,79,92,72,64,307,4,50
667,3/03/2018 7:35,78,78,74,66,296,4,50
668,3/03/2018 7:40,83,91,76,68,318,4,50
669,3/03/2018 7:45,72,105,82,74,333,4,50
670,3/03/2018 7:50,96,87,80,71,334,4,50
671,3/03/2018 7:55,90,91,77,69,327,4,50
672,3/03/2018 8:00,94,87,57,50,288,4,50
673,3/03/2018 8:05,78,84,74,66,302,4,50
674,3/03/2018 8:10,76,77,65,58,276,4,50
675,3/03/2018 8:15,97,96,65,57,315,4,50
676,3/03/2018 8:20,71,85,60,53,269,4,50
677,3/03/2018 8:25,98,116,66,58,338,4,50
678,3/03/2018 8:30,101,103,76,68,348,4,50
679,3/03/2018 8:35,107,110,71,63,351,4,50
680,3/03/2018 8:40,109,99,79,71,358,4,50
681,3/03/2018 8:45,93,98,84,75,350,4,50
682,3/03/2018 8:50,103,108,85,76,372,4,50
683,3/03/2018 8:55,83,84,75,66,308,4,50
684,3/03/2018 9:00,97,99,74,66,336,4,50
685,3/03/2018 9:05,88,94,79,70,331,4,50
686,3/03/2018 9:10,89,95,76,67,327,4,50
687,3/03/2018 9:15,87,99,72,64,322,4,50
688,3/03/2018 9:20,99,102,69,62,332,4,50
689,3/03/2018 9:25,107,101,73,65,346,4,50
690,3/03/2018 9:30,113,115,74,66,368,4,50
691,3/03/2018 9:35,115,119,77,68,379,4,50
692,3/03/2018 9:40,108,101,74,66,349,4,50
693,3/03/2018 9:45,102,102,88,79,371,4,50
694,3/03/2018 9:50,110,95,77,68,350,4,50
695,3/03/2018 9:55,114,111,81,73,379,4,50
696,3/03/2018 10:00,121,97,71,63,352,4,50
697,3/03/2018 10:05,99,116,82,73,370,4,50
698,3/03/2018 10:10,116,94,77,69,356,4,50
699,3/03/2018 10:15,111,105,64,57,337,4,50
700,3/03/2018 10:20,86,76,49,42,253,4,50
701,3/03/2018 10:25,78,72,55,48,253,4,50
702,3/03/2018 10:30,63,64,48,41,216,4,50
703,3/03/2018 10:35,63,66,44,37,210,4,50
704,3/03/2018 10:40,61,62,43,36,202,4,50
705,3/03/2018 10:45,58,54,45,39,196,4,50
706,3/03/2018 10:50,108,100,76,67,351,4,50
707,3/03/2018 10:55,100,109,76,68,353,4,50
708,3/03/2018 11:00,79,89,70,62,300,4,50
709,3/03/2018 11:05,93,110,72,64,339,4,50
710,3/03/2018 11:10,111,109,91,82,393,4,50
711,3/03/2018 11:15,111,109,88,79,387,4,50
712,3/03/2018 11:20,103,122,95,86,406,4,50
713,3/03/2018 11:25,109,118,89,80,396,4,50
714,3/03/2018 11:30,124,135,93,84,436,4,50
715,3/03/2018 11:35,124,121,94,85,424,4,50
716,3/03/2018 11:40,133,125,93,84,435,4,50
717,3/03/2018 11:45,124,111,78,70,383,4,50
718,3/03/2018 11:50,119,135,91,82,427,4,50
719,3/03/2018 11:55,117,112,83,75,387,4,50
720,3/03/2018 12:00,114,129,104,94,441,4,50
721,3/03/2018 12:05,126,108,85,77,396,4,50
722,3/03/2018 12:10,113,119,88,79,399,4,50
723,3/03/2018 12:15,99,113,87,78,377,4,50
724,3/03/2018 12:20,104,113,94,85,396,4,50
725,3/03/2018 12:25,109,116,93,84,402,4,50
726,3/03/2018 12:30,131,119,103,93,446,4,50
727,3/03/2018 12:35,106,134,95,86,421,4,50
728,3/03/2018 12:40,127,124,100,90,441,4,50
729,3/03/2018 12:45,111,114,96,86,407,4,50
730,3/03/2018 12:50,98,121,90,81,390,4,50
731,3/03/2018 12:55,112,123,85,77,397,4,50
732,3/03/2018 13:00,101,116,88,79,384,4,50
733,3/03/2018 13:05,104,103,90,81,378,4,50
734,3/03/2018 13:10,109,108,82,73,372,4,50
735,3/03/2018 13:15,110,136,93,84,423,4,50
736,3/03/2018 13:20,128,114,97,88,427,4,50
737,3/03/2018 13:25,122,110,88,79,399,4,50
738,3/03/2018 13:30,103,116,91,82,392,4,50
739,3/03/2018 13:35,112,121,96,87,416,4,50
740,3/03/2018 13:40,105,129,95,86,415,4,50
741,3/03/2018 13:45,104,112,91,82,389,4,50
742,3/03/2018 13:50,122,132,100,90,444,4,50
743,3/03/2018 13:55,124,121,93,84,422,4,50
744,3/03/2018 14:00,110,123,92,83,408,4,50
745,3/03/2018 14:05,102,106,80,71,359,4,50
746,3/03/2018 14:10,97,100,85,76,358,4,50
747,3/03/2018 14:15,108,118,74,66,366,4,50
748,3/03/2018 14:20,110,107,90,81,388,4,50
749,3/03/2018 14:25,109,108,93,84,394,4,50
750,3/03/2018 14:30,118,124,96,87,425,4,50
751,3/03/2018 14:35,109,130,90,81,410,4,50
752,3/03/2018 14:40,114,108,95,85,402,4,50
753,3/03/2018 14:45,85,107,84,76,352,4,50
754,3/03/2018 14:50,104,109,97,87,397,4,50
755,3/03/2018 14:55,103,113,88,79,383,4,50
756,3/03/2018 15:00,109,115,94,85,403,4,50
757,3/03/2018 15:05,103,110,90,81,384,4,50
758,3/03/2018 15:10,113,111,83,75,382,4,50
759,3/03/2018 15:15,110,97,87,78,372,4,50
760,3/03/2018 15:20,116,107,88,79,390,4,50
761,3/03/2018 15:25,113,116,98,89,416,4,50
762,3/03/2018 15:30,106,123,92,83,404,4,50
763,3/03/2018 15:35,106,116,90,82,394,4,50
764,3/03/2018 15:40,113,131,99,89,432,4,50
765,3/03/2018 15:45,117,124,96,86,423,4,50
766,3/03/2018 15:50,110,116,97,88,411,4,50
767,3/03/2018 15:55,131,128,101,92,452,4,50
768,3/03/2018 16:00,90,103,82,73,348,4,50
769,3/03/2018 16:05,108,109,94,85,396,4,50
770,3/03/2018 16:10,98,111,83,75,367,4,50
771,3/03/2018 16:15,116,111,98,89,414,4,50
772,3/03/2018 16:20,110,104,93,84,391,4,50
773,3/03/2018 16:25,124,123,96,87,430,4,50
774,3/03/2018 16:30,108,117,98,89,412,4,50
775,3/03/2018 16:35,122,113,99,90,424,4,50
776,3/03/2018 16:40,116,120,102,92,430,4,50
777,3/03/2018 16:45,124,111,97,88,420,4,50
778,3/03/2018 16:50,119,111,96,87,413,4,50
779,3/03/2018 16:55,111,120,83,75,389,4,50
780,3/03/2018 17:00,112,108,83,75,378,4,50
781,3/03/2018 17:05,113,127,92,83,415,4,50
782,3/03/2018 17:10,119,130,105,95,449,4,50
783,3/03/2018 17:15,137,118,101,92,448,4,50
784,3/03/2018 17:20,120,119,95,86,420,4,50
785,3/03/2018 17:25,130,121,97,88,436,4,50
786,3/03/2018 17:30,114,127,100,90,431,4,50
787,3/03/2018 17:35,112,117,94,85,408,4,50
788,3/03/2018 17:40,104,101,91,82,378,4,50
789,3/03/2018 17:45,118,108,88,80,394,4,50
790,3/03/2018 17:50,105,108,87,78,378,4,50
791,3/03/2018 17:55,100,117,86,77,380,4,50
792,3/03/2018 18:00,116,113,89,80,398,4,50
793,3/03/2018 18:05,109,113,94,85,401,4,50
794,3/03/2018 18:10,120,130,97,88,435,4,50
795,3/03/2018 18:15,120,112,94,85,411,4,50
796,3/03/2018 18:20,99,106,88,79,372,4,50
797,3/03/2018 18:25,96,109,87,78,370,4,50
798,3/03/2018 18:30,105,108,93,84,390,4,50
799,3/03/2018 18:35,103,111,90,82,386,4,50
800,3/03/2018 18:40,99,113,86,77,375,4,50
801,3/03/2018 18:45,81,90,82,73,326,4,50
802,3/03/2018 18:50,76,98,85,77,336,4,50
803,3/03/2018 18:55,67,75,72,63,277,4,50
804,3/03/2018 19:00,77,98,79,70,324,4,50
805,3/03/2018 19:05,62,70,69,61,262,4,50
806,3/03/2018 19:10,65,90,70,62,287,4,50
807,3/03/2018 19:15,77,75,74,66,292,4,50
808,3/03/2018 19:20,70,87,77,69,303,4,50
809,3/03/2018 19:25,68,98,75,67,308,4,50
810,3/03/2018 19:30,87,85,71,63,306,4,50
811,3/03/2018 19:35,105,94,75,67,341,4,50
812,3/03/2018 19:40,104,115,85,76,380,4,50
813,3/03/2018 19:45,91,109,82,73,355,4,50
814,3/03/2018 19:50,78,100,84,75,337,4,50
815,3/03/2018 19:55,78,96,77,69,320,4,50
816,3/03/2018 20:00,64,81,66,58,269,4,50
817,3/03/2018 20:05,81,92,74,66,313,4,50
818,3/03/2018 20:10,68,77,64,56,265,4,50
819,3/03/2018 20:15,64,72,64,56,256,4,50
820,3/03/2018 20:20,67,75,62,55,259,4,50
821,3/03/2018 20:25,63,74,69,61,267,4,50
822,3/03/2018 20:30,103,78,65,57,303,4,50
823,3/03/2018 20:35,68,81,63,56,268,4,50
824,3/03/2018 20:40,79,69,68,60,276,4,50
825,3/03/2018 20:45,63,71,69,61,264,4,50
826,3/03/2018 20:50,66,80,65,57,268,4,50
827,3/03/2018 20:55,73,93,57,50,273,4,50
828,3/03/2018 21:00,76,80,63,55,274,4,50
829,3/03/2018 21:05,67,89,62,54,272,4,50
830,3/03/2018 21:10,44,70,62,54,230,4,50
831,3/03/2018 21:15,80,74,54,47,255,4,50
832,3/03/2018 21:20,65,83,68,60,276,4,50
833,3/03/2018 21:25,86,84,69,61,300,4,50
834,3/03/2018 21:30,83,85,73,65,306,4,50
835,3/03/2018 21:35,65,79,67,59,270,4,50
836,3/03/2018 21:40,71,78,62,54,265,4,50
837,3/03/2018 21:45,58,75,61,53,247,4,50
838,3/03/2018 21:50,55,71,60,52,238,4,50
839,3/03/2018 21:55,64,73,65,57,259,4,50
840,3/03/2018 22:00,68,76,65,57,266,4,50
841,3/03/2018 22:05,57,66,61,54,238,4,50
842,3/03/2018 22:10,57,62,65,57,241,4,50
843,3/03/2018 22:15,58,69,57,50,234,4,50
844,3/03/2018 22:20,60,71,60,53,244,4,50
845,3/03/2018 22:25,58,91,62,54,265,4,50
846,3/03/2018 22:30,70,59,59,51,239,4,50
847,3/03/2018 22:35,65,68,53,46,232,4,50
848,3/03/2018 22:40,64,75,57,49,245,4,50
849,3/03/2018 22:45,68,76,63,55,262,4,50
850,3/03/2018 22:50,53,77,62,55,247,4,50
851,3/03/2018 22:55,50,59,53,46,208,4,50
852,3/03/2018 23:00,59,71,49,42,221,4,50
853,3/03/2018 23:05,50,51,49,42,192,4,50
854,3/03/2018 23:10,39,63,52,45,199,4,50
855,3/03/2018 23:15,14,36,42,35,127,4,50
856,3/03/2018 23:20,22,43,37,31,133,4,50
857,3/03/2018 23:25,16,23,35,28,102,4,50
858,3/03/2018 23:30,55,65,48,42,210,4,50
859,3/03/2018 23:35,44,67,57,49,217,4,50
860,3/03/2018 23:40,36,66,51,44,197,4,50
861,3/03/2018 23:45,33,57,45,38,173,4,50
862,3/03/2018 23:50,18,46,42,35,141,4,50
863,3/03/2018 23:55,24,45,49,42,160,4,50
864,3/04/2018 0:00,21,39,40,34,134,4,50
865,3/04/2018 0:05,16,33,37,31,117,4,50
866,3/04/2018 0:10,29,47,42,36,154,4,50
867,3/04/2018 0:15,23,48,39,32,142,4,50
868,3/04/2018 0:20,24,37,36,30,127,4,50
869,3/04/2018 0:25,16,38,35,29,118,4,50
870,3/04/2018 0:30,15,34,37,31,117,4,50
871,3/04/2018 0:35,11,41,35,29,116,4,50
872,3/04/2018 0:40,18,38,28,22,106,4,50
873,3/04/2018 0:45,12,27,33,26,98,4,50
874,3/04/2018 0:50,27,39,39,33,138,4,50
875,3/04/2018 0:55,12,44,35,29,120,4,50
876,3/04/2018 1:00,10,38,28,23,99,4,50
877,3/04/2018 1:05,8,32,33,27,100,4,50
878,3/04/2018 1:10,8,22,29,23,82,4,50
879,3/04/2018 1:15,12,33,33,27,105,4,50
880,3/04/2018 1:20,7,26,25,19,77,4,50
881,3/04/2018 1:25,14,27,27,21,89,4,50
882,3/04/2018 1:30,12,32,32,26,102,4,50
883,3/04/2018 1:35,14,30,27,21,92,4,50
884,3/04/2018 1:40,12,22,25,20,79,4,50
885,3/04/2018 1:45,10,34,25,20,89,4,50
886,3/04/2018 1:50,12,22,30,24,88,4,50
887,3/04/2018 1:55,6,19,29,23,77,4,50
888,3/04/2018 2:00,6,29,25,20,80,4,50
889,3/04/2018 2:05,8,22,27,21,78,4,50
890,3/04/2018 2:10,9,19,22,17,67,4,50
891,3/04/2018 2:15,8,29,25,20,82,4,50
892,3/04/2018 2:20,7,21,25,20,73,4,50
893,3/04/2018 2:25,13,26,24,18,81,4,50
894,3/04/2018 2:30,18,30,25,19,92,4,50
895,3/04/2018 2:35,12,20,25,19,76,4,50
896,3/04/2018 2:40,8,19,21,15,63,4,50
897,3/04/2018 2:45,6,16,23,18,63,4,50
898,3/04/2018 2:50,4,17,22,17,60,4,50
899,3/04/2018 2:55,9,27,23,17,76,4,50
900,3/04/2018 3:00,5,21,19,14,59,4,50
901,3/04/2018 3:05,0,18,22,17,57,4,50
902,3/04/2018 3:10,5,16,23,17,61,4,50
903,3/04/2018 3:15,9,21,19,13,62,4,50
904,3/04/2018 3:20,16,12,21,16,65,4,50
905,3/04/2018 3:25,1,19,22,17,59,4,50
906,3/04/2018 3:30,4,11,20,15,50,4,50
907,3/04/2018 3:35,17,18,11,7,53,4,50
908,3/04/2018 3:40,2,20,29,23,74,4,50
909,3/04/2018 3:45,5,13,21,16,55,4,50
910,3/04/2018 3:50,2,17,14,9,42,4,50
911,3/04/2018 3:55,2,12,12,12,38,4,50
912,3/04/2018 4:00,4,13,12,12,41,4,50
913,3/04/2018 4:05,1,12,18,13,44,4,50
914,3/04/2018 4:10,4,17,12,8,41,4,50
915,3/04/2018 4:15,3,12,19,13,47,4,50
916,3/04/2018 4:20,6,8,16,14,44,4,50
917,3/04/2018 4:25,6,20,19,14,59,4,50
918,3/04/2018 4:30,3,12,21,16,52,4,50
919,3/04/2018 4:35,0,13,19,14,46,4,50
920,3/04/2018 4:40,5,9,17,11,42,4,50
921,3/04/2018 4:45,4,13,16,12,45,4,50
922,3/04/2018 4:50,1,10,17,11,39,4,50
923,3/04/2018 4:55,11,13,15,10,49,4,50
924,3/04/2018 5:00,4,16,15,10,45,4,50
925,3/04/2018 5:05,3,9,17,12,41,4,50
926,3/04/2018 5:10,7,15,19,14,55,4,50
927,3/04/2018 5:15,3,18,20,15,56,4,50
928,3/04/2018 5:20,13,16,23,18,70,4,50
929,3/04/2018 5:25,9,16,24,18,67,4,50
930,3/04/2018 5:30,5,29,25,20,79,4,50
931,3/04/2018 5:35,12,21,20,15,68,4,50
932,3/04/2018 5:40,11,31,27,21,90,4,50
933,3/04/2018 5:45,12,24,24,19,79,4,50
934,3/04/2018 5:50,10,27,29,24,90,4,50
935,3/04/2018 5:55,13,23,30,24,90,4,50
936,3/04/2018 6:00,11,29,29,23,92,4,50
937,3/04/2018 6:05,7,30,27,21,85,4,50
938,3/04/2018 6:10,11,33,24,19,87,4,50
939,3/04/2018 6:15,18,26,30,25,99,4,50
940,3/04/2018 6:20,13,32,27,22,94,4,50
941,3/04/2018 6:25,10,27,34,28,99,4,50
942,3/04/2018 6:30,26,38,32,26,122,4,50
943,3/04/2018 6:35,17,36,31,25,109,4,50
944,3/04/2018 6:40,19,40,40,34,133,4,50
945,3/04/2018 6:45,34,44,34,27,139,4,50
946,3/04/2018 6:50,14,46,35,29,124,4,50
947,3/04/2018 6:55,19,41,37,31,128,4,50
948,3/04/2018 7:00,7,39,39,33,118,4,50
949,3/04/2018 7:05,15,40,36,30,121,4,50
950,3/04/2018 7:10,21,48,37,30,136,4,50
951,3/04/2018 7:15,30,47,40,34,151,4,50
952,3/04/2018 7:20,19,61,38,32,150,4,50
953,3/04/2018 7:25,29,63,48,41,181,4,50
954,3/04/2018 7:30,27,48,46,40,161,4,50
955,3/04/2018 7:35,49,75,44,37,205,4,50
956,3/04/2018 7:40,44,54,56,49,203,4,50
957,3/04/2018 7:45,39,64,64,56,223,4,50
958,3/04/2018 7:50,35,63,57,50,205,4,50
959,3/04/2018 7:55,47,56,58,51,212,4,50
960,3/04/2018 8:00,29,56,51,44,180,4,50
961,3/04/2018 8:05,47,70,46,40,203,4,50
962,3/04/2018 8:10,31,56,45,39,171,4,50
963,3/04/2018 8:15,47,61,52,45,205,4,50
964,3/04/2018 8:20,50,77,56,49,232,4,50
965,3/04/2018 8:25,53,60,58,51,222,4,50
966,3/04/2018 8:30,48,75,56,49,228,4,50
967,3/04/2018 8:35,43,64,58,51,216,4,50
968,3/04/2018 8:40,47,72,58,51,228,4,50
969,3/04/2018 8:45,54,67,64,57,242,4,50
970,3/04/2018 8:50,67,89,66,58,280,4,50
971,3/04/2018 8:55,62,69,64,56,251,4,50
972,3/04/2018 9:00,54,63,61,54,232,4,50
973,3/04/2018 9:05,66,82,54,47,249,4,50
974,3/04/2018 9:10,70,70,53,47,240,4,50
975,3/04/2018 9:15,80,82,62,54,278,4,50
976,3/04/2018 9:20,79,89,70,62,300,4,50
977,3/04/2018 9:25,93,89,67,59,308,4,50
978,3/04/2018 9:30,98,93,75,66,332,4,50
979,3/04/2018 9:35,36,51,55,48,190,4,50
980,3/04/2018 9:40,114,115,84,75,388,4,50
981,3/04/2018 9:45,116,117,81,73,387,4,50
982,3/04/2018 9:50,114,107,88,79,388,4,50
983,3/04/2018 9:55,83,102,69,61,315,4,50
984,3/04/2018 10:00,101,104,74,66,345,4,50
985,3/04/2018 10:05,111,100,77,68,356,4,50
986,3/04/2018 10:10,107,124,78,70,379,4,50
987,3/04/2018 10:15,95,114,69,62,340,4,50
988,3/04/2018 10:20,117,94,86,77,374,4,50
989,3/04/2018 10:25,98,121,81,73,373,4,50
990,3/04/2018 10:30,113,111,88,79,391,4,50
991,3/04/2018 10:35,121,122,77,69,389,4,50
992,3/04/2018 10:40,127,121,84,75,407,4,50
993,3/04/2018 10:45,141,119,82,73,415,4,50
994,3/04/2018 10:50,122,117,94,85,418,4,50
995,3/04/2018 10:55,114,120,87,78,399,4,50
996,3/04/2018 11:00,94,116,84,75,369,4,50
997,3/04/2018 11:05,97,105,86,77,365,4,50
998,3/04/2018 11:10,102,114,80,72,368,4,50
999,3/04/2018 11:15,124,122,92,83,421,4,50
1000,3/04/2018 11:20,128,114,90,81,413,4,50
1001,3/04/2018 11:25,130,118,92,83,423,4,50
1002,3/04/2018 11:30,105,105,84,75,369,4,50
1003,3/04/2018 11:35,127,111,81,73,392,4,50
1004,3/04/2018 11:40,127,116,82,73,398,4,50
1005,3/04/2018 11:45,123,130,95,86,434,4,50
1006,3/04/2018 11:50,126,111,89,80,406,4,50
1007,3/04/2018 11:55,102,117,80,72,371,4,50
1008,3/04/2018 12:00,112,130,90,81,413,4,50
1009,3/04/2018 12:05,103,128,90,81,402,4,50
1010,3/04/2018 12:10,107,110,96,86,399,4,50
1011,3/04/2018 12:15,113,106,91,82,392,4,50
1012,3/04/2018 12:20,116,110,97,88,411,4,50
1013,3/04/2018 12:25,114,122,89,80,405,4,50
1014,3/04/2018 12:30,121,119,90,81,411,4,50
1015,3/04/2018 12:35,121,123,96,87,427,4,50
1016,3/04/2018 12:40,109,106,94,85,394,4,50
1017,3/04/2018 12:45,126,118,103,94,441,4,50
1018,3/04/2018 12:50,134,113,93,84,424,4,50
1019,3/04/2018 12:55,92,106,82,74,354,4,50
1020,3/04/2018 13:00,103,106,92,83,384,4,50
1021,3/04/2018 13:05,108,109,89,80,386,4,50
1022,3/04/2018 13:10,103,102,86,77,368,4,50
1023,3/04/2018 13:15,108,104,84,75,371,4,50
1024,3/04/2018 13:20,113,116,101,91,421,4,50
1025,3/04/2018 13:25,106,108,85,77,376,4,50
1026,3/04/2018 13:30,110,126,86,77,399,4,50
1027,3/04/2018 13:35,105,118,98,88,409,4,50
1028,3/04/2018 13:40,116,107,89,80,392,4,50
1029,3/04/2018 13:45,117,120,85,77,399,4,50
1030,3/04/2018 13:50,125,110,84,75,394,4,50
1031,3/04/2018 13:55,118,118,82,74,392,4,50
1032,3/04/2018 14:00,112,112,88,79,391,4,50
1033,3/04/2018 14:05,102,105,88,79,374,4,50
1034,3/04/2018 14:10,111,117,101,91,420,4,50
1035,3/04/2018 14:15,108,122,100,90,420,4,50
1036,3/04/2018 14:20,106,113,94,85,398,4,50
1037,3/04/2018 14:25,106,118,93,84,401,4,50
1038,3/04/2018 14:30,93,107,93,84,377,4,50
1039,3/04/2018 14:35,121,116,93,84,414,4,50
1040,3/04/2018 14:40,105,97,79,70,351,4,50
1041,3/04/2018 14:45,108,120,92,83,403,4,50
1042,3/04/2018 14:50,104,109,93,84,390,4,50
1043,3/04/2018 14:55,99,101,84,75,359,4,50
1044,3/04/2018 15:00,118,120,90,81,409,4,50
1045,3/04/2018 15:05,99,106,94,85,384,4,50
1046,3/04/2018 15:10,113,106,85,77,381,4,50
1047,3/04/2018 15:15,113,112,96,87,408,4,50
1048,3/04/2018 15:20,119,116,90,81,406,4,50
1049,3/04/2018 15:25,112,114,93,84,403,4,50
1050,3/04/2018 15:30,127,101,87,78,393,4,50
1051,3/04/2018 15:35,105,109,97,87,398,4,50
1052,3/04/2018 15:40,103,111,92,83,389,4,50
1053,3/04/2018 15:45,90,94,86,78,348,4,50
1054,3/04/2018 15:50,124,117,94,85,420,4,50
1055,3/04/2018 15:55,96,113,88,79,376,4,50
1056,3/04/2018 16:00,116,110,97,88,411,4,50
1057,3/04/2018 16:05,114,97,88,79,378,4,50
1058,3/04/2018 16:10,106,117,96,87,406,4,50
1059,3/04/2018 16:15,107,108,86,77,378,4,50
1060,3/04/2018 16:20,94,101,91,82,368,4,50
1061,3/04/2018 16:25,91,110,93,84,378,4,50
1062,3/04/2018 16:30,99,109,92,83,383,4,50
1063,3/04/2018 16:35,103,111,85,77,376,4,50
1064,3/04/2018 16:40,100,114,95,86,395,4,50
1065,3/04/2018 16:45,103,113,89,80,385,4,50
1066,3/04/2018 16:50,108,102,87,78,375,4,50
1067,3/04/2018 16:55,106,116,98,89,409,4,50
1068,3/04/2018 17:00,104,124,89,80,397,4,50
1069,3/04/2018 17:05,104,115,86,77,382,4,50
1070,3/04/2018 17:10,105,100,90,81,376,4,50
1071,3/04/2018 17:15,97,115,91,82,385,4,50
1072,3/04/2018 17:20,107,103,93,83,386,4,50
1073,3/04/2018 17:25,106,106,89,81,382,4,50
1074,3/04/2018 17:30,112,114,95,86,407,4,50
1075,3/04/2018 17:35,108,126,94,85,413,4,50
1076,3/04/2018 17:40,97,111,96,86,390,4,50
1077,3/04/2018 17:45,117,123,91,82,413,4,50
1078,3/04/2018 17:50,115,106,88,79,388,4,50
1079,3/04/2018 17:55,109,114,94,85,402,4,50
1080,3/04/2018 18:00,113,104,85,76,378,4,50
1081,3/04/2018 18:05,89,102,85,76,352,4,50
1082,3/04/2018 18:10,107,122,88,79,396,4,50
1083,3/04/2018 18:15,94,105,92,83,374,4,50
1084,3/04/2018 18:20,91,96,79,70,336,4,50
1085,3/04/2018 18:25,112,112,78,70,372,4,50
1086,3/04/2018 18:30,79,102,85,77,343,4,50
1087,3/04/2018 18:35,85,90,72,64,311,4,50
1088,3/04/2018 18:40,97,101,82,73,353,4,50
1089,3/04/2018 18:45,87,93,75,66,321,4,50
1090,3/04/2018 18:50,100,102,78,69,349,4,50
1091,3/04/2018 18:55,70,97,75,67,309,4,50
1092,3/04/2018 19:00,65,95,73,65,298,4,50
1093,3/04/2018 19:05,92,98,81,72,343,4,50
1094,3/04/2018 19:10,81,80,75,66,302,4,50
1095,3/04/2018 19:15,81,87,78,70,316,4,50
1096,3/04/2018 19:20,85,83,80,71,319,4,50
1097,3/04/2018 19:25,71,84,66,58,279,4,50
1098,3/04/2018 19:30,75,85,74,66,300,4,50
1099,3/04/2018 19:35,77,84,72,64,297,4,50
1100,3/04/2018 19:40,78,85,77,69,309,4,50
1101,3/04/2018 19:45,85,81,74,66,306,4,50
1102,3/04/2018 19:50,95,82,71,63,311,4,50
1103,3/04/2018 19:55,91,87,77,68,323,4,50
1104,3/04/2018 20:00,90,91,59,52,292,4,50
1105,3/04/2018 20:05,72,94,67,60,293,4,50
1106,3/04/2018 20:10,95,84,69,62,310,4,50
1107,3/04/2018 20:15,63,71,69,61,264,4,50
1108,3/04/2018 20:20,79,91,69,61,300,4,50
1109,3/04/2018 20:25,73,76,64,56,269,4,50
1110,3/04/2018 20:30,84,90,61,53,288,4,50
1111,3/04/2018 20:35,58,78,66,58,260,4,50
1112,3/04/2018 20:40,72,88,56,49,265,4,50
1113,3/04/2018 20:45,77,66,57,49,249,4,50
1114,3/04/2018 20:50,65,66,64,57,252,4,50
1115,3/04/2018 20:55,60,68,61,53,242,4,50
1116,3/04/2018 21:00,76,79,72,64,291,4,50
1117,3/04/2018 21:05,80,91,63,55,289,4,50
1118,3/04/2018 21:10,68,87,70,62,287,4,50
1119,3/04/2018 21:15,76,75,62,54,267,4,50
1120,3/04/2018 21:20,92,79,66,58,295,4,50
1121,3/04/2018 21:25,68,78,71,63,280,4,50
1122,3/04/2018 21:30,72,83,63,55,273,4,50
1123,3/04/2018 21:35,67,65,59,51,242,4,50
1124,3/04/2018 21:40,77,74,53,47,251,4,50
1125,3/04/2018 21:45,67,69,53,47,236,4,50
1126,3/04/2018 21:50,58,73,55,48,234,4,50
1127,3/04/2018 21:55,71,74,55,48,248,4,50
1128,3/04/2018 22:00,59,67,47,40,213,4,50
1129,3/04/2018 22:05,57,77,51,44,229,4,50
1130,3/04/2018 22:10,58,69,40,33,200,4,50
1131,3/04/2018 22:15,51,65,51,44,211,4,50
1132,3/04/2018 22:20,56,57,48,41,202,4,50
1133,3/04/2018 22:25,53,47,43,36,179,4,50
1134,3/04/2018 22:30,51,57,46,39,193,4,50
1135,3/04/2018 22:35,51,52,41,35,179,4,50
1136,3/04/2018 22:40,48,60,55,47,210,4,50
1137,3/04/2018 22:45,32,41,48,41,162,4,50
1138,3/04/2018 22:50,39,47,45,38,169,4,50
1139,3/04/2018 22:55,44,34,34,28,140,4,50
1140,3/04/2018 23:00,30,41,42,36,149,4,50
1141,3/04/2018 23:05,17,42,41,35,135,4,50
1142,3/04/2018 23:10,13,28,37,30,108,4,50
1143,3/04/2018 23:15,29,36,31,25,121,4,50
1144,3/04/2018 23:20,63,73,48,42,226,4,50
1145,3/04/2018 23:25,79,96,58,51,284,4,50
1146,3/04/2018 23:30,63,69,59,51,242,4,50
1147,3/04/2018 23:35,52,66,53,45,216,4,50
1148,3/04/2018 23:40,53,54,50,43,200,4,50
1149,3/04/2018 23:45,38,53,46,40,177,4,50
1150,3/04/2018 23:50,33,41,40,33,147,4,50
1151,3/04/2018 23:55,25,50,44,37,156,4,50
1152,3/05/2018 0:00,30,46,42,35,153,4,50
1153,3/05/2018 0:05,24,49,40,34,147,4,50
1154,3/05/2018 0:10,30,49,36,30,145,4,50
1155,3/05/2018 0:15,34,43,35,29,141,4,50
1156,3/05/2018 0:20,29,35,35,29,128,4,50
1157,3/05/2018 0:25,23,40,40,33,136,4,50
1158,3/05/2018 0:30,22,36,34,28,120,4,50
1159,3/05/2018 0:35,24,39,35,29,127,4,50
1160,3/05/2018 0:40,18,35,31,26,110,4,50
1161,3/05/2018 0:45,24,41,31,26,122,4,50
1162,3/05/2018 0:50,16,26,34,28,104,4,50
1163,3/05/2018 0:55,14,30,23,17,84,4,50
1164,3/05/2018 1:00,17,28,30,24,99,4,50
1165,3/05/2018 1:05,14,26,25,20,85,4,50
1166,3/05/2018 1:10,14,29,31,25,99,4,50
1167,3/05/2018 1:15,18,29,25,20,92,4,50
1168,3/05/2018 1:20,11,26,25,19,81,4,50
1169,3/05/2018 1:25,12,27,21,16,76,4,50
1170,3/05/2018 1:30,14,23,25,20,82,4,50
1171,3/05/2018 1:35,16,28,23,17,84,4,50
1172,3/05/2018 1:40,11,14,25,19,69,4,50
1173,3/05/2018 1:45,7,10,11,6,34,4,50
1174,3/05/2018 1:50,23,39,30,24,116,4,50
1175,3/05/2018 1:55,11,21,25,20,77,4,50
1176,3/05/2018 2:00,13,29,28,22,92,4,50
1177,3/05/2018 2:05,13,23,24,18,78,4,50
1178,3/05/2018 2:10,9,21,21,20,71,4,50
1179,3/05/2018 2:15,8,22,23,18,71,4,50
1180,3/05/2018 2:20,5,27,27,22,81,4,50
1181,3/05/2018 2:25,13,20,22,17,72,4,50
1182,3/05/2018 2:30,10,19,19,13,61,4,50
1183,3/05/2018 2:35,16,22,20,15,73,4,50
1184,3/05/2018 2:40,16,29,22,16,83,4,50
1185,3/05/2018 2:45,11,31,23,18,83,4,50
1186,3/05/2018 2:50,14,25,18,13,70,4,50
1187,3/05/2018 2:55,9,15,20,15,59,4,50
1188,3/05/2018 3:00,12,14,24,18,68,4,50
1189,3/05/2018 3:05,10,21,25,20,76,4,50
1190,3/05/2018 3:10,14,33,26,21,94,4,50
1191,3/05/2018 3:15,13,23,29,24,89,4,50
1192,3/05/2018 3:20,14,31,35,29,109,4,50
1193,3/05/2018 3:25,20,36,25,20,101,4,50
1194,3/05/2018 3:30,20,26,30,25,101,4,50
1195,3/05/2018 3:35,26,35,36,30,127,4,50
1196,3/05/2018 3:40,23,38,33,27,121,4,50
1197,3/05/2018 3:45,28,36,32,26,122,4,50
1198,3/05/2018 3:50,16,31,33,27,107,4,50
1199,3/05/2018 3:55,28,49,33,27,137,4,50
1200,3/05/2018 4:00,27,47,32,27,133,4,50
1201,3/05/2018 4:05,31,48,34,28,141,4,50
1202,3/05/2018 4:10,43,54,42,36,175,4,50
1203,3/05/2018 4:15,37,60,47,40,184,4,50
1204,3/05/2018 4:20,48,63,47,40,198,4,50
1205,3/05/2018 4:25,66,66,56,49,237,4,50
1206,3/05/2018 4:30,55,62,50,43,210,4,50
1207,3/05/2018 4:35,48,58,55,48,209,4,50
1208,3/05/2018 4:40,52,66,51,44,213,4,50
1209,3/05/2018 4:45,87,79,57,50,273,4,50
1210,3/05/2018 4:50,54,87,48,42,231,4,50
1211,3/05/2018 4:55,47,61,47,40,195,4,50
1212,3/05/2018 5:00,59,71,61,53,244,4,50
1213,3/05/2018 5:05,62,62,59,52,235,4,50
1214,3/05/2018 5:10,89,76,68,60,293,4,50
1215,3/05/2018 5:15,87,78,63,55,283,4,50
1216,3/05/2018 5:20,82,74,71,63,290,4,50
1217,3/05/2018 5:25,84,81,77,68,310,4,50
1218,3/05/2018 5:30,113,93,85,76,367,4,50
1219,3/05/2018 5:35,121,96,81,73,371,4,50
1220,3/05/2018 5:40,113,95,72,64,344,4,50
1221,3/05/2018 5:45,125,111,97,88,421,4,50
1222,3/05/2018 5:50,117,110,90,81,398,4,50
1223,3/05/2018 5:55,140,116,92,83,431,4,50
1224,3/05/2018 6:00,120,106,90,81,397,4,50
1225,3/05/2018 6:05,138,121,93,84,436,4,50
1226,3/05/2018 6:10,132,121,101,92,446,4,50
1227,3/05/2018 6:15,134,123,106,97,460,4,50
1228,3/05/2018 6:20,158,127,92,83,460,4,50
1229,3/05/2018 6:25,149,122,95,86,452,4,50
1230,3/05/2018 6:30,148,128,103,93,472,4,50
1231,3/05/2018 6:35,161,137,98,88,484,4,50
1232,3/05/2018 6:40,176,144,107,97,524,4,50
1233,3/05/2018 6:45,158,135,107,97,497,4,50
1234,3/05/2018 6:50,144,138,85,76,443,4,50
1235,3/05/2018 6:55,140,135,82,74,431,4,50
1236,3/05/2018 7:00,113,100,69,62,344,4,50
1237,3/05/2018 7:05,150,152,104,94,500,4,50
1238,3/05/2018 7:10,156,143,94,85,478,4,50
1239,3/05/2018 7:15,144,141,104,94,483,4,50
1240,3/05/2018 7:20,148,137,99,90,474,4,50
1241,3/05/2018 7:25,137,140,106,96,479,4,50
1242,3/05/2018 7:30,142,143,115,105,505,4,50
1243,3/05/2018 7:35,162,151,98,88,499,4,50
1244,3/05/2018 7:40,143,134,105,95,477,4,50
1245,3/05/2018 7:45,128,134,90,82,434,4,50
1246,3/05/2018 7:50,137,129,96,87,449,4,50
1247,3/05/2018 7:55,134,126,98,89,447,4,50
1248,3/05/2018 8:00,172,143,93,84,492,4,50
1249,3/05/2018 8:05,144,147,88,79,458,4,50
1250,3/05/2018 8:10,142,115,90,81,428,4,50
1251,3/05/2018 8:15,137,122,90,81,430,4,50
1252,3/05/2018 8:20,130,119,87,78,414,4,50
1253,3/05/2018 8:25,137,121,97,88,443,4,50
1254,3/05/2018 8:30,149,124,88,79,440,4,50
1255,3/05/2018 8:35,133,113,86,77,409,4,50
1256,3/05/2018 8:40,136,133,101,91,461,4,50
1257,3/05/2018 8:45,126,121,100,90,437,4,50
1258,3/05/2018 8:50,146,131,79,71,427,4,50
1259,3/05/2018 8:55,143,132,91,82,448,4,50
1260,3/05/2018 9:00,134,121,84,75,414,4,50
1261,3/05/2018 9:05,153,122,83,75,433,4,50
1262,3/05/2018 9:10,138,114,75,67,394,4,50
1263,3/05/2018 9:15,109,104,60,53,326,4,50
1264,3/05/2018 9:20,85,86,74,66,311,4,50
1265,3/05/2018 9:25,120,117,85,77,399,4,50
1266,3/05/2018 9:30,113,124,73,65,375,4,50
1267,3/05/2018 9:35,107,98,72,64,341,4,50
1268,3/05/2018 9:40,112,104,82,73,371,4,50
1269,3/05/2018 9:45,115,122,82,74,393,4,50
1270,3/05/2018 9:50,140,104,79,70,393,4,50
1271,3/05/2018 9:55,123,125,85,77,410,4,50
1272,3/05/2018 10:00,115,109,82,74,380,4,50
1273,3/05/2018 10:05,114,119,81,73,387,4,50
1274,3/05/2018 10:10,113,120,79,70,382,4,50
1275,3/05/2018 10:15,126,114,86,77,403,4,50
1276,3/05/2018 10:20,121,106,81,73,381,4,50
1277,3/05/2018 10:25,121,107,87,78,393,4,50
1278,3/05/2018 10:30,126,103,84,75,388,4,50
1279,3/05/2018 10:35,142,113,77,69,401,4,50
1280,3/05/2018 10:40,139,114,80,71,404,4,50
1281,3/05/2018 10:45,114,112,88,79,393,4,50
1282,3/05/2018 10:50,98,105,74,66,343,4,50
1283,3/05/2018 10:55,96,102,69,62,329,4,50
1284,3/05/2018 11:00,91,106,82,73,352,4,50
1285,3/05/2018 11:05,117,99,79,70,365,4,50
1286,3/05/2018 11:10,106,103,85,77,371,4,50
1287,3/05/2018 11:15,108,96,75,66,345,4,50
1288,3/05/2018 11:20,112,117,75,67,371,4,50
1289,3/05/2018 11:25,130,108,77,68,383,4,50
1290,3/05/2018 11:30,103,121,93,84,401,4,50
1291,3/05/2018 11:35,118,126,76,68,388,4,50
1292,3/05/2018 11:40,105,113,79,70,367,4,50
1293,3/05/2018 11:45,109,113,86,77,385,4,50
1294,3/05/2018 11:50,119,104,80,72,375,4,50
1295,3/05/2018 11:55,121,113,79,70,383,4,50
1296,3/05/2018 12:00,111,109,93,84,397,4,50
1297,3/05/2018 12:05,111,111,83,74,379,4,50
1298,3/05/2018 12:10,95,96,84,75,350,4,50
1299,3/05/2018 12:15,117,114,87,78,396,4,50
1300,3/05/2018 12:20,116,109,84,75,384,4,50
1301,3/05/2018 12:25,123,105,85,77,390,4,50
1302,3/05/2018 12:30,124,130,98,89,441,4,50
1303,3/05/2018 12:35,132,123,79,70,404,4,50
1304,3/05/2018 12:40,118,110,86,77,391,4,50
1305,3/05/2018 12:45,105,120,96,86,407,4,50
1306,3/05/2018 12:50,115,111,82,74,382,4,50
1307,3/05/2018 12:55,116,126,85,76,403,4,50
1308,3/05/2018 13:00,87,111,81,73,352,4,50
1309,3/05/2018 13:05,113,110,79,70,372,4,50
1310,3/05/2018 13:10,102,97,88,79,366,4,50
1311,3/05/2018 13:15,112,114,93,84,403,4,50
1312,3/05/2018 13:20,99,109,80,71,359,4,50
1313,3/05/2018 13:25,100,99,87,78,364,4,50
1314,3/05/2018 13:30,112,115,75,67,369,4,50
1315,3/05/2018 13:35,107,101,73,65,346,4,50
1316,3/05/2018 13:40,109,114,94,85,402,4,50
1317,3/05/2018 13:45,108,104,86,77,375,4,50
1318,3/05/2018 13:50,110,102,92,83,387,4,50
1319,3/05/2018 13:55,111,113,82,74,380,4,50
1320,3/05/2018 14:00,112,119,85,77,393,4,50
1321,3/05/2018 14:05,108,101,91,82,382,4,50
1322,3/05/2018 14:10,135,121,87,78,421,4,50
1323,3/05/2018 14:15,116,108,87,78,389,4,50
1324,3/05/2018 14:20,122,126,89,80,417,4,50
1325,3/05/2018 14:25,121,118,94,85,418,4,50
1326,3/05/2018 14:30,134,129,87,78,428,4,50
1327,3/05/2018 14:35,139,126,91,82,438,4,50
1328,3/05/2018 14:40,133,117,94,85,429,4,50
1329,3/05/2018 14:45,119,121,88,79,407,4,50
1330,3/05/2018 14:50,120,122,101,92,435,4,50
1331,3/05/2018 14:55,137,124,102,93,456,4,50
1332,3/05/2018 15:00,137,130,100,90,457,4,50
1333,3/05/2018 15:05,139,124,90,81,434,4,50
1334,3/05/2018 15:10,138,140,104,94,476,4,50
1335,3/05/2018 15:15,147,120,104,95,466,4,50
1336,3/05/2018 15:20,148,139,95,86,468,4,50
1337,3/05/2018 15:25,136,123,99,90,448,4,50
1338,3/05/2018 15:30,139,124,101,92,456,4,50
1339,3/05/2018 15:35,134,141,101,92,468,4,50
1340,3/05/2018 15:40,153,134,110,100,497,4,50
1341,3/05/2018 15:45,151,131,97,88,467,4,50
1342,3/05/2018 15:50,150,146,111,101,508,4,50
1343,3/05/2018 15:55,150,135,99,90,474,4,50
1344,3/05/2018 16:00,143,123,107,97,470,4,50
1345,3/05/2018 16:05,149,139,108,98,494,4,50
1346,3/05/2018 16:10,147,141,115,105,508,4,50
1347,3/05/2018 16:15,136,149,95,85,465,4,50
1348,3/05/2018 16:20,144,122,106,96,468,4,50
1349,3/05/2018 16:25,164,148,108,98,518,4,50
1350,3/05/2018 16:30,138,138,105,96,477,4,50
1351,3/05/2018 16:35,146,138,112,102,498,4,50
1352,3/05/2018 16:40,161,138,116,106,521,4,50
1353,3/05/2018 16:45,172,153,112,101,538,4,50
1354,3/05/2018 16:50,154,144,108,98,504,4,50
1355,3/05/2018 16:55,162,148,118,108,536,4,50
1356,3/05/2018 17:00,162,128,108,98,496,4,50
1357,3/05/2018 17:05,163,150,119,108,540,4,50
1358,3/05/2018 17:10,160,147,122,112,541,4,50
1359,3/05/2018 17:15,154,140,106,97,497,4,50
1360,3/05/2018 17:20,157,138,117,107,519,4,50
1361,3/05/2018 17:25,160,147,123,112,542,4,50
1362,3/05/2018 17:30,147,136,106,96,485,4,50
1363,3/05/2018 17:35,153,133,114,104,504,4,50
1364,3/05/2018 17:40,141,134,108,98,481,4,50
1365,3/05/2018 17:45,158,122,104,95,479,4,50
1366,3/05/2018 17:50,146,132,106,96,480,4,50
1367,3/05/2018 17:55,164,124,99,90,477,4,50
1368,3/05/2018 18:00,160,134,109,99,502,4,50
1369,3/05/2018 18:05,120,124,107,98,449,4,50
1370,3/05/2018 18:10,118,122,103,93,436,4,50
1371,3/05/2018 18:15,132,129,89,80,430,4,50
1372,3/05/2018 18:20,138,125,101,92,456,4,50
1373,3/05/2018 18:25,106,120,100,90,416,4,50
1374,3/05/2018 18:30,113,119,87,78,397,4,50
1375,3/05/2018 18:35,114,126,102,93,435,4,50
1376,3/05/2018 18:40,126,120,95,86,427,4,50
1377,3/05/2018 18:45,122,117,98,89,426,4,50
1378,3/05/2018 18:50,114,105,83,74,376,4,50
1379,3/05/2018 18:55,94,102,89,81,366,4,50
1380,3/05/2018 19:00,82,80,76,68,306,4,50
1381,3/05/2018 19:05,73,86,75,67,301,4,50
1382,3/05/2018 19:10,93,103,72,64,332,4,50
1383,3/05/2018 19:15,91,82,77,69,319,4,50
1384,3/05/2018 19:20,79,83,71,63,296,4,50
1385,3/05/2018 19:25,55,61,61,53,230,4,50
1386,3/05/2018 19:30,76,77,68,60,281,4,50
1387,3/05/2018 19:35,75,73,71,63,282,4,50
1388,3/05/2018 19:40,72,76,73,65,286,4,50
1389,3/05/2018 19:45,69,69,67,59,264,4,50
1390,3/05/2018 19:50,74,94,80,71,319,4,50
1391,3/05/2018 19:55,100,104,87,78,369,4,50
1392,3/05/2018 20:00,75,81,77,68,301,4,50
1393,3/05/2018 20:05,85,91,73,65,314,4,50
1394,3/05/2018 20:10,91,99,74,66,330,4,50
1395,3/05/2018 20:15,79,79,69,62,289,4,50
1396,3/05/2018 20:20,74,69,67,60,270,4,50
1397,3/05/2018 20:25,63,80,66,58,267,4,50
1398,3/05/2018 20:30,70,81,60,53,264,4,50
1399,3/05/2018 20:35,62,70,69,61,262,4,50
1400,3/05/2018 20:40,74,76,56,49,255,4,50
1401,3/05/2018 20:45,54,64,56,49,223,4,50
1402,3/05/2018 20:50,54,69,61,54,238,4,50
1403,3/05/2018 20:55,55,51,54,47,207,4,50
1404,3/05/2018 21:00,53,65,52,45,215,4,50
1405,3/05/2018 21:05,57,72,54,47,230,4,50
1406,3/05/2018 21:10,52,60,55,48,215,4,50
1407,3/05/2018 21:15,66,62,53,46,227,4,50
1408,3/05/2018 21:20,51,58,56,49,214,4,50
1409,3/05/2018 21:25,47,63,55,48,213,4,50
1410,3/05/2018 21:30,55,63,58,50,226,4,50
1411,3/05/2018 21:35,51,79,55,48,233,4,50
1412,3/05/2018 21:40,50,73,55,48,226,4,50
1413,3/05/2018 21:45,50,58,51,44,203,4,50
1414,3/05/2018 21:50,44,71,52,45,212,4,50
1415,3/05/2018 21:55,40,56,45,38,179,4,50
1416,3/05/2018 22:00,35,50,47,40,172,4,50
1417,3/05/2018 22:05,41,70,51,44,206,4,50
1418,3/05/2018 22:10,32,42,44,37,155,4,50
1419,3/05/2018 22:15,55,43,49,42,189,4,50
1420,3/05/2018 22:20,54,52,56,48,210,4,50
1421,3/05/2018 22:25,54,71,48,42,215,4,50
1422,3/05/2018 22:30,39,53,55,48,195,4,50
1423,3/05/2018 22:35,31,44,44,38,157,4,50
1424,3/05/2018 22:40,45,56,50,43,194,4,50
1425,3/05/2018 22:45,57,79,60,53,249,4,50
1426,3/05/2018 22:50,63,91,61,54,269,4,50
1427,3/05/2018 22:55,93,99,66,58,316,4,50
1428,3/05/2018 23:00,59,72,60,53,244,4,50
1429,3/05/2018 23:05,54,83,48,41,226,4,50
1430,3/05/2018 23:10,58,70,54,47,229,4,50
1431,3/05/2018 23:15,37,66,53,46,202,4,50
1432,3/05/2018 23:20,47,53,47,40,187,4,50
1433,3/05/2018 23:25,30,46,43,37,156,4,50
1434,3/05/2018 23:30,52,64,42,36,194,4,50
1435,3/05/2018 23:35,43,58,37,31,169,4,50
1436,3/05/2018 23:40,40,44,42,36,162,4,50
1437,3/05/2018 23:45,41,63,48,41,193,4,50
1438,3/05/2018 23:50,37,40,31,26,134,4,50
1439,3/05/2018 23:55,20,41,32,26,119,4,50
1440,3/06/2018 0:00,28,37,37,31,133,4,50
1441,3/06/2018 0:05,23,40,40,34,137,4,50
1442,3/06/2018 0:10,23,35,39,33,130,4,50
1443,3/06/2018 0:15,24,43,36,30,133,4,50
1444,3/06/2018 0:20,13,33,31,25,102,4,50
1445,3/06/2018 0:25,12,25,27,21,85,4,50
1446,3/06/2018 0:30,19,38,35,29,121,4,50
1447,3/06/2018 0:35,24,38,30,25,117,4,50
1448,3/06/2018 0:40,33,33,32,26,124,4,50
1449,3/06/2018 0:45,16,25,26,21,88,4,50
1450,3/06/2018 0:50,17,30,30,24,101,4,50
1451,3/06/2018 0:55,18,30,23,18,89,4,50
1452,3/06/2018 1:00,22,28,27,21,98,4,50
1453,3/06/2018 1:05,11,22,29,24,86,4,50
1454,3/06/2018 1:10,13,25,25,20,83,4,50
1455,3/06/2018 1:15,12,29,26,20,87,4,50
1456,3/06/2018 1:20,18,27,28,22,95,4,50
1457,3/06/2018 1:25,20,28,24,18,90,4,50
1458,3/06/2018 1:30,14,24,27,21,86,4,50
1459,3/06/2018 1:35,11,26,33,27,97,4,50
1460,3/06/2018 1:40,16,26,20,15,77,4,50
1461,3/06/2018 1:45,10,32,23,18,83,4,50
1462,3/06/2018 1:50,7,29,19,13,68,4,50
1463,3/06/2018 1:55,6,18,21,16,61,4,50
1464,3/06/2018 2:00,6,21,24,19,70,4,50
1465,3/06/2018 2:05,14,24,21,15,74,4,50
1466,3/06/2018 2:10,13,24,22,17,76,4,50
1467,3/06/2018 2:15,9,23,21,16,69,4,50
1468,3/06/2018 2:20,9,16,18,13,56,4,50
1469,3/06/2018 2:25,10,26,27,21,84,4,50
1470,3/06/2018 2:30,11,26,26,20,83,4,50
1471,3/06/2018 2:35,8,17,25,20,70,4,50
1472,3/06/2018 2:40,14,19,25,19,77,4,50
1473,3/06/2018 2:45,19,22,22,16,79,4,50
1474,3/06/2018 2:50,17,26,27,21,91,4,50
1475,3/06/2018 2:55,12,20,24,18,74,4,50
1476,3/06/2018 3:00,12,27,30,24,93,4,50
1477,3/06/2018 3:05,14,27,21,15,77,4,50
1478,3/06/2018 3:10,15,17,24,18,74,4,50
1479,3/06/2018 3:15,11,21,30,25,87,4,50
1480,3/06/2018 3:20,13,25,24,18,80,4,50
1481,3/06/2018 3:25,15,21,30,24,90,4,50
1482,3/06/2018 3:30,12,40,32,26,110,4,50
1483,3/06/2018 3:35,24,41,36,30,131,4,50
1484,3/06/2018 3:40,26,31,35,29,121,4,50
1485,3/06/2018 3:45,33,40,37,31,141,4,50
1486,3/06/2018 3:50,34,49,36,29,148,4,50
1487,3/06/2018 3:55,19,30,31,25,105,4,50
1488,3/06/2018 4:00,30,45,36,29,140,4,50
1489,3/06/2018 4:05,36,42,35,29,142,4,50
1490,3/06/2018 4:10,29,45,47,40,161,4,50
1491,3/06/2018 4:15,57,62,44,37,200,4,50
1492,3/06/2018 4:20,59,80,57,49,245,4,50
1493,3/06/2018 4:25,67,77,51,44,239,4,50
1494,3/06/2018 4:30,65,87,63,55,270,4,50
1495,3/06/2018 4:35,85,109,63,55,312,4,50
1496,3/06/2018 4:40,79,106,64,57,306,4,50
1497,3/06/2018 4:45,98,102,77,68,345,4,50
1498,3/06/2018 4:50,68,87,66,58,279,4,50
1499,3/06/2018 4:55,60,80,67,59,266,4,50
1500,3/06/2018 5:00,91,92,65,57,305,4,50
1501,3/06/2018 5:05,70,90,71,63,294,4,50
1502,3/06/2018 5:10,78,87,78,70,313,4,50
1503,3/06/2018 5:15,95,98,82,74,349,4,50
1504,3/06/2018 5:20,90,107,87,78,362,4,50
1505,3/06/2018 5:25,110,117,98,88,413,4,50
1506,3/06/2018 5:30,110,123,93,84,410,4,50
1507,3/06/2018 5:35,113,99,89,81,382,4,50
1508,3/06/2018 5:40,122,112,87,78,399,4,50
1509,3/06/2018 5:45,134,125,99,90,448,4,50
1510,3/06/2018 5:50,127,123,106,97,453,4,50
1511,3/06/2018 5:55,112,124,103,93,432,4,50
1512,3/06/2018 6:00,101,79,73,65,318,4,50
1513,3/06/2018 6:05,111,130,101,91,433,4,50
1514,3/06/2018 6:10,124,108,94,85,411,4,50
1515,3/06/2018 6:15,122,116,102,92,432,4,50
1516,3/06/2018 6:20,130,105,87,78,400,4,50
1517,3/06/2018 6:25,117,106,86,77,386,4,50
1518,3/06/2018 6:30,118,107,89,81,395,4,50
1519,3/06/2018 6:35,136,116,95,86,433,4,50
1520,3/06/2018 6:40,137,125,104,94,460,4,50
1521,3/06/2018 6:45,145,143,107,97,492,4,50
1522,3/06/2018 6:50,139,125,106,97,467,4,50
1523,3/06/2018 6:55,143,131,103,93,470,4,50
1524,3/06/2018 7:00,135,134,100,90,459,4,50
1525,3/06/2018 7:05,159,139,98,88,484,4,50
1526,3/06/2018 7:10,139,136,107,97,479,4,50
1527,3/06/2018 7:15,156,136,104,94,490,4,50
1528,3/06/2018 7:20,153,153,116,106,528,4,50
1529,3/06/2018 7:25,134,144,109,99,486,4,50
1530,3/06/2018 7:30,144,136,116,106,502,4,50
1531,3/06/2018 7:35,141,134,106,97,478,4,50
1532,3/06/2018 7:40,140,136,110,100,486,4,50
1533,3/06/2018 7:45,134,116,94,85,429,4,50
1534,3/06/2018 7:50,157,150,102,92,501,4,50
1535,3/06/2018 7:55,128,123,101,91,443,4,50
1536,3/06/2018 8:00,147,129,100,90,466,4,50
1537,3/06/2018 8:05,141,141,107,98,487,4,50
1538,3/06/2018 8:10,142,122,106,96,466,4,50
1539,3/06/2018 8:15,155,128,91,82,456,4,50
1540,3/06/2018 8:20,161,134,104,94,493,4,50
1541,3/06/2018 8:25,160,141,111,101,513,4,50
1542,3/06/2018 8:30,158,150,94,85,487,4,50
1543,3/06/2018 8:35,160,146,85,77,468,4,50
1544,3/06/2018 8:40,138,134,111,101,484,4,50
1545,3/06/2018 8:45,171,139,106,97,513,4,50
1546,3/06/2018 8:50,144,146,95,86,471,4,50
1547,3/06/2018 8:55,147,122,92,83,444,4,50
1548,3/06/2018 9:00,133,115,86,77,411,4,50
1549,3/06/2018 9:05,123,116,77,68,384,4,50
1550,3/06/2018 9:10,135,126,75,67,403,4,50
1551,3/06/2018 9:15,126,97,78,70,371,4,50
1552,3/06/2018 9:20,129,113,65,57,364,4,50
1553,3/06/2018 9:25,130,115,82,73,400,4,50
1554,3/06/2018 9:30,120,110,80,71,381,4,50
1555,3/06/2018 9:35,127,113,70,62,372,4,50
1556,3/06/2018 9:40,111,101,77,69,358,4,50
1557,3/06/2018 9:45,119,116,82,74,391,4,50
1558,3/06/2018 9:50,118,107,70,62,357,4,50
1559,3/06/2018 9:55,126,104,86,77,393,4,50
1560,3/06/2018 10:00,141,122,82,73,418,4,50
1561,3/06/2018 10:05,127,111,89,80,407,4,50
1562,3/06/2018 10:10,110,116,82,74,382,4,50
1563,3/06/2018 10:15,115,108,87,78,388,4,50
1564,3/06/2018 10:20,128,104,80,72,384,4,50
1565,3/06/2018 10:25,140,119,93,84,436,4,50
1566,3/06/2018 10:30,124,97,88,79,388,4,50
1567,3/06/2018 10:35,129,121,91,82,423,4,50
1568,3/06/2018 10:40,119,114,93,84,410,4,50
1569,3/06/2018 10:45,123,100,88,79,390,4,50
1570,3/06/2018 10:50,108,95,87,78,368,4,50
1571,3/06/2018 10:55,100,100,89,80,369,4,50
1572,3/06/2018 11:00,108,114,95,86,403,4,50
1573,3/06/2018 11:05,117,114,89,80,400,4,50
1574,3/06/2018 11:10,110,114,80,71,375,4,50
1575,3/06/2018 11:15,105,109,85,77,376,4,50
1576,3/06/2018 11:20,122,103,81,73,379,4,50
1577,3/06/2018 11:25,118,112,77,68,375,4,50
1578,3/06/2018 11:30,102,112,83,75,372,4,50
1579,3/06/2018 11:35,121,95,77,69,362,4,50
1580,3/06/2018 11:40,131,117,77,68,393,4,50
1581,3/06/2018 11:45,123,126,80,72,401,4,50
1582,3/06/2018 11:50,131,109,86,77,403,4,50
1583,3/06/2018 11:55,149,110,97,88,444,4,50
1584,3/06/2018 12:00,119,111,87,78,395,4,50
1585,3/06/2018 12:05,113,103,78,69,363,4,50
1586,3/06/2018 12:10,113,112,87,78,390,4,50
1587,3/06/2018 12:15,131,119,92,83,425,4,50
1588,3/06/2018 12:20,110,109,78,70,367,4,50
1589,3/06/2018 12:25,129,132,80,71,412,4,50
1590,3/06/2018 12:30,127,111,79,70,387,4,50
1591,3/06/2018 12:35,112,106,88,79,385,4,50
1592,3/06/2018 12:40,137,114,80,71,402,4,50
1593,3/06/2018 12:45,109,102,85,76,372,4,50
1594,3/06/2018 12:50,129,119,87,78,413,4,50
1595,3/06/2018 12:55,112,109,77,68,366,4,50
1596,3/06/2018 13:00,119,118,82,73,392,4,50
1597,3/06/2018 13:05,106,104,93,84,387,4,50
1598,3/06/2018 13:10,156,140,77,69,442,4,50
1599,3/06/2018 13:15,129,112,86,77,404,4,50
1600,3/06/2018 13:20,113,120,85,76,394,4,50
1601,3/06/2018 13:25,111,104,80,71,366,4,50
1602,3/06/2018 13:30,115,107,87,78,387,4,50
1603,3/06/2018 13:35,109,112,85,76,382,4,50
1604,3/06/2018 13:40,118,111,85,76,390,4,50
1605,3/06/2018 13:45,107,106,77,69,359,4,50
1606,3/06/2018 13:50,114,107,82,73,376,4,50
1607,3/06/2018 13:55,100,107,85,77,369,4,50
1608,3/06/2018 14:00,119,118,82,73,392,4,50
1609,3/06/2018 14:05,122,110,95,86,413,4,50
1610,3/06/2018 14:10,131,136,83,75,425,4,50
1611,3/06/2018 14:15,114,132,88,79,413,4,50
1612,3/06/2018 14:20,116,127,94,85,422,4,50
1613,3/06/2018 14:25,125,114,77,69,385,4,50
1614,3/06/2018 14:30,143,127,94,85,449,4,50
1615,3/06/2018 14:35,134,117,91,82,424,4,50
1616,3/06/2018 14:40,145,126,103,93,467,4,50
1617,3/06/2018 14:45,129,121,98,89,437,4,50
1618,3/06/2018 14:50,138,130,98,89,455,4,50
1619,3/06/2018 14:55,136,126,99,90,451,4,50
1620,3/06/2018 15:00,133,123,100,90,446,4,50
1621,3/06/2018 15:05,150,127,105,96,478,4,50
1622,3/06/2018 15:10,159,139,98,89,485,4,50
1623,3/06/2018 15:15,153,138,95,86,472,4,50
1624,3/06/2018 15:20,141,153,104,94,492,4,50
1625,3/06/2018 15:25,142,128,104,94,468,4,50
1626,3/06/2018 15:30,143,135,104,94,476,4,50
1627,3/06/2018 15:35,138,134,104,94,470,4,50
1628,3/06/2018 15:40,159,126,92,83,460,4,50
1629,3/06/2018 15:45,144,138,107,97,486,4,50
1630,3/06/2018 15:50,143,126,99,90,458,4,50
1631,3/06/2018 15:55,143,134,101,92,470,4,50
1632,3/06/2018 16:00,147,123,101,91,462,4,50
1633,3/06/2018 16:05,152,124,104,95,475,4,50
1634,3/06/2018 16:10,167,145,111,101,524,4,50
1635,3/06/2018 16:15,140,140,110,100,490,4,50
1636,3/06/2018 16:20,146,141,109,99,495,4,50
1637,3/06/2018 16:25,158,129,111,101,499,4,50
1638,3/06/2018 16:30,133,126,102,92,453,4,50
1639,3/06/2018 16:35,161,152,125,114,552,4,50
1640,3/06/2018 16:40,146,136,116,106,504,4,50
1641,3/06/2018 16:45,149,134,104,94,481,4,50
1642,3/06/2018 16:50,161,134,112,102,509,4,50
1643,3/06/2018 16:55,143,144,120,109,516,4,50
1644,3/06/2018 17:00,131,148,116,106,501,4,50
1645,3/06/2018 17:05,161,144,117,107,529,4,50
1646,3/06/2018 17:10,151,147,110,100,508,4,50
1647,3/06/2018 17:15,169,158,127,116,570,4,50
1648,3/06/2018 17:20,162,147,110,100,519,4,50
1649,3/06/2018 17:25,159,139,101,91,490,4,50
1650,3/06/2018 17:30,148,147,114,104,513,4,50
1651,3/06/2018 17:35,167,154,106,96,523,4,50
1652,3/06/2018 17:40,159,142,103,93,497,4,50
1653,3/06/2018 17:45,155,130,107,98,490,4,50
1654,3/06/2018 17:50,156,146,115,105,522,4,50
1655,3/06/2018 17:55,158,141,111,101,511,4,50
1656,3/06/2018 18:00,150,135,101,92,478,4,50
1657,3/06/2018 18:05,150,149,117,107,523,4,50
1658,3/06/2018 18:10,145,130,109,99,483,4,50
1659,3/06/2018 18:15,143,126,107,97,473,4,50
1660,3/06/2018 18:20,128,117,99,90,434,4,50
1661,3/06/2018 18:25,127,149,101,92,469,4,50
1662,3/06/2018 18:30,123,129,104,94,450,4,50
1663,3/06/2018 18:35,125,105,94,85,409,4,50
1664,3/06/2018 18:40,110,126,94,85,415,4,50
1665,3/06/2018 18:45,114,118,103,93,428,4,50
1666,3/06/2018 18:50,117,111,90,81,399,4,50
1667,3/06/2018 18:55,117,122,85,77,401,4,50
1668,3/06/2018 19:00,113,111,85,76,385,4,50
1669,3/06/2018 19:05,104,104,80,71,359,4,50
1670,3/06/2018 19:10,110,100,80,72,362,4,50
1671,3/06/2018 19:15,103,101,81,73,358,4,50
1672,3/06/2018 19:20,109,103,85,76,373,4,50
1673,3/06/2018 19:25,116,108,88,79,391,4,50
1674,3/06/2018 19:30,103,116,85,77,381,4,50
1675,3/06/2018 19:35,115,94,69,62,340,4,50
1676,3/06/2018 19:40,101,99,79,70,349,4,50
1677,3/06/2018 19:45,102,95,77,68,342,4,50
1678,3/06/2018 19:50,95,98,73,65,331,4,50
1679,3/06/2018 19:55,91,85,69,62,307,4,50
1680,3/06/2018 20:00,93,83,74,66,316,4,50
1681,3/06/2018 20:05,80,98,68,60,306,4,50
1682,3/06/2018 20:10,98,99,75,66,338,4,50
1683,3/06/2018 20:15,87,83,75,67,312,4,50
1684,3/06/2018 20:20,88,84,71,63,306,4,50
1685,3/06/2018 20:25,90,93,66,58,307,4,50
1686,3/06/2018 20:30,87,93,69,61,310,4,50
1687,3/06/2018 20:35,79,70,55,48,252,4,50
1688,3/06/2018 20:40,66,78,64,57,265,4,50
1689,3/06/2018 20:45,76,83,64,56,279,4,50
1690,3/06/2018 20:50,48,65,57,49,219,4,50
1691,3/06/2018 20:55,73,80,64,57,274,4,50
1692,3/06/2018 21:00,83,74,58,51,266,4,50
1693,3/06/2018 21:05,79,65,59,51,254,4,50
1694,3/06/2018 21:10,60,69,64,56,249,4,50
1695,3/06/2018 21:15,61,74,70,62,267,4,50
1696,3/06/2018 21:20,59,67,60,53,239,4,50
1697,3/06/2018 21:25,68,65,63,55,251,4,50
1698,3/06/2018 21:30,60,73,59,52,244,4,50
1699,3/06/2018 21:35,67,81,57,50,255,4,50
1700,3/06/2018 21:40,54,63,61,53,231,4,50
1701,3/06/2018 21:45,64,76,62,55,257,4,50
1702,3/06/2018 21:50,58,63,50,43,214,4,50
1703,3/06/2018 21:55,51,73,55,48,227,4,50
1704,3/06/2018 22:00,34,57,51,44,186,4,50
1705,3/06/2018 22:05,49,69,56,49,223,4,50
1706,3/06/2018 22:10,57,58,51,44,210,4,50
1707,3/06/2018 22:15,63,70,63,55,251,4,50
1708,3/06/2018 22:20,58,66,58,51,233,4,50
1709,3/06/2018 22:25,52,52,46,40,190,4,50
1710,3/06/2018 22:30,42,56,40,34,172,4,50
1711,3/06/2018 22:35,55,66,48,42,211,4,50
1712,3/06/2018 22:40,71,97,65,57,290,4,50
1713,3/06/2018 22:45,74,82,69,61,286,4,50
1714,3/06/2018 22:50,76,93,69,62,300,4,50
1715,3/06/2018 22:55,80,103,62,54,299,4,50
1716,3/06/2018 23:00,64,76,63,55,258,4,50
1717,3/06/2018 23:05,63,74,60,53,250,4,50
1718,3/06/2018 23:10,60,79,62,54,255,4,50
1719,3/06/2018 23:15,46,64,54,47,211,4,50
1720,3/06/2018 23:20,49,59,43,36,187,4,50
1721,3/06/2018 23:25,46,56,36,29,167,4,50
1722,3/06/2018 23:30,40,69,40,33,182,4,50
1723,3/06/2018 23:35,44,71,44,38,197,4,50
1724,3/06/2018 23:40,33,47,43,37,160,4,50
1725,3/06/2018 23:45,38,60,48,42,188,4,50
1726,3/06/2018 23:50,35,43,45,38,161,4,50
1727,3/06/2018 23:55,29,36,36,29,130,4,50
1728,3/07/2018 0:00,29,45,40,33,147,4,50
1729,3/07/2018 0:05,11,37,30,23,101,4,50
1730,3/07/2018 0:10,26,37,35,29,127,4,50
1731,3/07/2018 0:15,15,38,32,27,112,4,50
1732,3/07/2018 0:20,24,40,35,29,128,4,50
1733,3/07/2018 0:25,21,34,30,24,109,4,50
1734,3/07/2018 0:30,16,30,33,27,106,4,50
1735,3/07/2018 0:35,21,36,31,25,113,4,50
1736,3/07/2018 0:40,24,37,32,26,119,4,50
1737,3/07/2018 0:45,20,39,27,22,108,4,50
1738,3/07/2018 0:50,17,27,27,22,93,4,50
1739,3/07/2018 0:55,19,31,26,20,96,4,50
1740,3/07/2018 1:00,21,30,31,26,108,4,50
1741,3/07/2018 1:05,18,31,27,22,98,4,50
1742,3/07/2018 1:10,21,37,26,20,104,4,50
1743,3/07/2018 1:15,19,29,28,22,98,4,50
1744,3/07/2018 1:20,12,21,28,22,83,4,50
1745,3/07/2018 1:25,13,27,26,20,86,4,50
1746,3/07/2018 1:30,14,31,25,20,90,4,50
1747,3/07/2018 1:35,9,27,23,17,76,4,50
1748,3/07/2018 1:40,13,33,25,20,91,4,50
1749,3/07/2018 1:45,15,19,23,22,79,4,50
1750,3/07/2018 1:50,7,31,17,12,67,4,50
1751,3/07/2018 1:55,14,19,23,18,74,4,50
1752,3/07/2018 2:00,9,30,21,16,76,4,50
1753,3/07/2018 2:05,11,20,19,13,63,4,50
1754,3/07/2018 2:10,14,31,21,15,81,4,50
1755,3/07/2018 2:15,11,26,24,18,79,4,50
1756,3/07/2018 2:20,16,28,23,18,85,4,50
1757,3/07/2018 2:25,14,33,19,14,80,4,50
1758,3/07/2018 2:30,8,23,22,17,70,4,50
1759,3/07/2018 2:35,18,34,26,21,99,4,50
1760,3/07/2018 2:40,11,26,26,21,84,4,50
1761,3/07/2018 2:45,13,26,25,19,83,4,50
1762,3/07/2018 2:50,19,31,29,23,102,4,50
1763,3/07/2018 2:55,8,23,27,21,79,4,50
1764,3/07/2018 3:00,11,28,27,22,88,4,50
1765,3/07/2018 3:05,13,24,25,20,82,4,50
1766,3/07/2018 3:10,14,28,26,20,88,4,50
1767,3/07/2018 3:15,24,29,28,22,103,4,50
1768,3/07/2018 3:20,6,29,27,21,83,4,50
1769,3/07/2018 3:25,26,34,29,23,112,4,50
1770,3/07/2018 3:30,23,30,27,22,102,4,50
1771,3/07/2018 3:35,29,42,42,36,149,4,50
1772,3/07/2018 3:40,22,44,32,26,124,4,50
1773,3/07/2018 3:45,22,39,31,25,117,4,50
1774,3/07/2018 3:50,30,29,29,23,111,4,50
1775,3/07/2018 3:55,31,40,38,31,140,4,50
1776,3/07/2018 4:00,39,44,39,33,155,4,50
1777,3/07/2018 4:05,36,48,38,32,154,4,50
1778,3/07/2018 4:10,37,64,46,40,187,4,50
1779,3/07/2018 4:15,49,60,44,38,191,4,50
1780,3/07/2018 4:20,64,79,56,49,248,4,50
1781,3/07/2018 4:25,74,68,55,48,245,4,50
1782,3/07/2018 4:30,66,91,56,49,262,4,50
1783,3/07/2018 4:35,84,98,67,59,308,4,50
1784,3/07/2018 4:40,68,98,74,66,306,4,50
1785,3/07/2018 4:45,89,98,67,59,313,4,50
1786,3/07/2018 4:50,76,89,74,65,304,4,50
1787,3/07/2018 4:55,91,82,63,55,291,4,50
1788,3/07/2018 5:00,94,86,77,68,325,4,50
1789,3/07/2018 5:05,83,85,67,60,295,4,50
1790,3/07/2018 5:10,88,75,72,64,299,4,50
1791,3/07/2018 5:15,99,96,75,67,337,4,50
1792,3/07/2018 5:20,105,101,76,68,350,4,50
1793,3/07/2018 5:25,101,95,81,73,350,4,50
1794,3/07/2018 5:30,129,107,90,81,407,4,50
1795,3/07/2018 5:35,101,102,83,75,361,4,50
1796,3/07/2018 5:40,111,100,84,75,370,4,50
1797,3/07/2018 5:45,118,117,93,84,412,4,50
1798,3/07/2018 5:50,120,128,95,86,429,4,50
1799,3/07/2018 5:55,134,102,92,83,411,4,50
1800,3/07/2018 6:00,116,108,76,68,368,4,50
1801,3/07/2018 6:05,138,115,92,83,428,4,50
1802,3/07/2018 6:10,126,114,99,89,428,4,50
1803,3/07/2018 6:15,125,117,101,91,434,4,50
1804,3/07/2018 6:20,136,130,104,94,464,4,50
1805,3/07/2018 6:25,147,108,91,82,428,4,50
1806,3/07/2018 6:30,126,119,90,81,416,4,50
1807,3/07/2018 6:35,171,149,104,94,518,4,50
1808,3/07/2018 6:40,173,154,112,102,541,4,50
1809,3/07/2018 6:45,163,153,110,100,526,4,50
1810,3/07/2018 6:50,171,154,102,92,519,4,50
1811,3/07/2018 6:55,153,138,106,97,494,4,50
1812,3/07/2018 7:00,182,174,98,88,542,4,50
1813,3/07/2018 7:05,149,130,112,102,493,4,50
1814,3/07/2018 7:10,165,155,114,104,538,4,50
1815,3/07/2018 7:15,155,160,106,97,518,4,50
1816,3/07/2018 7:20,162,159,114,104,539,4,50
1817,3/07/2018 7:25,169,163,114,104,550,4,50
1818,3/07/2018 7:30,152,127,107,98,484,4,50
1819,3/07/2018 7:35,161,136,116,106,519,4,50
1820,3/07/2018 7:40,132,139,114,103,488,4,50
1821,3/07/2018 7:45,143,155,120,109,527,4,50
1822,3/07/2018 7:50,143,126,109,99,477,4,50
1823,3/07/2018 7:55,124,118,103,94,439,4,50
1824,3/07/2018 8:00,147,129,108,98,482,4,50
1825,3/07/2018 8:05,117,114,88,79,398,4,50
1826,3/07/2018 8:10,141,139,99,89,468,4,50
1827,3/07/2018 8:15,147,147,95,86,475,4,50
1828,3/07/2018 8:20,133,123,98,89,443,4,50
1829,3/07/2018 8:25,153,142,98,89,482,4,50
1830,3/07/2018 8:30,156,129,109,99,493,4,50
1831,3/07/2018 8:35,173,156,104,94,527,4,50
1832,3/07/2018 8:40,152,135,96,87,470,4,50
1833,3/07/2018 8:45,139,128,88,79,434,4,50
1834,3/07/2018 8:50,138,121,101,91,451,4,50
1835,3/07/2018 8:55,147,103,92,83,425,4,50
1836,3/07/2018 9:00,147,113,99,90,449,4,50
1837,3/07/2018 9:05,131,124,77,68,400,4,50
1838,3/07/2018 9:10,98,110,89,80,377,4,50
1839,3/07/2018 9:15,133,115,110,90,448,4,0
1840,3/07/2018 9:20,90,89,83,74,336,4,0
1841,3/07/2018 9:25,123,115,92,83,413,4,50
1842,3/07/2018 9:30,133,126,89,80,428,4,50
1843,3/07/2018 9:35,130,118,94,85,427,4,50
1844,3/07/2018 9:40,138,104,86,77,405,4,50
1845,3/07/2018 9:45,116,113,77,68,374,4,50
1846,3/07/2018 9:50,114,121,88,79,402,4,50
1847,3/07/2018 9:55,116,121,85,77,399,4,50
1848,3/07/2018 10:00,120,105,80,71,376,4,50
1849,3/07/2018 10:05,111,99,82,74,366,4,50
1850,3/07/2018 10:10,113,97,84,75,369,4,50
1851,3/07/2018 10:15,114,100,81,72,367,4,50
1852,3/07/2018 10:20,117,129,101,92,439,4,50
1853,3/07/2018 10:25,118,113,99,89,419,4,50
1854,3/07/2018 10:30,114,115,93,84,406,4,50
1855,3/07/2018 10:35,119,99,84,75,377,4,50
1856,3/07/2018 10:40,113,104,86,77,380,4,50
1857,3/07/2018 10:45,117,113,95,86,411,4,50
1858,3/07/2018 10:50,113,112,92,83,400,4,50
1859,3/07/2018 10:55,114,108,81,73,376,4,50
1860,3/07/2018 11:00,99,111,89,80,379,4,50
1861,3/07/2018 11:05,125,114,87,79,405,4,50
1862,3/07/2018 11:10,115,121,87,78,401,4,50
1863,3/07/2018 11:15,113,121,94,85,413,4,50
1864,3/07/2018 11:20,120,121,99,90,430,4,50
1865,3/07/2018 11:25,105,108,90,81,384,4,50
1866,3/07/2018 11:30,100,106,85,77,368,4,50
1867,3/07/2018 11:35,115,115,79,70,379,4,50
1868,3/07/2018 11:40,124,116,82,74,396,4,50
1869,3/07/2018 11:45,116,116,90,81,403,4,50
1870,3/07/2018 11:50,102,109,89,80,380,4,50
1871,3/07/2018 11:55,112,121,89,81,403,4,50
0,3/07/2018 11:00,99,111,89,80,379,4,50
1,3/07/2018 11:05,125,114,87,79,405,4,50
2,3/07/2018 11:10,115,121,87,78,401,4,50
3,3/07/2018 11:15,113,121,94,85,413,4,50
4,3/07/2018 11:20,120,121,99,90,430,4,50
5,3/07/2018 11:25,105,108,90,81,384,4,50
6,3/07/2018 11:30,100,106,85,77,368,4,50
7,3/07/2018 11:35,115,115,79,70,379,4,50
8,3/07/2018 11:40,124,116,82,74,396,4,50
9,3/07/2018 11:45,116,116,90,81,403,4,50
10,3/07/2018 11:50,102,109,89,80,380,4,50
11,3/07/2018 11:55,112,121,89,81,403,4,50
12,3/07/2018 12:00,121,117,94,85,417,4,50
13,3/07/2018 12:05,108,99,86,77,370,4,50
14,3/07/2018 12:10,124,110,97,88,419,4,50
15,3/07/2018 12:15,112,122,91,82,407,4,50
16,3/07/2018 12:20,128,108,82,74,392,4,50
17,3/07/2018 12:25,127,131,94,85,437,4,50
18,3/07/2018 12:30,121,118,85,77,401,4,50
19,3/07/2018 12:35,126,105,81,73,385,4,50
20,3/07/2018 12:40,97,126,93,84,400,4,50
21,3/07/2018 12:45,104,99,86,77,366,4,50
22,3/07/2018 12:50,118,110,89,80,397,4,50
23,3/07/2018 12:55,124,119,91,82,416,4,50
24,3/07/2018 13:00,116,128,85,76,405,4,50
25,3/07/2018 13:05,124,113,97,88,422,4,50
26,3/07/2018 13:10,121,121,89,80,411,4,50
27,3/07/2018 13:15,121,115,92,83,411,4,50
28,3/07/2018 13:20,116,128,98,88,430,4,50
29,3/07/2018 13:25,134,138,99,90,461,4,50
30,3/07/2018 13:30,127,115,98,89,429,4,50
31,3/07/2018 13:35,109,124,93,84,410,4,50
32,3/07/2018 13:40,118,114,96,87,415,4,50
33,3/07/2018 13:45,117,106,93,84,400,4,50
34,3/07/2018 13:50,125,120,89,80,414,4,50
35,3/07/2018 13:55,104,113,86,77,380,4,50
36,3/07/2018 14:00,140,113,94,85,432,4,50
37,3/07/2018 14:05,118,119,94,85,416,4,50
38,3/07/2018 14:10,135,134,102,92,463,4,50
39,3/07/2018 14:15,110,125,96,87,418,4,50
40,3/07/2018 14:20,144,122,89,80,435,4,50
41,3/07/2018 14:25,120,127,96,87,430,4,50
42,3/07/2018 14:30,111,130,85,77,403,4,50
43,3/07/2018 14:35,158,130,96,87,471,4,50
44,3/07/2018 14:40,134,127,92,83,436,4,50
45,3/07/2018 14:45,136,139,94,85,454,4,50
46,3/07/2018 14:50,105,129,94,85,413,4,50
47,3/07/2018 14:55,113,116,97,87,413,4,50
48,3/07/2018 15:00,121,119,95,86,421,4,50
49,3/07/2018 15:05,154,147,98,89,488,4,50
50,3/07/2018 15:10,146,142,117,107,512,4,50
51,3/07/2018 15:15,158,136,116,106,516,4,50
52,3/07/2018 15:20,153,143,99,90,485,4,50
53,3/07/2018 15:25,130,138,104,94,466,4,50
54,3/07/2018 15:30,143,138,109,99,489,4,50
55,3/07/2018 15:35,148,143,99,90,480,4,50
56,3/07/2018 15:40,158,143,112,102,515,4,50
57,3/07/2018 15:45,142,158,115,105,520,4,50
58,3/07/2018 15:50,134,143,116,106,499,4,50
59,3/07/2018 15:55,141,130,98,88,457,4,50
60,3/07/2018 16:00,166,129,111,101,507,4,50
61,3/07/2018 16:05,147,144,102,92,485,4,50
62,3/07/2018 16:10,141,124,107,98,470,4,50
63,3/07/2018 16:15,155,133,114,104,506,4,50
64,3/07/2018 16:20,156,145,106,97,504,4,50
65,3/07/2018 16:25,149,139,109,99,496,4,50
66,3/07/2018 16:30,150,131,102,93,476,4,50
67,3/07/2018 16:35,157,152,121,111,541,4,50
68,3/07/2018 16:40,154,128,106,96,484,4,50
69,3/07/2018 16:45,150,145,108,98,501,4,50
70,3/07/2018 16:50,157,142,120,110,529,4,50
71,3/07/2018 16:55,158,165,116,105,544,4,50
72,3/07/2018 17:00,154,160,115,105,534,4,50
73,3/07/2018 17:05,166,128,101,92,487,4,50
74,3/07/2018 17:10,166,139,118,108,531,4,50
75,3/07/2018 17:15,164,144,119,108,535,4,50
76,3/07/2018 17:20,159,138,117,107,521,4,50
77,3/07/2018 17:25,178,155,106,96,535,4,50
78,3/07/2018 17:30,131,131,93,84,439,4,50
79,3/07/2018 17:35,156,151,97,87,491,4,50
80,3/07/2018 17:40,137,124,101,92,454,4,50
81,3/07/2018 17:45,175,154,99,89,517,4,50
82,3/07/2018 17:50,131,127,109,99,466,4,50
83,3/07/2018 17:55,152,144,106,96,498,4,50
84,3/07/2018 18:00,142,131,107,98,478,4,50
85,3/07/2018 18:05,141,150,109,99,499,4,50
86,3/07/2018 18:10,142,134,106,97,479,4,50
87,3/07/2018 18:15,135,127,109,99,470,4,50
88,3/07/2018 18:20,142,145,112,102,501,4,50
89,3/07/2018 18:25,144,124,86,77,431,4,50
90,3/07/2018 18:30,116,132,93,84,425,4,50
91,3/07/2018 18:35,121,123,99,90,433,4,50
92,3/07/2018 18:40,127,127,108,98,460,4,50
93,3/07/2018 18:45,127,113,99,90,429,4,50
94,3/07/2018 18:50,129,133,106,97,465,4,50
95,3/07/2018 18:55,105,102,86,77,370,4,50
96,3/07/2018 19:00,116,111,91,82,400,4,50
97,3/07/2018 19:05,132,122,102,92,448,4,50
98,3/07/2018 19:10,116,104,92,83,395,4,50
99,3/07/2018 19:15,106,116,96,86,404,4,50
100,3/07/2018 19:20,115,105,92,83,395,4,50
101,3/07/2018 19:25,109,108,87,79,383,4,50
102,3/07/2018 19:30,99,107,71,63,340,4,50
103,3/07/2018 19:35,99,97,72,64,332,4,50
104,3/07/2018 19:40,111,103,65,57,336,4,50
105,3/07/2018 19:45,98,109,76,68,351,4,50
106,3/07/2018 19:50,82,93,77,68,320,4,50
107,3/07/2018 19:55,90,100,77,69,336,4,50
108,3/07/2018 20:00,76,91,72,64,303,4,50
109,3/07/2018 20:05,86,82,73,65,306,4,50
110,3/07/2018 20:10,81,91,74,66,312,4,50
111,3/07/2018 20:15,86,76,72,64,298,4,50
112,3/07/2018 20:20,81,81,74,66,302,4,50
113,3/07/2018 20:25,67,68,60,53,248,4,50
114,3/07/2018 20:30,68,82,58,50,258,4,50
115,3/07/2018 20:35,88,94,79,70,331,4,50
116,3/07/2018 20:40,80,88,72,64,304,4,50
117,3/07/2018 20:45,83,76,66,58,283,4,50
118,3/07/2018 20:50,88,76,69,61,294,4,50
119,3/07/2018 20:55,69,82,69,61,281,4,50
120,3/07/2018 21:00,69,81,72,64,286,4,50
121,3/07/2018 21:05,53,62,63,55,233,4,50
122,3/07/2018 21:10,62,66,61,53,242,4,50
123,3/07/2018 21:15,76,69,60,53,258,4,50
124,3/07/2018 21:20,72,76,60,53,261,4,50
125,3/07/2018 21:25,61,61,54,47,223,4,50
126,3/07/2018 21:30,70,76,69,61,276,4,50
127,3/07/2018 21:35,74,66,56,49,245,4,50
128,3/07/2018 21:40,61,58,51,44,214,4,50
129,3/07/2018 21:45,55,72,51,44,222,4,50
130,3/07/2018 21:50,53,71,53,47,224,4,50
131,3/07/2018 21:55,49,71,53,47,220,4,50
132,3/07/2018 22:00,26,60,44,38,168,4,50
133,3/07/2018 22:05,44,52,46,39,181,4,50
134,3/07/2018 22:10,62,65,57,50,234,4,50
135,3/07/2018 22:15,67,67,59,52,245,4,50
136,3/07/2018 22:20,72,88,66,58,284,4,50
137,3/07/2018 22:25,63,65,64,56,248,4,50
138,3/07/2018 22:30,56,79,51,44,230,4,50
139,3/07/2018 22:35,39,58,45,38,180,4,50
140,3/07/2018 22:40,40,55,51,44,190,4,50
141,3/07/2018 22:45,49,64,51,44,208,4,50
142,3/07/2018 22:50,58,70,61,54,243,4,50
143,3/07/2018 22:55,59,95,67,59,280,4,50
144,3/07/2018 23:00,54,98,58,51,261,4,50
145,3/07/2018 23:05,62,82,68,60,272,4,50
146,3/07/2018 23:10,72,93,76,67,308,4,50
147,3/07/2018 23:15,67,78,56,49,250,4,50
148,3/07/2018 23:20,22,51,45,38,156,4,50
149,3/07/2018 23:25,49,56,46,40,191,4,50
150,3/07/2018 23:30,41,71,50,44,206,4,50
151,3/07/2018 23:35,38,69,51,44,202,4,50
152,3/07/2018 23:40,44,71,50,44,209,4,50
153,3/07/2018 23:45,36,57,41,35,169,4,50
154,3/07/2018 23:50,35,48,48,42,173,4,50
155,3/07/2018 23:55,42,64,44,38,188,4,50
156,3/08/2018 0:00,38,50,48,41,177,4,50
157,3/08/2018 0:05,23,56,40,34,153,4,50
158,3/08/2018 0:10,32,44,38,32,146,4,50
159,3/08/2018 0:15,24,36,37,31,128,4,50
160,3/08/2018 0:20,37,44,39,33,153,4,50
161,3/08/2018 0:25,20,31,34,27,112,4,50
162,3/08/2018 0:30,31,43,36,30,140,4,50
163,3/08/2018 0:35,20,42,30,24,116,4,50
164,3/08/2018 0:40,26,51,29,24,130,4,50
165,3/08/2018 0:45,29,32,32,26,119,4,50
166,3/08/2018 0:50,21,37,36,29,123,4,50
167,3/08/2018 0:55,23,43,27,21,114,4,50
168,3/08/2018 1:00,19,40,36,29,124,4,50
169,3/08/2018 1:05,18,43,28,22,111,4,50
170,3/08/2018 1:10,19,29,34,28,110,4,50
171,3/08/2018 1:15,10,33,32,26,101,4,50
172,3/08/2018 1:20,31,29,26,21,107,4,50
173,3/08/2018 1:25,18,30,29,23,100,4,50
174,3/08/2018 1:30,11,34,25,19,89,4,50
175,3/08/2018 1:35,19,29,30,24,102,4,50
176,3/08/2018 1:40,16,30,29,24,99,4,50
177,3/08/2018 1:45,12,26,27,22,87,4,50
178,3/08/2018 1:50,11,27,25,20,83,4,50
179,3/08/2018 1:55,11,20,25,20,76,4,50
180,3/08/2018 2:00,18,36,23,18,95,4,50
181,3/08/2018 2:05,20,28,27,21,96,4,50
182,3/08/2018 2:10,11,32,32,26,101,4,50
183,3/08/2018 2:15,11,19,21,16,67,4,50
184,3/08/2018 2:20,14,21,23,18,76,4,50
185,3/08/2018 2:25,26,27,23,18,94,4,50
186,3/08/2018 2:30,13,36,25,20,94,4,50
187,3/08/2018 2:35,13,31,24,18,86,4,50
188,3/08/2018 2:40,14,29,29,23,95,4,50
189,3/08/2018 2:45,27,40,27,21,115,4,50
190,3/08/2018 2:50,14,23,25,20,82,4,50
191,3/08/2018 2:55,17,24,27,21,89,4,50
192,3/08/2018 3:00,10,26,24,19,79,4,50
193,3/08/2018 3:05,19,21,28,23,91,4,50
194,3/08/2018 3:10,18,32,25,20,95,4,50
195,3/08/2018 3:15,13,28,28,22,91,4,50
196,3/08/2018 3:20,14,29,30,24,97,4,50
197,3/08/2018 3:25,13,23,31,25,92,4,50
198,3/08/2018 3:30,22,35,32,26,115,4,50
199,3/08/2018 3:35,28,37,35,29,129,4,50
200,3/08/2018 3:40,26,42,42,36,146,4,50
201,3/08/2018 3:45,23,44,33,27,127,4,50
202,3/08/2018 3:50,21,50,36,30,137,4,50
203,3/08/2018 3:55,20,42,37,31,130,4,50
204,3/08/2018 4:00,23,53,41,35,152,4,50
205,3/08/2018 4:05,18,49,48,42,157,4,50
206,3/08/2018 4:10,32,65,41,35,173,4,50
207,3/08/2018 4:15,52,70,54,47,223,4,50
208,3/08/2018 4:20,70,83,48,42,243,4,50
209,3/08/2018 4:25,64,92,71,63,290,4,50
210,3/08/2018 4:30,58,72,67,59,256,4,50
211,3/08/2018 4:35,64,92,71,63,290,4,50
212,3/08/2018 4:40,87,105,68,60,320,4,50
213,3/08/2018 4:45,87,94,59,52,292,4,50
214,3/08/2018 4:50,56,85,75,66,282,4,50
215,3/08/2018 4:55,59,72,53,47,231,4,50
216,3/08/2018 5:00,72,73,60,53,258,4,50
217,3/08/2018 5:05,67,70,69,61,267,4,50
218,3/08/2018 5:10,69,73,63,55,260,4,50
219,3/08/2018 5:15,103,83,70,62,318,4,50
220,3/08/2018 5:20,110,106,77,69,362,4,50
221,3/08/2018 5:25,122,119,75,66,382,4,50
222,3/08/2018 5:30,108,100,90,81,379,4,50
223,3/08/2018 5:35,117,97,87,78,379,4,50
224,3/08/2018 5:40,118,110,91,82,401,4,50
225,3/08/2018 5:45,117,101,91,82,391,4,50
226,3/08/2018 5:50,133,129,99,89,450,4,50
227,3/08/2018 5:55,132,96,87,79,394,4,50
228,3/08/2018 6:00,139,114,80,72,405,4,50
229,3/08/2018 6:05,129,120,101,92,442,4,50
230,3/08/2018 6:10,142,138,93,84,457,4,50
231,3/08/2018 6:15,136,125,100,90,451,4,50
232,3/08/2018 6:20,147,147,93,84,471,4,50
233,3/08/2018 6:25,145,132,102,92,471,4,50
234,3/08/2018 6:30,137,119,99,89,444,4,50
235,3/08/2018 6:35,169,152,91,82,494,4,50
236,3/08/2018 6:40,160,124,105,96,485,4,50
237,3/08/2018 6:45,151,138,99,90,478,4,50
238,3/08/2018 6:50,147,141,105,95,488,4,50
239,3/08/2018 6:55,159,148,99,90,496,4,50
240,3/08/2018 7:00,145,128,109,99,481,4,50
241,3/08/2018 7:05,167,138,111,101,517,4,50
242,3/08/2018 7:10,164,141,114,104,523,4,50
243,3/08/2018 7:15,148,136,112,102,498,4,50
244,3/08/2018 7:20,159,148,115,105,527,4,50
245,3/08/2018 7:25,151,148,117,106,522,4,50
246,3/08/2018 7:30,160,149,104,94,507,4,50
247,3/08/2018 7:35,168,153,110,100,531,4,50
248,3/08/2018 7:40,147,143,101,91,482,4,50
249,3/08/2018 7:45,157,142,114,104,517,4,50
250,3/08/2018 7:50,147,131,101,91,470,4,50
251,3/08/2018 7:55,157,146,123,113,539,4,50
252,3/08/2018 8:00,139,122,105,96,462,4,50
253,3/08/2018 8:05,150,129,101,91,471,4,50
254,3/08/2018 8:10,136,128,104,94,462,4,50
255,3/08/2018 8:15,166,131,105,95,497,4,50
256,3/08/2018 8:20,160,134,90,81,465,4,50
257,3/08/2018 8:25,164,117,94,85,460,4,50
258,3/08/2018 8:30,156,146,97,88,487,4,50
259,3/08/2018 8:35,165,143,96,86,490,4,50
260,3/08/2018 8:40,140,127,107,98,472,4,50
261,3/08/2018 8:45,138,140,114,104,496,4,50
262,3/08/2018 8:50,134,129,91,82,436,4,50
263,3/08/2018 8:55,153,128,90,81,452,4,50
264,3/08/2018 9:00,119,120,91,82,412,4,50
265,3/08/2018 9:05,122,110,89,80,401,4,50
266,3/08/2018 9:10,121,113,88,79,401,4,50
267,3/08/2018 9:15,125,127,95,86,433,4,50
268,3/08/2018 9:20,131,121,90,81,423,4,50
269,3/08/2018 9:25,123,108,69,61,361,4,50
270,3/08/2018 9:30,148,127,95,86,456,4,50
271,3/08/2018 9:35,123,130,91,82,426,4,50
272,3/08/2018 9:40,133,123,97,88,441,4,50
273,3/08/2018 9:45,136,131,98,88,453,4,50
274,3/08/2018 9:50,132,117,88,79,416,4,50
275,3/08/2018 9:55,119,116,72,64,371,4,50
276,3/08/2018 10:00,141,121,94,85,441,4,50
277,3/08/2018 10:05,111,113,77,68,369,4,50
278,3/08/2018 10:10,123,122,105,96,446,4,50
279,3/08/2018 10:15,124,122,89,80,415,4,50
280,3/08/2018 10:20,123,110,88,79,400,4,50
281,3/08/2018 10:25,126,111,98,89,424,4,50
282,3/08/2018 10:30,113,115,90,81,399,4,50
283,3/08/2018 10:35,132,114,92,83,421,4,50
284,3/08/2018 10:40,110,108,90,81,389,4,50
285,3/08/2018 10:45,126,106,94,85,411,4,50
286,3/08/2018 10:50,111,110,92,83,396,4,50
287,3/08/2018 10:55,123,116,91,82,412,4,50
288,3/08/2018 11:00,124,113,90,81,408,4,50
289,3/08/2018 11:05,119,119,91,82,411,4,50
290,3/08/2018 11:10,110,111,88,79,388,4,50
291,3/08/2018 11:15,129,113,96,87,425,4,50
292,3/08/2018 11:20,128,120,98,88,434,4,50
293,3/08/2018 11:25,122,113,88,79,402,4,50
294,3/08/2018 11:30,123,125,93,84,425,4,50
295,3/08/2018 11:35,121,105,84,75,385,4,50
296,3/08/2018 11:40,128,129,83,75,415,4,50
297,3/08/2018 11:45,133,118,98,89,438,4,50
298,3/08/2018 11:50,127,106,94,85,412,4,50
299,3/08/2018 11:55,127,117,88,79,411,4,50
300,3/08/2018 12:00,115,114,77,68,374,4,50
301,3/08/2018 12:05,118,113,82,74,387,4,50
302,3/08/2018 12:10,123,100,89,80,392,4,50
303,3/08/2018 12:15,115,109,90,81,395,4,50
304,3/08/2018 12:20,112,115,82,74,383,4,50
305,3/08/2018 12:25,114,126,90,81,411,4,50
306,3/08/2018 12:30,119,105,80,71,375,4,50
307,3/08/2018 12:35,126,123,93,84,426,4,50
308,3/08/2018 12:40,121,109,95,86,411,4,50
309,3/08/2018 12:45,121,113,89,80,403,4,50
310,3/08/2018 12:50,127,133,102,92,454,4,50
311,3/08/2018 12:55,108,108,95,86,397,4,50
312,3/08/2018 13:00,115,107,86,77,385,4,50
313,3/08/2018 13:05,119,117,93,84,413,4,50
314,3/08/2018 13:10,130,112,97,87,426,4,50
315,3/08/2018 13:15,130,124,85,77,416,4,50
316,3/08/2018 13:20,114,126,88,79,407,4,50
317,3/08/2018 13:25,136,121,90,81,428,4,50
318,3/08/2018 13:30,139,114,98,89,440,4,50
319,3/08/2018 13:35,130,110,84,75,399,4,50
320,3/08/2018 13:40,127,129,102,93,451,4,50
321,3/08/2018 13:45,126,112,92,83,413,4,50
322,3/08/2018 13:50,125,132,104,94,455,4,50
323,3/08/2018 13:55,120,123,96,87,426,4,50
324,3/08/2018 14:00,129,129,94,85,437,4,50
325,3/08/2018 14:05,124,117,98,88,427,4,50
326,3/08/2018 14:10,121,112,94,85,412,4,50
327,3/08/2018 14:15,124,131,96,87,438,4,50
328,3/08/2018 14:20,110,118,101,91,420,4,50
329,3/08/2018 14:25,126,119,96,87,428,4,50
330,3/08/2018 14:30,131,117,82,73,403,4,50
331,3/08/2018 14:35,131,111,82,74,398,4,50
332,3/08/2018 14:40,127,121,100,90,438,4,50
333,3/08/2018 14:45,148,140,97,88,473,4,50
334,3/08/2018 14:50,140,124,89,80,433,4,50
335,3/08/2018 14:55,144,129,90,81,444,4,50
336,3/08/2018 15:00,146,126,103,93,468,4,50
337,3/08/2018 15:05,153,131,94,85,463,4,50
338,3/08/2018 15:10,154,136,98,89,477,4,50
339,3/08/2018 15:15,156,140,101,91,488,4,50
340,3/08/2018 15:20,141,139,102,92,474,4,50
341,3/08/2018 15:25,151,136,95,86,468,4,50
342,3/08/2018 15:30,151,146,119,108,524,4,50
343,3/08/2018 15:35,156,134,109,99,498,4,50
344,3/08/2018 15:40,162,143,107,98,510,4,50
345,3/08/2018 15:45,144,138,111,102,495,4,50
346,3/08/2018 15:50,162,131,108,98,499,4,50
347,3/08/2018 15:55,161,126,108,98,493,4,50
348,3/08/2018 16:00,153,128,110,100,491,4,50
349,3/08/2018 16:05,153,143,112,102,510,4,50
350,3/08/2018 16:10,159,139,113,103,514,4,50
351,3/08/2018 16:15,162,146,117,106,531,4,50
352,3/08/2018 16:20,174,129,111,101,515,4,50
353,3/08/2018 16:25,154,128,105,95,482,4,50
354,3/08/2018 16:30,165,134,99,90,488,4,50
355,3/08/2018 16:35,161,156,106,96,519,4,50
356,3/08/2018 16:40,163,142,118,107,530,4,50
357,3/08/2018 16:45,157,140,109,99,505,4,50
358,3/08/2018 16:50,140,119,104,94,457,4,50
359,3/08/2018 16:55,153,128,110,100,491,4,50
360,3/08/2018 17:00,166,154,129,118,567,4,50
361,3/08/2018 17:05,140,155,119,108,522,4,50
362,3/08/2018 17:10,158,138,116,106,518,4,50
363,3/08/2018 17:15,149,144,116,106,515,4,50
364,3/08/2018 17:20,165,156,123,112,556,4,50
365,3/08/2018 17:25,168,152,113,103,536,4,50
366,3/08/2018 17:30,154,145,113,103,515,4,50
367,3/08/2018 17:35,148,153,103,93,497,4,50
368,3/08/2018 17:40,163,147,114,104,528,4,50
369,3/08/2018 17:45,147,138,114,104,503,4,50
370,3/08/2018 17:50,158,152,120,109,539,4,50
371,3/08/2018 17:55,141,120,104,95,460,4,50
372,3/08/2018 18:00,132,121,101,91,445,4,50
373,3/08/2018 18:05,136,146,113,103,498,4,50
374,3/08/2018 18:10,143,146,102,92,483,4,50
375,3/08/2018 18:15,131,130,107,98,466,4,50
376,3/08/2018 18:20,141,130,107,97,475,4,50
377,3/08/2018 18:25,119,126,93,84,422,4,50
378,3/08/2018 18:30,137,125,105,96,463,4,50
379,3/08/2018 18:35,131,128,100,90,449,4,50
380,3/08/2018 18:40,125,129,99,90,443,4,50
381,3/08/2018 18:45,117,121,93,84,415,4,50
382,3/08/2018 18:50,118,117,95,86,416,4,50
383,3/08/2018 18:55,101,109,96,87,393,4,50
384,3/08/2018 19:00,95,110,91,82,378,4,50
385,3/08/2018 19:05,108,121,88,79,396,4,50
386,3/08/2018 19:10,103,90,81,72,346,4,50
387,3/08/2018 19:15,117,110,94,85,406,4,50
388,3/08/2018 19:20,120,102,85,77,384,4,50
389,3/08/2018 19:25,111,114,96,87,408,4,50
390,3/08/2018 19:30,113,105,81,73,372,4,50
391,3/08/2018 19:35,118,110,90,81,399,4,50
392,3/08/2018 19:40,110,106,84,75,375,4,50
393,3/08/2018 19:45,105,106,87,78,376,4,50
394,3/08/2018 19:50,104,89,80,72,345,4,50
395,3/08/2018 19:55,110,109,82,74,375,4,50
396,3/08/2018 20:00,101,95,77,69,342,4,50
397,3/08/2018 20:05,98,103,69,62,332,4,50
398,3/08/2018 20:10,80,99,86,77,342,4,50
399,3/08/2018 20:15,90,109,70,62,331,4,50
400,3/08/2018 20:20,103,103,71,63,340,4,50
401,3/08/2018 20:25,99,93,75,66,333,4,50
402,3/08/2018 20:30,92,93,57,50,292,4,50
403,3/08/2018 20:35,79,74,67,59,279,4,50
404,3/08/2018 20:40,83,101,70,62,316,4,50
405,3/08/2018 20:45,85,85,72,64,306,4,50
406,3/08/2018 20:50,77,93,67,59,296,4,50
407,3/08/2018 20:55,83,92,72,64,311,4,50
408,3/08/2018 21:00,76,83,56,49,264,4,50
409,3/08/2018 21:05,69,85,59,51,264,4,50
410,3/08/2018 21:10,71,93,71,63,298,4,50
411,3/08/2018 21:15,91,83,67,59,300,4,50
412,3/08/2018 21:20,70,76,61,54,261,4,50
413,3/08/2018 21:25,90,86,65,57,298,4,50
414,3/08/2018 21:30,74,69,66,58,267,4,50
415,3/08/2018 21:35,78,90,59,51,278,4,50
416,3/08/2018 21:40,62,66,54,47,229,4,50
417,3/08/2018 21:45,66,81,61,53,261,4,50
418,3/08/2018 21:50,64,68,67,59,258,4,50
419,3/08/2018 21:55,64,70,56,49,239,4,50
420,3/08/2018 22:00,30,60,55,48,193,4,50
421,3/08/2018 22:05,81,81,53,46,261,4,50
422,3/08/2018 22:10,60,74,57,50,241,4,50
423,3/08/2018 22:15,89,71,59,51,270,4,50
424,3/08/2018 22:20,45,59,52,45,201,4,50
425,3/08/2018 22:25,46,48,53,46,193,4,50
426,3/08/2018 22:30,44,72,52,45,213,4,50
427,3/08/2018 22:35,54,63,49,42,208,4,50
428,3/08/2018 22:40,71,81,53,46,251,4,50
429,3/08/2018 22:45,47,66,51,44,208,4,50
430,3/08/2018 22:50,49,54,45,39,187,4,50
431,3/08/2018 22:55,49,66,46,40,201,4,50
432,3/08/2018 23:00,33,34,40,34,141,4,50
433,3/08/2018 23:05,39,30,42,36,147,4,50
434,3/08/2018 23:10,41,56,51,43,191,4,50
435,3/08/2018 23:15,34,44,39,33,150,4,50
436,3/08/2018 23:20,34,53,47,40,174,4,50
437,3/08/2018 23:25,23,33,42,35,133,4,50
438,3/08/2018 23:30,17,31,34,27,109,4,50
439,3/08/2018 23:35,20,29,31,25,105,4,50
440,3/08/2018 23:40,29,36,39,32,136,4,50
441,3/08/2018 23:45,18,35,37,31,121,4,50
442,3/08/2018 23:50,29,38,37,30,134,4,50
443,3/08/2018 23:55,20,37,34,28,119,4,50
444,3/09/2018 0:00,17,23,34,28,102,4,50
445,3/09/2018 0:05,17,41,29,23,110,4,50
446,3/09/2018 0:10,13,28,30,24,95,4,50
447,3/09/2018 0:15,24,34,23,17,98,4,50
448,3/09/2018 0:20,15,35,28,22,100,4,50
449,3/09/2018 0:25,20,31,32,26,109,4,50
450,3/09/2018 0:30,4,23,24,18,69,4,50
451,3/09/2018 0:35,21,31,31,25,108,4,50
452,3/09/2018 0:40,20,14,23,17,74,4,50
453,3/09/2018 0:45,23,37,29,23,112,4,50
454,3/09/2018 0:50,18,22,21,15,76,4,50
455,3/09/2018 0:55,7,27,22,17,73,4,50
456,3/09/2018 1:00,15,24,21,16,76,4,50
457,3/09/2018 1:05,12,14,19,13,58,4,50
458,3/09/2018 1:10,9,14,23,17,63,4,50
459,3/09/2018 1:15,10,21,18,13,62,4,50
460,3/09/2018 1:20,10,18,19,13,60,4,50
461,3/09/2018 1:25,14,18,18,13,63,4,50
462,3/09/2018 1:30,11,13,17,12,53,4,50
463,3/09/2018 1:35,10,13,18,13,54,4,50
464,3/09/2018 1:40,8,17,17,11,53,4,50
465,3/09/2018 1:45,12,22,15,9,58,4,50
466,3/09/2018 1:50,9,17,19,14,59,4,50
467,3/09/2018 1:55,10,10,14,9,43,4,50
468,3/09/2018 2:00,4,22,19,13,58,4,50
469,3/09/2018 2:05,3,10,16,10,39,4,50
470,3/09/2018 2:10,4,18,14,9,45,4,50
471,3/09/2018 2:15,11,10,16,11,48,4,50
472,3/09/2018 2:20,2,10,17,11,40,4,50
473,3/09/2018 2:25,13,20,14,9,56,4,50
474,3/09/2018 2:30,23,38,22,17,100,4,50
475,3/09/2018 2:35,9,11,15,10,45,4,50
476,3/09/2018 2:40,12,21,15,10,58,4,50
477,3/09/2018 2:45,13,12,17,11,53,4,50
478,3/09/2018 2:50,11,16,14,10,51,4,50
479,3/09/2018 2:55,12,13,14,9,48,4,50
480,3/09/2018 3:00,7,7,13,8,35,4,50
481,3/09/2018 3:05,8,14,17,12,51,4,50
482,3/09/2018 3:10,11,10,20,15,56,4,50
483,3/09/2018 3:15,10,23,19,14,66,4,50
484,3/09/2018 3:20,14,20,25,20,79,4,50
485,3/09/2018 3:25,15,19,19,14,67,4,50
486,3/09/2018 3:30,18,22,24,18,82,4,50
487,3/09/2018 3:35,18,18,20,15,71,4,50
488,3/09/2018 3:40,12,19,22,16,69,4,50
489,3/09/2018 3:45,13,18,20,14,65,4,50
490,3/09/2018 3:50,10,14,24,18,66,4,50
491,3/09/2018 3:55,3,10,15,10,38,4,50
492,3/09/2018 4:00,35,39,28,23,125,4,50
493,3/09/2018 4:05,13,24,21,16,74,4,50
494,3/09/2018 4:10,19,32,32,27,110,4,50
495,3/09/2018 4:15,26,38,37,31,132,4,50
496,3/09/2018 4:20,34,37,37,31,139,4,50
497,3/09/2018 4:25,45,44,37,31,157,4,50
498,3/09/2018 4:30,40,45,46,39,170,4,50
499,3/09/2018 4:35,39,58,42,36,175,4,50
500,3/09/2018 4:40,55,56,52,45,208,4,50
501,3/09/2018 4:45,73,70,53,47,243,4,50
502,3/09/2018 4:50,52,66,48,42,208,4,50
503,3/09/2018 4:55,49,60,45,38,192,4,50
504,3/09/2018 5:00,50,59,47,40,196,4,50
505,3/09/2018 5:05,52,69,55,48,224,4,50
506,3/09/2018 5:10,65,76,65,57,263,4,50
507,3/09/2018 5:15,96,78,73,65,312,4,50
508,3/09/2018 5:20,87,83,75,66,311,4,50
509,3/09/2018 5:25,92,91,75,66,324,4,50
510,3/09/2018 5:30,107,91,73,65,336,4,50
511,3/09/2018 5:35,123,113,88,79,403,4,50
512,3/09/2018 5:40,122,123,95,86,426,4,50
513,3/09/2018 5:45,126,100,90,81,397,4,50
514,3/09/2018 5:50,116,100,85,77,378,4,50
515,3/09/2018 5:55,132,127,90,81,430,4,50
516,3/09/2018 6:00,133,119,85,76,413,4,50
517,3/09/2018 6:05,132,102,92,83,409,4,50
518,3/09/2018 6:10,123,101,89,81,394,4,50
519,3/09/2018 6:15,139,126,98,89,452,4,50
520,3/09/2018 6:20,143,129,93,84,449,4,50
521,3/09/2018 6:25,154,151,104,94,503,4,50
522,3/09/2018 6:30,148,131,104,94,477,4,50
523,3/09/2018 6:35,155,126,98,89,468,4,50
524,3/09/2018 6:40,148,135,104,95,482,4,50
525,3/09/2018 6:45,140,134,109,99,482,4,50
526,3/09/2018 6:50,147,124,98,88,457,4,50
527,3/09/2018 6:55,129,148,102,92,471,4,50
528,3/09/2018 7:00,162,146,88,79,475,4,50
529,3/09/2018 7:05,150,130,99,89,468,4,50
530,3/09/2018 7:10,150,134,114,104,502,4,50
531,3/09/2018 7:15,159,141,113,103,516,4,50
532,3/09/2018 7:20,166,152,109,99,526,4,50
533,3/09/2018 7:25,143,141,118,108,510,4,50
534,3/09/2018 7:30,157,142,110,100,509,4,50
535,3/09/2018 7:35,158,151,109,99,517,4,50
536,3/09/2018 7:40,151,137,106,97,491,4,50
537,3/09/2018 7:45,139,130,108,98,475,4,50
538,3/09/2018 7:50,129,144,90,81,444,4,50
539,3/09/2018 7:55,138,134,91,82,445,4,50
540,3/09/2018 8:00,133,113,99,90,435,4,50
541,3/09/2018 8:05,144,147,92,83,466,4,50
542,3/09/2018 8:10,143,118,103,94,458,4,50
543,3/09/2018 8:15,169,152,110,100,531,4,50
544,3/09/2018 8:20,137,132,95,86,450,4,50
545,3/09/2018 8:25,147,146,93,84,470,4,50
546,3/09/2018 8:30,152,130,90,81,453,4,50
547,3/09/2018 8:35,150,137,96,87,470,4,50
548,3/09/2018 8:40,139,123,104,94,460,4,50
549,3/09/2018 8:45,142,140,101,92,475,4,50
550,3/09/2018 8:50,122,122,101,91,436,4,50
551,3/09/2018 8:55,134,118,92,83,427,4,50
552,3/09/2018 9:00,117,119,87,78,401,4,50
553,3/09/2018 9:05,118,103,91,82,394,4,50
554,3/09/2018 9:10,120,114,87,78,399,4,50
555,3/09/2018 9:15,116,113,97,87,413,4,50
556,3/09/2018 9:20,121,113,78,70,382,4,50
557,3/09/2018 9:25,142,132,89,80,443,4,50
558,3/09/2018 9:30,129,121,93,84,427,4,50
559,3/09/2018 9:35,125,114,87,79,405,4,50
560,3/09/2018 9:40,122,118,88,79,407,4,50
561,3/09/2018 9:45,118,121,77,68,384,4,50
562,3/09/2018 9:50,129,111,90,81,411,4,50
563,3/09/2018 9:55,121,111,85,77,394,4,50
564,3/09/2018 10:00,104,93,84,75,356,4,50
565,3/09/2018 10:05,113,117,77,68,375,4,50
566,3/09/2018 10:10,121,103,92,83,399,4,50
567,3/09/2018 10:15,117,114,91,82,404,4,50
568,3/09/2018 10:20,116,125,86,77,404,4,50
569,3/09/2018 10:25,112,119,88,79,398,4,50
570,3/09/2018 10:30,121,111,88,79,399,4,50
571,3/09/2018 10:35,115,110,85,77,387,4,50
572,3/09/2018 10:40,121,121,93,84,419,4,50
573,3/09/2018 10:45,102,120,97,88,407,4,50
574,3/09/2018 10:50,110,122,89,80,401,4,50
575,3/09/2018 10:55,116,97,69,62,344,4,50
576,3/09/2018 11:00,106,109,85,77,377,4,50
577,3/09/2018 11:05,116,130,100,90,436,4,50
578,3/09/2018 11:10,117,129,90,81,417,4,50
579,3/09/2018 11:15,111,126,90,81,408,4,50
580,3/09/2018 11:20,128,113,78,70,389,4,50
581,3/09/2018 11:25,119,128,66,58,371,4,50
582,3/09/2018 11:30,133,135,84,75,427,4,50
583,3/09/2018 11:35,131,114,79,71,395,4,50
584,3/09/2018 11:40,141,133,95,86,455,4,50
585,3/09/2018 11:45,130,134,89,80,433,4,50
586,3/09/2018 11:50,129,129,82,73,413,4,50
587,3/09/2018 11:55,131,135,80,72,418,4,50
588,3/09/2018 12:00,116,115,79,70,380,4,50
589,3/09/2018 12:05,136,128,77,68,409,4,50
590,3/09/2018 12:10,127,133,89,80,429,4,50
591,3/09/2018 12:15,149,129,106,97,481,4,50
592,3/09/2018 12:20,133,108,89,80,410,4,50
593,3/09/2018 12:25,119,106,85,76,386,4,50
594,3/09/2018 12:30,130,119,85,77,411,4,50
595,3/09/2018 12:35,119,125,78,70,392,4,50
596,3/09/2018 12:40,130,130,86,77,423,4,50
597,3/09/2018 12:45,124,126,82,74,406,4,50
598,3/09/2018 12:50,123,123,87,78,411,4,50
599,3/09/2018 12:55,134,126,82,73,415,4,50
600,3/09/2018 13:00,96,114,81,73,364,4,50
601,3/09/2018 13:05,133,116,75,67,391,4,50
602,3/09/2018 13:10,134,111,78,70,393,4,50
603,3/09/2018 13:15,125,107,84,75,391,4,50
604,3/09/2018 13:20,90,124,86,77,377,4,50
605,3/09/2018 13:25,120,107,79,71,377,4,50
606,3/09/2018 13:30,113,107,85,77,382,4,50
607,3/09/2018 13:35,128,122,87,78,415,4,50
608,3/09/2018 13:40,119,135,77,69,400,4,50
609,3/09/2018 13:45,140,135,90,81,446,4,50
610,3/09/2018 13:50,149,139,84,75,447,4,50
611,3/09/2018 13:55,119,132,86,77,414,4,50
612,3/09/2018 14:00,127,134,93,84,438,4,50
613,3/09/2018 14:05,138,128,85,76,427,4,50
614,3/09/2018 14:10,135,134,93,84,446,4,50
615,3/09/2018 14:15,135,131,93,84,443,4,50
616,3/09/2018 14:20,144,124,107,98,473,4,50
617,3/09/2018 14:25,152,147,98,89,486,4,50
618,3/09/2018 14:30,116,120,96,87,419,4,50
619,3/09/2018 14:35,143,125,91,82,441,4,50
620,3/09/2018 14:40,160,131,102,92,485,4,50
621,3/09/2018 14:45,159,123,95,86,463,4,50
622,3/09/2018 14:50,123,114,100,91,428,4,50
623,3/09/2018 14:55,149,130,104,94,477,4,50
624,3/09/2018 15:00,139,124,94,85,442,4,50
625,3/09/2018 15:05,124,146,85,77,432,4,50
626,3/09/2018 15:10,152,124,107,98,481,4,50
627,3/09/2018 15:15,147,117,102,93,459,4,50
628,3/09/2018 15:20,141,151,104,94,490,4,50
629,3/09/2018 15:25,150,127,108,98,483,4,50
630,3/09/2018 15:30,171,136,106,96,509,4,50
631,3/09/2018 15:35,166,153,107,97,523,4,50
632,3/09/2018 15:40,166,136,109,100,511,4,50
633,3/09/2018 15:45,156,145,116,105,522,4,50
634,3/09/2018 15:50,154,152,114,103,523,4,50
635,3/09/2018 15:55,148,127,104,94,473,4,50
636,3/09/2018 16:00,151,144,111,101,507,4,50
637,3/09/2018 16:05,165,144,116,106,531,4,50
638,3/09/2018 16:10,156,141,108,98,503,4,50
639,3/09/2018 16:15,168,156,103,94,521,4,50
640,3/09/2018 16:20,144,130,106,97,477,4,50
641,3/09/2018 16:25,154,137,98,89,478,4,50
642,3/09/2018 16:30,147,132,97,87,463,4,50
643,3/09/2018 16:35,151,140,102,92,485,4,50
644,3/09/2018 16:40,160,144,104,94,502,4,50
645,3/09/2018 16:45,168,144,109,99,520,4,50
646,3/09/2018 16:50,108,101,72,63,344,4,50
647,3/09/2018 16:55,165,129,98,89,481,4,50
648,3/09/2018 17:00,169,141,103,94,507,4,50
649,3/09/2018 17:05,151,130,105,95,481,4,50
650,3/09/2018 17:10,156,141,105,96,498,4,50
651,3/09/2018 17:15,159,151,111,101,522,4,50
652,3/09/2018 17:20,158,142,109,99,508,4,50
653,3/09/2018 17:25,150,146,117,107,520,4,50
654,3/09/2018 17:30,141,144,114,104,503,4,50
655,3/09/2018 17:35,143,131,112,102,488,4,50
656,3/09/2018 17:40,144,132,112,102,490,4,50
657,3/09/2018 17:45,141,141,113,103,498,4,50
658,3/09/2018 17:50,148,134,108,98,488,4,50
659,3/09/2018 17:55,150,129,111,101,491,4,50
660,3/09/2018 18:00,131,128,100,91,450,4,50
661,3/09/2018 18:05,136,134,108,98,476,4,50
662,3/09/2018 18:10,119,133,108,98,458,4,50
663,3/09/2018 18:15,122,127,102,92,443,4,50
664,3/09/2018 18:20,121,126,98,88,433,4,50
665,3/09/2018 18:25,126,117,97,88,428,4,50
666,3/09/2018 18:30,131,125,95,86,437,4,50
667,3/09/2018 18:35,114,123,98,89,424,4,50
668,3/09/2018 18:40,114,99,88,79,380,4,50
669,3/09/2018 18:45,123,100,89,81,393,4,50
670,3/09/2018 18:50,113,114,92,83,402,4,50
671,3/09/2018 18:55,136,129,96,86,447,4,50
672,3/09/2018 19:00,111,113,88,79,391,4,50
673,3/09/2018 19:05,113,124,89,80,406,4,50
674,3/09/2018 19:10,99,113,87,78,377,4,50
675,3/09/2018 19:15,98,117,91,82,388,4,50
676,3/09/2018 19:20,109,108,85,77,379,4,50
677,3/09/2018 19:25,87,100,90,81,358,4,50
678,3/09/2018 19:30,94,91,80,71,336,4,50
679,3/09/2018 19:35,114,129,90,81,414,4,50
680,3/09/2018 19:40,108,124,96,86,414,4,50
681,3/09/2018 19:45,111,121,101,91,424,4,50
682,3/09/2018 19:50,103,98,89,80,370,4,50
683,3/09/2018 19:55,96,95,86,77,354,4,50
684,3/09/2018 20:00,88,94,82,73,337,4,50
685,3/09/2018 20:05,97,90,80,71,338,4,50
686,3/09/2018 20:10,98,97,78,70,343,4,50
687,3/09/2018 20:15,98,96,85,76,355,4,50
688,3/09/2018 20:20,104,86,77,69,336,4,50
689,3/09/2018 20:25,92,101,73,65,331,4,50
690,3/09/2018 20:30,82,87,81,72,322,4,50
691,3/09/2018 20:35,105,99,72,64,340,4,50
692,3/09/2018 20:40,91,103,83,75,352,4,50
693,3/09/2018 20:45,100,87,75,66,328,4,50
694,3/09/2018 20:50,94,101,75,66,336,4,50
695,3/09/2018 20:55,86,90,81,73,330,4,50
696,3/09/2018 21:00,78,89,77,69,313,4,50
697,3/09/2018 21:05,75,87,77,68,307,4,50
698,3/09/2018 21:10,76,88,76,68,308,4,50
699,3/09/2018 21:15,74,94,75,67,310,4,50
700,3/09/2018 21:20,76,90,69,61,296,4,50
701,3/09/2018 21:25,73,89,78,70,310,4,50
702,3/09/2018 21:30,73,81,72,64,290,4,50
703,3/09/2018 21:35,76,88,73,65,302,4,50
704,3/09/2018 21:40,75,88,75,67,305,4,50
705,3/09/2018 21:45,74,76,70,62,282,4,50
706,3/09/2018 21:50,61,84,65,57,267,4,50
707,3/09/2018 21:55,66,74,60,53,253,4,50
708,3/09/2018 22:00,63,90,64,57,274,4,50
709,3/09/2018 22:05,61,83,59,51,254,4,50
710,3/09/2018 22:10,51,60,56,49,216,4,50
711,3/09/2018 22:15,69,81,62,55,267,4,50
712,3/09/2018 22:20,53,76,62,55,246,4,50
713,3/09/2018 22:25,74,89,58,51,272,4,50
714,3/09/2018 22:30,71,71,64,56,262,4,50
715,3/09/2018 22:35,58,78,64,57,257,4,50
716,3/09/2018 22:40,59,67,56,49,231,4,50
717,3/09/2018 22:45,51,60,62,54,227,4,50
718,3/09/2018 22:50,49,51,53,47,200,4,50
719,3/09/2018 22:55,60,65,53,46,224,4,50
720,3/09/2018 23:00,62,60,56,49,227,4,50
721,3/09/2018 23:05,67,60,57,49,233,4,50
722,3/09/2018 23:10,50,68,53,46,217,4,50
723,3/09/2018 23:15,30,43,46,40,159,4,50
724,3/09/2018 23:20,45,57,44,37,183,4,50
725,3/09/2018 23:25,33,53,50,43,179,4,50
726,3/09/2018 23:30,39,54,45,38,176,4,50
727,3/09/2018 23:35,40,42,50,43,175,4,50
728,3/09/2018 23:40,44,63,51,44,202,4,50
729,3/09/2018 23:45,39,48,47,40,174,4,50
730,3/09/2018 23:50,35,51,51,43,180,4,50
731,3/09/2018 23:55,40,44,43,36,163,4,50
732,3/10/2018 0:00,46,26,37,31,140,4,50
733,3/10/2018 0:05,27,45,39,33,144,4,50
734,3/10/2018 0:10,22,40,41,34,137,4,50
735,3/10/2018 0:15,30,46,34,27,137,4,50
736,3/10/2018 0:20,26,33,29,24,112,4,50
737,3/10/2018 0:25,30,40,29,23,122,4,50
738,3/10/2018 0:30,38,41,39,33,151,4,50
739,3/10/2018 0:35,24,44,29,23,120,4,50
740,3/10/2018 0:40,30,37,38,31,136,4,50
741,3/10/2018 0:45,26,33,33,27,119,4,50
742,3/10/2018 0:50,20,23,32,25,100,4,50
743,3/10/2018 0:55,25,38,32,26,121,4,50
744,3/10/2018 1:00,17,23,24,18,82,4,50
745,3/10/2018 1:05,24,15,24,18,81,4,50
746,3/10/2018 1:10,29,30,24,18,101,4,50
747,3/10/2018 1:15,16,22,20,15,73,4,50
748,3/10/2018 1:20,19,26,24,18,87,4,50
749,3/10/2018 1:25,13,32,24,18,87,4,50
750,3/10/2018 1:30,13,28,29,23,93,4,50
751,3/10/2018 1:35,17,21,22,17,77,4,50
752,3/10/2018 1:40,13,18,22,17,70,4,50
753,3/10/2018 1:45,7,22,27,21,77,4,50
754,3/10/2018 1:50,22,28,25,19,94,4,50
755,3/10/2018 1:55,14,14,18,13,59,4,50
756,3/10/2018 2:00,15,30,26,21,92,4,50
757,3/10/2018 2:05,15,25,25,20,85,4,50
758,3/10/2018 2:10,12,18,20,15,65,4,50
759,3/10/2018 2:15,15,26,24,18,83,4,50
760,3/10/2018 2:20,17,23,27,22,89,4,50
761,3/10/2018 2:25,10,19,25,20,74,4,50
762,3/10/2018 2:30,13,22,25,20,80,4,50
763,3/10/2018 2:35,19,23,21,16,79,4,50
764,3/10/2018 2:40,12,24,21,16,73,4,50
765,3/10/2018 2:45,16,17,22,20,75,4,50
766,3/10/2018 2:50,18,24,24,19,85,4,50
767,3/10/2018 2:55,9,18,17,12,56,4,50
768,3/10/2018 3:00,5,17,21,15,58,4,50
769,3/10/2018 3:05,17,20,19,14,70,4,50
770,3/10/2018 3:10,11,16,19,13,59,4,50
771,3/10/2018 3:15,7,15,18,13,53,4,50
772,3/10/2018 3:20,8,17,17,12,54,4,50
773,3/10/2018 3:25,10,14,24,18,66,4,50
774,3/10/2018 3:30,15,19,22,16,72,4,50
775,3/10/2018 3:35,15,19,19,14,67,4,50
776,3/10/2018 3:40,9,11,17,11,48,4,50
777,3/10/2018 3:45,9,21,17,12,59,4,50
778,3/10/2018 3:50,9,19,18,13,59,4,50
779,3/10/2018 3:55,9,24,16,12,61,4,50
780,3/10/2018 4:00,9,13,15,10,47,4,50
781,3/10/2018 4:05,11,14,15,9,49,4,50
782,3/10/2018 4:10,10,23,19,14,66,4,50
783,3/10/2018 4:15,12,22,21,16,71,4,50
784,3/10/2018 4:20,13,20,23,17,73,4,50
785,3/10/2018 4:25,34,34,22,17,107,4,50
786,3/10/2018 4:30,16,28,26,21,91,4,50
787,3/10/2018 4:35,22,27,34,28,111,4,50
788,3/10/2018 4:40,18,32,24,18,92,4,50
789,3/10/2018 4:45,18,27,32,26,103,4,50
790,3/10/2018 4:50,14,34,27,21,96,4,50
791,3/10/2018 4:55,24,39,29,23,115,4,50
792,3/10/2018 5:00,17,28,23,18,86,4,50
793,3/10/2018 5:05,16,36,29,24,105,4,50
794,3/10/2018 5:10,28,34,24,19,105,4,50
795,3/10/2018 5:15,26,30,35,29,120,4,50
796,3/10/2018 5:20,29,36,31,25,121,4,50
797,3/10/2018 5:25,43,43,31,25,142,4,50
798,3/10/2018 5:30,33,35,37,31,136,4,50
799,3/10/2018 5:35,43,42,37,31,153,4,50
800,3/10/2018 5:40,38,56,40,34,168,4,50
801,3/10/2018 5:45,31,45,50,43,169,4,50
802,3/10/2018 5:50,32,47,45,38,162,4,50
803,3/10/2018 5:55,32,47,36,29,144,4,50
804,3/10/2018 6:00,38,51,41,35,165,4,50
805,3/10/2018 6:05,36,34,40,34,144,4,50
806,3/10/2018 6:10,40,47,39,33,159,4,50
807,3/10/2018 6:15,49,60,45,38,192,4,50
808,3/10/2018 6:20,56,65,44,37,202,4,50
809,3/10/2018 6:25,47,53,48,41,189,4,50
810,3/10/2018 6:30,54,63,62,55,234,4,50
811,3/10/2018 6:35,70,66,62,55,253,4,50
812,3/10/2018 6:40,64,63,64,56,247,4,50
813,3/10/2018 6:45,58,73,65,57,253,4,50
814,3/10/2018 6:50,56,73,67,59,255,4,50
815,3/10/2018 6:55,66,76,61,54,257,4,50
816,3/10/2018 7:00,63,60,61,53,237,4,50
817,3/10/2018 7:05,68,76,59,52,255,4,50
818,3/10/2018 7:10,73,75,64,57,269,4,50
819,3/10/2018 7:15,69,81,68,60,278,4,50
820,3/10/2018 7:20,88,99,76,68,331,4,50
821,3/10/2018 7:25,89,94,73,65,321,4,50
822,3/10/2018 7:30,87,94,74,66,321,4,50
823,3/10/2018 7:35,107,103,81,72,363,4,50
824,3/10/2018 7:40,86,113,87,78,364,4,50
825,3/10/2018 7:45,91,94,69,62,316,4,50
826,3/10/2018 7:50,89,87,79,70,325,4,50
827,3/10/2018 7:55,78,112,82,74,346,4,50
828,3/10/2018 8:00,107,104,74,66,351,4,50
829,3/10/2018 8:05,93,104,60,53,310,4,50
830,3/10/2018 8:10,90,101,67,60,318,4,50
831,3/10/2018 8:15,118,114,82,74,388,4,50
832,3/10/2018 8:20,95,96,82,74,347,4,50
833,3/10/2018 8:25,103,100,82,73,358,4,50
834,3/10/2018 8:30,130,111,94,85,420,4,50
835,3/10/2018 8:35,133,114,82,73,402,4,50
836,3/10/2018 8:40,127,117,88,79,411,4,50
837,3/10/2018 8:45,115,119,90,81,405,4,50
838,3/10/2018 8:50,121,127,83,75,406,4,50
839,3/10/2018 8:55,124,118,103,94,439,4,50
840,3/10/2018 9:00,97,117,86,77,377,4,50
841,3/10/2018 9:05,110,110,77,68,365,4,50
842,3/10/2018 9:10,112,116,82,74,384,4,50
843,3/10/2018 9:15,108,104,85,77,374,4,50
844,3/10/2018 9:20,106,106,90,81,383,4,50
845,3/10/2018 9:25,117,112,83,75,387,4,50
846,3/10/2018 9:30,103,116,97,88,404,4,50
847,3/10/2018 9:35,120,113,85,77,395,4,50
848,3/10/2018 9:40,123,103,92,83,401,4,50
849,3/10/2018 9:45,124,120,102,92,438,4,50
850,3/10/2018 9:50,112,110,87,78,387,4,50
851,3/10/2018 9:55,113,118,93,84,408,4,50
852,3/10/2018 10:00,99,95,82,73,349,4,50
853,3/10/2018 10:05,108,117,90,81,396,4,50
854,3/10/2018 10:10,117,116,86,77,396,4,50
855,3/10/2018 10:15,135,108,90,81,414,4,50
856,3/10/2018 10:20,135,125,94,85,439,4,50
857,3/10/2018 10:25,115,108,81,73,377,4,50
858,3/10/2018 10:30,103,98,82,74,357,4,50
859,3/10/2018 10:35,114,128,96,87,425,4,50
860,3/10/2018 10:40,113,93,85,76,367,4,50
861,3/10/2018 10:45,108,105,89,80,382,4,50
862,3/10/2018 10:50,126,127,102,93,448,4,50
863,3/10/2018 10:55,117,111,93,84,405,4,50
864,3/10/2018 11:00,123,128,88,79,418,4,50
865,3/10/2018 11:05,116,124,97,87,424,4,50
866,3/10/2018 11:10,114,121,80,71,386,4,50
867,3/10/2018 11:15,114,125,88,79,406,4,50
868,3/10/2018 11:20,118,121,99,90,428,4,50
869,3/10/2018 11:25,122,114,84,75,395,4,50
870,3/10/2018 11:30,119,121,96,86,422,4,50
871,3/10/2018 11:35,104,106,84,76,370,4,50
872,3/10/2018 11:40,131,121,99,89,440,4,50
873,3/10/2018 11:45,126,133,95,86,440,4,50
874,3/10/2018 11:50,133,115,100,91,439,4,50
875,3/10/2018 11:55,123,130,94,85,432,4,50
876,3/10/2018 12:00,110,100,90,81,381,4,50
877,3/10/2018 12:05,105,119,101,92,417,4,50
878,3/10/2018 12:10,119,125,99,90,433,4,50
879,3/10/2018 12:15,126,120,99,89,434,4,50
880,3/10/2018 12:20,104,116,94,85,399,4,50
881,3/10/2018 12:25,103,108,88,79,378,4,50
882,3/10/2018 12:30,113,120,93,84,410,4,50
883,3/10/2018 12:35,119,103,90,81,393,4,50
884,3/10/2018 12:40,114,100,91,82,387,4,50
885,3/10/2018 12:45,131,118,98,89,436,4,50
886,3/10/2018 12:50,113,129,93,84,419,4,50
887,3/10/2018 12:55,109,112,96,86,403,4,50
888,3/10/2018 13:00,114,113,90,81,398,4,50
889,3/10/2018 13:05,76,75,75,67,293,4,50
890,3/10/2018 13:10,101,112,82,73,368,4,50
891,3/10/2018 13:15,127,136,94,85,442,4,50
892,3/10/2018 13:20,102,108,93,84,387,4,50
893,3/10/2018 13:25,104,118,94,85,401,4,50
894,3/10/2018 13:30,103,117,101,91,412,4,50
895,3/10/2018 13:35,106,113,87,78,384,4,50
896,3/10/2018 13:40,122,124,102,92,440,4,50
897,3/10/2018 13:45,120,113,95,86,414,4,50
898,3/10/2018 13:50,111,129,90,81,411,4,50
899,3/10/2018 13:55,124,122,93,84,423,4,50
900,3/10/2018 14:00,121,129,97,88,435,4,50
901,3/10/2018 14:05,129,122,100,91,442,4,50
902,3/10/2018 14:10,122,131,99,90,442,4,50
903,3/10/2018 14:15,122,134,93,83,432,4,50
904,3/10/2018 14:20,113,120,98,89,420,4,50
905,3/10/2018 14:25,123,121,98,89,431,4,50
906,3/10/2018 14:30,116,119,85,76,396,4,50
907,3/10/2018 14:35,117,127,96,87,427,4,50
908,3/10/2018 14:40,133,130,104,94,461,4,50
909,3/10/2018 14:45,120,116,101,91,428,4,50
910,3/10/2018 14:50,104,105,80,72,361,4,50
911,3/10/2018 14:55,103,117,93,84,397,4,50
912,3/10/2018 15:00,122,113,88,79,402,4,50
913,3/10/2018 15:05,96,110,97,88,391,4,50
914,3/10/2018 15:10,100,111,93,84,388,4,50
915,3/10/2018 15:15,110,125,88,79,402,4,50
916,3/10/2018 15:20,130,122,97,88,437,4,50
917,3/10/2018 15:25,116,120,96,87,419,4,50
918,3/10/2018 15:30,118,113,94,85,410,4,50
919,3/10/2018 15:35,113,110,94,85,402,4,50
920,3/10/2018 15:40,97,106,94,85,382,4,50
921,3/10/2018 15:45,95,108,81,73,357,4,50
922,3/10/2018 15:50,122,115,97,87,421,4,50
923,3/10/2018 15:55,118,114,90,81,403,4,50
924,3/10/2018 16:00,102,99,88,79,368,4,50
925,3/10/2018 16:05,97,103,89,81,370,4,50
926,3/10/2018 16:10,107,97,88,79,371,4,50
927,3/10/2018 16:15,110,107,95,86,398,4,50
928,3/10/2018 16:20,110,110,86,77,383,4,50
929,3/10/2018 16:25,96,91,84,75,346,4,50
930,3/10/2018 16:30,111,110,77,68,366,4,50
931,3/10/2018 16:35,101,100,85,77,363,4,50
932,3/10/2018 16:40,84,102,84,75,345,4,50
933,3/10/2018 16:45,89,114,80,71,354,4,50
934,3/10/2018 16:50,102,107,80,72,361,4,50
935,3/10/2018 16:55,96,116,77,68,357,4,50
936,3/10/2018 17:00,105,106,90,81,382,4,50
937,3/10/2018 17:05,95,102,89,80,366,4,50
938,3/10/2018 17:10,114,98,89,80,381,4,50
939,3/10/2018 17:15,93,106,86,77,362,4,50
940,3/10/2018 17:20,100,99,89,81,369,4,50
941,3/10/2018 17:25,101,100,86,77,364,4,50
942,3/10/2018 17:30,105,106,72,64,347,4,50
943,3/10/2018 17:35,73,96,80,71,320,4,50
944,3/10/2018 17:40,95,106,75,67,343,4,50
945,3/10/2018 17:45,92,107,84,76,359,4,50
946,3/10/2018 17:50,95,97,81,73,346,4,50
947,3/10/2018 17:55,85,94,73,65,317,4,50
948,3/10/2018 18:00,105,103,84,75,367,4,50
949,3/10/2018 18:05,99,93,83,75,350,4,50
950,3/10/2018 18:10,100,88,82,73,343,4,50
951,3/10/2018 18:15,88,91,78,70,327,4,50
952,3/10/2018 18:20,100,99,85,77,361,4,50
953,3/10/2018 18:25,88,98,79,70,335,4,50
954,3/10/2018 18:30,87,90,80,72,329,4,50
955,3/10/2018 18:35,93,102,84,75,354,4,50
956,3/10/2018 18:40,87,93,82,73,335,4,50
957,3/10/2018 18:45,79,97,72,64,312,4,50
958,3/10/2018 18:50,99,93,84,75,351,4,50
959,3/10/2018 18:55,74,86,75,66,301,4,50
960,3/10/2018 19:00,89,94,84,75,342,4,50
961,3/10/2018 19:05,81,88,70,62,301,4,50
962,3/10/2018 19:10,90,98,86,77,351,4,50
963,3/10/2018 19:15,89,84,76,68,317,4,50
964,3/10/2018 19:20,73,100,81,73,327,4,50
965,3/10/2018 19:25,88,97,74,66,325,4,50
966,3/10/2018 19:30,96,84,79,70,329,4,50
967,3/10/2018 19:35,94,90,75,67,326,4,50
968,3/10/2018 19:40,70,83,67,60,280,4,50
969,3/10/2018 19:45,71,82,72,64,289,4,50
970,3/10/2018 19:50,77,76,67,60,280,4,50
971,3/10/2018 19:55,66,85,68,60,279,4,50
972,3/10/2018 20:00,81,79,74,66,300,4,50
973,3/10/2018 20:05,72,93,69,62,296,4,50
974,3/10/2018 20:10,65,73,64,57,259,4,50
975,3/10/2018 20:15,72,76,73,65,286,4,50
976,3/10/2018 20:20,68,82,67,60,277,4,50
977,3/10/2018 20:25,62,79,64,56,261,4,50
978,3/10/2018 20:30,61,75,64,56,256,4,50
979,3/10/2018 20:35,73,79,69,61,282,4,50
980,3/10/2018 20:40,68,70,69,61,268,4,50
981,3/10/2018 20:45,65,69,61,53,248,4,50
982,3/10/2018 20:50,49,60,59,51,219,4,50
983,3/10/2018 20:55,26,44,50,43,163,4,50
984,3/10/2018 21:00,31,43,45,39,158,4,50
985,3/10/2018 21:05,59,67,54,47,227,4,50
986,3/10/2018 21:10,77,82,63,55,277,4,50
987,3/10/2018 21:15,74,83,72,64,293,4,50
988,3/10/2018 21:20,63,63,53,45,224,4,50
989,3/10/2018 21:25,54,73,60,52,239,4,50
990,3/10/2018 21:30,69,81,72,64,286,4,50
991,3/10/2018 21:35,66,66,61,53,246,4,50
992,3/10/2018 21:40,60,60,62,54,236,4,50
993,3/10/2018 21:45,66,86,62,54,268,4,50
994,3/10/2018 21:50,68,76,61,54,259,4,50
995,3/10/2018 21:55,64,80,53,46,243,4,50
996,3/10/2018 22:00,60,74,59,51,244,4,50
997,3/10/2018 22:05,56,70,56,49,231,4,50
998,3/10/2018 22:10,66,59,61,53,239,4,50
999,3/10/2018 22:15,56,68,61,53,238,4,50
1000,3/10/2018 22:20,48,64,61,54,227,4,50
1001,3/10/2018 22:25,52,68,47,40,207,4,50
1002,3/10/2018 22:30,60,66,55,48,229,4,50
1003,3/10/2018 22:35,53,56,51,44,204,4,50
1004,3/10/2018 22:40,55,63,59,52,229,4,50
1005,3/10/2018 22:45,48,73,57,50,228,4,50
1006,3/10/2018 22:50,53,69,47,40,209,4,50
1007,3/10/2018 22:55,54,60,49,42,205,4,50
1008,3/10/2018 23:00,44,61,53,46,204,4,50
1009,3/10/2018 23:05,46,58,50,43,197,4,50
1010,3/10/2018 23:10,50,58,46,40,194,4,50
1011,3/10/2018 23:15,40,71,48,41,200,4,50
1012,3/10/2018 23:20,40,46,52,44,182,4,50
1013,3/10/2018 23:25,54,54,43,37,188,4,50
1014,3/10/2018 23:30,38,55,46,40,179,4,50
1015,3/10/2018 23:35,36,56,43,36,171,4,50
1016,3/10/2018 23:40,40,50,43,36,169,4,50
1017,3/10/2018 23:45,26,43,42,35,146,4,50
1018,3/10/2018 23:50,40,51,43,36,170,4,50
1019,3/10/2018 23:55,34,41,35,28,138,4,50
1020,3/11/2018 0:00,36,49,32,25,142,4,50
1021,3/11/2018 0:05,2,2,21,15,40,4,50
1022,3/11/2018 0:10,0,0,18,13,31,4,50
1023,3/11/2018 0:15,0,0,17,11,28,4,50
1024,3/11/2018 0:20,34,32,27,21,114,4,50
1025,3/11/2018 0:25,81,71,45,38,235,4,50
1026,3/11/2018 0:30,63,67,53,45,228,4,50
1027,3/11/2018 0:35,29,35,34,28,126,4,50
1028,3/11/2018 0:40,30,33,30,24,117,4,50
1029,3/11/2018 0:45,23,34,38,31,126,4,50
1030,3/11/2018 0:50,15,34,35,28,112,4,50
1031,3/11/2018 0:55,27,33,28,21,109,4,50
1032,3/11/2018 1:00,26,34,22,16,98,4,50
1033,3/11/2018 1:05,26,30,25,19,100,4,50
1034,3/11/2018 1:10,10,20,25,19,74,4,50
1035,3/11/2018 1:15,11,21,23,17,72,4,50
1036,3/11/2018 1:20,10,26,19,13,68,4,50
1037,3/11/2018 1:25,16,27,23,18,84,4,50
1038,3/11/2018 1:30,37,39,31,26,133,4,50
1039,3/11/2018 1:35,22,33,31,25,111,4,50
1040,3/11/2018 1:40,10,17,24,19,70,4,50
1041,3/11/2018 1:45,18,24,25,20,87,4,50
1042,3/11/2018 1:50,13,20,25,20,78,4,50
1043,3/11/2018 1:55,9,20,20,15,64,4,50
1044,3/11/2018 3:00,7,25,22,17,71,4,50
1045,3/11/2018 3:05,18,26,19,14,77,4,50
1046,3/11/2018 3:10,16,15,21,16,68,4,50
1047,3/11/2018 3:15,17,22,21,16,76,4,50
1048,3/11/2018 3:20,16,21,23,17,77,4,50
1049,3/11/2018 3:25,12,24,26,20,82,4,50
1050,3/11/2018 3:30,22,31,23,17,93,4,50
1051,3/11/2018 3:35,18,22,23,18,81,4,50
1052,3/11/2018 3:40,8,18,19,14,59,4,50
1053,3/11/2018 3:45,11,18,19,13,61,4,50
1054,3/11/2018 3:50,15,24,21,16,76,4,50
1055,3/11/2018 3:55,14,18,16,11,59,4,50
1056,3/11/2018 4:00,6,20,25,20,71,4,50
1057,3/11/2018 4:05,8,15,10,9,42,4,0
1058,3/11/2018 4:10,0,20,17,18,55,4,50
1059,3/11/2018 4:15,12,24,16,11,63,4,50
1060,3/11/2018 4:20,16,19,23,17,75,4,50
1061,3/11/2018 4:25,13,21,19,14,67,4,50
1062,3/11/2018 4:30,19,19,16,11,65,4,50
1063,3/11/2018 4:35,6,18,15,10,49,4,50
1064,3/11/2018 4:40,13,23,21,15,72,4,50
1065,3/11/2018 4:45,17,16,25,20,78,4,50
1066,3/11/2018 4:50,16,22,20,14,72,4,50
1067,3/11/2018 4:55,9,26,19,14,68,4,50
1068,3/11/2018 5:00,11,20,15,9,55,4,50
1069,3/11/2018 5:05,14,23,23,17,77,4,50
1070,3/11/2018 5:10,6,23,15,10,54,4,50
1071,3/11/2018 5:15,15,21,23,18,77,4,50
1072,3/11/2018 5:20,21,18,22,17,78,4,50
1073,3/11/2018 5:25,14,26,20,15,75,4,50
1074,3/11/2018 5:30,24,29,20,15,88,4,50
1075,3/11/2018 5:35,10,21,21,16,68,4,50
1076,3/11/2018 5:40,20,28,20,15,83,4,50
1077,3/11/2018 5:45,24,25,21,16,86,4,50
1078,3/11/2018 5:50,23,36,24,18,101,4,50
1079,3/11/2018 5:55,20,25,28,23,96,4,50
1080,3/11/2018 6:00,12,26,23,17,78,4,50
1081,3/11/2018 6:05,21,23,29,24,97,4,50
1082,3/11/2018 6:10,19,30,22,16,87,4,50
1083,3/11/2018 6:15,21,37,26,21,105,4,50
1084,3/11/2018 6:20,32,43,34,27,136,4,50
1085,3/11/2018 6:25,36,42,32,26,136,4,50
1086,3/11/2018 6:30,33,50,29,23,135,4,50
1087,3/11/2018 6:35,38,41,45,38,162,4,50
1088,3/11/2018 6:40,37,52,36,30,155,4,50
1089,3/11/2018 6:45,30,45,29,23,127,4,50
1090,3/11/2018 6:50,36,49,43,37,165,4,50
1091,3/11/2018 6:55,36,51,37,31,155,4,50
1092,3/11/2018 7:00,36,41,31,26,134,4,50
1093,3/11/2018 7:05,33,42,35,29,139,4,50
1094,3/11/2018 7:10,32,38,36,29,135,4,50
1095,3/11/2018 7:15,37,39,34,28,138,4,50
1096,3/11/2018 7:20,42,53,42,36,173,4,50
1097,3/11/2018 7:25,30,42,43,36,151,4,50
1098,3/11/2018 7:30,42,49,35,29,155,4,50
1099,3/11/2018 7:35,30,43,48,41,162,4,50
1100,3/11/2018 7:40,43,51,42,36,172,4,50
1101,3/11/2018 7:45,42,48,46,39,175,4,50
1102,3/11/2018 7:50,41,46,49,42,178,4,50
1103,3/11/2018 7:55,44,48,44,38,174,4,50
1104,3/11/2018 8:00,37,54,46,40,177,4,50
1105,3/11/2018 8:05,33,47,41,35,156,4,50
1106,3/11/2018 8:10,40,38,37,31,146,4,50
1107,3/11/2018 8:15,35,46,44,37,162,4,50
1108,3/11/2018 8:20,38,50,50,43,181,4,50
1109,3/11/2018 8:25,48,51,43,36,178,4,50
1110,3/11/2018 8:30,45,51,52,45,193,4,50
1111,3/11/2018 8:35,51,59,46,40,196,4,50
1112,3/11/2018 8:40,64,56,57,50,227,4,50
1113,3/11/2018 8:45,50,67,58,51,226,4,50
1114,3/11/2018 8:50,53,63,50,43,209,4,50
1115,3/11/2018 8:55,52,62,52,45,211,4,50
1116,3/11/2018 9:00,55,63,51,44,213,4,50
1117,3/11/2018 9:05,48,56,53,46,203,4,50
1118,3/11/2018 9:10,51,66,56,49,222,4,50
1119,3/11/2018 9:15,49,67,57,50,223,4,50
1120,3/11/2018 9:20,46,66,59,52,223,4,50
1121,3/11/2018 9:25,69,77,54,47,247,4,50
1122,3/11/2018 9:30,67,69,67,59,262,4,50
1123,3/11/2018 9:35,79,90,73,65,307,4,50
1124,3/11/2018 9:40,84,80,72,64,300,4,50
1125,3/11/2018 9:45,88,90,71,63,312,4,50
1126,3/11/2018 9:50,91,84,74,66,315,4,50
1127,3/11/2018 9:55,74,88,62,55,279,4,50
1128,3/11/2018 10:00,79,78,72,64,293,4,50
1129,3/11/2018 10:05,89,84,71,63,307,4,50
1130,3/11/2018 10:10,91,99,74,66,330,4,50
1131,3/11/2018 10:15,80,88,67,60,295,4,50
1132,3/11/2018 10:20,102,112,70,62,346,4,50
1133,3/11/2018 10:25,86,94,68,60,308,4,50
1134,3/11/2018 10:30,85,81,77,68,311,4,50
1135,3/11/2018 10:35,97,105,74,66,342,4,50
1136,3/11/2018 10:40,96,98,89,80,363,4,50
1137,3/11/2018 10:45,109,113,96,87,405,4,50
1138,3/11/2018 10:50,104,99,83,75,361,4,50
1139,3/11/2018 10:55,90,100,74,66,330,4,50
1140,3/11/2018 11:00,99,110,82,74,365,4,50
1141,3/11/2018 11:05,90,97,77,68,332,4,50
1142,3/11/2018 11:10,96,98,77,69,340,4,50
1143,3/11/2018 11:15,106,102,81,73,362,4,50
1144,3/11/2018 11:20,119,110,85,76,390,4,50
1145,3/11/2018 11:25,116,112,99,89,416,4,50
1146,3/11/2018 11:30,96,92,67,60,315,4,50
1147,3/11/2018 11:35,121,101,91,82,395,4,50
1148,3/11/2018 11:40,114,96,75,66,351,4,50
1149,3/11/2018 11:45,111,121,82,74,388,4,50
1150,3/11/2018 11:50,110,110,84,76,380,4,50
1151,3/11/2018 11:55,119,120,88,79,406,4,50
1152,3/11/2018 12:00,88,107,90,81,366,4,50
1153,3/11/2018 12:05,98,104,89,80,371,4,50
1154,3/11/2018 12:10,116,122,101,91,430,4,50
1155,3/11/2018 12:15,114,123,91,82,410,4,50
1156,3/11/2018 12:20,99,111,85,77,372,4,50
1157,3/11/2018 12:25,113,100,89,80,382,4,50
1158,3/11/2018 12:30,117,109,93,84,403,4,50
1159,3/11/2018 12:35,106,102,87,79,374,4,50
1160,3/11/2018 12:40,108,114,91,82,395,4,50
1161,3/11/2018 12:45,126,130,86,77,419,4,50
1162,3/11/2018 12:50,113,113,89,80,395,4,50
1163,3/11/2018 12:55,108,109,95,86,398,4,50
1164,3/11/2018 13:00,119,113,95,86,413,4,50
1165,3/11/2018 13:05,110,128,83,75,396,4,50
1166,3/11/2018 13:10,120,136,101,91,448,4,50
1167,3/11/2018 13:15,104,116,95,86,401,4,50
1168,3/11/2018 13:20,104,112,82,73,371,4,50
1169,3/11/2018 13:25,115,117,89,80,401,4,50
1170,3/11/2018 13:30,128,123,96,87,434,4,50
1171,3/11/2018 13:35,122,122,101,91,436,4,50
1172,3/11/2018 13:40,116,125,90,81,412,4,50
1173,3/11/2018 13:45,101,113,90,81,385,4,50
1174,3/11/2018 13:50,107,112,88,79,386,4,50
1175,3/11/2018 13:55,101,120,81,73,375,4,50
1176,3/11/2018 14:00,103,109,83,75,370,4,50
1177,3/11/2018 14:05,119,123,88,79,409,4,50
1178,3/11/2018 14:10,104,119,94,85,402,4,50
1179,3/11/2018 14:15,111,128,90,81,410,4,50
1180,3/11/2018 14:20,103,122,95,85,405,4,50
1181,3/11/2018 14:25,99,124,90,81,394,4,50
1182,3/11/2018 14:30,111,111,91,82,395,4,50
1183,3/11/2018 14:35,113,112,94,85,404,4,50
1184,3/11/2018 14:40,109,113,86,77,385,4,50
1185,3/11/2018 14:45,114,116,91,82,403,4,50
1186,3/11/2018 14:50,103,119,99,89,410,4,50
1187,3/11/2018 14:55,116,100,82,73,371,4,50
1188,3/11/2018 15:00,109,118,93,84,404,4,50
1189,3/11/2018 15:05,122,107,87,78,394,4,50
1190,3/11/2018 15:10,97,98,85,77,357,4,50
1191,3/11/2018 15:15,109,104,86,77,376,4,50
1192,3/11/2018 15:20,107,111,98,89,405,4,50
1193,3/11/2018 15:25,107,92,84,76,359,4,50
1194,3/11/2018 15:30,110,105,87,78,380,4,50
1195,3/11/2018 15:35,114,117,98,89,418,4,50
1196,3/11/2018 15:40,94,118,98,88,398,4,50
1197,3/11/2018 15:45,115,109,92,83,399,4,50
1198,3/11/2018 15:50,102,109,90,81,382,4,50
1199,3/11/2018 15:55,89,110,89,80,368,4,50
1200,3/11/2018 16:00,113,114,100,91,418,4,50
1201,3/11/2018 16:05,116,127,89,80,412,4,50
1202,3/11/2018 16:10,100,113,89,80,382,4,50
1203,3/11/2018 16:15,118,122,91,82,413,4,50
1204,3/11/2018 16:20,91,117,96,86,390,4,50
1205,3/11/2018 16:25,113,124,97,88,422,4,50
1206,3/11/2018 16:30,124,123,95,86,428,4,50
1207,3/11/2018 16:35,105,111,94,85,395,4,50
1208,3/11/2018 16:40,113,111,89,80,393,4,50
1209,3/11/2018 16:45,127,114,85,76,402,4,50
1210,3/11/2018 16:50,118,117,89,80,404,4,50
1211,3/11/2018 16:55,106,104,87,78,375,4,50
1212,3/11/2018 17:00,100,106,90,81,377,4,50
1213,3/11/2018 17:05,101,111,82,74,368,4,50
1214,3/11/2018 17:10,99,103,88,79,369,4,50
1215,3/11/2018 17:15,103,98,87,78,366,4,50
1216,3/11/2018 17:20,105,118,83,75,381,4,50
1217,3/11/2018 17:25,99,114,85,77,375,4,50
1218,3/11/2018 17:30,113,106,88,79,386,4,50
1219,3/11/2018 17:35,108,103,84,76,371,4,50
1220,3/11/2018 17:40,104,107,90,81,382,4,50
1221,3/11/2018 17:45,82,117,85,76,360,4,50
1222,3/11/2018 17:50,102,114,88,79,383,4,50
1223,3/11/2018 17:55,101,94,80,72,347,4,50
1224,3/11/2018 18:00,92,104,79,70,345,4,50
1225,3/11/2018 18:05,94,99,82,74,349,4,50
1226,3/11/2018 18:10,98,108,82,73,361,4,50
1227,3/11/2018 18:15,103,97,83,75,358,4,50
1228,3/11/2018 18:20,96,103,85,76,360,4,50
1229,3/11/2018 18:25,94,120,82,73,369,4,50
1230,3/11/2018 18:30,113,106,84,75,378,4,50
1231,3/11/2018 18:35,106,94,82,74,356,4,50
1232,3/11/2018 18:40,93,100,87,78,358,4,50
1233,3/11/2018 18:45,98,104,73,65,340,4,50
1234,3/11/2018 18:50,84,97,70,62,313,4,50
1235,3/11/2018 18:55,93,89,75,67,324,4,50
1236,3/11/2018 19:00,97,93,72,64,326,4,50
1237,3/11/2018 19:05,87,88,71,63,309,4,50
1238,3/11/2018 19:10,84,92,84,76,336,4,50
1239,3/11/2018 19:15,74,93,75,67,309,4,50
1240,3/11/2018 19:20,76,96,79,70,321,4,50
1241,3/11/2018 19:25,77,82,75,66,300,4,50
1242,3/11/2018 19:30,74,97,76,68,315,4,50
1243,3/11/2018 19:35,83,89,82,74,328,4,50
1244,3/11/2018 19:40,82,100,80,71,333,4,50
1245,3/11/2018 19:45,97,99,88,79,363,4,50
1246,3/11/2018 19:50,100,89,75,66,330,4,50
1247,3/11/2018 19:55,91,94,80,71,336,4,50
1248,3/11/2018 20:00,79,93,84,75,331,4,50
1249,3/11/2018 20:05,81,100,80,72,333,4,50
1250,3/11/2018 20:10,90,104,75,66,335,4,50
1251,3/11/2018 20:15,85,86,74,66,311,4,50
1252,3/11/2018 20:20,96,99,81,72,348,4,50
1253,3/11/2018 20:25,91,89,69,61,310,4,50
1254,3/11/2018 20:30,86,93,80,71,330,4,50
1255,3/11/2018 20:35,89,87,68,60,304,4,50
1256,3/11/2018 20:40,84,90,72,63,309,4,50
1257,3/11/2018 20:45,78,82,72,64,296,4,50
1258,3/11/2018 20:50,79,68,67,59,273,4,50
1259,3/11/2018 20:55,76,87,76,68,307,4,50
1260,3/11/2018 21:00,79,91,70,62,302,4,50
1261,3/11/2018 21:05,69,90,68,60,287,4,50
1262,3/11/2018 21:10,84,76,68,60,288,4,50
1263,3/11/2018 21:15,69,84,68,60,281,4,50
1264,3/11/2018 21:20,67,81,69,61,278,4,50
1265,3/11/2018 21:25,74,83,72,64,293,4,50
1266,3/11/2018 21:30,72,79,57,50,258,4,50
1267,3/11/2018 21:35,70,86,62,54,272,4,50
1268,3/11/2018 21:40,68,77,58,51,254,4,50
1269,3/11/2018 21:45,76,80,62,55,273,4,50
1270,3/11/2018 21:50,58,71,56,49,234,4,50
1271,3/11/2018 21:55,69,84,55,48,256,4,50
1272,3/11/2018 22:00,86,77,64,57,284,4,50
1273,3/11/2018 22:05,57,70,61,53,241,4,50
1274,3/11/2018 22:10,88,66,59,52,265,4,50
1275,3/11/2018 22:15,54,62,51,44,211,4,50
1276,3/11/2018 22:20,60,63,51,44,218,4,50
1277,3/11/2018 22:25,50,66,53,45,214,4,50
1278,3/11/2018 22:30,42,56,50,43,191,4,50
1279,3/11/2018 22:35,68,64,49,42,223,4,50
1280,3/11/2018 22:40,45,67,48,42,202,4,50
1281,3/11/2018 22:45,57,58,45,38,198,4,50
1282,3/11/2018 22:50,53,61,51,44,209,4,50
1283,3/11/2018 22:55,41,53,40,34,168,4,50
1284,3/11/2018 23:00,37,43,43,36,159,4,50
1285,3/11/2018 23:05,32,45,40,33,150,4,50
1286,3/11/2018 23:10,44,48,38,31,161,4,50
1287,3/11/2018 23:15,36,46,42,36,160,4,50
1288,3/11/2018 23:20,33,36,41,35,145,4,50
1289,3/11/2018 23:25,28,32,38,32,130,4,50
1290,3/11/2018 23:30,23,50,27,22,122,4,50
1291,3/11/2018 23:35,30,32,32,25,119,4,50
1292,3/11/2018 23:40,29,42,34,27,132,4,50
1293,3/11/2018 23:45,27,30,29,23,109,4,50
1294,3/11/2018 23:50,17,21,34,27,99,4,50
1295,3/11/2018 23:55,16,28,33,26,103,4,50
1296,3/12/2018 0:00,22,24,24,19,89,4,50
1297,3/12/2018 0:05,19,33,27,22,101,4,50
1298,3/12/2018 0:10,21,29,30,24,104,4,50
1299,3/12/2018 0:15,19,25,29,23,96,4,50
1300,3/12/2018 0:20,15,24,25,20,84,4,50
1301,3/12/2018 0:25,17,33,27,21,98,4,50
1302,3/12/2018 0:30,13,17,26,20,76,4,50
1303,3/12/2018 0:35,17,28,23,17,85,4,50
1304,3/12/2018 0:40,7,18,28,22,75,4,50
1305,3/12/2018 0:45,9,18,22,17,66,4,50
1306,3/12/2018 0:50,12,16,26,20,74,4,50
1307,3/12/2018 0:55,7,16,19,14,56,4,50
1308,3/12/2018 1:00,11,18,22,17,68,4,50
1309,3/12/2018 1:05,8,12,20,14,54,4,50
1310,3/12/2018 1:10,7,16,22,17,62,4,50
1311,3/12/2018 1:15,14,17,18,13,62,4,50
1312,3/12/2018 1:20,10,12,20,14,56,4,50
1313,3/12/2018 1:25,8,14,18,13,53,4,50
1314,3/12/2018 1:30,5,13,15,10,43,4,50
1315,3/12/2018 1:35,10,10,13,8,41,4,50
1316,3/12/2018 1:40,6,14,19,13,52,4,50
1317,3/12/2018 1:45,6,16,12,8,42,4,50
1318,3/12/2018 1:50,6,11,16,11,44,4,50
1319,3/12/2018 1:55,6,10,16,11,43,4,50
1320,3/12/2018 2:00,10,11,19,14,54,4,50
1321,3/12/2018 2:05,10,19,17,12,58,4,50
1322,3/12/2018 2:10,3,16,13,8,40,4,50
1323,3/12/2018 2:15,11,11,15,10,47,4,50
1324,3/12/2018 2:20,4,17,14,9,44,4,50
1325,3/12/2018 2:25,8,10,12,7,37,4,50
1326,3/12/2018 2:30,8,19,12,6,45,4,50
1327,3/12/2018 2:35,7,10,15,9,41,4,50
1328,3/12/2018 2:40,9,13,10,5,37,4,50
1329,3/12/2018 2:45,5,9,12,8,34,4,50
1330,3/12/2018 2:50,6,12,13,8,39,4,50
1331,3/12/2018 2:55,1,14,11,6,32,4,50
1332,3/12/2018 3:00,9,13,15,10,47,4,50
1333,3/12/2018 3:05,4,10,13,8,35,4,50
1334,3/12/2018 3:10,9,13,15,9,46,4,50
1335,3/12/2018 3:15,3,13,14,10,40,4,50
1336,3/12/2018 3:20,10,18,18,13,59,4,50
1337,3/12/2018 3:25,7,11,19,13,50,4,50
1338,3/12/2018 3:30,17,22,17,12,68,4,50
1339,3/12/2018 3:35,17,28,22,17,84,4,50
1340,3/12/2018 3:40,18,20,22,17,77,4,50
1341,3/12/2018 3:45,12,20,23,17,72,4,50
1342,3/12/2018 3:50,16,21,22,16,75,4,50
1343,3/12/2018 3:55,26,29,18,13,86,4,50
1344,3/12/2018 4:00,10,20,19,14,63,4,50
1345,3/12/2018 4:05,17,29,30,24,100,4,50
1346,3/12/2018 4:10,20,37,25,20,102,4,50
1347,3/12/2018 4:15,22,33,27,22,104,4,50
1348,3/12/2018 4:20,38,42,44,37,161,4,50
1349,3/12/2018 4:25,42,41,34,27,144,4,50
1350,3/12/2018 4:30,48,52,50,43,193,4,50
1351,3/12/2018 4:35,41,48,37,31,157,4,50
1352,3/12/2018 4:40,54,53,48,41,196,4,50
1353,3/12/2018 4:45,53,57,42,35,187,4,50
1354,3/12/2018 4:50,47,51,55,48,201,4,50
1355,3/12/2018 4:55,58,57,40,34,189,4,50
1356,3/12/2018 5:00,61,50,46,40,197,4,50
1357,3/12/2018 5:05,65,61,58,51,235,4,50
1358,3/12/2018 5:10,75,81,60,53,269,4,50
1359,3/12/2018 5:15,84,84,61,54,283,4,50
1360,3/12/2018 5:20,97,75,70,62,304,4,50
1361,3/12/2018 5:25,95,109,77,68,349,4,50
1362,3/12/2018 5:30,117,101,76,68,362,4,50
1363,3/12/2018 5:35,98,82,75,67,322,4,50
1364,3/12/2018 5:40,116,114,77,68,375,4,50
1365,3/12/2018 5:45,123,105,94,85,407,4,50
1366,3/12/2018 5:50,110,103,92,83,388,4,50
1367,3/12/2018 5:55,120,102,82,74,378,4,50
1368,3/12/2018 6:00,118,98,89,80,385,4,50
1369,3/12/2018 6:05,117,98,84,75,374,4,50
1370,3/12/2018 6:10,108,104,93,84,389,4,50
1371,3/12/2018 6:15,121,120,93,84,418,4,50
1372,3/12/2018 6:20,117,109,89,80,395,4,50
1373,3/12/2018 6:25,130,110,78,70,388,4,50
1374,3/12/2018 6:30,116,111,97,88,412,4,50
1375,3/12/2018 6:35,133,121,93,84,431,4,50
1376,3/12/2018 6:40,130,124,101,91,446,4,50
1377,3/12/2018 6:45,141,132,95,86,454,4,50
1378,3/12/2018 6:50,136,127,104,94,461,4,50
1379,3/12/2018 6:55,152,140,104,94,490,4,50
1380,3/12/2018 7:00,145,135,96,86,462,4,50
1381,3/12/2018 7:05,146,137,103,93,479,4,50
1382,3/12/2018 7:10,169,151,107,97,524,4,50
1383,3/12/2018 7:15,158,147,117,106,528,4,50
1384,3/12/2018 7:20,166,148,107,97,518,4,50
1385,3/12/2018 7:25,146,129,95,86,456,4,50
1386,3/12/2018 7:30,150,144,104,94,492,4,50
1387,3/12/2018 7:35,131,129,111,101,472,4,50
1388,3/12/2018 7:40,135,121,104,95,455,4,50
1389,3/12/2018 7:45,138,140,106,96,480,4,50
1390,3/12/2018 7:50,145,139,106,96,486,4,50
1391,3/12/2018 7:55,145,132,108,98,483,4,50
1392,3/12/2018 8:00,146,110,96,87,439,4,50
1393,3/12/2018 8:05,143,134,101,91,469,4,50
1394,3/12/2018 8:10,143,128,98,89,458,4,50
1395,3/12/2018 8:15,148,120,98,88,454,4,50
1396,3/12/2018 8:20,142,119,102,92,455,4,50
1397,3/12/2018 8:25,142,146,104,94,486,4,50
1398,3/12/2018 8:30,133,136,106,97,472,4,50
1399,3/12/2018 8:35,147,124,85,77,433,4,50
1400,3/12/2018 8:40,156,142,96,87,481,4,50
1401,3/12/2018 8:45,144,124,96,86,450,4,50
1402,3/12/2018 8:50,150,138,93,84,465,4,50
1403,3/12/2018 8:55,146,123,87,78,434,4,50
1404,3/12/2018 9:00,125,110,89,80,404,4,50
1405,3/12/2018 9:05,121,130,86,77,414,4,50
1406,3/12/2018 9:10,127,112,82,74,395,4,50
1407,3/12/2018 9:15,148,116,100,90,454,4,50
1408,3/12/2018 9:20,120,113,82,73,388,4,50
1409,3/12/2018 9:25,114,116,80,71,381,4,50
1410,3/12/2018 9:30,135,114,75,67,391,4,50
1411,3/12/2018 9:35,108,119,81,72,380,4,50
1412,3/12/2018 9:40,123,117,93,84,417,4,50
1413,3/12/2018 9:45,122,125,79,70,396,4,50
1414,3/12/2018 9:50,114,104,75,67,360,4,50
1415,3/12/2018 9:55,121,107,86,77,391,4,50
1416,3/12/2018 10:00,119,96,83,75,373,4,50
1417,3/12/2018 10:05,117,115,89,80,401,4,50
1418,3/12/2018 10:10,123,124,81,73,401,4,50
1419,3/12/2018 10:15,118,113,80,72,383,4,50
1420,3/12/2018 10:20,135,113,81,73,402,4,50
1421,3/12/2018 10:25,112,107,77,68,364,4,50
1422,3/12/2018 10:30,122,111,81,73,387,4,50
1423,3/12/2018 10:35,112,107,82,74,375,4,50
1424,3/12/2018 10:40,112,114,85,77,388,4,50
1425,3/12/2018 10:45,114,106,80,72,372,4,50
1426,3/12/2018 10:50,108,121,76,68,373,4,50
1427,3/12/2018 10:55,104,110,76,68,358,4,50
1428,3/12/2018 11:00,117,109,78,70,374,4,50
1429,3/12/2018 11:05,105,110,79,70,364,4,50
1430,3/12/2018 11:10,99,104,80,71,354,4,50
1431,3/12/2018 11:15,98,102,75,66,341,4,50
1432,3/12/2018 11:20,125,117,82,74,398,4,50
1433,3/12/2018 11:25,113,110,85,77,385,4,50
1434,3/12/2018 11:30,108,103,79,70,360,4,50
1435,3/12/2018 11:35,116,101,84,75,376,4,50
1436,3/12/2018 11:40,113,104,84,75,376,4,50
1437,3/12/2018 11:45,122,118,77,68,385,4,50
1438,3/12/2018 11:50,104,113,91,82,390,4,50
1439,3/12/2018 11:55,100,99,87,79,365,4,50
1440,3/12/2018 12:00,94,90,72,64,320,4,50
1441,3/12/2018 12:05,85,89,82,74,330,4,50
1442,3/12/2018 12:10,118,104,82,73,377,4,50
1443,3/12/2018 12:15,107,98,74,66,345,4,50
1444,3/12/2018 12:20,130,123,80,71,404,4,50
1445,3/12/2018 12:25,106,114,93,84,397,4,50
1446,3/12/2018 12:30,115,115,82,74,386,4,50
1447,3/12/2018 12:35,121,117,90,81,409,4,50
1448,3/12/2018 12:40,107,110,82,74,373,4,50
1449,3/12/2018 12:45,98,116,88,79,381,4,50
1450,3/12/2018 12:50,96,100,87,78,361,4,50
1451,3/12/2018 12:55,107,108,89,80,384,4,50
1452,3/12/2018 13:00,95,103,69,62,329,4,50
1453,3/12/2018 13:05,106,109,80,71,366,4,50
1454,3/12/2018 13:10,113,105,78,70,366,4,50
1455,3/12/2018 13:15,109,105,71,63,348,4,50
1456,3/12/2018 13:20,117,106,91,82,396,4,50
1457,3/12/2018 13:25,111,110,82,73,376,4,50
1458,3/12/2018 13:30,137,124,87,78,426,4,50
1459,3/12/2018 13:35,119,123,86,77,405,4,50
1460,3/12/2018 13:40,130,117,81,73,401,4,50
1461,3/12/2018 13:45,126,120,93,84,423,4,50
1462,3/12/2018 13:50,114,124,90,81,409,4,50
1463,3/12/2018 13:55,127,110,79,70,386,4,50
1464,3/12/2018 14:00,115,111,76,68,370,4,50
1465,3/12/2018 14:05,104,114,82,74,374,4,50
1466,3/12/2018 14:10,121,123,93,84,421,4,50
1467,3/12/2018 14:15,137,113,90,81,421,4,50
1468,3/12/2018 14:20,118,118,94,85,415,4,50
1469,3/12/2018 14:25,122,104,93,84,403,4,50
1470,3/12/2018 14:30,123,121,94,85,423,4,50
1471,3/12/2018 14:35,120,132,89,80,421,4,50
1472,3/12/2018 14:40,132,127,88,79,426,4,50
1473,3/12/2018 14:45,139,122,96,86,443,4,50
1474,3/12/2018 14:50,129,111,93,84,417,4,50
1475,3/12/2018 14:55,168,143,109,99,519,4,50
1476,3/12/2018 15:00,143,121,102,92,458,4,50
1477,3/12/2018 15:05,136,128,102,92,458,4,50
1478,3/12/2018 15:10,142,130,104,95,471,4,50
1479,3/12/2018 15:15,160,133,77,69,439,4,50
1480,3/12/2018 15:20,137,136,110,100,483,4,50
1481,3/12/2018 15:25,126,129,93,84,432,4,50
1482,3/12/2018 15:30,167,138,88,79,472,4,50
1483,3/12/2018 15:35,148,141,90,81,460,4,50
1484,3/12/2018 15:40,153,133,101,91,478,4,50
1485,3/12/2018 15:45,143,116,102,92,453,4,50
1486,3/12/2018 15:50,151,137,106,96,490,4,50
1487,3/12/2018 15:55,135,126,99,89,449,4,50
1488,3/12/2018 16:00,128,122,98,89,437,4,50
1489,3/12/2018 16:05,155,139,112,102,508,4,50
1490,3/12/2018 16:10,139,147,106,96,488,4,50
1491,3/12/2018 16:15,167,147,114,104,532,4,50
1492,3/12/2018 16:20,151,139,101,91,482,4,50
1493,3/12/2018 16:25,157,130,107,97,491,4,50
1494,3/12/2018 16:30,164,157,118,107,546,4,50
1495,3/12/2018 16:35,138,139,107,97,481,4,50
1496,3/12/2018 16:40,148,148,111,101,508,4,50
1497,3/12/2018 16:45,153,124,105,96,478,4,50
1498,3/12/2018 16:50,154,139,104,94,491,4,50
1499,3/12/2018 16:55,154,142,118,108,522,4,50
1500,3/12/2018 17:00,158,121,99,90,468,4,50
1501,3/12/2018 17:05,150,133,108,98,489,4,50
1502,3/12/2018 17:10,156,134,110,100,500,4,50
1503,3/12/2018 17:15,151,160,115,105,531,4,50
1504,3/12/2018 17:20,167,142,114,103,526,4,50
1505,3/12/2018 17:25,147,131,104,94,476,4,50
1506,3/12/2018 17:30,148,143,112,101,504,4,50
1507,3/12/2018 17:35,161,119,104,94,478,4,50
1508,3/12/2018 17:40,139,124,102,92,457,4,50
1509,3/12/2018 17:45,145,145,114,103,507,4,50
1510,3/12/2018 17:50,134,123,97,88,442,4,50
1511,3/12/2018 17:55,136,134,106,96,472,4,50
1512,3/12/2018 18:00,121,124,94,85,424,4,50
1513,3/12/2018 18:05,131,124,106,96,457,4,50
1514,3/12/2018 18:10,140,134,114,105,493,4,50
1515,3/12/2018 18:15,154,133,109,99,495,4,50
1516,3/12/2018 18:20,140,138,103,93,474,4,50
1517,3/12/2018 18:25,146,149,105,95,495,4,50
1518,3/12/2018 18:30,139,123,97,88,447,4,50
1519,3/12/2018 18:35,127,123,105,95,450,4,50
1520,3/12/2018 18:40,118,125,91,82,416,4,50
1521,3/12/2018 18:45,118,125,101,91,435,4,50
1522,3/12/2018 18:50,119,110,97,88,414,4,50
1523,3/12/2018 18:55,120,109,90,81,400,4,50
1524,3/12/2018 19:00,105,110,80,72,367,4,50
1525,3/12/2018 19:05,110,106,86,77,379,4,50
1526,3/12/2018 19:10,99,97,87,78,361,4,50
1527,3/12/2018 19:15,112,120,88,79,399,4,50
1528,3/12/2018 19:20,108,112,86,77,383,4,50
1529,3/12/2018 19:25,90,90,75,67,322,4,50
1530,3/12/2018 19:30,88,93,78,70,329,4,50
1531,3/12/2018 19:35,96,93,79,70,338,4,50
1532,3/12/2018 19:40,90,98,77,69,334,4,50
1533,3/12/2018 19:45,80,92,84,76,332,4,50
1534,3/12/2018 19:50,76,95,82,74,327,4,50
1535,3/12/2018 19:55,72,79,75,67,293,4,50
1536,3/12/2018 20:00,87,82,73,65,307,4,50
1537,3/12/2018 20:05,66,89,66,58,279,4,50
1538,3/12/2018 20:10,87,91,77,69,324,4,50
1539,3/12/2018 20:15,90,91,80,72,333,4,50
1540,3/12/2018 20:20,90,77,73,65,305,4,50
1541,3/12/2018 20:25,64,68,63,55,250,4,50
1542,3/12/2018 20:30,80,87,69,61,297,4,50
1543,3/12/2018 20:35,79,86,54,47,266,4,50
1544,3/12/2018 20:40,89,85,72,64,310,4,50
1545,3/12/2018 20:45,56,80,61,53,250,4,50
1546,3/12/2018 20:50,66,66,59,51,242,4,50
1547,3/12/2018 20:55,53,66,57,50,226,4,50
1548,3/12/2018 21:00,65,81,53,46,245,4,50
1549,3/12/2018 21:05,64,64,56,49,233,4,50
1550,3/12/2018 21:10,57,79,66,58,260,4,50
1551,3/12/2018 21:15,58,78,54,47,237,4,50
1552,3/12/2018 21:20,54,57,54,46,211,4,50
1553,3/12/2018 21:25,78,66,63,55,262,4,50
1554,3/12/2018 21:30,47,56,50,43,196,4,50
1555,3/12/2018 21:35,74,79,56,49,258,4,50
1556,3/12/2018 21:40,59,61,54,47,221,4,50
1557,3/12/2018 21:45,53,59,59,52,223,4,50
1558,3/12/2018 21:50,45,56,51,44,196,4,50
1559,3/12/2018 21:55,49,56,51,44,200,4,50
1560,3/12/2018 22:00,52,56,53,46,207,4,50
1561,3/12/2018 22:05,49,58,56,49,212,4,50
1562,3/12/2018 22:10,49,50,54,47,200,4,50
1563,3/12/2018 22:15,57,65,53,47,222,4,50
1564,3/12/2018 22:20,51,60,49,42,202,4,50
1565,3/12/2018 22:25,39,50,49,42,180,4,50
1566,3/12/2018 22:30,40,61,55,48,204,4,50
1567,3/12/2018 22:35,52,58,45,38,193,4,50
1568,3/12/2018 22:40,41,63,40,34,178,4,50
1569,3/12/2018 22:45,54,54,57,50,215,4,50
1570,3/12/2018 22:50,39,51,39,33,162,4,50
1571,3/12/2018 22:55,32,51,35,29,147,4,50
1572,3/12/2018 23:00,26,40,41,35,142,4,50
1573,3/12/2018 23:05,17,34,32,26,109,4,50
1574,3/12/2018 23:10,32,38,40,33,143,4,50
1575,3/12/2018 23:15,42,58,50,44,194,4,50
1576,3/12/2018 23:20,64,89,58,51,262,4,50
1577,3/12/2018 23:25,57,87,55,48,247,4,50
1578,3/12/2018 23:30,49,63,47,40,199,4,50
1579,3/12/2018 23:35,30,51,41,35,157,4,50
1580,3/12/2018 23:40,37,52,43,36,168,4,50
1581,3/12/2018 23:45,33,54,45,38,170,4,50
1582,3/12/2018 23:50,29,41,48,41,159,4,50
1583,3/12/2018 23:55,17,39,41,35,132,4,50
1584,3/13/2018 0:00,25,42,40,34,141,4,50
1585,3/13/2018 0:05,36,45,40,34,155,4,50
1586,3/13/2018 0:10,27,43,43,36,149,4,50
1587,3/13/2018 0:15,22,35,36,30,123,4,50
1588,3/13/2018 0:20,25,36,35,29,125,4,50
1589,3/13/2018 0:25,21,41,35,29,126,4,50
1590,3/13/2018 0:30,25,34,28,23,110,4,50
1591,3/13/2018 0:35,25,32,34,27,118,4,50
1592,3/13/2018 0:40,13,34,31,26,104,4,50
1593,3/13/2018 0:45,16,33,30,24,103,4,50
1594,3/13/2018 0:50,16,31,30,24,101,4,50
1595,3/13/2018 0:55,16,33,24,18,91,4,50
1596,3/13/2018 1:00,24,23,26,21,94,4,50
1597,3/13/2018 1:05,14,32,25,20,91,4,50
1598,3/13/2018 1:10,23,28,30,25,106,4,50
1599,3/13/2018 1:15,14,27,25,19,85,4,50
1600,3/13/2018 1:20,7,16,19,14,56,4,50
1601,3/13/2018 1:25,9,18,21,16,64,4,50
1602,3/13/2018 1:30,17,37,27,22,103,4,50
1603,3/13/2018 1:35,19,32,33,27,111,4,50
1604,3/13/2018 1:40,19,27,24,18,88,4,50
1605,3/13/2018 1:45,19,31,23,18,91,4,50
1606,3/13/2018 1:50,9,18,25,20,72,4,50
1607,3/13/2018 1:55,9,22,22,17,70,4,50
1608,3/13/2018 2:00,8,18,23,18,67,4,50
1609,3/13/2018 2:05,16,24,21,16,77,4,50
1610,3/13/2018 2:10,15,34,27,21,97,4,50
1611,3/13/2018 2:15,14,27,25,19,85,4,50
1612,3/13/2018 2:20,12,28,25,20,85,4,50
1613,3/13/2018 2:25,17,23,26,21,87,4,50
1614,3/13/2018 2:30,10,24,25,19,78,4,50
1615,3/13/2018 2:35,15,27,23,17,82,4,50
1616,3/13/2018 2:40,13,29,27,22,91,4,50
1617,3/13/2018 2:45,16,23,29,23,91,4,50
1618,3/13/2018 2:50,9,19,20,15,63,4,50
1619,3/13/2018 2:55,10,25,20,15,70,4,50
1620,3/13/2018 3:00,17,25,29,23,94,4,50
1621,3/13/2018 3:05,10,22,28,23,83,4,50
1622,3/13/2018 3:10,8,24,25,20,77,4,50
1623,3/13/2018 3:15,16,24,30,24,94,4,50
1624,3/13/2018 3:20,12,31,27,22,92,4,50
1625,3/13/2018 3:25,25,33,29,23,110,4,50
1626,3/13/2018 3:30,23,31,28,22,104,4,50
1627,3/13/2018 3:35,27,41,31,25,124,4,50
1628,3/13/2018 3:40,28,44,36,30,138,4,50
1629,3/13/2018 3:45,30,36,36,30,132,4,50
1630,3/13/2018 3:50,28,36,33,27,124,4,50
1631,3/13/2018 3:55,22,44,36,29,131,4,50
1632,3/13/2018 4:00,25,41,31,25,122,4,50
1633,3/13/2018 4:05,29,50,46,39,164,4,50
1634,3/13/2018 4:10,44,58,38,31,171,4,50
1635,3/13/2018 4:15,49,59,44,37,189,4,50
1636,3/13/2018 4:20,55,83,55,48,241,4,50
1637,3/13/2018 4:25,60,70,52,45,227,4,50
1638,3/13/2018 4:30,80,97,62,54,293,4,50
1639,3/13/2018 4:35,83,90,68,60,301,4,50
1640,3/13/2018 4:40,75,95,61,53,284,4,50
1641,3/13/2018 4:45,75,77,67,60,279,4,50
1642,3/13/2018 4:50,54,60,53,47,214,4,50
1643,3/13/2018 4:55,61,66,45,39,211,4,50
1644,3/13/2018 5:00,61,73,58,51,243,4,50
1645,3/13/2018 5:05,79,71,59,52,261,4,50
1646,3/13/2018 5:10,72,62,58,50,242,4,50
1647,3/13/2018 5:15,104,92,77,68,341,4,50
1648,3/13/2018 5:20,95,100,75,67,337,4,50
1649,3/13/2018 5:25,116,109,80,72,377,4,50
1650,3/13/2018 5:30,121,113,74,66,374,4,50
1651,3/13/2018 5:35,118,113,93,84,408,4,50
1652,3/13/2018 5:40,116,113,94,85,408,4,50
1653,3/13/2018 5:45,127,110,94,85,416,4,50
1654,3/13/2018 5:50,124,124,90,81,419,4,50
1655,3/13/2018 5:55,119,116,85,77,397,4,50
1656,3/13/2018 6:00,143,108,91,82,424,4,50
1657,3/13/2018 6:05,117,112,86,77,392,4,50
1658,3/13/2018 6:10,126,106,85,77,394,4,50
1659,3/13/2018 6:15,128,111,94,85,418,4,50
1660,3/13/2018 6:20,138,117,86,77,418,4,50
1661,3/13/2018 6:25,124,124,98,89,435,4,50
1662,3/13/2018 6:30,117,122,90,81,410,4,50
1663,3/13/2018 6:35,138,121,105,96,460,4,50
1664,3/13/2018 6:40,150,130,95,86,461,4,50
1665,3/13/2018 6:45,164,132,104,94,494,4,50
1666,3/13/2018 6:50,144,138,98,89,469,4,50
1667,3/13/2018 6:55,151,137,82,73,443,4,50
1668,3/13/2018 7:00,155,126,101,92,474,4,50
1669,3/13/2018 7:05,164,141,101,91,497,4,50
1670,3/13/2018 7:10,149,145,106,97,497,4,50
1671,3/13/2018 7:15,165,151,106,96,518,4,50
1672,3/13/2018 7:20,164,141,117,107,529,4,50
1673,3/13/2018 7:25,157,154,120,109,540,4,50
1674,3/13/2018 7:30,155,146,114,104,519,4,50
1675,3/13/2018 7:35,149,141,100,90,480,4,50
1676,3/13/2018 7:40,136,139,104,94,473,4,50
1677,3/13/2018 7:45,149,140,100,90,479,4,50
1678,3/13/2018 7:50,129,122,100,91,442,4,50
1679,3/13/2018 7:55,152,123,101,92,468,4,50
1680,3/13/2018 8:00,144,119,86,78,427,4,50
1681,3/13/2018 8:05,142,133,96,87,458,4,50
1682,3/13/2018 8:10,147,133,90,81,451,4,50
1683,3/13/2018 8:15,154,134,93,84,465,4,50
1684,3/13/2018 8:20,147,130,100,90,467,4,50
1685,3/13/2018 8:25,147,125,98,89,459,4,50
1686,3/13/2018 8:30,165,150,94,85,494,4,50
1687,3/13/2018 8:35,144,134,96,87,461,4,50
1688,3/13/2018 8:40,166,160,97,88,511,4,50
1689,3/13/2018 8:45,162,145,85,76,468,4,50
1690,3/13/2018 8:50,136,127,87,78,428,4,50
1691,3/13/2018 8:55,132,128,75,66,401,4,50
1692,3/13/2018 9:00,131,126,64,56,377,4,50
1693,3/13/2018 9:05,135,122,73,65,395,4,50
1694,3/13/2018 9:10,125,129,75,67,396,4,50
1695,3/13/2018 9:15,112,101,75,67,355,4,50
1696,3/13/2018 9:20,79,87,73,65,304,4,50
1697,3/13/2018 9:25,144,132,85,77,438,4,50
1698,3/13/2018 9:30,134,124,82,74,414,4,50
1699,3/13/2018 9:35,121,111,83,75,390,4,50
1700,3/13/2018 9:40,104,120,86,77,387,4,50
1701,3/13/2018 9:45,54,55,58,50,217,4,50
1702,3/13/2018 9:50,177,159,88,79,503,4,50
1703,3/13/2018 9:55,139,108,78,70,395,4,50
1704,3/13/2018 10:00,112,115,76,68,371,4,50
1705,3/13/2018 10:05,124,104,76,68,372,4,50
1706,3/13/2018 10:10,142,112,87,78,419,4,50
1707,3/13/2018 10:15,123,121,77,69,390,4,50
1708,3/13/2018 10:20,132,110,88,79,409,4,50
1709,3/13/2018 10:25,125,132,82,73,412,4,50
1710,3/13/2018 10:30,120,119,82,73,394,4,50
1711,3/13/2018 10:35,142,123,89,80,434,4,50
1712,3/13/2018 10:40,127,120,85,77,409,4,50
1713,3/13/2018 10:45,118,123,72,63,376,4,50
1714,3/13/2018 10:50,109,104,75,67,355,4,50
1715,3/13/2018 10:55,126,118,72,64,380,4,50
1716,3/13/2018 11:00,103,101,78,70,352,4,50
1717,3/13/2018 11:05,96,114,78,70,358,4,50
1718,3/13/2018 11:10,96,94,86,77,353,4,50
1719,3/13/2018 11:15,95,106,86,77,364,4,50
1720,3/13/2018 11:20,123,104,82,74,383,4,50
1721,3/13/2018 11:25,132,120,100,91,443,4,50
1722,3/13/2018 11:30,115,119,89,80,403,4,50
1723,3/13/2018 11:35,124,101,75,67,367,4,50
1724,3/13/2018 11:40,120,96,75,67,358,4,50
1725,3/13/2018 11:45,118,113,80,72,383,4,50
1726,3/13/2018 11:50,114,138,85,77,414,4,50
1727,3/13/2018 11:55,112,116,82,74,384,4,50
0,3/13/2018 11:00,103,101,78,70,352,4,50
1,3/13/2018 11:05,96,114,78,70,358,4,50
2,3/13/2018 11:10,96,94,86,77,353,4,50
3,3/13/2018 11:15,95,106,86,77,364,4,50
4,3/13/2018 11:20,123,104,82,74,383,4,50
5,3/13/2018 11:25,132,120,100,91,443,4,50
6,3/13/2018 11:30,115,119,89,80,403,4,50
7,3/13/2018 11:35,124,101,75,67,367,4,50
8,3/13/2018 11:40,120,96,75,67,358,4,50
9,3/13/2018 11:45,118,113,80,72,383,4,50
10,3/13/2018 11:50,114,138,85,77,414,4,50
11,3/13/2018 11:55,112,116,82,74,384,4,50
12,3/13/2018 12:00,110,108,81,73,372,4,50
13,3/13/2018 12:05,105,105,81,73,364,4,50
14,3/13/2018 12:10,125,109,89,80,403,4,50
15,3/13/2018 12:15,120,110,84,75,389,4,50
16,3/13/2018 12:20,121,113,79,70,383,4,50
17,3/13/2018 12:25,107,109,85,77,378,4,50
18,3/13/2018 12:30,94,111,81,73,359,4,50
19,3/13/2018 12:35,95,113,85,77,370,4,50
20,3/13/2018 12:40,90,87,69,62,308,4,50
21,3/13/2018 12:45,140,122,84,75,421,4,50
22,3/13/2018 12:50,106,119,99,90,414,4,50
23,3/13/2018 12:55,131,128,99,89,447,4,50
24,3/13/2018 13:00,113,128,80,72,393,4,50
25,3/13/2018 13:05,108,112,78,70,368,4,50
26,3/13/2018 13:10,124,123,75,67,389,4,50
27,3/13/2018 13:15,116,108,91,82,397,4,50
28,3/13/2018 13:20,130,124,93,84,431,4,50
29,3/13/2018 13:25,124,110,71,63,368,4,50
30,3/13/2018 13:30,100,112,93,84,389,4,50
31,3/13/2018 13:35,116,106,82,74,378,4,50
32,3/13/2018 13:40,114,111,84,75,384,4,50
33,3/13/2018 13:45,129,129,84,75,417,4,50
34,3/13/2018 13:50,111,88,78,69,346,4,50
35,3/13/2018 13:55,129,112,91,82,414,4,50
36,3/13/2018 14:00,128,111,85,76,400,4,50
37,3/13/2018 14:05,116,109,86,77,388,4,50
38,3/13/2018 14:10,114,112,82,74,382,4,50
39,3/13/2018 14:15,117,117,82,73,389,4,50
40,3/13/2018 14:20,131,123,96,86,436,4,50
41,3/13/2018 14:25,133,118,94,85,430,4,50
42,3/13/2018 14:30,136,125,86,77,424,4,50
43,3/13/2018 14:35,123,112,90,81,406,4,50
44,3/13/2018 14:40,151,142,82,74,449,4,50
45,3/13/2018 14:45,136,119,102,93,450,4,50
46,3/13/2018 14:50,144,130,101,92,467,4,50
47,3/13/2018 14:55,151,147,94,85,477,4,50
48,3/13/2018 15:00,151,134,102,92,479,4,50
49,3/13/2018 15:05,144,130,88,79,441,4,50
50,3/13/2018 15:10,158,112,99,89,458,4,50
51,3/13/2018 15:15,153,131,109,99,492,4,50
52,3/13/2018 15:20,146,133,101,92,472,4,50
53,3/13/2018 15:25,139,134,101,92,466,4,50
54,3/13/2018 15:30,141,124,98,89,452,4,50
55,3/13/2018 15:35,122,121,97,88,428,4,50
56,3/13/2018 15:40,110,119,93,84,406,4,50
57,3/13/2018 15:45,128,115,90,81,414,4,50
58,3/13/2018 15:50,136,119,95,86,436,4,50
59,3/13/2018 15:55,129,113,90,81,413,4,50
60,3/13/2018 16:00,119,131,94,85,429,4,50
61,3/13/2018 16:05,132,112,93,84,421,4,50
62,3/13/2018 16:10,149,136,95,86,466,4,50
63,3/13/2018 16:15,140,119,95,86,440,4,50
64,3/13/2018 16:20,143,133,90,81,447,4,50
65,3/13/2018 16:25,129,113,94,85,421,4,50
66,3/13/2018 16:30,131,118,89,80,418,4,50
67,3/13/2018 16:35,140,119,104,94,457,4,50
68,3/13/2018 16:40,134,132,107,97,470,4,50
69,3/13/2018 16:45,146,119,103,93,461,4,50
70,3/13/2018 16:50,111,137,91,82,421,4,50
71,3/13/2018 16:55,147,130,105,95,477,4,50
72,3/13/2018 17:00,141,138,106,97,482,4,50
73,3/13/2018 17:05,132,131,104,95,462,4,50
74,3/13/2018 17:10,148,142,93,84,467,4,50
75,3/13/2018 17:15,161,141,111,101,514,4,50
76,3/13/2018 17:20,158,143,119,108,528,4,50
77,3/13/2018 17:25,142,130,112,102,486,4,50
78,3/13/2018 17:30,152,143,116,106,517,4,50
79,3/13/2018 17:35,149,132,112,101,494,4,50
80,3/13/2018 17:40,144,135,103,93,475,4,50
81,3/13/2018 17:45,138,141,107,97,483,4,50
82,3/13/2018 17:50,147,121,102,92,462,4,50
83,3/13/2018 17:55,136,125,106,97,464,4,50
84,3/13/2018 18:00,135,123,98,88,444,4,50
85,3/13/2018 18:05,143,117,102,93,455,4,50
86,3/13/2018 18:10,121,129,102,92,444,4,50
87,3/13/2018 18:15,132,128,107,97,464,4,50
88,3/13/2018 18:20,136,140,105,95,476,4,50
89,3/13/2018 18:25,136,120,100,91,447,4,50
90,3/13/2018 18:30,124,126,96,87,433,4,50
91,3/13/2018 18:35,109,91,84,75,359,4,50
92,3/13/2018 18:40,115,122,94,85,416,4,50
93,3/13/2018 18:45,108,107,80,72,367,4,50
94,3/13/2018 18:50,108,115,91,82,396,4,50
95,3/13/2018 18:55,121,119,74,66,380,4,50
96,3/13/2018 19:00,110,100,75,67,352,4,50
97,3/13/2018 19:05,108,106,75,67,356,4,50
98,3/13/2018 19:10,114,101,88,79,382,4,50
99,3/13/2018 19:15,117,101,81,73,372,4,50
100,3/13/2018 19:20,113,106,89,80,388,4,50
101,3/13/2018 19:25,109,88,77,69,343,4,50
102,3/13/2018 19:30,108,96,77,69,350,4,50
103,3/13/2018 19:35,90,101,73,65,329,4,50
104,3/13/2018 19:40,90,96,81,72,339,4,50
105,3/13/2018 19:45,97,93,77,68,335,4,50
106,3/13/2018 19:50,78,92,67,60,297,4,50
107,3/13/2018 19:55,111,113,82,73,379,4,50
108,3/13/2018 20:00,67,88,72,64,291,4,50
109,3/13/2018 20:05,81,85,64,57,287,4,50
110,3/13/2018 20:10,83,94,76,68,321,4,50
111,3/13/2018 20:15,72,87,72,64,295,4,50
112,3/13/2018 20:20,71,73,61,53,258,4,50
113,3/13/2018 20:25,64,67,59,52,242,4,50
114,3/13/2018 20:30,65,87,65,57,274,4,50
115,3/13/2018 20:35,74,81,74,66,295,4,50
116,3/13/2018 20:40,71,80,67,60,278,4,50
117,3/13/2018 20:45,75,70,64,57,266,4,50
118,3/13/2018 20:50,73,91,76,68,308,4,50
119,3/13/2018 20:55,63,73,67,60,263,4,50
120,3/13/2018 21:00,57,72,60,53,242,4,50
121,3/13/2018 21:05,64,80,58,51,253,4,50
122,3/13/2018 21:10,51,62,63,55,231,4,50
123,3/13/2018 21:15,61,69,59,52,241,4,50
124,3/13/2018 21:20,78,77,65,57,277,4,50
125,3/13/2018 21:25,53,55,58,50,216,4,50
126,3/13/2018 21:30,51,70,56,49,226,4,50
127,3/13/2018 21:35,60,68,45,39,212,4,50
128,3/13/2018 21:40,71,73,66,58,268,4,50
129,3/13/2018 21:45,61,69,68,60,258,4,50
130,3/13/2018 21:50,70,64,54,47,235,4,50
131,3/13/2018 21:55,50,53,49,42,194,4,50
132,3/13/2018 22:00,41,52,50,43,186,4,50
133,3/13/2018 22:05,47,69,50,43,209,4,50
134,3/13/2018 22:10,60,61,61,53,235,4,50
135,3/13/2018 22:15,50,58,58,50,216,4,50
136,3/13/2018 22:20,48,60,49,42,199,4,50
137,3/13/2018 22:25,54,68,56,49,227,4,50
138,3/13/2018 22:30,63,64,47,40,214,4,50
139,3/13/2018 22:35,44,56,50,43,193,4,50
140,3/13/2018 22:40,45,74,53,47,219,4,50
141,3/13/2018 22:45,46,66,48,41,201,4,50
142,3/13/2018 22:50,51,64,40,33,188,4,50
143,3/13/2018 22:55,21,24,33,27,105,4,50
144,3/13/2018 23:00,19,39,38,31,127,4,50
145,3/13/2018 23:05,54,70,43,36,203,4,50
146,3/13/2018 23:10,74,89,74,66,303,4,50
147,3/13/2018 23:15,81,96,60,53,290,4,50
148,3/13/2018 23:20,73,94,65,57,289,4,50
149,3/13/2018 23:25,59,86,57,49,251,4,50
150,3/13/2018 23:30,52,86,52,45,235,4,50
151,3/13/2018 23:35,49,67,57,50,223,4,50
152,3/13/2018 23:40,53,64,53,45,215,4,50
153,3/13/2018 23:45,34,48,46,39,167,4,50
154,3/13/2018 23:50,41,55,46,40,182,4,50
155,3/13/2018 23:55,37,58,39,33,167,4,50
156,3/14/2018 0:00,27,49,38,32,146,4,50
157,3/14/2018 0:05,30,41,37,31,139,4,50
158,3/14/2018 0:10,30,46,35,29,140,4,50
159,3/14/2018 0:15,24,36,40,34,134,4,50
160,3/14/2018 0:20,27,44,37,31,139,4,50
161,3/14/2018 0:25,29,51,38,31,149,4,50
162,3/14/2018 0:30,20,50,42,35,147,4,50
163,3/14/2018 0:35,28,41,38,32,139,4,50
164,3/14/2018 0:40,24,29,34,28,115,4,50
165,3/14/2018 0:45,21,31,28,22,102,4,50
166,3/14/2018 0:50,21,38,40,33,132,4,50
167,3/14/2018 0:55,18,27,26,20,91,4,50
168,3/14/2018 1:00,22,29,24,19,94,4,50
169,3/14/2018 1:05,21,27,29,24,101,4,50
170,3/14/2018 1:10,15,32,33,27,107,4,50
171,3/14/2018 1:15,19,31,30,24,104,4,50
172,3/14/2018 1:20,16,26,25,20,87,4,50
173,3/14/2018 1:25,14,23,22,17,76,4,50
174,3/14/2018 1:30,12,26,29,24,91,4,50
175,3/14/2018 1:35,20,31,23,18,92,4,50
176,3/14/2018 1:40,11,28,29,23,91,4,50
177,3/14/2018 1:45,16,26,26,20,88,4,50
178,3/14/2018 1:50,7,19,15,9,50,4,50
179,3/14/2018 1:55,5,14,16,11,46,4,50
180,3/14/2018 2:00,13,28,29,23,93,4,50
181,3/14/2018 2:05,19,44,30,24,117,4,50
182,3/14/2018 2:10,19,27,29,23,98,4,50
183,3/14/2018 2:15,18,17,25,19,79,4,50
184,3/14/2018 2:20,15,35,26,20,96,4,50
185,3/14/2018 2:25,10,25,22,17,74,4,50
186,3/14/2018 2:30,11,24,19,14,68,4,50
187,3/14/2018 2:35,11,24,15,9,59,4,50
188,3/14/2018 2:40,14,21,19,13,67,4,50
189,3/14/2018 2:45,11,14,23,17,65,4,50
190,3/14/2018 2:50,7,13,15,10,45,4,50
191,3/14/2018 2:55,18,21,20,15,74,4,50
192,3/14/2018 3:00,2,12,12,7,33,4,50
193,3/14/2018 3:05,10,17,23,18,68,4,50
194,3/14/2018 3:10,7,11,15,10,43,4,50
195,3/14/2018 3:15,9,13,15,9,46,4,50
196,3/14/2018 3:20,15,12,15,10,52,4,50
197,3/14/2018 3:25,11,19,17,12,59,4,50
198,3/14/2018 3:30,10,11,20,15,56,4,50
199,3/14/2018 3:35,21,27,19,14,81,4,50
200,3/14/2018 3:40,11,25,24,18,78,4,50
201,3/14/2018 3:45,18,24,23,17,82,4,50
202,3/14/2018 3:50,13,17,24,18,72,4,50
203,3/14/2018 3:55,16,24,27,22,89,4,50
204,3/14/2018 4:00,14,22,28,23,87,4,50
205,3/14/2018 4:05,18,28,22,17,85,4,50
206,3/14/2018 4:10,19,30,28,23,100,4,50
207,3/14/2018 4:15,29,34,30,24,117,4,50
208,3/14/2018 4:20,33,48,37,31,149,4,50
209,3/14/2018 4:25,40,49,41,35,165,4,50
210,3/14/2018 4:30,31,48,43,36,158,4,50
211,3/14/2018 4:35,43,53,48,42,186,4,50
212,3/14/2018 4:40,53,40,44,38,175,4,50
213,3/14/2018 4:45,43,61,45,38,187,4,50
214,3/14/2018 4:50,62,60,44,38,204,4,50
215,3/14/2018 4:55,48,50,53,45,196,4,50
216,3/14/2018 5:00,55,59,40,34,188,4,50
217,3/14/2018 5:05,61,63,48,41,213,4,50
218,3/14/2018 5:10,76,76,59,51,262,4,50
219,3/14/2018 5:15,92,69,60,53,274,4,50
220,3/14/2018 5:20,91,105,69,61,326,4,50
221,3/14/2018 5:25,96,102,80,72,350,4,50
222,3/14/2018 5:30,112,106,85,76,379,4,50
223,3/14/2018 5:35,113,110,91,82,396,4,50
224,3/14/2018 5:40,117,104,91,82,394,4,50
225,3/14/2018 5:45,122,101,84,75,382,4,50
226,3/14/2018 5:50,120,98,82,74,374,4,50
227,3/14/2018 5:55,119,101,90,81,391,4,50
228,3/14/2018 6:00,110,107,82,73,372,4,50
229,3/14/2018 6:05,130,117,88,79,414,4,50
230,3/14/2018 6:10,126,103,82,73,384,4,50
231,3/14/2018 6:15,126,112,87,78,403,4,50
232,3/14/2018 6:20,126,103,91,82,402,4,50
233,3/14/2018 6:25,140,122,93,84,439,4,50
234,3/14/2018 6:30,138,122,90,81,431,4,50
235,3/14/2018 6:35,143,134,103,93,473,4,50
236,3/14/2018 6:40,125,123,99,89,436,4,50
237,3/14/2018 6:45,172,119,100,90,481,4,50
238,3/14/2018 6:50,142,120,93,84,439,4,50
239,3/14/2018 6:55,144,145,96,87,472,4,50
240,3/14/2018 7:00,151,142,104,94,491,4,50
241,3/14/2018 7:05,166,143,113,103,525,4,50
242,3/14/2018 7:10,154,130,104,94,482,4,50
243,3/14/2018 7:15,173,143,108,98,522,4,50
244,3/14/2018 7:20,160,161,109,99,529,4,50
245,3/14/2018 7:25,156,144,116,105,521,4,50
246,3/14/2018 7:30,169,142,106,96,513,4,50
247,3/14/2018 7:35,158,137,114,103,512,4,50
248,3/14/2018 7:40,158,122,105,95,480,4,50
249,3/14/2018 7:45,139,129,108,98,474,4,50
250,3/14/2018 7:50,134,135,98,89,456,4,50
251,3/14/2018 7:55,148,124,90,81,443,4,50
252,3/14/2018 8:00,132,134,103,93,462,4,50
253,3/14/2018 8:05,135,126,101,91,453,4,50
254,3/14/2018 8:10,163,124,97,88,472,4,50
255,3/14/2018 8:15,143,136,92,83,454,4,50
256,3/14/2018 8:20,149,142,84,75,450,4,50
257,3/14/2018 8:25,146,138,96,87,467,4,50
258,3/14/2018 8:30,146,137,90,81,454,4,50
259,3/14/2018 8:35,157,132,76,68,433,4,50
260,3/14/2018 8:40,144,131,87,78,440,4,50
261,3/14/2018 8:45,143,144,90,81,458,4,50
262,3/14/2018 8:50,135,122,87,78,422,4,50
263,3/14/2018 8:55,144,143,93,84,464,4,50
264,3/14/2018 9:00,139,128,88,79,434,4,50
265,3/14/2018 9:05,138,128,89,80,435,4,50
266,3/14/2018 9:10,125,115,81,73,394,4,50
267,3/14/2018 9:15,122,113,73,65,373,4,50
268,3/14/2018 9:20,140,121,83,75,419,4,50
269,3/14/2018 9:25,126,107,89,80,402,4,50
270,3/14/2018 9:30,127,126,80,71,404,4,50
271,3/14/2018 9:35,136,130,80,72,418,4,50
272,3/14/2018 9:40,142,131,87,78,438,4,50
273,3/14/2018 9:45,129,124,81,73,407,4,50
274,3/14/2018 9:50,120,126,96,87,429,4,50
275,3/14/2018 9:55,116,107,85,76,384,4,50
276,3/14/2018 10:00,115,106,82,73,376,4,50
277,3/14/2018 10:05,120,112,87,78,397,4,50
278,3/14/2018 10:10,119,109,67,60,355,4,50
279,3/14/2018 10:15,106,112,90,81,389,4,50
280,3/14/2018 10:20,137,124,88,79,428,4,50
281,3/14/2018 10:25,120,102,76,68,366,4,50
282,3/14/2018 10:30,126,129,83,75,413,4,50
283,3/14/2018 10:35,138,121,91,82,432,4,50
284,3/14/2018 10:40,111,100,78,70,359,4,50
285,3/14/2018 10:45,132,108,81,72,393,4,50
286,3/14/2018 10:50,116,100,77,68,361,4,50
287,3/14/2018 10:55,131,109,78,70,388,4,50
288,3/14/2018 11:00,121,114,81,73,389,4,50
289,3/14/2018 11:05,111,107,89,80,387,4,50
290,3/14/2018 11:10,94,96,83,75,348,4,50
291,3/14/2018 11:15,109,105,79,70,363,4,50
292,3/14/2018 11:20,116,111,76,68,371,4,50
293,3/14/2018 11:25,118,120,90,81,409,4,50
294,3/14/2018 11:30,106,107,80,72,365,4,50
295,3/14/2018 11:35,130,109,97,87,423,4,50
296,3/14/2018 11:40,119,117,80,71,387,4,50
297,3/14/2018 11:45,109,113,87,78,387,4,50
298,3/14/2018 11:50,102,123,90,81,396,4,50
299,3/14/2018 11:55,109,106,87,78,380,4,50
300,3/14/2018 12:00,124,112,94,85,415,4,50
301,3/14/2018 12:05,111,116,77,69,373,4,50
302,3/14/2018 12:10,119,116,86,77,398,4,50
303,3/14/2018 12:15,109,114,69,62,354,4,50
304,3/14/2018 12:20,100,113,82,74,369,4,50
305,3/14/2018 12:25,111,119,72,64,366,4,50
306,3/14/2018 12:30,104,98,81,73,356,4,50
307,3/14/2018 12:35,136,124,77,69,406,4,50
308,3/14/2018 12:40,124,100,76,68,368,4,50
309,3/14/2018 12:45,118,117,82,73,390,4,50
310,3/14/2018 12:50,113,112,99,89,413,4,50
311,3/14/2018 12:55,116,116,93,84,409,4,50
312,3/14/2018 13:00,106,114,82,74,376,4,50
313,3/14/2018 13:05,140,120,86,77,423,4,50
314,3/14/2018 13:10,119,115,85,76,395,4,50
315,3/14/2018 13:15,121,115,96,87,419,4,50
316,3/14/2018 13:20,116,104,90,81,391,4,50
317,3/14/2018 13:25,131,119,93,84,427,4,50
318,3/14/2018 13:30,120,119,80,71,390,4,50
319,3/14/2018 13:35,131,123,90,81,425,4,50
320,3/14/2018 13:40,140,112,92,83,427,4,50
321,3/14/2018 13:45,141,119,85,76,421,4,50
322,3/14/2018 13:50,124,123,90,81,418,4,50
323,3/14/2018 13:55,118,107,82,74,381,4,50
324,3/14/2018 14:00,107,108,93,84,392,4,50
325,3/14/2018 14:05,129,129,80,71,409,4,50
326,3/14/2018 14:10,105,123,95,86,409,4,50
327,3/14/2018 14:15,130,118,90,81,419,4,50
328,3/14/2018 14:20,135,113,89,80,417,4,50
329,3/14/2018 14:25,142,121,102,92,457,4,50
330,3/14/2018 14:30,132,117,85,77,411,4,50
331,3/14/2018 14:35,148,126,101,91,466,4,50
332,3/14/2018 14:40,138,125,85,76,424,4,50
333,3/14/2018 14:45,142,123,104,95,464,4,50
334,3/14/2018 14:50,129,121,93,84,427,4,50
335,3/14/2018 14:55,133,118,97,88,436,4,50
336,3/14/2018 15:00,135,132,86,77,430,4,50
337,3/14/2018 15:05,152,122,106,96,476,4,50
338,3/14/2018 15:10,160,133,114,104,511,4,50
339,3/14/2018 15:15,151,130,96,87,464,4,50
340,3/14/2018 15:20,150,124,99,90,463,4,50
341,3/14/2018 15:25,139,127,106,97,469,4,50
342,3/14/2018 15:30,157,126,102,92,477,4,50
343,3/14/2018 15:35,137,124,104,94,459,4,50
344,3/14/2018 15:40,164,145,122,112,543,4,50
345,3/14/2018 15:45,145,144,111,101,501,4,50
346,3/14/2018 15:50,165,150,106,96,517,4,50
347,3/14/2018 15:55,142,138,108,98,486,4,50
348,3/14/2018 16:00,148,133,107,97,485,4,50
349,3/14/2018 16:05,159,140,111,101,511,4,50
350,3/14/2018 16:10,141,139,112,102,494,4,50
351,3/14/2018 16:15,167,154,108,98,527,4,50
352,3/14/2018 16:20,149,144,109,99,501,4,50
353,3/14/2018 16:25,156,128,107,97,488,4,50
354,3/14/2018 16:30,154,141,108,98,501,4,50
355,3/14/2018 16:35,156,130,112,102,500,4,50
356,3/14/2018 16:40,153,140,119,109,521,4,50
357,3/14/2018 16:45,152,141,112,101,506,4,50
358,3/14/2018 16:50,153,145,116,106,520,4,50
359,3/14/2018 16:55,150,158,116,106,530,4,50
360,3/14/2018 17:00,153,144,122,111,530,4,50
361,3/14/2018 17:05,153,134,110,100,497,4,50
362,3/14/2018 17:10,153,158,115,105,531,4,50
363,3/14/2018 17:15,159,149,107,97,512,4,50
364,3/14/2018 17:20,160,144,94,85,483,4,50
365,3/14/2018 17:25,152,139,99,90,480,4,50
366,3/14/2018 17:30,151,149,112,102,514,4,50
367,3/14/2018 17:35,138,140,101,92,471,4,50
368,3/14/2018 17:40,144,130,104,95,473,4,50
369,3/14/2018 17:45,153,132,101,92,478,4,50
370,3/14/2018 17:50,151,133,107,98,489,4,50
371,3/14/2018 17:55,146,128,103,93,470,4,50
372,3/14/2018 18:00,148,137,109,99,493,4,50
373,3/14/2018 18:05,138,123,99,89,449,4,50
374,3/14/2018 18:10,174,146,103,93,516,4,50
375,3/14/2018 18:15,154,123,105,95,477,4,50
376,3/14/2018 18:20,135,135,113,103,486,4,50
377,3/14/2018 18:25,154,145,111,101,511,4,50
378,3/14/2018 18:30,146,139,102,92,479,4,50
379,3/14/2018 18:35,137,134,102,92,465,4,50
380,3/14/2018 18:40,144,142,113,103,502,4,50
381,3/14/2018 18:45,151,133,109,99,492,4,50
382,3/14/2018 18:50,126,123,101,91,441,4,50
383,3/14/2018 18:55,131,111,98,89,429,4,50
384,3/14/2018 19:00,138,129,98,88,453,4,50
385,3/14/2018 19:05,95,92,81,72,340,4,50
386,3/14/2018 19:10,102,105,88,79,374,4,50
387,3/14/2018 19:15,94,111,79,70,354,4,50
388,3/14/2018 19:20,109,102,84,75,370,4,50
389,3/14/2018 19:25,81,110,74,66,331,4,50
390,3/14/2018 19:30,90,96,83,74,343,4,50
391,3/14/2018 19:35,108,102,81,73,364,4,50
392,3/14/2018 19:40,90,89,80,71,330,4,50
393,3/14/2018 19:45,91,100,78,70,339,4,50
394,3/14/2018 19:50,110,106,90,81,387,4,50
395,3/14/2018 19:55,96,84,74,66,320,4,50
396,3/14/2018 20:00,78,89,78,70,315,4,50
397,3/14/2018 20:05,100,107,77,69,353,4,50
398,3/14/2018 20:10,104,107,88,79,378,4,50
399,3/14/2018 20:15,89,98,72,64,323,4,50
400,3/14/2018 20:20,89,100,81,72,342,4,50
401,3/14/2018 20:25,90,92,71,63,316,4,50
402,3/14/2018 20:30,77,81,74,66,298,4,50
403,3/14/2018 20:35,77,94,74,66,311,4,50
404,3/14/2018 20:40,78,91,75,67,311,4,50
405,3/14/2018 20:45,73,81,61,53,268,4,50
406,3/14/2018 20:50,71,96,76,68,311,4,50
407,3/14/2018 20:55,76,79,74,66,295,4,50
408,3/14/2018 21:00,72,80,70,62,284,4,50
409,3/14/2018 21:05,46,83,75,66,270,4,50
410,3/14/2018 21:10,69,77,72,64,282,4,50
411,3/14/2018 21:15,66,87,64,57,274,4,50
412,3/14/2018 21:20,60,70,59,52,241,4,50
413,3/14/2018 21:25,70,84,61,53,268,4,50
414,3/14/2018 21:30,53,75,48,42,218,4,50
415,3/14/2018 21:35,66,73,59,51,249,4,50
416,3/14/2018 21:40,63,74,65,58,260,4,50
417,3/14/2018 21:45,59,70,61,54,244,4,50
418,3/14/2018 21:50,69,79,58,51,257,4,50
419,3/14/2018 21:55,58,79,54,47,238,4,50
420,3/14/2018 22:00,63,75,50,43,231,4,50
421,3/14/2018 22:05,56,66,52,45,219,4,50
422,3/14/2018 22:10,54,67,56,49,226,4,50
423,3/14/2018 22:15,61,71,51,43,226,4,50
424,3/14/2018 22:20,44,49,50,43,186,4,50
425,3/14/2018 22:25,50,60,51,43,204,4,50
426,3/14/2018 22:30,46,65,53,46,210,4,50
427,3/14/2018 22:35,51,65,45,38,199,4,50
428,3/14/2018 22:40,46,51,54,46,197,4,50
429,3/14/2018 22:45,50,65,47,40,202,4,50
430,3/14/2018 22:50,42,51,41,35,169,4,50
431,3/14/2018 22:55,49,48,39,33,169,4,50
432,3/14/2018 23:00,40,51,41,35,167,4,50
433,3/14/2018 23:05,36,51,48,41,176,4,50
434,3/14/2018 23:10,41,44,38,32,155,4,50
435,3/14/2018 23:15,27,36,38,32,133,4,50
436,3/14/2018 23:20,34,50,39,33,156,4,50
437,3/14/2018 23:25,35,48,38,32,153,4,50
438,3/14/2018 23:30,44,51,38,32,165,4,50
439,3/14/2018 23:35,28,45,38,31,142,4,50
440,3/14/2018 23:40,37,34,37,31,139,4,50
441,3/14/2018 23:45,33,41,33,26,133,4,50
442,3/14/2018 23:50,21,36,30,23,110,4,50
443,3/14/2018 23:55,26,22,33,26,107,4,50
444,3/15/2018 0:00,26,23,24,18,91,4,50
445,3/15/2018 0:05,22,19,31,25,97,4,50
446,3/15/2018 0:10,26,31,27,21,105,4,50
447,3/15/2018 0:15,16,29,22,17,84,4,50
448,3/15/2018 0:20,19,26,24,18,87,4,50
449,3/15/2018 0:25,17,19,30,24,90,4,50
450,3/15/2018 0:30,21,21,21,15,78,4,50
451,3/15/2018 0:35,19,27,25,19,90,4,50
452,3/15/2018 0:40,8,19,28,22,77,4,50
453,3/15/2018 0:45,11,27,26,20,84,4,50
454,3/15/2018 0:50,9,19,22,16,66,4,50
455,3/15/2018 0:55,10,19,25,19,73,4,50
456,3/15/2018 1:00,9,18,16,10,53,4,50
457,3/15/2018 1:05,13,18,17,12,60,4,50
458,3/15/2018 1:10,7,16,17,11,51,4,50
459,3/15/2018 1:15,16,23,23,18,80,4,50
460,3/15/2018 1:20,5,13,16,11,45,4,50
461,3/15/2018 1:25,12,16,19,13,60,4,50
462,3/15/2018 1:30,10,24,16,11,61,4,50
463,3/15/2018 1:35,13,20,16,11,60,4,50
464,3/15/2018 1:40,7,11,17,11,46,4,50
465,3/15/2018 1:45,5,15,16,11,47,4,50
466,3/15/2018 1:50,6,10,14,9,39,4,50
467,3/15/2018 1:55,6,17,17,17,57,4,50
468,3/15/2018 2:00,7,26,26,20,79,4,50
469,3/15/2018 2:05,7,12,16,12,47,4,50
470,3/15/2018 2:10,3,8,14,10,35,4,50
471,3/15/2018 2:15,12,16,15,9,52,4,50
472,3/15/2018 2:20,10,17,11,6,44,4,50
473,3/15/2018 2:25,10,12,14,10,46,4,50
474,3/15/2018 2:30,10,17,17,12,56,4,50
475,3/15/2018 2:35,9,22,16,12,59,4,50
476,3/15/2018 2:40,11,18,13,8,50,4,50
477,3/15/2018 2:45,9,15,17,11,52,4,50
478,3/15/2018 2:50,10,12,16,11,49,4,50
479,3/15/2018 2:55,7,13,14,10,44,4,50
480,3/15/2018 3:00,3,11,15,9,38,4,50
481,3/15/2018 3:05,8,14,14,9,45,4,50
482,3/15/2018 3:10,10,16,14,10,50,4,50
483,3/15/2018 3:15,5,16,15,10,46,4,50
484,3/15/2018 3:20,11,18,16,11,56,4,50
485,3/15/2018 3:25,16,13,15,9,53,4,50
486,3/15/2018 3:30,14,20,19,14,67,4,50
487,3/15/2018 3:35,11,23,16,10,60,4,50
488,3/15/2018 3:40,18,27,19,14,78,4,50
489,3/15/2018 3:45,19,26,23,18,86,4,50
490,3/15/2018 3:50,13,18,22,16,69,4,50
491,3/15/2018 3:55,15,25,21,15,76,4,50
492,3/15/2018 4:00,16,26,27,21,90,4,50
493,3/15/2018 4:05,18,33,15,12,78,4,0
494,3/15/2018 4:10,23,32,29,23,107,4,50
495,3/15/2018 4:15,30,36,35,29,130,4,50
496,3/15/2018 4:20,29,43,35,29,136,4,50
497,3/15/2018 4:25,32,37,44,37,150,4,50
498,3/15/2018 4:30,41,43,32,26,142,4,50
499,3/15/2018 4:35,35,53,48,42,178,4,50
500,3/15/2018 4:40,48,52,50,43,193,4,50
501,3/15/2018 4:45,48,60,48,41,197,4,50
502,3/15/2018 4:50,49,51,53,46,199,4,50
503,3/15/2018 4:55,44,56,55,47,202,4,50
504,3/15/2018 5:00,63,55,58,50,226,4,50
505,3/15/2018 5:05,57,72,59,51,239,4,50
506,3/15/2018 5:10,75,72,64,57,268,4,50
507,3/15/2018 5:15,92,76,70,62,300,4,50
508,3/15/2018 5:20,78,97,73,65,313,4,50
509,3/15/2018 5:25,89,88,78,70,325,4,50
510,3/15/2018 5:30,94,89,79,70,332,4,50
511,3/15/2018 5:35,94,100,82,74,350,4,50
512,3/15/2018 5:40,113,101,84,75,373,4,50
513,3/15/2018 5:45,130,107,94,85,416,4,50
514,3/15/2018 5:50,124,96,87,79,386,4,50
515,3/15/2018 5:55,142,98,84,75,399,4,50
516,3/15/2018 6:00,111,102,92,83,388,4,50
517,3/15/2018 6:05,120,102,87,79,388,4,50
518,3/15/2018 6:10,120,112,86,77,395,4,50
519,3/15/2018 6:15,114,108,80,71,373,4,50
520,3/15/2018 6:20,116,106,80,72,374,4,50
521,3/15/2018 6:25,122,116,77,68,383,4,50
522,3/15/2018 6:30,129,111,82,73,395,4,50
523,3/15/2018 6:35,149,127,96,86,458,4,50
524,3/15/2018 6:40,146,129,85,76,436,4,50
525,3/15/2018 6:45,139,133,90,81,443,4,50
526,3/15/2018 6:50,152,139,100,90,481,4,50
527,3/15/2018 6:55,155,133,97,88,473,4,50
528,3/15/2018 7:00,147,142,93,84,466,4,50
529,3/15/2018 7:05,151,148,95,86,480,4,50
530,3/15/2018 7:10,169,140,99,90,498,4,50
531,3/15/2018 7:15,165,143,116,106,530,4,50
532,3/15/2018 7:20,128,135,112,101,476,4,50
533,3/15/2018 7:25,169,151,101,91,512,4,50
534,3/15/2018 7:30,146,128,108,98,480,4,50
535,3/15/2018 7:35,158,136,111,101,506,4,50
536,3/15/2018 7:40,154,138,110,100,502,4,50
537,3/15/2018 7:45,141,134,85,77,437,4,50
538,3/15/2018 7:50,118,123,95,86,422,4,50
539,3/15/2018 7:55,132,137,100,90,459,4,50
540,3/15/2018 8:00,152,129,102,92,475,4,50
541,3/15/2018 8:05,128,128,101,91,448,4,50
542,3/15/2018 8:10,138,129,101,92,460,4,50
543,3/15/2018 8:15,141,124,94,85,444,4,50
544,3/15/2018 8:20,160,141,112,102,515,4,50
545,3/15/2018 8:25,126,127,71,63,387,4,50
546,3/15/2018 8:30,151,130,90,81,452,4,50
547,3/15/2018 8:35,150,141,92,83,466,4,50
548,3/15/2018 8:40,154,127,94,85,460,4,50
549,3/15/2018 8:45,138,138,107,97,480,4,50
550,3/15/2018 8:50,139,123,104,94,460,4,50
551,3/15/2018 8:55,167,143,103,93,506,4,50
552,3/15/2018 9:00,133,122,104,94,453,4,50
553,3/15/2018 9:05,132,112,91,82,417,4,50
554,3/15/2018 9:10,143,114,87,78,422,4,50
555,3/15/2018 9:15,123,122,91,82,418,4,50
556,3/15/2018 9:20,121,118,89,80,408,4,50
557,3/15/2018 9:25,132,128,86,77,423,4,50
558,3/15/2018 9:30,144,124,83,74,425,4,50
559,3/15/2018 9:35,120,118,69,61,368,4,50
560,3/15/2018 9:40,124,106,88,79,397,4,50
561,3/15/2018 9:45,138,124,90,81,433,4,50
562,3/15/2018 9:50,134,117,83,75,409,4,50
563,3/15/2018 9:55,115,107,78,70,370,4,50
564,3/15/2018 10:00,102,97,82,73,354,4,50
565,3/15/2018 10:05,118,120,77,69,384,4,50
566,3/15/2018 10:10,120,108,94,85,407,4,50
567,3/15/2018 10:15,133,114,88,79,414,4,50
568,3/15/2018 10:20,111,112,88,79,390,4,50
569,3/15/2018 10:25,138,125,80,71,414,4,50
570,3/15/2018 10:30,110,109,88,79,386,4,50
571,3/15/2018 10:35,115,115,93,84,407,4,50
572,3/15/2018 10:40,118,129,85,76,408,4,50
573,3/15/2018 10:45,120,102,85,77,384,4,50
574,3/15/2018 10:50,126,120,86,77,409,4,50
575,3/15/2018 10:55,114,108,93,84,399,4,50
576,3/15/2018 11:00,111,95,86,77,369,4,50
577,3/15/2018 11:05,126,118,87,78,409,4,50
578,3/15/2018 11:10,117,118,77,69,381,4,50
579,3/15/2018 11:15,106,103,84,75,368,4,50
580,3/15/2018 11:20,119,99,77,68,363,4,50
581,3/15/2018 11:25,129,127,89,80,425,4,50
582,3/15/2018 11:30,117,112,78,69,376,4,50
583,3/15/2018 11:35,95,95,77,68,335,4,50
584,3/15/2018 11:40,103,99,74,66,342,4,50
585,3/15/2018 11:45,125,111,89,80,405,4,50
586,3/15/2018 11:50,123,115,92,83,413,4,50
587,3/15/2018 11:55,125,120,93,84,422,4,50
588,3/15/2018 12:00,120,111,88,79,398,4,50
589,3/15/2018 12:05,101,108,82,74,365,4,50
590,3/15/2018 12:10,138,130,82,74,424,4,50
591,3/15/2018 12:15,124,106,88,79,397,4,50
592,3/15/2018 12:20,100,116,83,75,374,4,50
593,3/15/2018 12:25,117,108,86,77,388,4,50
594,3/15/2018 12:30,116,116,89,80,401,4,50
595,3/15/2018 12:35,118,118,76,68,380,4,50
596,3/15/2018 12:40,110,121,84,75,390,4,50
597,3/15/2018 12:45,120,116,75,66,377,4,50
598,3/15/2018 12:50,106,124,97,88,415,4,50
599,3/15/2018 12:55,121,109,86,77,393,4,50
600,3/15/2018 13:00,116,123,93,84,416,4,50
601,3/15/2018 13:05,118,110,84,75,387,4,50
602,3/15/2018 13:10,96,112,85,77,370,4,50
603,3/15/2018 13:15,124,126,91,82,423,4,50
604,3/15/2018 13:20,120,121,93,84,418,4,50
605,3/15/2018 13:25,121,126,80,71,398,4,50
606,3/15/2018 13:30,118,109,90,81,398,4,50
607,3/15/2018 13:35,105,119,89,81,394,4,50
608,3/15/2018 13:40,128,115,85,77,405,4,50
609,3/15/2018 13:45,112,114,90,81,397,4,50
610,3/15/2018 13:50,121,110,84,75,390,4,50
611,3/15/2018 13:55,116,112,88,79,395,4,50
612,3/15/2018 14:00,112,111,94,85,402,4,50
613,3/15/2018 14:05,125,124,93,84,426,4,50
614,3/15/2018 14:10,124,116,91,82,413,4,50
615,3/15/2018 14:15,123,111,95,86,415,4,50
616,3/15/2018 14:20,124,113,90,81,408,4,50
617,3/15/2018 14:25,140,123,88,79,430,4,50
618,3/15/2018 14:30,130,125,92,83,430,4,50
619,3/15/2018 14:35,129,115,90,81,415,4,50
620,3/15/2018 14:40,134,123,81,73,411,4,50
621,3/15/2018 14:45,142,139,95,86,462,4,50
622,3/15/2018 14:50,140,122,98,89,449,4,50
623,3/15/2018 14:55,149,139,106,96,490,4,50
624,3/15/2018 15:00,128,110,96,87,421,4,50
625,3/15/2018 15:05,140,132,93,84,449,4,50
626,3/15/2018 15:10,152,138,95,86,471,4,50
627,3/15/2018 15:15,141,133,103,93,470,4,50
628,3/15/2018 15:20,154,135,89,80,458,4,50
629,3/15/2018 15:25,148,124,96,86,454,4,50
630,3/15/2018 15:30,151,144,105,95,495,4,50
631,3/15/2018 15:35,149,132,107,98,486,4,50
632,3/15/2018 15:40,159,140,97,88,484,4,50
633,3/15/2018 15:45,158,138,107,97,500,4,50
634,3/15/2018 15:50,156,147,106,97,506,4,50
635,3/15/2018 15:55,157,136,106,96,495,4,50
636,3/15/2018 16:00,154,134,109,99,496,4,50
637,3/15/2018 16:05,160,148,120,110,538,4,50
638,3/15/2018 16:10,159,129,102,92,482,4,50
639,3/15/2018 16:15,161,149,107,97,514,4,50
640,3/15/2018 16:20,134,124,107,98,463,4,50
641,3/15/2018 16:25,146,128,101,91,466,4,50
642,3/15/2018 16:30,149,141,119,109,518,4,50
643,3/15/2018 16:35,174,148,111,102,535,4,50
644,3/15/2018 16:40,147,138,111,101,497,4,50
645,3/15/2018 16:45,166,134,99,90,489,4,50
646,3/15/2018 16:50,151,126,96,87,460,4,50
647,3/15/2018 16:55,163,136,105,95,499,4,50
648,3/15/2018 17:00,138,128,102,93,461,4,50
649,3/15/2018 17:05,149,138,100,90,477,4,50
650,3/15/2018 17:10,165,139,118,108,530,4,50
651,3/15/2018 17:15,154,149,106,97,506,4,50
652,3/15/2018 17:20,148,129,96,87,460,4,50
653,3/15/2018 17:25,166,143,99,89,497,4,50
654,3/15/2018 17:30,137,129,85,77,428,4,50
655,3/15/2018 17:35,152,144,100,91,487,4,50
656,3/15/2018 17:40,147,121,96,87,451,4,50
657,3/15/2018 17:45,146,141,96,87,470,4,50
658,3/15/2018 17:50,137,129,100,91,457,4,50
659,3/15/2018 17:55,150,139,101,91,481,4,50
660,3/15/2018 18:00,144,124,99,89,456,4,50
661,3/15/2018 18:05,129,129,106,97,461,4,50
662,3/15/2018 18:10,141,117,92,83,433,4,50
663,3/15/2018 18:15,153,138,104,94,489,4,50
664,3/15/2018 18:20,145,139,104,94,482,4,50
665,3/15/2018 18:25,127,116,96,86,425,4,50
666,3/15/2018 18:30,155,128,104,94,481,4,50
667,3/15/2018 18:35,133,110,93,84,420,4,50
668,3/15/2018 18:40,124,122,102,92,440,4,50
669,3/15/2018 18:45,128,121,98,89,436,4,50
670,3/15/2018 18:50,121,114,95,86,416,4,50
671,3/15/2018 18:55,118,105,85,76,384,4,50
672,3/15/2018 19:00,123,123,91,82,419,4,50
673,3/15/2018 19:05,106,114,81,73,374,4,50
674,3/15/2018 19:10,135,125,85,77,422,4,50
675,3/15/2018 19:15,113,117,90,81,401,4,50
676,3/15/2018 19:20,117,121,90,81,409,4,50
677,3/15/2018 19:25,96,103,73,65,337,4,50
678,3/15/2018 19:30,101,108,86,77,372,4,50
679,3/15/2018 19:35,98,106,84,76,364,4,50
680,3/15/2018 19:40,104,103,79,70,356,4,50
681,3/15/2018 19:45,110,99,82,73,364,4,50
682,3/15/2018 19:50,97,86,80,71,334,4,50
683,3/15/2018 19:55,93,97,78,70,338,4,50
684,3/15/2018 20:00,101,107,82,73,363,4,50
685,3/15/2018 20:05,82,89,82,74,327,4,50
686,3/15/2018 20:10,96,92,77,68,333,4,50
687,3/15/2018 20:15,93,108,81,73,355,4,50
688,3/15/2018 20:20,88,106,77,69,340,4,50
689,3/15/2018 20:25,90,99,77,68,334,4,50
690,3/15/2018 20:30,80,99,82,73,334,4,50
691,3/15/2018 20:35,88,85,72,64,309,4,50
692,3/15/2018 20:40,96,106,69,61,332,4,50
693,3/15/2018 20:45,80,88,70,62,300,4,50
694,3/15/2018 20:50,85,84,70,62,301,4,50
695,3/15/2018 20:55,79,83,72,64,298,4,50
696,3/15/2018 21:00,75,84,66,58,283,4,50
697,3/15/2018 21:05,78,76,70,62,286,4,50
698,3/15/2018 21:10,79,91,81,72,323,4,50
699,3/15/2018 21:15,77,81,72,64,294,4,50
700,3/15/2018 21:20,77,83,63,55,278,4,50
701,3/15/2018 21:25,81,75,70,62,288,4,50
702,3/15/2018 21:30,69,80,73,65,287,4,50
703,3/15/2018 21:35,77,95,64,56,292,4,50
704,3/15/2018 21:40,68,83,64,57,272,4,50
705,3/15/2018 21:45,74,84,68,60,286,4,50
706,3/15/2018 21:50,70,72,59,52,253,4,50
707,3/15/2018 21:55,66,71,62,55,254,4,50
708,3/15/2018 22:00,68,64,62,54,248,4,50
709,3/15/2018 22:05,61,78,66,58,263,4,50
710,3/15/2018 22:10,53,76,67,59,255,4,50
711,3/15/2018 22:15,75,84,60,53,272,4,50
712,3/15/2018 22:20,61,59,59,51,230,4,50
713,3/15/2018 22:25,57,79,56,49,241,4,50
714,3/15/2018 22:30,50,61,54,47,212,4,50
715,3/15/2018 22:35,57,69,58,51,235,4,50
716,3/15/2018 22:40,51,63,54,47,215,4,50
717,3/15/2018 22:45,55,59,57,50,221,4,50
718,3/15/2018 22:50,53,52,52,45,202,4,50
719,3/15/2018 22:55,26,38,46,39,149,4,50
720,3/15/2018 23:00,21,32,41,35,129,4,50
721,3/15/2018 23:05,30,41,44,37,152,4,50
722,3/15/2018 23:10,64,92,60,53,269,4,50
723,3/15/2018 23:15,84,97,72,64,317,4,50
724,3/15/2018 23:20,77,98,78,69,322,4,50
725,3/15/2018 23:25,67,104,81,72,324,4,50
726,3/15/2018 23:30,85,91,75,67,318,4,50
727,3/15/2018 23:35,64,70,52,45,231,4,50
728,3/15/2018 23:40,44,60,62,54,220,4,50
729,3/15/2018 23:45,58,63,56,49,226,4,50
730,3/15/2018 23:50,49,59,50,44,202,4,50
731,3/15/2018 23:55,47,61,52,45,205,4,50
732,3/16/2018 0:00,36,42,48,41,167,4,50
733,3/16/2018 0:05,23,43,50,43,159,4,50
734,3/16/2018 0:10,32,58,47,40,177,4,50
735,3/16/2018 0:15,36,48,44,37,165,4,50
736,3/16/2018 0:20,30,49,40,34,153,4,50
737,3/16/2018 0:25,39,52,48,42,181,4,50
738,3/16/2018 0:30,32,56,48,41,177,4,50
739,3/16/2018 0:35,30,45,38,32,145,4,50
740,3/16/2018 0:40,33,50,44,37,164,4,50
741,3/16/2018 0:45,26,52,37,31,146,4,50
742,3/16/2018 0:50,29,46,36,30,141,4,50
743,3/16/2018 0:55,31,46,37,31,145,4,50
744,3/16/2018 1:00,29,41,34,27,131,4,50
745,3/16/2018 1:05,22,39,34,28,123,4,50
746,3/16/2018 1:10,16,39,38,31,124,4,50
747,3/16/2018 1:15,26,42,35,29,132,4,50
748,3/16/2018 1:20,26,36,30,24,116,4,50
749,3/16/2018 1:25,28,38,41,35,142,4,50
750,3/16/2018 1:30,17,39,24,18,98,4,50
751,3/16/2018 1:35,18,47,30,24,119,4,50
752,3/16/2018 1:40,29,42,35,29,135,4,50
753,3/16/2018 1:45,16,29,34,27,106,4,50
754,3/16/2018 1:50,11,30,30,24,95,4,50
755,3/16/2018 1:55,17,35,30,24,106,4,50
756,3/16/2018 2:00,18,29,29,23,99,4,50
757,3/16/2018 2:05,22,37,30,24,113,4,50
758,3/16/2018 2:10,14,38,26,21,99,4,50
759,3/16/2018 2:15,23,32,28,23,106,4,50
760,3/16/2018 2:20,16,34,31,25,106,4,50
761,3/16/2018 2:25,14,31,37,30,112,4,50
762,3/16/2018 2:30,20,38,28,23,109,4,50
763,3/16/2018 2:35,29,41,30,24,124,4,50
764,3/16/2018 2:40,17,37,25,20,99,4,50
765,3/16/2018 2:45,25,39,25,20,109,4,50
766,3/16/2018 2:50,18,26,26,21,91,4,50
767,3/16/2018 2:55,20,28,27,22,97,4,50
768,3/16/2018 3:00,19,29,32,27,107,4,50
769,3/16/2018 3:05,20,31,27,21,99,4,50
770,3/16/2018 3:10,19,29,29,24,101,4,50
771,3/16/2018 3:15,25,37,29,24,115,4,50
772,3/16/2018 3:20,17,31,28,22,98,4,50
773,3/16/2018 3:25,20,33,32,26,111,4,50
774,3/16/2018 3:30,40,37,34,28,139,4,50
775,3/16/2018 3:35,28,38,34,28,128,4,50
776,3/16/2018 3:40,32,49,38,31,150,4,50
777,3/16/2018 3:45,30,43,38,32,143,4,50
778,3/16/2018 3:50,26,43,37,31,137,4,50
779,3/16/2018 3:55,25,30,36,30,121,4,50
780,3/16/2018 4:00,34,51,37,31,153,4,50
781,3/16/2018 4:05,31,50,38,31,150,4,50
782,3/16/2018 4:10,37,56,41,35,169,4,50
783,3/16/2018 4:15,48,61,48,41,198,4,50
784,3/16/2018 4:20,41,66,53,46,206,4,50
785,3/16/2018 4:25,56,70,55,47,228,4,50
786,3/16/2018 4:30,44,50,44,38,176,4,50
787,3/16/2018 4:35,42,48,49,42,181,4,50
788,3/16/2018 4:40,64,64,58,51,237,4,50
789,3/16/2018 4:45,65,55,55,48,223,4,50
790,3/16/2018 4:50,40,40,47,40,167,4,50
791,3/16/2018 4:55,40,51,43,37,171,4,50
792,3/16/2018 5:00,72,76,51,44,243,4,50
793,3/16/2018 5:05,49,64,49,42,204,4,50
794,3/16/2018 5:10,75,69,52,45,241,4,50
795,3/16/2018 5:15,65,82,72,64,283,4,50
796,3/16/2018 5:20,94,90,72,64,320,4,50
797,3/16/2018 5:25,86,88,78,70,322,4,50
798,3/16/2018 5:30,103,106,85,77,371,4,50
799,3/16/2018 5:35,110,110,93,84,397,4,50
800,3/16/2018 5:40,108,105,87,78,378,4,50
801,3/16/2018 5:45,122,104,88,79,393,4,50
802,3/16/2018 5:50,113,98,87,78,376,4,50
803,3/16/2018 5:55,122,104,90,81,397,4,50
804,3/16/2018 6:00,119,99,83,75,376,4,50
805,3/16/2018 6:05,123,108,90,81,402,4,50
806,3/16/2018 6:10,118,107,87,78,390,4,50
807,3/16/2018 6:15,132,100,86,77,395,4,50
808,3/16/2018 6:20,148,124,93,84,449,4,50
809,3/16/2018 6:25,128,102,92,83,405,4,50
810,3/16/2018 6:30,148,120,89,80,437,4,50
811,3/16/2018 6:35,144,129,96,86,455,4,50
812,3/16/2018 6:40,130,113,85,76,404,4,50
813,3/16/2018 6:45,145,142,107,98,492,4,50
814,3/16/2018 6:50,142,133,101,92,468,4,50
815,3/16/2018 6:55,159,124,96,87,466,4,50
816,3/16/2018 7:00,144,129,100,90,463,4,50
817,3/16/2018 7:05,147,136,96,87,466,4,50
818,3/16/2018 7:10,148,122,104,94,468,4,50
819,3/16/2018 7:15,134,117,102,93,446,4,50
820,3/16/2018 7:20,144,138,110,100,492,4,50
821,3/16/2018 7:25,150,123,103,93,469,4,50
822,3/16/2018 7:30,148,143,100,90,481,4,50
823,3/16/2018 7:35,161,143,99,90,493,4,50
824,3/16/2018 7:40,119,121,104,94,438,4,50
825,3/16/2018 7:45,159,129,106,97,491,4,50
826,3/16/2018 7:50,150,156,116,105,527,4,50
827,3/16/2018 7:55,138,136,114,104,492,4,50
828,3/16/2018 8:00,147,129,109,99,484,4,50
829,3/16/2018 8:05,157,136,111,102,506,4,50
830,3/16/2018 8:10,157,126,102,92,477,4,50
831,3/16/2018 8:15,148,148,113,103,512,4,50
832,3/16/2018 8:20,150,141,86,77,454,4,50
833,3/16/2018 8:25,159,141,95,86,481,4,50
834,3/16/2018 8:30,139,136,94,85,454,4,50
835,3/16/2018 8:35,153,131,103,93,480,4,50
836,3/16/2018 8:40,162,134,99,90,485,4,50
837,3/16/2018 8:45,145,137,96,87,465,4,50
838,3/16/2018 8:50,150,131,96,87,464,4,50
839,3/16/2018 8:55,124,131,87,78,420,4,50
840,3/16/2018 9:00,136,117,80,72,405,4,50
841,3/16/2018 9:05,108,109,81,73,371,4,50
842,3/16/2018 9:10,128,119,94,85,426,4,50
843,3/16/2018 9:15,143,110,84,76,413,4,50
844,3/16/2018 9:20,113,114,90,81,398,4,50
845,3/16/2018 9:25,123,122,86,77,408,4,50
846,3/16/2018 9:30,132,129,80,72,413,4,50
847,3/16/2018 9:35,121,120,90,81,412,4,50
848,3/16/2018 9:40,116,124,93,84,417,4,50
849,3/16/2018 9:45,130,127,82,73,412,4,50
850,3/16/2018 9:50,131,121,87,78,417,4,50
851,3/16/2018 9:55,123,106,90,81,400,4,50
852,3/16/2018 10:00,111,110,84,75,380,4,50
853,3/16/2018 10:05,110,111,85,77,383,4,50
854,3/16/2018 10:10,125,114,76,68,383,4,50
855,3/16/2018 10:15,112,111,84,75,382,4,50
856,3/16/2018 10:20,122,119,90,81,412,4,50
857,3/16/2018 10:25,130,118,73,65,386,4,50
858,3/16/2018 10:30,94,93,77,68,332,4,50
859,3/16/2018 10:35,119,109,74,66,368,4,50
860,3/16/2018 10:40,139,136,97,88,460,4,50
861,3/16/2018 10:45,122,121,102,92,437,4,50
862,3/16/2018 10:50,119,119,92,83,413,4,50
863,3/16/2018 10:55,128,127,90,81,426,4,50
864,3/16/2018 11:00,116,113,82,74,385,4,50
865,3/16/2018 11:05,113,114,87,78,392,4,50
866,3/16/2018 11:10,118,110,85,76,389,4,50
867,3/16/2018 11:15,111,120,81,73,385,4,50
868,3/16/2018 11:20,117,102,92,83,394,4,50
869,3/16/2018 11:25,122,124,82,74,402,4,50
870,3/16/2018 11:30,111,106,88,79,384,4,50
871,3/16/2018 11:35,112,115,87,78,392,4,50
872,3/16/2018 11:40,120,132,90,81,423,4,50
873,3/16/2018 11:45,127,126,83,75,411,4,50
874,3/16/2018 11:50,117,122,83,75,397,4,50
875,3/16/2018 11:55,114,106,88,79,387,4,50
876,3/16/2018 12:00,121,123,85,77,406,4,50
877,3/16/2018 12:05,115,115,78,69,377,4,50
878,3/16/2018 12:10,117,108,83,75,383,4,50
879,3/16/2018 12:15,128,106,81,73,388,4,50
880,3/16/2018 12:20,139,136,80,71,426,4,50
881,3/16/2018 12:25,122,119,87,78,406,4,50
882,3/16/2018 12:30,125,103,76,68,372,4,50
883,3/16/2018 12:35,130,130,88,79,427,4,50
884,3/16/2018 12:40,131,113,76,68,388,4,50
885,3/16/2018 12:45,118,127,95,86,426,4,50
886,3/16/2018 12:50,136,112,99,89,436,4,50
887,3/16/2018 12:55,115,121,100,91,427,4,50
888,3/16/2018 13:00,122,108,86,77,393,4,50
889,3/16/2018 13:05,111,122,84,75,392,4,50
890,3/16/2018 13:10,138,123,98,89,448,4,50
891,3/16/2018 13:15,131,141,101,92,465,4,50
892,3/16/2018 13:20,146,134,97,88,465,4,50
893,3/16/2018 13:25,124,119,91,82,416,4,50
894,3/16/2018 13:30,129,114,94,85,422,4,50
895,3/16/2018 13:35,136,121,98,88,443,4,50
896,3/16/2018 13:40,154,120,90,81,445,4,50
897,3/16/2018 13:45,125,120,98,89,432,4,50
898,3/16/2018 13:50,150,124,99,90,463,4,50
899,3/16/2018 13:55,127,111,96,87,421,4,50
900,3/16/2018 14:00,131,125,86,77,419,4,50
901,3/16/2018 14:05,128,123,91,82,424,4,50
902,3/16/2018 14:10,147,131,95,86,459,4,50
903,3/16/2018 14:15,137,123,101,91,452,4,50
904,3/16/2018 14:20,125,127,91,82,425,4,50
905,3/16/2018 14:25,139,116,101,91,447,4,50
906,3/16/2018 14:30,138,124,98,88,448,4,50
907,3/16/2018 14:35,142,120,98,89,449,4,50
908,3/16/2018 14:40,145,123,93,84,445,4,50
909,3/16/2018 14:45,131,109,88,79,407,4,50
910,3/16/2018 14:50,129,145,98,88,460,4,50
911,3/16/2018 14:55,149,136,88,80,453,4,50
912,3/16/2018 15:00,139,129,96,87,451,4,50
913,3/16/2018 15:05,140,133,83,75,431,4,50
914,3/16/2018 15:10,134,129,101,91,455,4,50
915,3/16/2018 15:15,132,117,93,84,426,4,50
916,3/16/2018 15:20,146,128,97,88,459,4,50
917,3/16/2018 15:25,146,132,107,98,483,4,50
918,3/16/2018 15:30,136,139,105,95,475,4,50
919,3/16/2018 15:35,139,136,106,96,477,4,50
920,3/16/2018 15:40,129,119,104,94,446,4,50
921,3/16/2018 15:45,164,146,111,101,522,4,50
922,3/16/2018 15:50,155,144,95,86,480,4,50
923,3/16/2018 15:55,151,136,108,98,493,4,50
924,3/16/2018 16:00,155,144,111,101,511,4,50
925,3/16/2018 16:05,139,138,117,107,501,4,50
926,3/16/2018 16:10,135,152,121,110,518,4,50
927,3/16/2018 16:15,145,149,109,99,502,4,50
928,3/16/2018 16:20,158,149,125,114,546,4,50
929,3/16/2018 16:25,139,118,103,94,454,4,50
930,3/16/2018 16:30,163,127,109,100,499,4,50
931,3/16/2018 16:35,141,147,106,97,491,4,50
932,3/16/2018 16:40,183,144,93,84,504,4,50
933,3/16/2018 16:45,139,142,98,88,467,4,50
934,3/16/2018 16:50,136,127,88,80,431,4,50
935,3/16/2018 16:55,137,127,96,87,447,4,50
936,3/16/2018 17:00,159,141,99,90,489,4,50
937,3/16/2018 17:05,138,130,101,91,460,4,50
938,3/16/2018 17:10,162,151,97,87,497,4,50
939,3/16/2018 17:15,134,130,95,86,445,4,50
940,3/16/2018 17:20,159,149,99,90,497,4,50
941,3/16/2018 17:25,159,150,114,103,526,4,50
942,3/16/2018 17:30,154,147,103,93,497,4,50
943,3/16/2018 17:35,150,141,107,97,495,4,50
944,3/16/2018 17:40,139,134,95,86,454,4,50
945,3/16/2018 17:45,139,132,112,101,484,4,50
946,3/16/2018 17:50,132,136,115,105,488,4,50
947,3/16/2018 17:55,156,133,114,103,506,4,50
948,3/16/2018 18:00,143,151,112,102,508,4,50
949,3/16/2018 18:05,130,130,104,94,458,4,50
950,3/16/2018 18:10,148,137,104,94,483,4,50
951,3/16/2018 18:15,130,123,100,91,444,4,50
952,3/16/2018 18:20,130,138,97,88,453,4,50
953,3/16/2018 18:25,117,122,99,90,428,4,50
954,3/16/2018 18:30,134,137,106,96,473,4,50
955,3/16/2018 18:35,142,119,96,86,443,4,50
956,3/16/2018 18:40,113,123,105,95,436,4,50
957,3/16/2018 18:45,119,124,98,89,430,4,50
958,3/16/2018 18:50,119,121,99,90,429,4,50
959,3/16/2018 18:55,100,111,90,81,382,4,50
960,3/16/2018 19:00,114,108,92,83,397,4,50
961,3/16/2018 19:05,117,131,93,84,425,4,50
962,3/16/2018 19:10,102,112,88,79,381,4,50
963,3/16/2018 19:15,113,101,91,82,387,4,50
964,3/16/2018 19:20,111,117,92,83,403,4,50
965,3/16/2018 19:25,103,114,86,78,381,4,50
966,3/16/2018 19:30,100,104,87,79,370,4,50
967,3/16/2018 19:35,97,103,88,79,367,4,50
968,3/16/2018 19:40,109,95,77,68,349,4,50
969,3/16/2018 19:45,100,79,75,66,320,4,50
970,3/16/2018 19:50,97,99,85,77,358,4,50
971,3/16/2018 19:55,99,93,82,73,347,4,50
972,3/16/2018 20:00,83,90,80,71,324,4,50
973,3/16/2018 20:05,95,109,80,72,356,4,50
974,3/16/2018 20:10,80,101,76,67,324,4,50
975,3/16/2018 20:15,85,95,82,73,335,4,50
976,3/16/2018 20:20,83,89,77,69,318,4,50
977,3/16/2018 20:25,84,88,80,71,323,4,50
978,3/16/2018 20:30,82,89,79,70,320,4,50
979,3/16/2018 20:35,85,77,57,50,269,4,50
980,3/16/2018 20:40,83,82,70,62,297,4,50
981,3/16/2018 20:45,65,74,68,60,267,4,50
982,3/16/2018 20:50,77,88,72,64,301,4,50
983,3/16/2018 20:55,73,73,67,59,272,4,50
984,3/16/2018 21:00,85,88,75,67,315,4,50
985,3/16/2018 21:05,79,76,66,58,279,4,50
986,3/16/2018 21:10,70,76,70,62,278,4,50
987,3/16/2018 21:15,67,83,65,57,272,4,50
988,3/16/2018 21:20,71,84,74,66,295,4,50
989,3/16/2018 21:25,74,82,75,66,297,4,50
990,3/16/2018 21:30,75,75,64,56,270,4,50
991,3/16/2018 21:35,62,81,67,60,270,4,50
992,3/16/2018 21:40,71,84,66,58,279,4,50
993,3/16/2018 21:45,63,81,59,52,255,4,50
994,3/16/2018 21:50,66,71,66,58,261,4,50
995,3/16/2018 21:55,66,69,59,52,246,4,50
996,3/16/2018 22:00,56,61,55,48,220,4,50
997,3/16/2018 22:05,72,76,62,55,265,4,50
998,3/16/2018 22:10,64,68,58,51,241,4,50
999,3/16/2018 22:15,74,65,59,51,249,4,50
1000,3/16/2018 22:20,54,78,61,54,247,4,50
1001,3/16/2018 22:25,51,74,61,53,239,4,50
1002,3/16/2018 22:30,61,71,64,57,253,4,50
1003,3/16/2018 22:35,56,68,53,45,222,4,50
1004,3/16/2018 22:40,59,76,53,47,235,4,50
1005,3/16/2018 22:45,56,74,48,42,220,4,50
1006,3/16/2018 22:50,55,52,45,39,191,4,50
1007,3/16/2018 22:55,43,72,56,49,220,4,50
1008,3/16/2018 23:00,63,71,51,44,229,4,50
1009,3/16/2018 23:05,38,58,48,41,185,4,50
1010,3/16/2018 23:10,22,40,47,40,149,4,50
1011,3/16/2018 23:15,46,47,52,45,190,4,50
1012,3/16/2018 23:20,69,79,60,53,261,4,50
1013,3/16/2018 23:25,33,55,42,35,165,4,50
1014,3/16/2018 23:30,53,56,43,37,189,4,50
1015,3/16/2018 23:35,42,43,47,40,172,4,50
1016,3/16/2018 23:40,42,45,44,37,168,4,50
1017,3/16/2018 23:45,30,47,44,38,159,4,50
1018,3/16/2018 23:50,30,44,46,39,159,4,50
1019,3/16/2018 23:55,27,36,37,30,130,4,50
1020,3/17/2018 0:00,39,44,37,31,151,4,50
1021,3/17/2018 0:05,32,36,37,31,136,4,50
1022,3/17/2018 0:10,25,42,33,27,127,4,50
1023,3/17/2018 0:15,28,46,40,34,148,4,50
1024,3/17/2018 0:20,28,35,27,22,112,4,50
1025,3/17/2018 0:25,34,42,31,26,133,4,50
1026,3/17/2018 0:30,32,45,32,25,134,4,50
1027,3/17/2018 0:35,19,32,38,31,120,4,50
1028,3/17/2018 0:40,25,35,33,27,120,4,50
1029,3/17/2018 0:45,13,32,32,25,102,4,50
1030,3/17/2018 0:50,23,34,30,25,112,4,50
1031,3/17/2018 0:55,15,31,28,22,96,4,50
1032,3/17/2018 1:00,15,19,31,25,90,4,50
1033,3/17/2018 1:05,19,33,25,20,97,4,50
1034,3/17/2018 1:10,12,27,24,18,81,4,50
1035,3/17/2018 1:15,19,26,23,18,86,4,50
1036,3/17/2018 1:20,18,23,25,20,86,4,50
1037,3/17/2018 1:25,11,31,25,20,87,4,50
1038,3/17/2018 1:30,11,21,22,16,70,4,50
1039,3/17/2018 1:35,11,21,22,16,70,4,50
1040,3/17/2018 1:40,14,17,24,19,74,4,50
1041,3/17/2018 1:45,10,20,22,16,68,4,50
1042,3/17/2018 1:50,22,20,21,16,79,4,50
1043,3/17/2018 1:55,14,14,21,15,64,4,50
1044,3/17/2018 2:00,15,25,23,17,80,4,50
1045,3/17/2018 2:05,17,20,22,17,76,4,50
1046,3/17/2018 2:10,13,20,21,16,70,4,50
1047,3/17/2018 2:15,16,18,26,20,80,4,50
1048,3/17/2018 2:20,22,34,25,19,100,4,50
1049,3/17/2018 2:25,12,23,17,12,64,4,50
1050,3/17/2018 2:30,12,24,18,13,67,4,50
1051,3/17/2018 2:35,17,29,19,14,79,4,50
1052,3/17/2018 2:40,12,27,20,14,73,4,50
1053,3/17/2018 2:45,13,17,21,15,66,4,50
1054,3/17/2018 2:50,10,13,21,16,60,4,50
1055,3/17/2018 2:55,10,14,19,14,57,4,50
1056,3/17/2018 3:00,9,19,18,13,59,4,50
1057,3/17/2018 3:05,14,22,19,14,69,4,50
1058,3/17/2018 3:10,15,15,15,10,55,4,50
1059,3/17/2018 3:15,8,13,17,12,50,4,50
1060,3/17/2018 3:20,8,21,20,15,64,4,50
1061,3/17/2018 3:25,12,25,19,13,69,4,50
1062,3/17/2018 3:30,10,21,19,14,64,4,50
1063,3/17/2018 3:35,13,28,20,15,76,4,50
1064,3/17/2018 3:40,7,13,16,11,47,4,50
1065,3/17/2018 3:45,12,17,20,15,64,4,50
1066,3/17/2018 3:50,11,12,19,14,56,4,50
1067,3/17/2018 3:55,8,17,13,8,46,4,50
1068,3/17/2018 4:00,7,21,15,10,53,4,50
1069,3/17/2018 4:05,8,13,17,11,49,4,50
1070,3/17/2018 4:10,12,24,16,11,63,4,50
1071,3/17/2018 4:15,12,23,23,17,75,4,50
1072,3/17/2018 4:20,15,23,22,16,76,4,50
1073,3/17/2018 4:25,18,21,26,20,85,4,50
1074,3/17/2018 4:30,27,25,29,23,104,4,50
1075,3/17/2018 4:35,20,34,24,18,96,4,50
1076,3/17/2018 4:40,15,25,32,26,98,4,50
1077,3/17/2018 4:45,11,28,28,23,90,4,50
1078,3/17/2018 4:50,14,26,30,24,94,4,50
1079,3/17/2018 4:55,16,25,27,22,90,4,50
1080,3/17/2018 5:00,13,26,24,18,81,4,50
1081,3/17/2018 5:05,24,23,24,19,90,4,50
1082,3/17/2018 5:10,18,29,24,18,89,4,50
1083,3/17/2018 5:15,25,33,28,23,109,4,50
1084,3/17/2018 5:20,28,42,31,26,127,4,50
1085,3/17/2018 5:25,28,41,33,27,129,4,50
1086,3/17/2018 5:30,32,41,34,27,134,4,50
1087,3/17/2018 5:35,32,41,36,30,139,4,50
1088,3/17/2018 5:40,40,40,36,30,146,4,50
1089,3/17/2018 5:45,38,39,37,31,145,4,50
1090,3/17/2018 5:50,42,58,37,30,167,4,50
1091,3/17/2018 5:55,27,48,33,26,134,4,50
1092,3/17/2018 6:00,30,44,37,30,141,4,50
1093,3/17/2018 6:05,28,36,36,30,130,4,50
1094,3/17/2018 6:10,32,39,45,38,154,4,50
1095,3/17/2018 6:15,36,52,48,42,178,4,50
1096,3/17/2018 6:20,38,46,48,41,173,4,50
1097,3/17/2018 6:25,46,44,47,40,177,4,50
1098,3/17/2018 6:30,58,58,49,42,207,4,50
1099,3/17/2018 6:35,61,58,48,42,209,4,50
1100,3/17/2018 6:40,56,74,62,55,247,4,50
1101,3/17/2018 6:45,48,69,60,53,230,4,50
1102,3/17/2018 6:50,61,69,53,47,230,4,50
1103,3/17/2018 6:55,43,60,62,54,219,4,50
1104,3/17/2018 7:00,62,67,49,42,220,4,50
1105,3/17/2018 7:05,57,55,58,50,220,4,50
1106,3/17/2018 7:10,67,60,53,46,226,4,50
1107,3/17/2018 7:15,65,87,54,47,253,4,50
1108,3/17/2018 7:20,73,72,64,56,265,4,50
1109,3/17/2018 7:25,80,80,60,53,273,4,50
1110,3/17/2018 7:30,93,81,57,49,280,4,50
1111,3/17/2018 7:35,84,93,73,65,315,4,50
1112,3/17/2018 7:40,105,100,68,60,333,4,50
1113,3/17/2018 7:45,94,103,75,66,338,4,50
1114,3/17/2018 7:50,88,85,79,71,323,4,50
1115,3/17/2018 7:55,91,103,82,74,350,4,50
1116,3/17/2018 8:00,77,93,71,63,304,4,50
1117,3/17/2018 8:05,81,87,56,49,273,4,50
1118,3/17/2018 8:10,109,105,68,60,342,4,50
1119,3/17/2018 8:15,70,86,71,63,290,4,50
1120,3/17/2018 8:20,104,109,82,74,369,4,50
1121,3/17/2018 8:25,97,88,78,70,333,4,50
1122,3/17/2018 8:30,108,96,81,72,357,4,50
1123,3/17/2018 8:35,106,104,78,70,358,4,50
1124,3/17/2018 8:40,103,107,87,78,375,4,50
1125,3/17/2018 8:45,112,115,90,81,398,4,50
1126,3/17/2018 8:50,118,119,81,73,391,4,50
1127,3/17/2018 8:55,108,114,77,69,368,4,50
1128,3/17/2018 9:00,88,102,82,74,346,4,50
1129,3/17/2018 9:05,98,95,71,63,327,4,50
1130,3/17/2018 9:10,106,100,82,74,362,4,50
1131,3/17/2018 9:15,89,115,82,73,359,4,50
1132,3/17/2018 9:20,136,138,96,87,457,4,50
1133,3/17/2018 9:25,111,118,76,67,372,4,50
1134,3/17/2018 9:30,133,124,90,81,428,4,50
1135,3/17/2018 9:35,123,124,96,87,430,4,50
1136,3/17/2018 9:40,119,128,89,80,416,4,50
1137,3/17/2018 9:45,136,129,99,90,454,4,50
1138,3/17/2018 9:50,129,127,76,68,400,4,50
1139,3/17/2018 9:55,127,120,94,85,426,4,50
1140,3/17/2018 10:00,127,119,87,78,411,4,50
1141,3/17/2018 10:05,126,120,92,83,421,4,50
1142,3/17/2018 10:10,103,119,90,81,393,4,50
1143,3/17/2018 10:15,118,118,92,83,411,4,50
1144,3/17/2018 10:20,132,115,96,86,429,4,50
1145,3/17/2018 10:25,113,120,87,78,398,4,50
1146,3/17/2018 10:30,120,118,95,86,419,4,50
1147,3/17/2018 10:35,124,133,85,77,419,4,50
1148,3/17/2018 10:40,119,122,102,93,436,4,50
1149,3/17/2018 10:45,134,119,91,82,426,4,50
1150,3/17/2018 10:50,139,118,93,84,434,4,50
1151,3/17/2018 10:55,123,123,84,75,405,4,50
1152,3/17/2018 11:00,127,128,89,80,424,4,50
1153,3/17/2018 11:05,132,134,87,78,431,4,50
1154,3/17/2018 11:10,116,126,96,87,425,4,50
1155,3/17/2018 11:15,120,127,97,87,431,4,50
1156,3/17/2018 11:20,136,136,91,82,445,4,50
1157,3/17/2018 11:25,114,118,97,87,416,4,50
1158,3/17/2018 11:30,126,128,108,98,460,4,50
1159,3/17/2018 11:35,131,153,95,86,465,4,50
1160,3/17/2018 11:40,123,147,104,94,468,4,50
1161,3/17/2018 11:45,129,109,94,85,417,4,50
1162,3/17/2018 11:50,123,124,88,79,414,4,50
1163,3/17/2018 11:55,107,113,96,87,403,4,50
1164,3/17/2018 12:00,120,128,104,94,446,4,50
1165,3/17/2018 12:05,108,117,85,77,387,4,50
1166,3/17/2018 12:10,126,128,98,89,441,4,50
1167,3/17/2018 12:15,124,123,92,83,422,4,50
1168,3/17/2018 12:20,130,125,97,88,440,4,50
1169,3/17/2018 12:25,121,125,96,87,429,4,50
1170,3/17/2018 12:30,144,142,98,89,473,4,50
1171,3/17/2018 12:35,119,132,105,95,451,4,50
1172,3/17/2018 12:40,139,132,101,91,463,4,50
1173,3/17/2018 12:45,131,126,105,95,457,4,50
1174,3/17/2018 12:50,130,118,91,82,421,4,50
1175,3/17/2018 12:55,120,119,100,90,429,4,50
1176,3/17/2018 13:00,137,131,96,86,450,4,50
1177,3/17/2018 13:05,128,114,100,91,433,4,50
1178,3/17/2018 13:10,137,137,95,86,455,4,50
1179,3/17/2018 13:15,129,124,95,85,433,4,50
1180,3/17/2018 13:20,96,107,88,79,370,4,50
1181,3/17/2018 13:25,107,116,90,81,394,4,50
1182,3/17/2018 13:30,119,116,89,80,404,4,50
1183,3/17/2018 13:35,90,92,84,76,342,4,50
1184,3/17/2018 13:40,107,108,93,84,392,4,50
1185,3/17/2018 13:45,122,117,93,84,416,4,50
1186,3/17/2018 13:50,123,127,97,88,435,4,50
1187,3/17/2018 13:55,120,110,93,84,407,4,50
1188,3/17/2018 14:00,135,141,95,86,457,4,50
1189,3/17/2018 14:05,121,122,92,83,418,4,50
1190,3/17/2018 14:10,103,113,96,87,399,4,50
1191,3/17/2018 14:15,135,114,90,81,420,4,50
1192,3/17/2018 14:20,113,116,102,92,423,4,50
1193,3/17/2018 14:25,113,119,89,80,401,4,50
1194,3/17/2018 14:30,111,120,96,87,414,4,50
1195,3/17/2018 14:35,116,116,89,80,401,4,50
1196,3/17/2018 14:40,121,106,94,85,406,4,50
1197,3/17/2018 14:45,130,120,95,86,431,4,50
1198,3/17/2018 14:50,121,130,93,84,428,4,50
1199,3/17/2018 14:55,124,126,86,77,413,4,50
1200,3/17/2018 15:00,101,113,99,90,403,4,50
1201,3/17/2018 15:05,106,118,86,78,388,4,50
1202,3/17/2018 15:10,120,114,83,74,391,4,50
1203,3/17/2018 15:15,125,130,112,102,469,4,50
1204,3/17/2018 15:20,121,128,108,98,455,4,50
1205,3/17/2018 15:25,118,116,88,80,402,4,50
1206,3/17/2018 15:30,117,114,99,89,419,4,50
1207,3/17/2018 15:35,117,119,76,68,380,4,50
1208,3/17/2018 15:40,122,119,96,86,423,4,50
1209,3/17/2018 15:45,115,113,97,87,412,4,50
1210,3/17/2018 15:50,122,119,100,90,431,4,50
1211,3/17/2018 15:55,103,130,102,92,427,4,50
1212,3/17/2018 16:00,121,116,102,92,431,4,50
1213,3/17/2018 16:05,129,126,101,91,447,4,50
1214,3/17/2018 16:10,123,119,100,90,432,4,50
1215,3/17/2018 16:15,130,118,97,88,433,4,50
1216,3/17/2018 16:20,126,116,96,87,425,4,50
1217,3/17/2018 16:25,111,113,99,90,413,4,50
1218,3/17/2018 16:30,126,123,104,94,447,4,50
1219,3/17/2018 16:40,124,130,96,86,436,4,50
1220,3/17/2018 16:45,121,130,105,96,452,4,50
1221,3/17/2018 16:50,113,112,96,87,408,4,50
1222,3/17/2018 16:55,119,128,105,96,448,4,50
1223,3/17/2018 17:00,133,119,84,75,411,4,50
1224,3/17/2018 17:05,108,119,102,93,422,4,50
1225,3/17/2018 17:10,125,129,104,94,452,4,50
1226,3/17/2018 17:15,123,130,95,86,434,4,50
1227,3/17/2018 17:20,108,118,94,85,405,4,50
1228,3/17/2018 17:25,139,133,82,74,428,4,50
1229,3/17/2018 17:30,119,110,78,70,377,4,50
1230,3/17/2018 17:35,146,126,94,85,451,4,50
1231,3/17/2018 17:40,118,133,102,93,446,4,50
1232,3/17/2018 17:45,99,114,95,86,394,4,50
1233,3/17/2018 17:50,118,126,100,90,434,4,50
1234,3/17/2018 17:55,126,141,97,88,452,4,50
1235,3/17/2018 18:00,124,123,98,88,433,4,50
1236,3/17/2018 18:05,132,128,90,81,431,4,50
1237,3/17/2018 18:10,119,129,96,87,431,4,50
1238,3/17/2018 18:15,123,128,98,89,438,4,50
1239,3/17/2018 18:20,117,118,90,81,406,4,50
1240,3/17/2018 18:25,117,130,93,84,424,4,50
1241,3/17/2018 18:30,119,132,93,84,428,4,50
1242,3/17/2018 18:35,122,119,92,83,416,4,50
1243,3/17/2018 18:40,103,103,85,77,368,4,50
1244,3/17/2018 18:45,117,112,88,79,396,4,50
1245,3/17/2018 18:50,112,118,83,75,388,4,50
1246,3/17/2018 18:55,117,110,89,81,397,4,50
1247,3/17/2018 19:00,109,109,94,85,397,4,50
1248,3/17/2018 19:05,119,102,92,83,396,4,50
1249,3/17/2018 19:10,103,111,84,75,373,4,50
1250,3/17/2018 19:15,105,120,88,79,392,4,50
1251,3/17/2018 19:20,106,100,85,76,367,4,50
1252,3/17/2018 19:25,96,98,81,72,347,4,50
1253,3/17/2018 19:30,91,101,78,70,340,4,50
1254,3/17/2018 19:35,94,104,78,70,346,4,50
1255,3/17/2018 19:40,83,103,92,83,361,4,50
1256,3/17/2018 19:45,94,100,80,72,346,4,50
1257,3/17/2018 19:50,76,88,81,72,317,4,50
1258,3/17/2018 19:55,90,89,77,69,325,4,50
1259,3/17/2018 20:00,99,88,80,71,338,4,50
1260,3/17/2018 20:05,85,97,81,72,335,4,50
1261,3/17/2018 20:10,71,94,76,68,309,4,50
1262,3/17/2018 20:15,81,91,80,72,324,4,50
1263,3/17/2018 20:20,68,66,66,58,258,4,50
1264,3/17/2018 20:25,85,81,68,60,294,4,50
1265,3/17/2018 20:30,76,93,71,63,303,4,50
1266,3/17/2018 20:35,74,78,70,62,284,4,50
1267,3/17/2018 20:40,84,92,76,68,320,4,50
1268,3/17/2018 20:45,90,88,74,66,318,4,50
1269,3/17/2018 20:50,92,94,77,68,331,4,50
1270,3/17/2018 20:55,76,84,67,59,286,4,50
1271,3/17/2018 21:00,69,83,72,64,288,4,50
1272,3/17/2018 21:05,81,71,71,63,286,4,50
1273,3/17/2018 21:10,72,85,74,66,297,4,50
1274,3/17/2018 21:15,80,63,63,55,261,4,50
1275,3/17/2018 21:20,84,89,72,64,309,4,50
1276,3/17/2018 21:25,63,80,68,60,271,4,50
1277,3/17/2018 21:30,63,80,69,61,273,4,50
1278,3/17/2018 21:35,69,79,65,57,270,4,50
1279,3/17/2018 21:40,70,74,67,59,270,4,50
1280,3/17/2018 21:45,73,74,69,61,277,4,50
1281,3/17/2018 21:50,81,92,67,60,300,4,50
1282,3/17/2018 21:55,59,77,69,61,266,4,50
1283,3/17/2018 22:00,68,73,67,60,268,4,50
1284,3/17/2018 22:05,75,72,62,55,264,4,50
1285,3/17/2018 22:10,64,98,69,61,292,4,50
1286,3/17/2018 22:15,74,80,69,62,285,4,50
1287,3/17/2018 22:20,69,73,70,62,274,4,50
1288,3/17/2018 22:25,63,71,59,52,245,4,50
1289,3/17/2018 22:30,74,76,61,53,264,4,50
1290,3/17/2018 22:35,61,74,57,49,241,4,50
1291,3/17/2018 22:40,57,64,64,56,241,4,50
1292,3/17/2018 22:45,48,62,57,50,217,4,50
1293,3/17/2018 22:50,51,64,62,55,232,4,50
1294,3/17/2018 22:55,47,54,47,40,188,4,50
1295,3/17/2018 23:00,46,63,52,45,206,4,50
1296,3/17/2018 23:05,56,69,57,50,232,4,50
1297,3/17/2018 23:10,47,55,51,44,197,4,50
1298,3/17/2018 23:15,47,55,48,41,191,4,50
1299,3/17/2018 23:20,54,66,47,40,207,4,50
1300,3/17/2018 23:25,34,61,45,38,178,4,50
1301,3/17/2018 23:30,53,64,50,44,211,4,50
1302,3/17/2018 23:35,49,57,45,39,190,4,50
1303,3/17/2018 23:40,46,54,45,38,183,4,50
1304,3/17/2018 23:45,41,49,44,38,172,4,50
1305,3/17/2018 23:50,34,58,39,33,164,4,50
1306,3/17/2018 23:55,25,38,34,27,124,4,50
1307,3/18/2018 0:00,25,31,37,31,124,4,50
1308,3/18/2018 0:05,28,41,34,28,131,4,50
1309,3/18/2018 0:10,32,56,44,38,170,4,50
1310,3/18/2018 0:15,38,45,34,28,145,4,50
1311,3/18/2018 0:20,37,50,40,34,161,4,50
1312,3/18/2018 0:25,31,50,39,33,153,4,50
1313,3/18/2018 0:30,30,37,31,25,123,4,50
1314,3/18/2018 0:35,30,36,34,28,128,4,50
1315,3/18/2018 0:40,36,40,36,30,142,4,50
1316,3/18/2018 0:45,29,34,36,29,128,4,50
1317,3/18/2018 0:50,29,31,29,23,112,4,50
1318,3/18/2018 0:55,18,39,32,26,115,4,50
1319,3/18/2018 1:00,32,34,31,25,122,4,50
1320,3/18/2018 1:05,24,42,32,26,124,4,50
1321,3/18/2018 1:10,30,36,28,22,116,4,50
1322,3/18/2018 1:15,23,25,27,21,96,4,50
1323,3/18/2018 1:20,29,28,29,23,109,4,50
1324,3/18/2018 1:25,17,24,25,19,85,4,50
1325,3/18/2018 1:30,14,27,25,19,85,4,50
1326,3/18/2018 1:35,16,30,22,17,85,4,50
1327,3/18/2018 1:40,15,18,22,17,72,4,50
1328,3/18/2018 1:45,18,17,25,19,79,4,50
1329,3/18/2018 1:50,24,24,27,21,96,4,50
1330,3/18/2018 1:55,17,26,24,19,86,4,50
1331,3/18/2018 2:00,19,21,24,18,82,4,50
1332,3/18/2018 2:05,13,23,26,20,82,4,50
1333,3/18/2018 2:10,18,33,29,23,103,4,50
1334,3/18/2018 2:15,24,27,25,19,95,4,50
1335,3/18/2018 2:20,8,26,23,18,75,4,50
1336,3/18/2018 2:25,17,21,25,20,83,4,50
1337,3/18/2018 2:30,11,20,15,10,56,4,50
1338,3/18/2018 2:35,11,15,21,15,62,4,50
1339,3/18/2018 2:40,9,17,21,16,63,4,50
1340,3/18/2018 2:45,10,22,24,18,74,4,50
1341,3/18/2018 2:50,15,26,19,13,73,4,50
1342,3/18/2018 2:55,13,21,19,14,67,4,50
1343,3/18/2018 3:00,14,28,25,20,87,4,50
1344,3/18/2018 3:05,9,32,28,22,91,4,50
1345,3/18/2018 3:10,9,17,19,13,58,4,50
1346,3/18/2018 3:15,9,18,19,14,60,4,50
1347,3/18/2018 3:20,13,19,19,13,64,4,50
1348,3/18/2018 3:25,7,17,14,10,48,4,50
1349,3/18/2018 3:30,8,20,20,15,63,4,50
1350,3/18/2018 3:35,7,24,22,17,70,4,50
1351,3/18/2018 3:40,6,15,19,13,53,4,50
1352,3/18/2018 3:45,11,19,18,13,61,4,50
1353,3/18/2018 3:50,13,19,15,9,56,4,50
1354,3/18/2018 3:55,6,10,11,6,33,4,50
1355,3/18/2018 4:00,13,17,14,9,53,4,50
1356,3/18/2018 4:05,8,12,13,8,41,4,50
1357,3/18/2018 4:10,9,26,22,17,74,4,50
1358,3/18/2018 4:15,8,16,19,14,57,4,50
1359,3/18/2018 4:20,10,14,19,13,56,4,50
1360,3/18/2018 4:25,8,19,16,11,54,4,50
1361,3/18/2018 4:30,10,14,20,15,59,4,50
1362,3/18/2018 4:35,11,16,14,9,50,4,50
1363,3/18/2018 4:40,16,20,16,11,63,4,50
1364,3/18/2018 4:45,10,13,17,11,51,4,50
1365,3/18/2018 4:50,13,15,15,10,53,4,50
1366,3/18/2018 4:55,12,18,15,9,54,4,50
1367,3/18/2018 5:00,12,17,16,11,56,4,50
1368,3/18/2018 5:05,13,19,17,11,60,4,50
1369,3/18/2018 5:10,15,18,21,15,69,4,50
1370,3/18/2018 5:15,12,17,18,13,60,4,50
1371,3/18/2018 5:20,10,19,21,15,65,4,50
1372,3/18/2018 5:25,19,20,21,16,76,4,50
1373,3/18/2018 5:30,17,33,22,16,88,4,50
1374,3/18/2018 5:35,21,34,29,23,107,4,50
1375,3/18/2018 5:40,18,20,22,16,76,4,50
1376,3/18/2018 5:45,14,24,24,19,81,4,50
1377,3/18/2018 5:50,21,38,24,18,101,4,50
1378,3/18/2018 5:55,11,25,22,16,74,4,50
1379,3/18/2018 6:00,17,16,22,16,71,4,50
1380,3/18/2018 6:05,19,22,23,18,82,4,50
1381,3/18/2018 6:10,14,27,25,20,86,4,50
1382,3/18/2018 6:15,21,32,23,18,94,4,50
1383,3/18/2018 6:20,29,46,28,21,124,4,50
1384,3/18/2018 6:25,24,31,30,25,110,4,50
1385,3/18/2018 6:30,30,32,27,21,110,4,50
1386,3/18/2018 6:35,23,29,30,25,107,4,50
1387,3/18/2018 6:40,33,41,35,29,138,4,50
1388,3/18/2018 6:45,28,38,30,24,120,4,50
1389,3/18/2018 6:50,33,45,37,31,146,4,50
1390,3/18/2018 6:55,23,38,38,31,130,4,50
1391,3/18/2018 7:00,34,49,34,28,145,4,50
1392,3/18/2018 7:05,33,37,32,26,128,4,50
1393,3/18/2018 7:10,21,38,35,29,123,4,50
1394,3/18/2018 7:15,37,43,43,36,159,4,50
1395,3/18/2018 7:20,24,37,38,32,131,4,50
1396,3/18/2018 7:25,44,56,41,34,175,4,50
1397,3/18/2018 7:30,45,52,45,38,180,4,50
1398,3/18/2018 7:35,40,57,40,34,171,4,50
1399,3/18/2018 7:40,46,61,54,47,208,4,50
1400,3/18/2018 7:45,42,59,52,45,198,4,50
1401,3/18/2018 7:50,40,58,45,38,181,4,50
1402,3/18/2018 7:55,43,49,52,45,189,4,50
1403,3/18/2018 8:00,37,53,43,36,169,4,50
1404,3/18/2018 8:05,42,54,45,38,179,4,50
1405,3/18/2018 8:10,48,57,56,49,210,4,50
1406,3/18/2018 8:15,50,56,53,46,205,4,50
1407,3/18/2018 8:20,45,50,49,42,186,4,50
1408,3/18/2018 8:25,54,70,59,52,235,4,50
1409,3/18/2018 8:30,63,71,50,44,228,4,50
1410,3/18/2018 8:35,55,60,56,49,220,4,50
1411,3/18/2018 8:40,59,79,55,47,240,4,50
1412,3/18/2018 8:45,60,78,59,51,248,4,50
1413,3/18/2018 8:50,62,81,58,50,251,4,50
1414,3/18/2018 8:55,74,69,56,49,248,4,50
1415,3/18/2018 9:00,52,80,53,46,231,4,50
1416,3/18/2018 9:05,52,69,62,54,237,4,50
1417,3/18/2018 9:10,71,70,60,53,254,4,50
1418,3/18/2018 9:15,57,69,60,52,238,4,50
1419,3/18/2018 9:20,78,88,70,62,298,4,50
1420,3/18/2018 9:25,79,85,68,60,292,4,50
1421,3/18/2018 9:30,77,93,80,71,321,4,50
1422,3/18/2018 9:35,91,85,71,63,310,4,50
1423,3/18/2018 9:40,88,105,84,75,352,4,50
1424,3/18/2018 9:45,89,104,73,65,331,4,50
1425,3/18/2018 9:50,88,105,70,62,325,4,50
1426,3/18/2018 9:55,105,95,82,74,356,4,50
1427,3/18/2018 10:00,100,102,66,58,326,4,50
1428,3/18/2018 10:05,101,103,74,66,344,4,50
1429,3/18/2018 10:10,102,90,66,58,316,4,50
1430,3/18/2018 10:15,104,103,81,73,361,4,50
1431,3/18/2018 10:20,104,117,71,63,355,4,50
1432,3/18/2018 10:25,103,100,81,73,357,4,50
1433,3/18/2018 10:30,131,126,73,65,395,4,50
1434,3/18/2018 10:35,120,126,79,71,396,4,50
1435,3/18/2018 10:40,115,119,78,70,382,4,50
1436,3/18/2018 10:45,96,112,78,70,356,4,50
1437,3/18/2018 10:50,127,128,94,85,434,4,50
1438,3/18/2018 10:55,111,133,85,76,405,4,50
1439,3/18/2018 11:00,111,112,84,75,382,4,50
1440,3/18/2018 11:05,125,120,82,73,400,4,50
1441,3/18/2018 11:10,116,119,90,81,406,4,50
1442,3/18/2018 11:15,119,118,84,76,397,4,50
1443,3/18/2018 11:20,130,122,89,80,421,4,50
1444,3/18/2018 11:25,136,118,81,73,408,4,50
1445,3/18/2018 11:30,115,119,92,83,409,4,50
1446,3/18/2018 11:35,115,126,82,74,397,4,50
1447,3/18/2018 11:40,121,135,82,73,411,4,50
1448,3/18/2018 11:45,119,120,88,79,406,4,50
1449,3/18/2018 11:50,118,115,88,79,400,4,50
1450,3/18/2018 11:55,118,116,84,75,393,4,50
1451,3/18/2018 12:00,108,127,86,77,398,4,50
1452,3/18/2018 12:05,122,118,83,75,398,4,50
1453,3/18/2018 12:10,121,120,88,79,408,4,50
1454,3/18/2018 12:15,120,118,80,72,390,4,50
1455,3/18/2018 12:20,128,129,99,90,446,4,50
1456,3/18/2018 12:25,121,121,100,91,433,4,50
1457,3/18/2018 12:30,117,121,88,79,405,4,50
1458,3/18/2018 12:35,119,118,96,86,419,4,50
1459,3/18/2018 12:40,94,103,82,74,353,4,50
1460,3/18/2018 12:45,122,128,97,88,435,4,50
1461,3/18/2018 12:50,114,123,98,88,423,4,50
1462,3/18/2018 12:55,129,131,104,94,458,4,50
1463,3/18/2018 13:00,108,127,90,81,406,4,50
1464,3/18/2018 13:05,94,114,85,77,370,4,50
1465,3/18/2018 13:10,113,112,84,75,384,4,50
1466,3/18/2018 13:15,114,120,98,88,420,4,50
1467,3/18/2018 13:20,121,120,99,90,430,4,50
1468,3/18/2018 13:25,118,110,94,85,407,4,50
1469,3/18/2018 13:30,123,119,93,84,419,4,50
1470,3/18/2018 13:35,128,126,95,85,434,4,50
1471,3/18/2018 13:40,120,118,85,76,399,4,50
1472,3/18/2018 13:45,124,123,92,83,422,4,50
1473,3/18/2018 13:50,110,119,103,93,425,4,50
1474,3/18/2018 13:55,100,106,91,82,379,4,50
1475,3/18/2018 14:00,116,123,79,70,388,4,50
1476,3/18/2018 14:05,108,120,87,78,393,4,50
1477,3/18/2018 14:10,117,129,102,93,441,4,50
1478,3/18/2018 14:15,107,120,99,90,416,4,50
1479,3/18/2018 14:20,108,101,82,73,364,4,50
1480,3/18/2018 14:25,107,113,93,84,397,4,50
1481,3/18/2018 14:30,110,100,85,77,372,4,50
1482,3/18/2018 14:35,119,112,91,82,404,4,50
1483,3/18/2018 14:40,124,115,95,86,420,4,50
1484,3/18/2018 14:45,112,112,84,75,383,4,50
1485,3/18/2018 14:50,109,106,93,84,392,4,50
1486,3/18/2018 14:55,103,107,82,73,365,4,50
1487,3/18/2018 15:00,103,111,94,85,393,4,50
1488,3/18/2018 15:05,105,113,90,82,390,4,50
1489,3/18/2018 15:10,114,118,91,82,405,4,50
1490,3/18/2018 15:15,110,117,94,85,406,4,50
1491,3/18/2018 15:20,111,126,96,87,420,4,50
1492,3/18/2018 15:25,114,114,95,86,409,4,50
1493,3/18/2018 15:30,115,120,98,89,422,4,50
1494,3/18/2018 15:35,122,117,96,86,421,4,50
1495,3/18/2018 15:40,126,124,102,92,444,4,50
1496,3/18/2018 15:45,98,99,89,81,367,4,50
1497,3/18/2018 15:50,120,114,94,85,413,4,50
1498,3/18/2018 15:55,106,123,99,89,417,4,50
1499,3/18/2018 16:00,119,114,97,88,418,4,50
1500,3/18/2018 16:05,120,110,93,84,407,4,50
1501,3/18/2018 16:10,123,117,93,84,417,4,50
1502,3/18/2018 16:15,106,120,93,84,403,4,50
1503,3/18/2018 16:20,94,113,87,79,373,4,50
1504,3/18/2018 16:25,112,117,85,77,391,4,50
1505,3/18/2018 16:30,102,106,84,75,367,4,50
1506,3/18/2018 16:35,117,113,99,89,418,4,50
1507,3/18/2018 16:40,100,110,89,80,379,4,50
1508,3/18/2018 16:45,109,115,88,79,391,4,50
1509,3/18/2018 16:50,103,119,92,83,397,4,50
1510,3/18/2018 16:55,108,101,91,82,382,4,50
1511,3/18/2018 17:00,112,114,96,86,408,4,50
1512,3/18/2018 17:05,121,118,89,80,408,4,50
1513,3/18/2018 17:10,123,115,88,80,406,4,50
1514,3/18/2018 17:15,127,113,94,85,419,4,50
1515,3/18/2018 17:20,109,117,91,82,399,4,50
1516,3/18/2018 17:25,115,110,97,88,410,4,50
1517,3/18/2018 17:30,114,111,83,74,382,4,50
1518,3/18/2018 17:35,111,101,88,79,379,4,50
1519,3/18/2018 17:40,107,121,92,83,403,4,50
1520,3/18/2018 17:45,134,109,92,83,418,4,50
1521,3/18/2018 17:50,108,111,93,84,396,4,50
1522,3/18/2018 17:55,117,120,81,73,391,4,50
1523,3/18/2018 18:00,87,98,72,64,321,4,50
1524,3/18/2018 18:05,99,112,97,87,395,4,50
1525,3/18/2018 18:10,103,118,91,82,394,4,50
1526,3/18/2018 18:15,97,107,80,72,356,4,50
1527,3/18/2018 18:20,115,133,96,86,430,4,50
1528,3/18/2018 18:25,102,108,85,76,371,4,50
1529,3/18/2018 18:30,98,102,80,72,352,4,50
1530,3/18/2018 18:35,105,106,80,71,362,4,50
1531,3/18/2018 18:40,84,97,82,74,337,4,50
1532,3/18/2018 18:45,93,100,76,68,337,4,50
1533,3/18/2018 18:50,97,94,75,66,332,4,50
1534,3/18/2018 18:55,91,95,79,70,335,4,50
1535,3/18/2018 19:00,96,99,72,64,331,4,50
1536,3/18/2018 19:05,88,80,72,64,304,4,50
1537,3/18/2018 19:10,92,91,81,72,336,4,50
1538,3/18/2018 19:15,100,97,81,73,351,4,50
1539,3/18/2018 19:20,85,86,77,68,316,4,50
1540,3/18/2018 19:25,76,89,77,69,311,4,50
1541,3/18/2018 19:30,83,78,74,66,301,4,50
1542,3/18/2018 19:35,102,93,75,67,337,4,50
1543,3/18/2018 19:40,89,96,80,71,336,4,50
1544,3/18/2018 19:45,68,88,77,69,302,4,50
1545,3/18/2018 19:50,85,88,79,70,322,4,50
1546,3/18/2018 19:55,79,91,67,60,297,4,50
1547,3/18/2018 20:00,73,86,69,61,289,4,50
1548,3/18/2018 20:05,73,87,72,64,296,4,50
1549,3/18/2018 20:10,71,81,72,64,288,4,50
1550,3/18/2018 20:15,84,81,70,62,297,4,50
1551,3/18/2018 20:20,82,90,70,62,304,4,50
1552,3/18/2018 20:25,79,91,67,59,296,4,50
1553,3/18/2018 20:30,79,90,68,60,297,4,50
1554,3/18/2018 20:35,86,90,66,58,300,4,50
1555,3/18/2018 20:40,70,82,68,60,280,4,50
1556,3/18/2018 20:45,79,82,71,63,295,4,50
1557,3/18/2018 20:50,68,73,68,60,269,4,50
1558,3/18/2018 20:55,83,88,61,54,286,4,50
1559,3/18/2018 21:00,59,69,63,55,246,4,50
1560,3/18/2018 21:05,76,80,65,58,279,4,50
1561,3/18/2018 21:10,63,78,62,55,258,4,50
1562,3/18/2018 21:15,74,71,64,56,265,4,50
1563,3/18/2018 21:20,76,80,69,61,286,4,50
1564,3/18/2018 21:25,72,82,63,55,272,4,50
1565,3/18/2018 21:30,79,94,61,53,287,4,50
1566,3/18/2018 21:35,71,77,52,45,245,4,50
1567,3/18/2018 21:40,61,66,48,42,217,4,50
1568,3/18/2018 21:45,61,86,69,61,277,4,50
1569,3/18/2018 21:50,78,73,53,45,249,4,50
1570,3/18/2018 21:55,57,68,51,43,219,4,50
1571,3/18/2018 22:00,70,78,54,47,249,4,50
1572,3/18/2018 22:05,61,72,56,49,238,4,50
1573,3/18/2018 22:10,61,84,59,51,255,4,50
1574,3/18/2018 22:15,64,71,60,53,248,4,50
1575,3/18/2018 22:20,72,80,57,49,258,4,50
1576,3/18/2018 22:25,69,72,55,48,244,4,50
1577,3/18/2018 22:30,59,69,61,54,243,4,50
1578,3/18/2018 22:35,57,67,57,50,231,4,50
1579,3/18/2018 22:40,50,66,47,40,203,4,50
1580,3/18/2018 22:45,52,58,48,41,199,4,50
1581,3/18/2018 22:50,39,62,52,45,198,4,50
1582,3/18/2018 22:55,37,66,50,43,196,4,50
1583,3/18/2018 23:00,32,41,41,35,149,4,50
1584,3/18/2018 23:05,26,38,38,32,134,4,50
1585,3/18/2018 23:10,39,42,48,41,170,4,50
1586,3/18/2018 23:15,75,79,61,53,268,4,50
1587,3/18/2018 23:20,85,112,80,71,348,4,50
1588,3/18/2018 23:25,79,92,67,60,298,4,50
1589,3/18/2018 23:30,74,81,65,57,277,4,50
1590,3/18/2018 23:35,53,60,62,54,229,4,50
1591,3/18/2018 23:40,47,59,50,43,199,4,50
1592,3/18/2018 23:45,37,42,49,42,170,4,50
1593,3/18/2018 23:50,40,59,48,41,188,4,50
1594,3/18/2018 23:55,39,54,53,46,192,4,50
1595,3/19/2018 0:00,32,54,46,40,172,4,50
1596,3/19/2018 0:05,42,60,53,46,201,4,50
1597,3/19/2018 0:10,32,57,46,40,175,4,50
1598,3/19/2018 0:15,32,51,46,39,168,4,50
1599,3/19/2018 0:20,29,53,45,38,165,4,50
1600,3/19/2018 0:25,37,55,44,38,174,4,50
1601,3/19/2018 0:30,32,53,42,36,163,4,50
1602,3/19/2018 0:35,26,43,43,36,148,4,50
1603,3/19/2018 0:40,31,36,32,25,124,4,50
1604,3/19/2018 0:45,18,36,37,30,121,4,50
1605,3/19/2018 0:50,31,36,38,32,137,4,50
1606,3/19/2018 0:55,22,34,31,25,112,4,50
1607,3/19/2018 1:00,17,26,29,24,96,4,50
1608,3/19/2018 1:05,11,30,27,22,90,4,50
1609,3/19/2018 1:10,16,30,25,20,91,4,50
1610,3/19/2018 1:15,9,30,28,22,89,4,50
1611,3/19/2018 1:20,15,24,22,17,78,4,50
1612,3/19/2018 1:25,10,26,21,16,73,4,50
1613,3/19/2018 1:30,13,28,27,21,89,4,50
1614,3/19/2018 1:35,7,17,24,18,66,4,50
1615,3/19/2018 1:40,14,18,19,14,65,4,50
1616,3/19/2018 1:45,14,23,25,20,82,4,50
1617,3/19/2018 1:50,9,26,25,20,80,4,50
1618,3/19/2018 1:55,18,20,28,23,89,4,50
1619,3/19/2018 2:00,14,21,31,24,90,4,50
1620,3/19/2018 2:05,8,19,23,18,68,4,50
1621,3/19/2018 2:10,18,26,19,14,77,4,50
1622,3/19/2018 2:15,7,23,21,15,66,4,50
1623,3/19/2018 2:20,7,27,25,19,78,4,50
1624,3/19/2018 2:25,15,29,23,17,84,4,50
1625,3/19/2018 2:30,16,20,22,17,75,4,50
1626,3/19/2018 2:35,7,23,22,17,69,4,50
1627,3/19/2018 2:40,21,27,25,20,93,4,50
1628,3/19/2018 2:45,13,29,21,15,78,4,50
1629,3/19/2018 2:50,16,20,22,17,75,4,50
1630,3/19/2018 2:55,16,21,26,20,83,4,50
1631,3/19/2018 3:00,6,30,23,17,76,4,50
1632,3/19/2018 3:05,14,29,21,16,80,4,50
1633,3/19/2018 3:10,9,16,23,18,66,4,50
1634,3/19/2018 3:15,13,21,29,23,86,4,50
1635,3/19/2018 3:20,16,29,24,19,88,4,50
1636,3/19/2018 3:25,18,27,24,19,88,4,50
1637,3/19/2018 3:30,22,36,30,24,112,4,50
1638,3/19/2018 3:35,24,33,25,19,101,4,50
1639,3/19/2018 3:40,20,24,24,18,86,4,50
1640,3/19/2018 3:45,18,31,25,20,94,4,50
1641,3/19/2018 3:50,18,30,30,24,102,4,50
1642,3/19/2018 3:55,20,21,22,17,80,4,50
1643,3/19/2018 4:00,17,22,27,22,88,4,50
1644,3/19/2018 4:05,16,33,27,21,97,4,50
1645,3/19/2018 4:10,19,33,31,25,108,4,50
1646,3/19/2018 4:15,32,39,32,26,129,4,50
1647,3/19/2018 4:20,41,40,39,33,153,4,50
1648,3/19/2018 4:25,30,46,43,36,155,4,50
1649,3/19/2018 4:30,37,47,40,34,158,4,50
1650,3/19/2018 4:35,48,58,46,39,191,4,50
1651,3/19/2018 4:40,62,73,53,47,235,4,50
1652,3/19/2018 4:45,49,54,51,44,198,4,50
1653,3/19/2018 4:50,60,67,45,38,210,4,50
1654,3/19/2018 4:55,55,70,53,47,225,4,50
1655,3/19/2018 5:00,67,69,61,53,250,4,50
1656,3/19/2018 5:05,64,72,53,46,235,4,50
1657,3/19/2018 5:10,80,77,57,50,264,4,50
1658,3/19/2018 5:15,87,79,65,58,289,4,50
1659,3/19/2018 5:20,96,93,67,59,315,4,50
1660,3/19/2018 5:25,93,96,75,66,330,4,50
1661,3/19/2018 5:30,99,81,77,68,325,4,50
1662,3/19/2018 5:35,104,94,86,77,361,4,50
1663,3/19/2018 5:40,116,113,85,77,391,4,50
1664,3/19/2018 5:45,115,108,85,77,385,4,50
1665,3/19/2018 5:50,119,109,84,75,387,4,50
1666,3/19/2018 5:55,105,107,79,70,361,4,50
1667,3/19/2018 6:00,114,104,82,73,373,4,50
1668,3/19/2018 6:05,119,101,82,74,376,4,50
1669,3/19/2018 6:10,121,109,90,81,401,4,50
1670,3/19/2018 6:15,124,116,97,88,425,4,50
1671,3/19/2018 6:20,123,108,95,86,412,4,50
1672,3/19/2018 6:25,131,128,101,91,451,4,50
1673,3/19/2018 6:30,131,132,102,92,457,4,50
1674,3/19/2018 6:35,138,136,90,81,445,4,50
1675,3/19/2018 6:40,146,135,104,94,479,4,50
1676,3/19/2018 6:45,158,138,104,94,494,4,50
1677,3/19/2018 6:50,148,143,96,86,473,4,50
1678,3/19/2018 6:55,154,137,88,79,458,4,50
1679,3/19/2018 7:00,149,133,103,93,478,4,50
1680,3/19/2018 7:05,164,153,109,99,525,4,50
1681,3/19/2018 7:10,141,136,100,90,467,4,50
1682,3/19/2018 7:15,166,154,115,105,540,4,50
1683,3/19/2018 7:20,147,143,111,101,502,4,50
1684,3/19/2018 7:25,152,154,117,106,529,4,50
1685,3/19/2018 7:30,170,152,115,105,542,4,50
1686,3/19/2018 7:35,149,137,117,107,510,4,50
1687,3/19/2018 7:40,140,129,108,98,475,4,50
1688,3/19/2018 7:45,139,126,106,96,467,4,50
1689,3/19/2018 7:50,149,150,113,103,515,4,50
1690,3/19/2018 7:55,150,140,90,81,461,4,50
1691,3/19/2018 8:00,142,136,99,90,467,4,50
1692,3/19/2018 8:05,154,136,90,81,461,4,50
1693,3/19/2018 8:10,149,139,95,86,469,4,50
1694,3/19/2018 8:15,133,137,104,95,469,4,50
1695,3/19/2018 8:20,155,136,113,103,507,4,50
1696,3/19/2018 8:25,159,142,107,98,506,4,50
1697,3/19/2018 8:30,163,151,117,106,537,4,50
1698,3/19/2018 8:35,162,137,95,85,479,4,50
1699,3/19/2018 8:40,151,144,94,85,474,4,50
1700,3/19/2018 8:45,153,118,103,94,468,4,50
1701,3/19/2018 8:50,148,138,109,99,494,4,50
1702,3/19/2018 8:55,134,118,103,93,448,4,50
1703,3/19/2018 9:00,137,133,101,92,463,4,50
1704,3/19/2018 9:05,125,106,94,85,410,4,50
1705,3/19/2018 9:10,132,116,81,73,402,4,50
1706,3/19/2018 9:15,117,110,91,82,400,4,50
1707,3/19/2018 9:20,112,117,93,84,406,4,50
1708,3/19/2018 9:25,125,116,84,75,400,4,50
1709,3/19/2018 9:30,121,113,75,67,376,4,50
1710,3/19/2018 9:35,140,117,88,79,424,4,50
1711,3/19/2018 9:40,137,113,92,83,425,4,50
1712,3/19/2018 9:45,124,128,85,77,414,4,50
1713,3/19/2018 9:50,115,123,93,84,415,4,50
1714,3/19/2018 9:55,117,107,92,83,399,4,50
1715,3/19/2018 10:00,97,98,78,70,343,4,50
1716,3/19/2018 10:05,112,116,86,77,391,4,50
1717,3/19/2018 10:10,130,104,84,75,393,4,50
1718,3/19/2018 10:15,124,114,90,81,409,4,50
1719,3/19/2018 10:20,118,99,80,72,369,4,50
1720,3/19/2018 10:25,115,108,82,73,378,4,50
1721,3/19/2018 10:30,113,105,83,75,376,4,50
1722,3/19/2018 10:35,112,106,89,80,387,4,50
1723,3/19/2018 10:40,109,108,88,79,384,4,50
1724,3/19/2018 10:45,121,105,82,74,382,4,50
1725,3/19/2018 10:50,94,91,74,66,325,4,50
1726,3/19/2018 10:55,122,112,84,75,393,4,50
1727,3/19/2018 11:00,115,99,78,70,362,4,50
1728,3/19/2018 11:05,111,110,81,73,375,4,50
1729,3/19/2018 11:10,114,114,91,82,401,4,50
1730,3/19/2018 11:15,114,111,80,71,376,4,50
1731,3/19/2018 11:20,107,110,88,79,384,4,50
1732,3/19/2018 11:25,123,116,90,81,410,4,50
1733,3/19/2018 11:30,103,114,80,71,368,4,50
1734,3/19/2018 11:35,120,120,80,71,391,4,50
1735,3/19/2018 11:40,119,114,84,75,392,4,50
1736,3/19/2018 11:45,120,121,79,71,391,4,50
1737,3/19/2018 11:50,109,108,89,80,386,4,50
1738,3/19/2018 11:55,99,101,87,78,365,4,50
0,3/19/2018 11:00,115,99,78,70,362,4,50
1,3/19/2018 11:05,111,110,81,73,375,4,50
2,3/19/2018 11:10,114,114,91,82,401,4,50
3,3/19/2018 11:15,114,111,80,71,376,4,50
4,3/19/2018 11:20,107,110,88,79,384,4,50
5,3/19/2018 11:25,123,116,90,81,410,4,50
6,3/19/2018 11:30,103,114,80,71,368,4,50
7,3/19/2018 11:35,120,120,80,71,391,4,50
8,3/19/2018 11:40,119,114,84,75,392,4,50
9,3/19/2018 11:45,120,121,79,71,391,4,50
10,3/19/2018 11:50,109,108,89,80,386,4,50
11,3/19/2018 11:55,99,101,87,78,365,4,50
12,3/19/2018 12:00,104,107,85,76,372,4,50
13,3/19/2018 12:05,100,100,88,79,367,4,50
14,3/19/2018 12:10,111,114,85,76,386,4,50
15,3/19/2018 12:15,121,117,92,83,413,4,50
16,3/19/2018 12:20,99,94,86,77,356,4,50
17,3/19/2018 12:25,132,124,92,83,431,4,50
18,3/19/2018 12:30,108,115,85,76,384,4,50
19,3/19/2018 12:35,99,91,81,72,343,4,50
20,3/19/2018 12:40,114,107,88,79,388,4,50
21,3/19/2018 12:45,105,97,85,77,364,4,50
22,3/19/2018 12:50,114,115,80,71,380,4,50
23,3/19/2018 12:55,114,114,78,70,376,4,50
24,3/19/2018 13:00,120,107,66,58,351,4,50
25,3/19/2018 13:05,111,104,80,71,366,4,50
26,3/19/2018 13:10,116,123,76,67,382,4,50
27,3/19/2018 13:15,114,115,83,75,387,4,50
28,3/19/2018 13:20,109,138,99,90,436,4,50
29,3/19/2018 13:25,115,120,95,86,416,4,50
30,3/19/2018 13:30,110,114,86,77,387,4,50
31,3/19/2018 13:35,119,111,88,79,397,4,50
32,3/19/2018 13:40,114,111,96,86,407,4,50
33,3/19/2018 13:45,113,117,97,88,415,4,50
34,3/19/2018 13:50,118,106,92,83,399,4,50
35,3/19/2018 13:55,96,115,84,76,371,4,50
36,3/19/2018 14:00,105,107,90,81,383,4,50
37,3/19/2018 14:05,124,133,86,77,420,4,50
38,3/19/2018 14:10,147,123,106,97,473,4,50
39,3/19/2018 14:15,116,108,83,75,382,4,50
40,3/19/2018 14:20,137,127,82,74,420,4,50
41,3/19/2018 14:25,134,113,96,86,429,4,50
42,3/19/2018 14:30,125,121,94,85,425,4,50
43,3/19/2018 14:35,132,123,101,91,447,4,50
44,3/19/2018 14:40,137,124,104,94,459,4,50
45,3/19/2018 14:45,138,128,98,88,452,4,50
46,3/19/2018 14:50,131,138,99,90,458,4,50
47,3/19/2018 14:55,140,116,92,83,431,4,50
48,3/19/2018 15:00,114,119,95,86,414,4,50
49,3/19/2018 15:05,125,128,109,99,461,4,50
50,3/19/2018 15:10,137,124,102,93,456,4,50
51,3/19/2018 15:15,147,130,104,94,475,4,50
52,3/19/2018 15:20,144,121,102,92,459,4,50
53,3/19/2018 15:25,139,129,98,88,454,4,50
54,3/19/2018 15:30,142,131,109,99,481,4,50
55,3/19/2018 15:35,115,113,97,88,413,4,50
56,3/19/2018 15:40,174,142,113,103,532,4,50
57,3/19/2018 15:45,133,132,112,101,478,4,50
58,3/19/2018 15:50,161,145,106,96,508,4,50
59,3/19/2018 15:55,136,128,110,100,474,4,50
60,3/19/2018 16:00,158,133,111,101,503,4,50
61,3/19/2018 16:05,138,133,108,98,477,4,50
62,3/19/2018 16:10,166,139,118,108,531,4,50
63,3/19/2018 16:15,159,146,104,94,503,4,50
64,3/19/2018 16:20,163,137,111,102,513,4,50
65,3/19/2018 16:25,160,147,113,103,523,4,50
66,3/19/2018 16:30,127,129,106,96,458,4,50
67,3/19/2018 16:35,164,136,116,105,521,4,50
68,3/19/2018 16:40,159,139,114,104,516,4,50
69,3/19/2018 16:45,159,134,109,99,501,4,50
70,3/19/2018 16:50,158,148,115,105,526,4,50
71,3/19/2018 16:55,134,131,112,102,479,4,50
72,3/19/2018 17:00,163,146,110,100,519,4,50
73,3/19/2018 17:05,160,149,117,107,533,4,50
74,3/19/2018 17:10,146,146,109,99,500,4,50
75,3/19/2018 17:15,168,158,116,105,547,4,50
76,3/19/2018 17:20,168,151,111,101,531,4,50
77,3/19/2018 17:25,156,157,115,105,533,4,50
78,3/19/2018 17:30,150,156,109,99,514,4,50
79,3/19/2018 17:35,147,137,107,98,489,4,50
80,3/19/2018 17:40,162,149,112,101,524,4,50
81,3/19/2018 17:45,155,147,118,107,527,4,50
82,3/19/2018 17:50,138,141,104,94,477,4,50
83,3/19/2018 17:55,144,123,99,90,456,4,50
84,3/19/2018 18:00,139,135,104,94,472,4,50
85,3/19/2018 18:05,162,142,108,98,510,4,50
86,3/19/2018 18:10,145,131,110,100,486,4,50
87,3/19/2018 18:15,136,134,106,96,472,4,50
88,3/19/2018 18:20,132,132,109,99,472,4,50
89,3/19/2018 18:25,144,128,106,97,475,4,50
90,3/19/2018 18:30,137,123,93,84,437,4,50
91,3/19/2018 18:35,121,112,99,89,421,4,50
92,3/19/2018 18:40,116,128,104,95,443,4,50
93,3/19/2018 18:45,118,127,101,92,438,4,50
94,3/19/2018 18:50,118,116,100,90,424,4,50
95,3/19/2018 18:55,115,110,96,87,408,4,50
96,3/19/2018 19:00,102,100,79,70,351,4,50
97,3/19/2018 19:05,100,103,87,78,368,4,50
98,3/19/2018 19:10,88,107,86,77,358,4,50
99,3/19/2018 19:15,93,118,88,79,378,4,50
100,3/19/2018 19:20,83,87,75,67,312,4,50
101,3/19/2018 19:25,91,101,84,76,352,4,50
102,3/19/2018 19:30,90,85,79,71,325,4,50
103,3/19/2018 19:35,92,110,74,66,342,4,50
104,3/19/2018 19:40,120,97,82,74,373,4,50
105,3/19/2018 19:45,118,108,83,75,384,4,50
106,3/19/2018 19:50,97,89,75,66,327,4,50
107,3/19/2018 19:55,95,103,69,62,329,4,50
108,3/19/2018 20:00,88,97,84,75,344,4,50
109,3/19/2018 20:05,89,98,72,64,323,4,50
110,3/19/2018 20:10,70,91,71,63,295,4,50
111,3/19/2018 20:15,80,88,69,61,298,4,50
112,3/19/2018 20:20,78,93,74,66,311,4,50
113,3/19/2018 20:25,79,92,70,62,303,4,50
114,3/19/2018 20:30,72,76,62,54,264,4,50
115,3/19/2018 20:35,72,66,61,53,252,4,50
116,3/19/2018 20:40,79,84,68,60,291,4,50
117,3/19/2018 20:45,70,80,71,63,284,4,50
118,3/19/2018 20:50,67,73,61,53,254,4,50
119,3/19/2018 20:55,66,79,66,58,269,4,50
120,3/19/2018 21:00,64,80,57,49,250,4,50
121,3/19/2018 21:05,67,79,52,45,243,4,50
122,3/19/2018 21:10,54,77,67,60,258,4,50
123,3/19/2018 21:15,50,69,63,55,237,4,50
124,3/19/2018 21:20,64,61,43,36,204,4,50
125,3/19/2018 21:25,53,56,58,51,218,4,50
126,3/19/2018 21:30,70,71,67,60,268,4,50
127,3/19/2018 21:35,50,72,49,42,213,4,50
128,3/19/2018 21:40,47,63,56,49,215,4,50
129,3/19/2018 21:45,57,52,45,38,192,4,50
130,3/19/2018 21:50,49,56,55,48,208,4,50
131,3/19/2018 21:55,50,58,50,43,201,4,50
132,3/19/2018 22:00,63,74,45,38,220,4,50
133,3/19/2018 22:05,52,61,43,36,192,4,50
134,3/19/2018 22:10,41,46,48,42,177,4,50
135,3/19/2018 22:15,49,66,53,47,215,4,50
136,3/19/2018 22:20,42,54,49,42,187,4,50
137,3/19/2018 22:25,42,60,48,42,192,4,50
138,3/19/2018 22:30,31,51,48,41,171,4,50
139,3/19/2018 22:35,42,56,44,37,179,4,50
140,3/19/2018 22:40,34,38,42,36,150,4,50
141,3/19/2018 22:45,37,51,43,36,167,4,50
142,3/19/2018 22:50,36,42,39,33,150,4,50
143,3/19/2018 22:55,28,42,42,35,147,4,50
144,3/19/2018 23:00,27,31,35,29,122,4,50
145,3/19/2018 23:05,24,34,38,31,127,4,50
146,3/19/2018 23:10,40,48,43,37,168,4,50
147,3/19/2018 23:15,58,71,63,55,247,4,50
148,3/19/2018 23:20,58,74,65,57,254,4,50
149,3/19/2018 23:25,48,76,53,46,223,4,50
150,3/19/2018 23:30,27,41,48,41,157,4,50
151,3/19/2018 23:35,30,34,39,33,136,4,50
152,3/19/2018 23:40,26,45,48,41,160,4,50
153,3/19/2018 23:45,36,45,43,36,160,4,50
154,3/19/2018 23:50,21,44,38,31,134,4,50
155,3/19/2018 23:55,28,51,34,28,141,4,50
156,3/20/2018 0:00,32,38,37,31,138,4,50
157,3/20/2018 0:05,25,42,35,29,131,4,50
158,3/20/2018 0:10,17,38,32,27,114,4,50
159,3/20/2018 0:15,23,36,32,26,117,4,50
160,3/20/2018 0:20,29,34,34,27,124,4,50
161,3/20/2018 0:25,24,34,34,28,120,4,50
162,3/20/2018 0:30,24,36,32,26,118,4,50
163,3/20/2018 0:35,20,36,35,29,120,4,50
164,3/20/2018 0:40,12,27,28,23,90,4,50
165,3/20/2018 0:45,20,28,32,26,106,4,50
166,3/20/2018 0:50,19,33,37,30,119,4,50
167,3/20/2018 0:55,16,29,27,21,93,4,50
168,3/20/2018 1:00,14,31,30,24,99,4,50
169,3/20/2018 1:05,16,27,29,23,95,4,50
170,3/20/2018 1:10,12,27,28,23,90,4,50
171,3/20/2018 1:15,14,26,30,24,94,4,50
172,3/20/2018 1:20,12,23,28,23,86,4,50
173,3/20/2018 1:25,11,20,24,18,73,4,50
174,3/20/2018 1:30,11,18,22,17,68,4,50
175,3/20/2018 1:35,13,30,26,20,89,4,50
176,3/20/2018 1:40,15,22,23,18,78,4,50
177,3/20/2018 1:45,11,19,27,21,78,4,50
178,3/20/2018 1:50,11,19,27,22,79,4,50
179,3/20/2018 1:55,11,31,25,19,86,4,50
180,3/20/2018 2:00,13,24,20,15,72,4,50
181,3/20/2018 2:05,13,19,16,11,59,4,50
182,3/20/2018 2:10,8,22,28,22,80,4,50
183,3/20/2018 2:15,7,21,23,18,69,4,50
184,3/20/2018 2:20,8,19,19,14,60,4,50
185,3/20/2018 2:25,16,23,20,15,74,4,50
186,3/20/2018 2:30,9,25,27,22,83,4,50
187,3/20/2018 2:35,14,23,23,17,77,4,50
188,3/20/2018 2:40,8,23,19,14,64,4,50
189,3/20/2018 2:45,10,30,25,20,85,4,50
190,3/20/2018 2:50,19,29,29,23,100,4,50
191,3/20/2018 2:55,14,21,18,13,66,4,50
192,3/20/2018 3:00,10,19,24,18,71,4,50
193,3/20/2018 3:05,10,17,20,15,62,4,50
194,3/20/2018 3:10,8,24,23,17,72,4,50
195,3/20/2018 3:15,12,14,22,17,65,4,50
196,3/20/2018 3:20,14,24,29,23,90,4,50
197,3/20/2018 3:25,19,27,28,23,97,4,50
198,3/20/2018 3:30,26,37,31,25,119,4,50
199,3/20/2018 3:35,26,38,31,26,121,4,50
200,3/20/2018 3:40,25,43,36,30,134,4,50
201,3/20/2018 3:45,21,42,38,32,133,4,50
202,3/20/2018 3:50,24,33,33,27,117,4,50
203,3/20/2018 3:55,24,36,29,23,112,4,50
204,3/20/2018 4:00,34,39,39,33,145,4,50
205,3/20/2018 4:05,22,42,39,33,136,4,50
206,3/20/2018 4:10,40,62,44,38,184,4,50
207,3/20/2018 4:15,54,60,51,44,209,4,50
208,3/20/2018 4:20,55,72,51,44,222,4,50
209,3/20/2018 4:25,57,75,54,47,233,4,50
210,3/20/2018 4:30,81,74,65,58,278,4,50
211,3/20/2018 4:35,71,98,70,62,301,4,50
212,3/20/2018 4:40,93,99,72,64,328,4,50
213,3/20/2018 4:45,74,87,67,59,287,4,50
214,3/20/2018 4:50,70,67,51,44,232,4,50
215,3/20/2018 4:55,60,75,54,47,236,4,50
216,3/20/2018 5:00,57,66,59,51,233,4,50
217,3/20/2018 5:05,75,79,59,52,265,4,50
218,3/20/2018 5:10,84,65,60,53,262,4,50
219,3/20/2018 5:15,109,88,77,69,343,4,50
220,3/20/2018 5:20,104,105,73,65,347,4,50
221,3/20/2018 5:25,102,106,88,79,375,4,50
222,3/20/2018 5:30,109,106,75,66,356,4,50
223,3/20/2018 5:35,114,111,86,77,388,4,50
224,3/20/2018 5:40,110,103,92,83,388,4,50
225,3/20/2018 5:45,114,99,85,77,375,4,50
226,3/20/2018 5:50,121,110,85,77,393,4,50
227,3/20/2018 5:55,104,103,90,81,378,4,50
228,3/20/2018 6:00,111,94,86,77,368,4,50
229,3/20/2018 6:05,103,92,84,75,354,4,50
230,3/20/2018 6:10,119,104,82,73,378,4,50
231,3/20/2018 6:15,100,106,93,84,383,4,50
232,3/20/2018 6:20,115,85,81,72,353,4,50
233,3/20/2018 6:25,112,109,93,84,398,4,50
234,3/20/2018 6:30,99,97,82,73,351,4,50
235,3/20/2018 6:35,119,109,84,75,387,4,50
236,3/20/2018 6:40,121,109,97,87,414,4,50
237,3/20/2018 6:45,109,117,95,86,407,4,50
238,3/20/2018 6:50,153,140,106,97,496,4,50
239,3/20/2018 6:55,171,156,116,105,548,4,50
240,3/20/2018 7:00,155,144,116,105,520,4,50
241,3/20/2018 7:05,162,154,113,103,532,4,50
242,3/20/2018 7:10,145,129,106,97,477,4,50
243,3/20/2018 7:15,143,129,104,95,471,4,50
244,3/20/2018 7:20,156,134,114,105,509,4,50
245,3/20/2018 7:25,166,129,111,101,507,4,50
246,3/20/2018 7:30,162,153,112,102,529,4,50
247,3/20/2018 7:35,151,125,108,98,482,4,50
248,3/20/2018 7:40,140,125,108,98,471,4,50
249,3/20/2018 7:45,142,143,102,92,479,4,50
250,3/20/2018 7:50,127,122,103,93,445,4,50
251,3/20/2018 7:55,158,156,106,97,517,4,50
252,3/20/2018 8:00,142,136,96,87,461,4,50
253,3/20/2018 8:05,142,121,96,87,446,4,50
254,3/20/2018 8:10,139,138,96,86,459,4,50
255,3/20/2018 8:15,156,136,98,88,478,4,50
256,3/20/2018 8:20,146,139,99,90,474,4,50
257,3/20/2018 8:25,146,127,82,74,429,4,50
258,3/20/2018 8:30,159,134,104,94,491,4,50
259,3/20/2018 8:35,164,142,94,85,485,4,50
260,3/20/2018 8:40,157,129,97,88,471,4,50
261,3/20/2018 8:45,143,143,105,95,486,4,50
262,3/20/2018 8:50,155,136,95,86,472,4,50
263,3/20/2018 8:55,122,100,88,79,389,4,50
264,3/20/2018 9:00,144,128,85,77,434,4,50
265,3/20/2018 9:05,135,110,86,77,408,4,50
266,3/20/2018 9:10,127,107,88,79,401,4,50
267,3/20/2018 9:15,120,134,80,71,405,4,50
268,3/20/2018 9:20,135,126,81,73,415,4,50
269,3/20/2018 9:25,118,115,83,74,390,4,50
270,3/20/2018 9:30,116,106,90,81,393,4,50
271,3/20/2018 9:35,129,106,87,78,400,4,50
272,3/20/2018 9:40,124,113,97,88,422,4,50
273,3/20/2018 9:45,114,111,96,87,408,4,50
274,3/20/2018 9:50,109,114,91,82,396,4,50
275,3/20/2018 9:55,114,123,67,60,364,4,50
276,3/20/2018 10:00,126,115,75,67,383,4,50
277,3/20/2018 10:05,123,119,68,60,370,4,50
278,3/20/2018 10:10,97,107,78,70,352,4,50
279,3/20/2018 10:15,118,110,78,70,376,4,50
280,3/20/2018 10:20,83,86,80,71,320,4,50
281,3/20/2018 10:25,107,107,91,82,387,4,50
282,3/20/2018 10:30,106,111,77,68,362,4,50
283,3/20/2018 10:35,110,108,96,87,401,4,50
284,3/20/2018 10:40,99,106,94,85,384,4,50
285,3/20/2018 10:45,105,115,100,91,411,4,50
286,3/20/2018 10:50,121,104,91,82,398,4,50
287,3/20/2018 10:55,113,104,93,84,394,4,50
288,3/20/2018 11:00,109,92,84,76,361,4,50
289,3/20/2018 11:05,87,89,82,74,332,4,50
290,3/20/2018 11:10,98,100,84,75,357,4,50
291,3/20/2018 11:15,97,93,83,74,347,4,50
292,3/20/2018 11:20,93,100,90,81,364,4,50
293,3/20/2018 11:25,105,107,88,79,379,4,50
294,3/20/2018 11:30,116,106,91,82,395,4,50
295,3/20/2018 11:35,106,106,83,75,370,4,50
296,3/20/2018 11:40,108,113,88,79,388,4,50
297,3/20/2018 11:45,102,110,87,78,377,4,50
298,3/20/2018 11:50,109,108,91,82,390,4,50
299,3/20/2018 11:55,116,122,75,67,380,4,50
300,3/20/2018 12:00,108,100,80,71,359,4,50
301,3/20/2018 12:05,108,99,88,79,374,4,50
302,3/20/2018 12:10,113,117,92,83,405,4,50
303,3/20/2018 12:15,113,117,89,80,399,4,50
304,3/20/2018 12:20,111,109,93,84,397,4,50
305,3/20/2018 12:25,109,116,90,81,396,4,50
306,3/20/2018 12:30,105,116,84,75,380,4,50
307,3/20/2018 12:35,98,111,88,79,376,4,50
308,3/20/2018 12:40,123,114,80,72,389,4,50
309,3/20/2018 12:45,121,121,90,81,413,4,50
310,3/20/2018 12:50,129,119,90,81,419,4,50
311,3/20/2018 12:55,109,111,98,89,407,4,50
312,3/20/2018 13:00,103,96,87,79,365,4,50
313,3/20/2018 13:05,112,115,86,77,390,4,50
314,3/20/2018 13:10,114,121,91,82,408,4,50
315,3/20/2018 13:15,117,113,99,90,419,4,50
316,3/20/2018 13:20,112,125,88,79,404,4,50
317,3/20/2018 13:25,128,134,87,78,427,4,50
318,3/20/2018 13:30,115,123,92,83,413,4,50
319,3/20/2018 13:35,132,116,98,89,435,4,50
320,3/20/2018 13:40,125,125,86,77,413,4,50
321,3/20/2018 13:45,118,114,93,84,409,4,50
322,3/20/2018 13:50,126,114,94,85,419,4,50
323,3/20/2018 13:55,149,134,99,90,472,4,50
324,3/20/2018 14:00,121,116,92,83,412,4,50
325,3/20/2018 14:05,117,120,86,77,400,4,50
326,3/20/2018 14:10,121,133,88,79,421,4,50
327,3/20/2018 14:15,134,121,96,86,437,4,50
328,3/20/2018 14:20,149,130,104,94,477,4,50
329,3/20/2018 14:25,142,119,93,84,438,4,50
330,3/20/2018 14:30,131,125,99,90,445,4,50
331,3/20/2018 14:35,151,133,93,84,461,4,50
332,3/20/2018 14:40,133,141,94,85,453,4,50
333,3/20/2018 14:45,136,120,92,83,431,4,50
334,3/20/2018 14:50,116,116,88,79,399,4,50
335,3/20/2018 14:55,95,98,89,80,362,4,50
336,3/20/2018 15:00,118,101,91,82,392,4,50
337,3/20/2018 15:05,127,120,80,72,399,4,50
338,3/20/2018 15:10,148,146,105,95,494,4,50
339,3/20/2018 15:15,147,145,101,91,484,4,50
340,3/20/2018 15:20,146,141,95,86,468,4,50
341,3/20/2018 15:25,145,140,114,103,502,4,50
342,3/20/2018 15:30,144,137,95,86,462,4,50
343,3/20/2018 15:35,146,137,104,94,481,4,50
344,3/20/2018 15:40,159,139,112,102,512,4,50
345,3/20/2018 15:45,151,122,88,79,440,4,50
346,3/20/2018 15:50,159,146,99,90,494,4,50
347,3/20/2018 15:55,136,123,84,75,418,4,50
348,3/20/2018 16:00,170,126,102,92,490,4,50
349,3/20/2018 16:05,154,133,101,91,479,4,50
350,3/20/2018 16:10,136,138,99,90,463,4,50
351,3/20/2018 16:15,148,129,103,93,473,4,50
352,3/20/2018 16:20,150,148,109,99,506,4,50
353,3/20/2018 16:25,148,137,106,96,487,4,50
354,3/20/2018 16:30,163,159,115,105,542,4,50
355,3/20/2018 16:35,144,133,109,100,486,4,50
356,3/20/2018 16:40,161,134,114,104,513,4,50
357,3/20/2018 16:45,148,141,112,102,503,4,50
358,3/20/2018 16:50,145,145,120,110,520,4,50
359,3/20/2018 16:55,156,143,104,94,497,4,50
360,3/20/2018 17:00,164,141,114,104,523,4,50
361,3/20/2018 17:05,176,153,115,105,549,4,50
362,3/20/2018 17:10,164,165,106,97,532,4,50
363,3/20/2018 17:15,151,138,108,98,495,4,50
364,3/20/2018 17:20,154,146,109,99,508,4,50
365,3/20/2018 17:25,163,141,109,99,512,4,50
366,3/20/2018 17:30,151,151,115,105,522,4,50
367,3/20/2018 17:35,164,149,112,102,527,4,50
368,3/20/2018 17:40,155,154,120,109,538,4,50
369,3/20/2018 17:45,143,144,109,99,495,4,50
370,3/20/2018 17:50,178,137,101,91,507,4,50
371,3/20/2018 17:55,148,137,98,88,471,4,50
372,3/20/2018 18:00,162,156,109,99,526,4,50
373,3/20/2018 18:05,145,140,109,100,494,4,50
374,3/20/2018 18:10,146,135,107,97,485,4,50
375,3/20/2018 18:15,162,136,110,100,508,4,50
376,3/20/2018 18:20,143,145,104,94,486,4,50
377,3/20/2018 18:25,134,121,105,96,456,4,50
378,3/20/2018 18:30,133,130,109,99,471,4,50
379,3/20/2018 18:35,130,124,95,86,435,4,50
380,3/20/2018 18:40,133,123,95,86,437,4,50
381,3/20/2018 18:45,139,131,104,94,468,4,50
382,3/20/2018 18:50,124,115,100,90,429,4,50
383,3/20/2018 18:55,125,119,90,81,415,4,50
384,3/20/2018 19:00,132,126,95,86,439,4,50
385,3/20/2018 19:05,112,101,77,68,358,4,50
386,3/20/2018 19:10,89,91,80,72,332,4,50
387,3/20/2018 19:15,83,91,75,67,316,4,50
388,3/20/2018 19:20,103,103,78,70,354,4,50
389,3/20/2018 19:25,94,86,80,72,332,4,50
390,3/20/2018 19:30,91,98,72,64,325,4,50
391,3/20/2018 19:35,95,82,76,68,321,4,50
392,3/20/2018 19:40,89,84,74,66,313,4,50
393,3/20/2018 19:45,114,104,85,77,380,4,50
394,3/20/2018 19:50,91,80,76,68,315,4,50
395,3/20/2018 19:55,88,89,78,70,325,4,50
396,3/20/2018 20:00,83,83,67,60,293,4,50
397,3/20/2018 20:05,83,90,72,64,309,4,50
398,3/20/2018 20:10,83,71,67,60,281,4,50
399,3/20/2018 20:15,82,86,75,66,309,4,50
400,3/20/2018 20:20,67,81,66,58,272,4,50
401,3/20/2018 20:25,86,93,82,73,334,4,50
402,3/20/2018 20:30,80,63,58,51,252,4,50
403,3/20/2018 20:35,65,82,59,52,258,4,50
404,3/20/2018 20:40,71,72,67,60,270,4,50
405,3/20/2018 20:45,85,83,75,66,309,4,50
406,3/20/2018 20:50,76,79,70,62,287,4,50
407,3/20/2018 20:55,74,78,61,53,266,4,50
408,3/20/2018 21:00,59,60,62,54,235,4,50
409,3/20/2018 21:05,74,81,59,52,266,4,50
410,3/20/2018 21:10,80,87,74,66,307,4,50
411,3/20/2018 21:15,76,78,62,54,270,4,50
412,3/20/2018 21:20,61,61,56,49,227,4,50
413,3/20/2018 21:25,60,75,56,49,240,4,50
414,3/20/2018 21:30,53,74,51,44,222,4,50
415,3/20/2018 21:35,57,56,58,50,221,4,50
416,3/20/2018 21:40,79,73,59,52,263,4,50
417,3/20/2018 21:45,59,65,60,52,236,4,50
418,3/20/2018 21:50,63,61,47,40,211,4,50
419,3/20/2018 21:55,58,61,56,49,224,4,50
420,3/20/2018 22:00,49,65,57,50,221,4,50
421,3/20/2018 22:05,57,68,52,45,222,4,50
422,3/20/2018 22:10,40,61,56,49,206,4,50
423,3/20/2018 22:15,58,64,54,46,222,4,50
424,3/20/2018 22:20,51,48,48,41,188,4,50
425,3/20/2018 22:25,47,60,46,40,193,4,50
426,3/20/2018 22:30,38,54,39,33,164,4,50
427,3/20/2018 22:35,47,60,53,47,207,4,50
428,3/20/2018 22:40,40,54,46,40,180,4,50
429,3/20/2018 22:45,43,48,50,43,184,4,50
430,3/20/2018 22:50,34,52,39,32,157,4,50
431,3/20/2018 22:55,24,31,38,31,124,4,50
432,3/20/2018 23:00,21,40,32,26,119,4,50
433,3/20/2018 23:05,46,50,45,38,179,4,50
434,3/20/2018 23:10,74,90,70,62,296,4,50
435,3/20/2018 23:15,66,83,69,61,279,4,50
436,3/20/2018 23:20,43,73,52,45,213,4,50
437,3/20/2018 23:25,56,66,54,47,223,4,50
438,3/20/2018 23:30,33,46,40,34,153,4,50
439,3/20/2018 23:35,25,48,46,39,158,4,50
440,3/20/2018 23:40,34,57,44,38,173,4,50
441,3/20/2018 23:45,41,60,43,37,181,4,50
442,3/20/2018 23:50,26,48,45,38,157,4,50
443,3/20/2018 23:55,25,50,37,31,143,4,50
444,3/21/2018 0:00,19,44,42,36,141,4,50
445,3/21/2018 0:05,25,40,36,30,131,4,50
446,3/21/2018 0:10,10,40,38,32,120,4,50
447,3/21/2018 0:15,27,37,36,30,130,4,0
448,3/21/2018 0:20,24,34,33,27,118,4,0
449,3/21/2018 0:25,17,30,32,27,106,4,50
450,3/21/2018 0:30,21,36,29,24,110,4,50
451,3/21/2018 0:35,23,41,31,25,120,4,50
452,3/21/2018 0:40,20,34,34,28,116,4,50
453,3/21/2018 0:45,22,38,37,31,128,4,50
454,3/21/2018 0:50,12,29,25,20,86,4,50
455,3/21/2018 0:55,18,32,31,25,106,4,50
456,3/21/2018 1:00,17,24,31,26,98,4,50
457,3/21/2018 1:05,12,26,23,18,79,4,50
458,3/21/2018 1:10,14,32,23,18,87,4,50
459,3/21/2018 1:15,16,32,34,27,109,4,50
460,3/21/2018 1:20,12,21,21,16,70,4,50
461,3/21/2018 1:25,15,25,31,25,96,4,50
462,3/21/2018 1:30,14,23,28,22,87,4,50
463,3/21/2018 1:35,16,24,27,22,89,4,50
464,3/21/2018 1:40,16,28,23,17,84,4,50
465,3/21/2018 1:45,12,23,22,16,73,4,50
466,3/21/2018 1:50,7,25,20,15,67,4,50
467,3/21/2018 1:55,11,25,24,18,78,4,50
468,3/21/2018 2:00,12,17,22,17,68,4,50
469,3/21/2018 2:05,12,29,25,20,86,4,50
470,3/21/2018 2:10,10,20,22,17,69,4,50
471,3/21/2018 2:15,9,33,25,20,87,4,50
472,3/21/2018 2:20,9,33,29,23,94,4,50
473,3/21/2018 2:25,13,38,22,17,90,4,50
474,3/21/2018 2:30,16,23,24,18,81,4,50
475,3/21/2018 2:35,18,18,17,12,65,4,50
476,3/21/2018 2:40,13,25,22,17,77,4,50
477,3/21/2018 2:45,14,26,32,26,98,4,50
478,3/21/2018 2:50,17,31,23,18,89,4,50
479,3/21/2018 2:55,15,22,21,15,73,4,50
480,3/21/2018 3:00,9,22,17,12,60,4,50
481,3/21/2018 3:05,15,25,23,18,81,4,50
482,3/21/2018 3:10,16,23,22,17,78,4,50
483,3/21/2018 3:15,15,24,23,18,80,4,50
484,3/21/2018 3:20,16,21,25,19,81,4,50
485,3/21/2018 3:25,20,34,34,28,116,4,50
486,3/21/2018 3:30,22,34,28,23,107,4,50
487,3/21/2018 3:35,20,36,35,29,120,4,50
488,3/21/2018 3:40,27,50,38,31,146,4,50
489,3/21/2018 3:45,30,36,34,28,128,4,50
490,3/21/2018 3:50,23,37,33,27,120,4,50
491,3/21/2018 3:55,26,46,36,29,137,4,50
492,3/21/2018 4:00,32,48,35,29,144,4,50
493,3/21/2018 4:05,30,38,32,27,127,4,50
494,3/21/2018 4:10,33,56,48,41,178,4,50
495,3/21/2018 4:15,42,57,50,43,192,4,50
496,3/21/2018 4:20,56,67,53,46,222,4,50
497,3/21/2018 4:25,77,75,55,47,254,4,50
498,3/21/2018 4:30,65,83,60,53,261,4,50
499,3/21/2018 4:35,55,65,63,55,238,4,50
500,3/21/2018 4:40,65,65,58,51,239,4,50
501,3/21/2018 4:45,58,66,47,40,211,4,50
502,3/21/2018 4:50,47,60,49,42,198,4,50
503,3/21/2018 4:55,52,70,56,49,227,4,50
504,3/21/2018 5:00,63,51,53,45,212,4,50
505,3/21/2018 5:05,71,67,60,53,251,4,50
506,3/21/2018 5:10,57,70,55,48,230,4,50
507,3/21/2018 5:15,74,77,64,56,271,4,50
508,3/21/2018 5:20,81,74,63,55,273,4,50
509,3/21/2018 5:25,96,86,80,72,334,4,50
510,3/21/2018 5:30,107,94,72,64,337,4,50
511,3/21/2018 5:35,89,104,80,72,345,4,50
512,3/21/2018 5:40,101,103,84,75,363,4,50
513,3/21/2018 5:45,109,98,87,78,372,4,50
514,3/21/2018 5:50,112,104,83,75,374,4,50
515,3/21/2018 5:55,86,88,80,72,326,4,50
516,3/21/2018 6:00,114,115,89,80,398,4,50
517,3/21/2018 6:05,100,96,86,77,359,4,50
518,3/21/2018 6:10,109,99,86,77,371,4,50
519,3/21/2018 6:15,112,100,88,79,379,4,50
520,3/21/2018 6:20,117,116,95,86,414,4,50
521,3/21/2018 6:25,141,123,105,96,465,4,50
522,3/21/2018 6:30,140,123,85,77,425,4,50
523,3/21/2018 6:35,150,131,98,89,468,4,50
524,3/21/2018 6:40,150,142,102,92,486,4,50
525,3/21/2018 6:45,155,147,93,84,479,4,50
526,3/21/2018 6:50,137,132,100,90,459,4,50
527,3/21/2018 6:55,173,151,98,89,511,4,50
528,3/21/2018 7:00,165,145,111,101,522,4,50
529,3/21/2018 7:05,167,150,116,105,538,4,50
530,3/21/2018 7:10,154,139,111,101,505,4,50
531,3/21/2018 7:15,180,151,108,98,537,4,50
532,3/21/2018 7:20,135,131,80,71,417,4,50
533,3/21/2018 7:25,132,132,93,84,441,4,50
534,3/21/2018 7:30,143,132,101,92,468,4,50
535,3/21/2018 7:35,146,140,109,99,494,4,50
536,3/21/2018 7:40,138,149,98,88,473,4,50
537,3/21/2018 7:45,152,137,97,88,474,4,50
538,3/21/2018 7:50,145,145,102,92,484,4,50
539,3/21/2018 7:55,150,139,111,102,502,4,50
540,3/21/2018 8:00,150,143,104,94,491,4,50
541,3/21/2018 8:05,134,130,109,99,472,4,50
542,3/21/2018 8:10,154,140,107,97,498,4,50
543,3/21/2018 8:15,155,138,96,87,476,4,50
544,3/21/2018 8:20,164,148,97,88,497,4,50
545,3/21/2018 8:25,134,132,101,91,458,4,50
546,3/21/2018 8:30,157,143,101,91,492,4,50
547,3/21/2018 8:35,156,131,75,67,429,4,50
548,3/21/2018 8:40,153,140,106,96,495,4,50
549,3/21/2018 8:45,155,146,111,102,514,4,50
550,3/21/2018 8:50,147,134,98,89,468,4,50
551,3/21/2018 8:55,148,127,88,79,442,4,50
552,3/21/2018 9:00,139,138,88,79,444,4,50
553,3/21/2018 9:05,143,114,93,84,434,4,50
554,3/21/2018 9:10,149,133,101,91,474,4,50
555,3/21/2018 9:15,137,124,92,83,436,4,50
556,3/21/2018 9:20,111,129,90,81,411,4,50
557,3/21/2018 9:25,111,125,85,77,398,4,50
558,3/21/2018 9:30,119,116,86,77,398,4,50
559,3/21/2018 9:35,117,111,89,80,397,4,50
560,3/21/2018 9:40,128,128,91,82,429,4,50
561,3/21/2018 9:45,106,117,85,76,384,4,50
562,3/21/2018 9:50,118,105,76,68,367,4,50
563,3/21/2018 9:55,108,93,85,76,362,4,50
564,3/21/2018 10:00,111,100,84,75,370,4,50
565,3/21/2018 10:05,107,99,89,81,376,4,50
566,3/21/2018 10:10,103,87,81,72,343,4,50
567,3/21/2018 10:15,108,114,62,54,338,4,50
568,3/21/2018 10:20,130,108,96,87,421,4,50
569,3/21/2018 10:25,126,119,96,86,427,4,50
570,3/21/2018 10:30,127,116,76,68,387,4,50
571,3/21/2018 10:35,122,109,80,72,383,4,50
572,3/21/2018 10:40,122,127,94,85,428,4,50
573,3/21/2018 10:45,109,108,75,67,359,4,50
574,3/21/2018 10:50,109,107,81,73,370,4,50
575,3/21/2018 10:55,112,129,67,60,368,4,50
576,3/21/2018 11:00,108,108,82,74,372,4,50
577,3/21/2018 11:05,103,102,82,73,360,4,50
578,3/21/2018 11:10,122,115,85,77,399,4,50
579,3/21/2018 11:15,118,119,73,65,375,4,50
580,3/21/2018 11:20,119,118,96,87,420,4,50
581,3/21/2018 11:25,113,119,100,90,422,4,50
582,3/21/2018 11:30,104,96,77,68,345,4,50
583,3/21/2018 11:35,102,118,82,73,375,4,50
584,3/21/2018 11:40,123,113,91,82,409,4,50
585,3/21/2018 11:45,124,115,90,81,410,4,50
586,3/21/2018 11:50,108,104,76,68,356,4,50
587,3/21/2018 11:55,107,107,67,60,341,4,50
588,3/21/2018 12:00,120,112,90,81,403,4,50
589,3/21/2018 12:05,110,113,78,70,371,4,50
590,3/21/2018 12:10,96,100,75,67,338,4,50
591,3/21/2018 12:15,113,102,82,73,370,4,50
592,3/21/2018 12:20,121,109,60,53,343,4,50
593,3/21/2018 12:25,101,101,82,73,357,4,50
594,3/21/2018 12:30,96,104,88,79,367,4,50
595,3/21/2018 12:35,93,100,77,68,338,4,50
596,3/21/2018 12:40,106,100,76,68,350,4,50
597,3/21/2018 12:45,109,96,82,74,361,4,50
598,3/21/2018 12:50,89,108,75,67,339,4,50
599,3/21/2018 12:55,98,96,72,64,330,4,50
600,3/21/2018 13:00,84,80,76,68,308,4,50
601,3/21/2018 13:05,91,96,75,66,328,4,50
602,3/21/2018 13:10,91,89,75,66,321,4,50
603,3/21/2018 13:15,112,88,82,73,355,4,50
604,3/21/2018 13:20,105,94,85,76,360,4,50
605,3/21/2018 13:25,111,113,85,76,385,4,50
606,3/21/2018 13:30,106,86,79,70,341,4,50
607,3/21/2018 13:35,116,109,79,70,374,4,50
608,3/21/2018 13:40,116,101,80,71,368,4,50
609,3/21/2018 13:45,110,122,78,70,380,4,50
610,3/21/2018 13:50,100,121,90,81,392,4,50
611,3/21/2018 13:55,116,110,85,77,388,4,50
612,3/21/2018 14:00,128,120,80,72,400,4,50
613,3/21/2018 14:05,130,116,80,71,397,4,50
614,3/21/2018 14:10,114,105,94,85,398,4,50
615,3/21/2018 14:15,120,103,92,83,398,4,50
616,3/21/2018 14:20,120,121,90,81,412,4,50
617,3/21/2018 14:25,126,118,96,86,426,4,50
618,3/21/2018 14:30,135,113,81,73,402,4,50
619,3/21/2018 14:35,123,123,93,84,423,4,50
620,3/21/2018 14:40,151,149,101,92,493,4,50
621,3/21/2018 14:45,153,116,99,89,457,4,50
622,3/21/2018 14:50,143,138,103,93,477,4,50
623,3/21/2018 14:55,144,123,95,86,448,4,50
624,3/21/2018 15:00,145,129,98,88,460,4,50
625,3/21/2018 15:05,117,131,112,102,462,4,50
626,3/21/2018 15:10,141,123,102,93,459,4,50
627,3/21/2018 15:15,150,121,98,89,458,4,50
628,3/21/2018 15:20,147,121,102,92,462,4,50
629,3/21/2018 15:25,157,128,109,99,493,4,50
630,3/21/2018 15:30,136,136,111,102,485,4,50
631,3/21/2018 15:35,147,138,109,99,493,4,50
632,3/21/2018 15:40,150,146,116,105,517,4,50
633,3/21/2018 15:45,157,140,104,94,495,4,50
634,3/21/2018 15:50,158,156,117,106,537,4,50
635,3/21/2018 15:55,141,134,95,86,456,4,50
636,3/21/2018 16:00,159,138,106,97,500,4,50
637,3/21/2018 16:05,136,146,118,107,507,4,50
638,3/21/2018 16:10,151,130,109,99,489,4,50
639,3/21/2018 16:15,127,136,105,96,464,4,50
640,3/21/2018 16:20,144,125,102,93,464,4,50
641,3/21/2018 16:25,153,142,112,102,509,4,50
642,3/21/2018 16:30,145,132,109,100,486,4,50
643,3/21/2018 16:35,144,130,110,100,484,4,50
644,3/21/2018 16:40,141,149,112,101,503,4,50
645,3/21/2018 16:45,151,148,114,104,517,4,50
646,3/21/2018 16:50,154,129,105,96,484,4,50
647,3/21/2018 16:55,163,159,125,114,561,4,50
648,3/21/2018 17:00,154,146,123,112,535,4,50
649,3/21/2018 17:05,146,138,97,88,469,4,50
650,3/21/2018 17:10,168,134,110,100,512,4,50
651,3/21/2018 17:15,164,139,99,90,492,4,50
652,3/21/2018 17:20,158,149,109,99,515,4,50
653,3/21/2018 17:25,161,142,120,110,533,4,50
654,3/21/2018 17:30,152,144,112,102,510,4,50
655,3/21/2018 17:35,161,134,110,100,505,4,50
656,3/21/2018 17:40,133,132,107,97,469,4,50
657,3/21/2018 17:45,143,140,109,99,491,4,50
658,3/21/2018 17:50,141,118,103,94,456,4,50
659,3/21/2018 17:55,149,129,104,94,476,4,50
660,3/21/2018 18:00,130,111,98,89,428,4,50
661,3/21/2018 18:05,126,123,101,91,441,4,50
662,3/21/2018 18:10,140,123,107,97,467,4,50
663,3/21/2018 18:15,140,133,112,101,486,4,50
664,3/21/2018 18:20,138,112,93,84,427,4,50
665,3/21/2018 18:25,143,118,101,91,453,4,50
666,3/21/2018 18:30,144,118,103,94,459,4,50
667,3/21/2018 18:35,120,129,103,93,445,4,50
668,3/21/2018 18:40,129,120,88,79,416,4,50
669,3/21/2018 18:45,131,115,96,87,429,4,50
670,3/21/2018 18:50,139,110,94,85,428,4,50
671,3/21/2018 18:55,122,118,87,79,406,4,50
672,3/21/2018 19:00,88,102,82,73,345,4,50
673,3/21/2018 19:05,91,91,84,75,341,4,50
674,3/21/2018 19:10,89,101,75,67,332,4,50
675,3/21/2018 19:15,108,103,74,66,351,4,50
676,3/21/2018 19:20,96,101,84,75,356,4,50
677,3/21/2018 19:25,95,96,86,77,354,4,50
678,3/21/2018 19:30,87,92,75,66,320,4,50
679,3/21/2018 19:35,106,106,79,70,361,4,50
680,3/21/2018 19:40,84,85,79,71,319,4,50
681,3/21/2018 19:45,80,81,76,68,305,4,50
682,3/21/2018 19:50,80,95,76,68,319,4,50
683,3/21/2018 19:55,79,83,69,62,293,4,50
684,3/21/2018 20:00,75,77,63,55,270,4,50
685,3/21/2018 20:05,65,78,66,58,267,4,50
686,3/21/2018 20:10,74,71,68,60,273,4,50
687,3/21/2018 20:15,77,83,69,61,290,4,50
688,3/21/2018 20:20,76,85,72,64,297,4,50
689,3/21/2018 20:25,70,79,72,64,285,4,50
690,3/21/2018 20:30,84,88,67,60,299,4,50
691,3/21/2018 20:35,63,73,65,58,259,4,50
692,3/21/2018 20:40,70,86,61,54,271,4,50
693,3/21/2018 20:45,66,77,69,61,273,4,50
694,3/21/2018 20:50,73,71,62,55,261,4,50
695,3/21/2018 20:55,56,81,67,60,264,4,50
696,3/21/2018 21:00,62,72,62,54,250,4,50
697,3/21/2018 21:05,70,81,59,52,262,4,50
698,3/21/2018 21:10,71,73,67,60,271,4,50
699,3/21/2018 21:15,52,74,61,53,240,4,50
700,3/21/2018 21:20,63,79,64,56,262,4,50
701,3/21/2018 21:25,60,68,55,48,231,4,50
702,3/21/2018 21:30,58,75,58,51,242,4,50
703,3/21/2018 21:35,51,64,58,51,224,4,50
704,3/21/2018 21:40,68,73,63,55,259,4,50
705,3/21/2018 21:45,56,68,58,51,233,4,50
706,3/21/2018 21:50,54,60,44,37,195,4,50
707,3/21/2018 21:55,56,65,51,43,215,4,50
708,3/21/2018 22:00,52,59,45,39,195,4,50
709,3/21/2018 22:05,56,68,55,48,227,4,50
710,3/21/2018 22:10,56,59,54,47,216,4,50
711,3/21/2018 22:15,71,60,48,42,221,4,50
712,3/21/2018 22:20,55,62,49,42,208,4,50
713,3/21/2018 22:25,42,66,43,36,187,4,50
714,3/21/2018 22:30,55,66,50,43,214,4,50
715,3/21/2018 22:35,44,48,44,38,174,4,50
716,3/21/2018 22:40,60,63,47,40,210,4,50
717,3/21/2018 22:45,45,51,40,33,169,4,50
718,3/21/2018 22:50,39,54,46,40,179,4,50
719,3/21/2018 22:55,20,41,47,40,148,4,50
720,3/21/2018 23:00,14,24,30,24,92,4,50
721,3/21/2018 23:05,47,56,50,43,196,4,50
722,3/21/2018 23:10,75,90,65,57,287,4,50
723,3/21/2018 23:15,76,102,75,67,320,4,50
724,3/21/2018 23:20,50,67,57,49,223,4,50
725,3/21/2018 23:25,40,58,56,49,203,4,50
726,3/21/2018 23:30,46,56,44,38,184,4,50
727,3/21/2018 23:35,38,45,45,38,166,4,50
728,3/21/2018 23:40,34,47,44,37,162,4,50
729,3/21/2018 23:45,39,48,43,36,166,4,50
730,3/21/2018 23:50,30,43,42,35,150,4,50
731,3/21/2018 23:55,23,54,45,38,160,4,50
732,3/22/2018 0:00,34,51,41,35,161,4,50
733,3/22/2018 0:05,41,54,42,36,173,4,50
734,3/22/2018 0:10,26,59,36,29,150,4,50
735,3/22/2018 0:15,34,46,38,32,150,4,50
736,3/22/2018 0:20,39,44,43,36,162,4,50
737,3/22/2018 0:25,26,40,37,31,134,4,50
738,3/22/2018 0:30,28,40,32,26,126,4,50
739,3/22/2018 0:35,34,39,36,29,138,4,50
740,3/22/2018 0:40,23,36,33,27,119,4,50
741,3/22/2018 0:45,23,36,34,27,120,4,50
742,3/22/2018 0:50,18,27,31,25,101,4,50
743,3/22/2018 0:55,22,33,29,23,107,4,50
744,3/22/2018 1:00,10,42,33,27,112,4,50
745,3/22/2018 1:05,22,29,30,24,105,4,50
746,3/22/2018 1:10,25,31,22,17,95,4,50
747,3/22/2018 1:15,16,34,23,18,91,4,50
748,3/22/2018 1:20,25,33,29,24,111,4,50
749,3/22/2018 1:25,17,34,24,18,93,4,50
750,3/22/2018 1:30,23,27,27,21,98,4,50
751,3/22/2018 1:35,16,25,25,20,86,4,50
752,3/22/2018 1:40,24,36,27,22,109,4,50
753,3/22/2018 1:45,16,24,21,16,77,4,50
754,3/22/2018 1:50,10,30,23,17,80,4,50
755,3/22/2018 1:55,17,20,22,17,76,4,50
756,3/22/2018 2:00,16,19,17,12,64,4,50
757,3/22/2018 2:05,16,31,24,18,89,4,50
758,3/22/2018 2:10,14,30,28,22,94,4,50
759,3/22/2018 2:15,8,36,23,18,85,4,50
760,3/22/2018 2:20,10,24,27,21,82,4,50
761,3/22/2018 2:25,19,29,25,20,93,4,50
762,3/22/2018 2:30,18,34,25,20,97,4,50
763,3/22/2018 2:35,17,23,22,16,78,4,50
764,3/22/2018 2:40,11,26,24,18,79,4,50
765,3/22/2018 2:45,18,24,26,21,89,4,50
766,3/22/2018 2:50,12,21,23,18,74,4,50
767,3/22/2018 2:55,13,19,24,19,75,4,50
768,3/22/2018 3:00,13,27,19,13,72,4,50
769,3/22/2018 3:05,14,20,33,26,93,4,50
770,3/22/2018 3:10,24,30,27,22,103,4,50
771,3/22/2018 3:15,19,34,30,24,107,4,50
772,3/22/2018 3:20,17,27,28,23,95,4,50
773,3/22/2018 3:25,19,32,31,25,107,4,50
774,3/22/2018 3:30,27,43,34,28,132,4,50
775,3/22/2018 3:35,23,44,33,27,127,4,50
776,3/22/2018 3:40,27,38,38,32,135,4,50
777,3/22/2018 3:45,19,46,32,26,123,4,50
778,3/22/2018 3:50,22,40,31,26,119,4,50
779,3/22/2018 3:55,28,32,34,28,122,4,50
780,3/22/2018 4:00,17,40,29,23,109,4,50
781,3/22/2018 4:05,28,33,26,21,108,4,50
782,3/22/2018 4:10,23,41,36,30,130,4,50
783,3/22/2018 4:15,40,47,38,31,156,4,50
784,3/22/2018 4:20,39,42,37,31,149,4,50
785,3/22/2018 4:25,24,38,39,32,133,4,50
786,3/22/2018 4:30,52,71,51,44,218,4,50
787,3/22/2018 4:35,53,49,49,42,193,4,50
788,3/22/2018 4:40,63,66,46,40,215,4,50
789,3/22/2018 4:45,49,50,53,45,197,4,50
790,3/22/2018 4:50,44,64,51,44,203,4,50
791,3/22/2018 4:55,54,56,44,38,192,4,50
792,3/22/2018 5:00,46,46,48,41,181,4,50
793,3/22/2018 5:05,68,64,53,47,232,4,50
794,3/22/2018 5:10,65,68,56,49,238,4,50
795,3/22/2018 5:15,81,74,65,58,278,4,50
796,3/22/2018 5:20,80,85,78,70,313,4,50
797,3/22/2018 5:25,88,84,77,69,318,4,50
798,3/22/2018 5:30,108,98,84,75,365,4,50
799,3/22/2018 5:35,100,89,80,72,341,4,50
800,3/22/2018 5:40,103,104,85,77,369,4,50
801,3/22/2018 5:45,98,93,85,76,352,4,50
802,3/22/2018 5:50,112,112,78,70,372,4,50
803,3/22/2018 5:55,118,93,76,68,355,4,50
804,3/22/2018 6:00,109,108,85,77,379,4,50
805,3/22/2018 6:05,117,105,75,66,363,4,50
806,3/22/2018 6:10,116,103,83,75,377,4,50
807,3/22/2018 6:15,99,101,89,81,370,4,50
808,3/22/2018 6:20,120,107,82,74,383,4,50
809,3/22/2018 6:25,129,112,91,82,414,4,50
810,3/22/2018 6:30,118,113,83,75,389,4,50
811,3/22/2018 6:35,144,132,84,75,435,4,50
812,3/22/2018 6:40,144,119,104,94,461,4,50
813,3/22/2018 6:45,131,128,108,98,465,4,50
814,3/22/2018 6:50,135,124,90,81,430,4,50
815,3/22/2018 6:55,156,127,97,88,468,4,50
816,3/22/2018 7:00,149,132,87,78,446,4,50
817,3/22/2018 7:05,137,121,102,92,452,4,50
818,3/22/2018 7:10,140,122,106,96,464,4,50
819,3/22/2018 7:15,140,123,94,85,442,4,50
820,3/22/2018 7:20,136,131,93,84,444,4,50
821,3/22/2018 7:25,122,123,97,88,430,4,50
822,3/22/2018 7:30,125,119,102,92,438,4,50
823,3/22/2018 7:35,138,132,107,98,475,4,50
824,3/22/2018 7:40,118,126,97,88,429,4,50
825,3/22/2018 7:45,117,116,98,89,420,4,50
826,3/22/2018 7:50,128,106,92,83,409,4,50
827,3/22/2018 7:55,113,126,102,92,433,4,50
828,3/22/2018 8:00,138,129,92,83,442,4,50
829,3/22/2018 8:05,114,99,89,81,383,4,50
830,3/22/2018 8:10,128,128,89,80,425,4,50
831,3/22/2018 8:15,121,109,94,85,409,4,50
832,3/22/2018 8:20,131,116,92,83,422,4,50
833,3/22/2018 8:25,143,113,96,86,438,4,50
834,3/22/2018 8:30,135,114,88,79,416,4,50
835,3/22/2018 8:35,125,123,95,86,429,4,50
836,3/22/2018 8:40,141,118,96,86,441,4,50
837,3/22/2018 8:45,136,119,81,73,409,4,50
838,3/22/2018 8:50,135,139,93,84,451,4,50
839,3/22/2018 8:55,131,111,89,80,411,4,50
840,3/22/2018 9:00,131,122,88,79,420,4,50
841,3/22/2018 9:05,113,124,81,73,391,4,50
842,3/22/2018 9:10,110,108,77,69,364,4,50
843,3/22/2018 9:15,115,102,79,70,366,4,50
844,3/22/2018 9:20,114,112,89,80,395,4,50
845,3/22/2018 9:25,116,101,85,77,379,4,50
846,3/22/2018 9:30,114,114,88,79,395,4,50
847,3/22/2018 9:35,133,117,76,68,394,4,50
848,3/22/2018 9:40,110,109,85,77,381,4,50
849,3/22/2018 9:45,116,104,87,78,385,4,50
850,3/22/2018 9:50,108,101,72,64,345,4,50
851,3/22/2018 9:55,104,102,78,70,354,4,50
852,3/22/2018 10:00,124,95,78,69,366,4,50
853,3/22/2018 10:05,95,99,64,56,314,4,50
854,3/22/2018 10:10,109,88,75,67,339,4,50
855,3/22/2018 10:15,113,91,82,74,360,4,50
856,3/22/2018 10:20,102,101,76,68,347,4,50
857,3/22/2018 10:25,110,108,63,55,336,4,50
858,3/22/2018 10:30,104,83,75,66,328,4,50
859,3/22/2018 10:35,108,90,70,62,330,4,50
860,3/22/2018 10:40,99,89,63,55,306,4,50
861,3/22/2018 10:45,101,95,77,68,341,4,50
862,3/22/2018 10:50,95,98,82,73,348,4,50
863,3/22/2018 10:55,92,90,79,70,331,4,50
864,3/22/2018 11:00,99,102,81,73,355,4,50
865,3/22/2018 11:05,98,102,68,60,328,4,50
866,3/22/2018 11:10,94,97,77,69,337,4,50
867,3/22/2018 11:15,95,99,71,63,328,4,50
868,3/22/2018 11:20,104,100,57,50,311,4,50
869,3/22/2018 11:25,103,102,76,68,349,4,50
870,3/22/2018 11:30,99,95,68,60,322,4,50
871,3/22/2018 11:35,89,91,69,61,310,4,50
872,3/22/2018 11:40,100,94,77,68,339,4,50
873,3/22/2018 11:45,100,90,83,74,347,4,50
874,3/22/2018 11:50,104,93,82,74,353,4,50
875,3/22/2018 11:55,96,90,70,62,318,4,50
876,3/22/2018 12:00,120,104,77,68,369,4,50
877,3/22/2018 12:05,105,108,80,72,365,4,50
878,3/22/2018 12:10,107,103,87,78,375,4,50
879,3/22/2018 12:15,99,98,85,77,359,4,50
880,3/22/2018 12:20,101,103,74,66,344,4,50
881,3/22/2018 12:25,91,114,92,83,380,4,50
882,3/22/2018 12:30,97,102,80,72,351,4,50
883,3/22/2018 12:35,101,108,84,75,368,4,50
884,3/22/2018 12:40,116,109,73,65,363,4,50
885,3/22/2018 12:45,112,110,95,86,403,4,50
886,3/22/2018 12:50,107,107,72,64,350,4,50
887,3/22/2018 12:55,84,100,76,68,328,4,50
888,3/22/2018 13:00,89,88,82,73,332,4,50
889,3/22/2018 13:05,97,90,77,69,333,4,50
890,3/22/2018 13:10,115,100,80,71,366,4,50
891,3/22/2018 13:15,106,86,80,72,344,4,50
892,3/22/2018 13:20,112,99,78,70,359,4,50
893,3/22/2018 13:25,103,103,80,72,358,4,50
894,3/22/2018 13:30,100,109,70,62,341,4,50
895,3/22/2018 13:35,112,108,84,75,379,4,50
896,3/22/2018 13:40,102,110,74,66,352,4,50
897,3/22/2018 13:45,129,110,82,73,394,4,50
898,3/22/2018 13:50,114,107,77,68,366,4,50
899,3/22/2018 13:55,100,103,82,74,359,4,50
900,3/22/2018 14:00,106,96,81,73,356,4,50
901,3/22/2018 14:05,109,108,85,77,379,4,50
902,3/22/2018 14:10,126,120,86,77,409,4,50
903,3/22/2018 14:15,125,128,100,91,444,4,50
904,3/22/2018 14:20,121,128,93,84,426,4,50
905,3/22/2018 14:25,124,110,92,83,409,4,50
906,3/22/2018 14:30,121,125,88,79,413,4,50
907,3/22/2018 14:35,136,127,102,92,457,4,50
908,3/22/2018 14:40,139,121,97,88,445,4,50
909,3/22/2018 14:45,123,136,102,92,453,4,50
910,3/22/2018 14:50,134,121,103,93,451,4,50
911,3/22/2018 14:55,146,131,107,97,481,4,50
912,3/22/2018 15:00,139,123,101,92,455,4,50
913,3/22/2018 15:05,153,133,108,98,492,4,50
914,3/22/2018 15:10,153,142,107,97,499,4,50
915,3/22/2018 15:15,161,141,119,108,529,4,50
916,3/22/2018 15:20,148,119,104,94,465,4,50
917,3/22/2018 15:25,143,124,100,90,457,4,50
918,3/22/2018 15:30,160,139,112,101,512,4,50
919,3/22/2018 15:35,151,139,104,94,488,4,50
920,3/22/2018 15:40,134,141,113,103,491,4,50
921,3/22/2018 15:45,145,145,116,106,512,4,50
922,3/22/2018 15:50,141,133,105,95,474,4,50
923,3/22/2018 15:55,145,127,100,90,462,4,50
924,3/22/2018 16:00,137,129,94,85,445,4,50
925,3/22/2018 16:05,159,140,118,108,525,4,50
926,3/22/2018 16:10,164,141,117,106,528,4,50
927,3/22/2018 16:15,134,131,106,96,467,4,50
928,3/22/2018 16:20,149,130,109,100,488,4,50
929,3/22/2018 16:25,140,124,107,98,469,4,50
930,3/22/2018 16:30,163,142,112,101,518,4,50
931,3/22/2018 16:35,153,148,119,108,528,4,50
932,3/22/2018 16:40,141,146,119,108,514,4,50
933,3/22/2018 16:45,146,141,118,107,512,4,50
934,3/22/2018 16:50,144,129,103,93,469,4,50
935,3/22/2018 16:55,154,160,116,105,535,4,50
936,3/22/2018 17:00,158,120,104,94,476,4,50
937,3/22/2018 17:05,164,149,112,101,526,4,50
938,3/22/2018 17:10,144,134,109,100,487,4,50
939,3/22/2018 17:15,153,162,105,95,515,4,50
940,3/22/2018 17:20,152,113,99,90,454,4,50
941,3/22/2018 17:25,142,148,101,92,483,4,50
942,3/22/2018 17:30,150,128,104,94,476,4,50
943,3/22/2018 17:35,137,142,109,99,487,4,50
944,3/22/2018 17:40,132,125,104,94,455,4,50
945,3/22/2018 17:45,136,123,104,94,457,4,50
946,3/22/2018 17:50,129,131,104,94,458,4,50
947,3/22/2018 17:55,123,102,80,72,377,4,50
948,3/22/2018 18:00,129,123,96,87,435,4,50
949,3/22/2018 18:05,116,123,92,83,414,4,50
950,3/22/2018 18:10,129,120,93,84,426,4,50
951,3/22/2018 18:15,127,118,88,79,412,4,50
952,3/22/2018 18:20,112,123,95,86,416,4,50
953,3/22/2018 18:25,136,111,96,87,430,4,50
954,3/22/2018 18:30,122,107,93,84,406,4,50
955,3/22/2018 18:35,114,106,91,82,393,4,50
956,3/22/2018 18:40,126,102,85,76,389,4,50
957,3/22/2018 18:45,107,121,105,96,429,4,50
958,3/22/2018 18:50,112,108,91,82,393,4,50
959,3/22/2018 18:55,126,120,98,89,433,4,50
960,3/22/2018 19:00,115,114,88,79,396,4,50
961,3/22/2018 19:05,86,91,75,67,319,4,50
962,3/22/2018 19:10,109,111,88,79,387,4,50
963,3/22/2018 19:15,89,93,81,73,336,4,50
964,3/22/2018 19:20,100,107,84,75,366,4,50
965,3/22/2018 19:25,87,91,79,70,327,4,50
966,3/22/2018 19:30,95,102,74,66,337,4,50
967,3/22/2018 19:35,92,91,71,63,317,4,50
968,3/22/2018 19:40,84,72,67,59,282,4,50
969,3/22/2018 19:45,88,88,79,70,325,4,50
970,3/22/2018 19:50,90,96,76,68,330,4,50
971,3/22/2018 19:55,88,87,66,58,299,4,50
972,3/22/2018 20:00,72,80,69,62,283,4,50
973,3/22/2018 20:05,94,91,68,60,313,4,50
974,3/22/2018 20:10,73,75,71,63,282,4,50
975,3/22/2018 20:15,89,94,67,60,310,4,50
976,3/22/2018 20:20,63,68,64,56,251,4,50
977,3/22/2018 20:25,88,75,67,59,289,4,50
978,3/22/2018 20:30,91,90,78,70,329,4,50
979,3/22/2018 20:35,71,76,58,51,256,4,50
980,3/22/2018 20:40,64,70,65,57,256,4,50
981,3/22/2018 20:45,76,71,64,57,268,4,50
982,3/22/2018 20:50,76,79,64,56,275,4,50
983,3/22/2018 20:55,69,77,58,51,255,4,50
984,3/22/2018 21:00,59,75,67,59,260,4,50
985,3/22/2018 21:05,78,76,63,55,272,4,50
986,3/22/2018 21:10,56,59,56,49,220,4,50
987,3/22/2018 21:15,72,67,64,56,259,4,50
988,3/22/2018 21:20,78,81,70,62,291,4,50
989,3/22/2018 21:25,59,75,66,58,258,4,50
990,3/22/2018 21:30,78,72,68,60,278,4,50
991,3/22/2018 21:35,58,71,53,45,227,4,50
992,3/22/2018 21:40,60,66,60,53,239,4,50
993,3/22/2018 21:45,61,73,58,50,242,4,50
994,3/22/2018 21:50,59,73,51,43,226,4,50
995,3/22/2018 21:55,71,77,48,42,238,4,50
996,3/22/2018 22:00,48,65,50,43,206,4,50
997,3/22/2018 22:05,66,59,53,46,224,4,50
998,3/22/2018 22:10,59,57,56,49,221,4,50
999,3/22/2018 22:15,57,67,49,42,215,4,50
1000,3/22/2018 22:20,48,61,48,42,199,4,50
1001,3/22/2018 22:25,54,55,48,41,198,4,50
1002,3/22/2018 22:30,47,53,50,43,193,4,50
1003,3/22/2018 22:35,54,61,42,36,193,4,50
1004,3/22/2018 22:40,47,55,49,42,193,4,50
1005,3/22/2018 22:45,45,49,47,40,181,4,50
1006,3/22/2018 22:50,33,36,46,39,154,4,50
1007,3/22/2018 22:55,37,56,45,39,177,4,50
1008,3/22/2018 23:00,36,41,46,39,162,4,50
1009,3/22/2018 23:05,27,49,43,37,156,4,50
1010,3/22/2018 23:10,43,49,42,35,169,4,50
1011,3/22/2018 23:15,46,50,43,37,176,4,50
1012,3/22/2018 23:20,37,45,48,41,171,4,50
1013,3/22/2018 23:25,36,55,38,32,161,4,50
1014,3/22/2018 23:30,23,38,44,37,142,4,50
1015,3/22/2018 23:35,26,36,35,29,126,4,50
1016,3/22/2018 23:40,33,38,43,36,150,4,50
1017,3/22/2018 23:45,36,44,38,32,150,4,50
1018,3/22/2018 23:50,26,35,35,29,125,4,50
1019,3/22/2018 23:55,20,40,46,39,145,4,50
1020,3/23/2018 0:00,21,49,40,34,144,4,50
1021,3/23/2018 0:05,25,36,34,28,123,4,50
1022,3/23/2018 0:10,23,43,34,28,128,4,50
1023,3/23/2018 0:15,24,36,34,27,121,4,50
1024,3/23/2018 0:20,24,38,27,21,110,4,50
1025,3/23/2018 0:25,29,40,30,24,123,4,50
1026,3/23/2018 0:30,22,21,34,27,104,4,50
1027,3/23/2018 0:35,14,34,26,20,94,4,50
1028,3/23/2018 0:40,15,37,28,21,101,4,50
1029,3/23/2018 0:45,19,21,31,25,96,4,50
1030,3/23/2018 0:50,15,31,26,20,92,4,50
1031,3/23/2018 0:55,19,16,27,21,83,4,50
1032,3/23/2018 1:00,11,25,27,22,85,4,50
1033,3/23/2018 1:05,11,23,21,15,70,4,50
1034,3/23/2018 1:10,14,22,27,21,84,4,50
1035,3/23/2018 1:15,10,22,18,13,63,4,50
1036,3/23/2018 1:20,8,19,21,16,64,4,50
1037,3/23/2018 1:25,16,25,20,14,75,4,50
1038,3/23/2018 1:30,9,14,27,21,71,4,50
1039,3/23/2018 1:35,12,27,20,15,74,4,50
1040,3/23/2018 1:40,6,17,19,14,56,4,50
1041,3/23/2018 1:45,9,16,25,19,69,4,50
1042,3/23/2018 1:50,11,20,20,15,66,4,50
1043,3/23/2018 1:55,11,19,24,18,72,4,50
1044,3/23/2018 2:00,14,20,19,14,67,4,50
1045,3/23/2018 2:05,7,11,16,10,44,4,50
1046,3/23/2018 2:10,9,15,19,14,57,4,50
1047,3/23/2018 2:15,15,21,19,14,69,4,50
1048,3/23/2018 2:20,12,26,18,13,69,4,50
1049,3/23/2018 2:25,9,22,22,17,70,4,50
1050,3/23/2018 2:30,11,18,21,15,65,4,50
1051,3/23/2018 2:35,14,15,19,14,62,4,50
1052,3/23/2018 2:40,6,17,19,13,55,4,50
1053,3/23/2018 2:45,13,20,19,14,66,4,50
1054,3/23/2018 2:50,10,21,25,19,75,4,50
1055,3/23/2018 2:55,8,15,16,11,50,4,50
1056,3/23/2018 3:00,8,17,21,16,62,4,50
1057,3/23/2018 3:05,8,10,20,14,52,4,50
1058,3/23/2018 3:10,7,17,18,13,55,4,50
1059,3/23/2018 3:15,7,16,19,14,56,4,50
1060,3/23/2018 3:20,10,19,22,17,68,4,50
1061,3/23/2018 3:25,10,24,23,18,75,4,50
1062,3/23/2018 3:30,14,24,18,13,69,4,50
1063,3/23/2018 3:35,19,18,21,15,73,4,50
1064,3/23/2018 3:40,22,28,22,16,88,4,50
1065,3/23/2018 3:45,19,39,30,24,112,4,50
1066,3/23/2018 3:50,17,33,22,16,88,4,50
1067,3/23/2018 3:55,17,22,27,21,87,4,50
1068,3/23/2018 4:00,16,20,30,24,90,4,50
1069,3/23/2018 4:05,16,28,16,13,73,4,0
1070,3/23/2018 4:10,27,30,18,14,89,4,0
1071,3/23/2018 4:15,31,38,31,25,125,4,50
1072,3/23/2018 4:20,25,43,39,33,140,4,50
1073,3/23/2018 4:25,32,37,40,34,143,4,50
1074,3/23/2018 4:30,43,49,38,32,162,4,50
1075,3/23/2018 4:35,49,62,45,39,195,4,50
1076,3/23/2018 4:40,52,54,51,44,201,4,50
1077,3/23/2018 4:45,59,54,50,43,206,4,50
1078,3/23/2018 4:50,57,55,45,38,195,4,50
1079,3/23/2018 4:55,45,56,45,39,185,4,50
1080,3/23/2018 5:00,58,62,50,43,213,4,50
1081,3/23/2018 5:05,52,61,59,51,223,4,50
1082,3/23/2018 5:10,72,70,59,51,252,4,50
1083,3/23/2018 5:15,82,91,74,66,313,4,50
1084,3/23/2018 5:20,88,83,69,62,302,4,50
1085,3/23/2018 5:25,97,85,74,66,322,4,50
1086,3/23/2018 5:30,104,101,75,66,346,4,50
1087,3/23/2018 5:35,109,92,84,76,361,4,50
1088,3/23/2018 5:40,93,89,79,70,331,4,50
1089,3/23/2018 5:45,106,104,80,71,361,4,50
1090,3/23/2018 5:50,119,117,83,75,394,4,50
1091,3/23/2018 5:55,102,89,82,73,346,4,50
1092,3/23/2018 6:00,118,111,88,79,396,4,50
1093,3/23/2018 6:05,109,123,83,75,390,4,50
1094,3/23/2018 6:10,108,103,83,75,369,4,50
1095,3/23/2018 6:15,124,116,98,88,426,4,50
1096,3/23/2018 6:20,130,127,90,81,428,4,50
1097,3/23/2018 6:25,153,129,96,87,465,4,50
1098,3/23/2018 6:30,117,113,98,89,417,4,50
1099,3/23/2018 6:35,158,135,102,92,487,4,50
1100,3/23/2018 6:40,151,137,100,90,478,4,50
1101,3/23/2018 6:45,140,132,106,97,475,4,50
1102,3/23/2018 6:50,150,138,90,81,459,4,50
1103,3/23/2018 6:55,162,138,112,101,513,4,50
1104,3/23/2018 7:00,161,139,106,96,502,4,50
1105,3/23/2018 7:05,153,131,105,95,484,4,50
1106,3/23/2018 7:10,145,127,104,95,471,4,50
1107,3/23/2018 7:15,140,124,101,91,456,4,50
1108,3/23/2018 7:20,155,140,106,96,497,4,50
1109,3/23/2018 7:25,153,138,98,89,478,4,50
1110,3/23/2018 7:30,168,160,115,105,548,4,50
1111,3/23/2018 7:35,141,137,111,102,491,4,50
1112,3/23/2018 7:40,158,138,112,102,510,4,50
1113,3/23/2018 7:45,132,133,104,94,463,4,50
1114,3/23/2018 7:50,132,126,102,92,452,4,50
1115,3/23/2018 7:55,132,139,113,103,487,4,50
1116,3/23/2018 8:00,137,117,98,89,441,4,50
1117,3/23/2018 8:05,149,135,104,94,482,4,50
1118,3/23/2018 8:10,149,146,105,95,495,4,50
1119,3/23/2018 8:15,147,136,104,94,481,4,50
1120,3/23/2018 8:20,174,144,98,88,504,4,50
1121,3/23/2018 8:25,153,125,90,82,450,4,50
1122,3/23/2018 8:30,142,131,99,90,462,4,50
1123,3/23/2018 8:35,163,134,93,84,474,4,50
1124,3/23/2018 8:40,127,123,99,90,439,4,50
1125,3/23/2018 8:45,143,126,99,89,457,4,50
1126,3/23/2018 8:50,151,136,97,88,472,4,50
1127,3/23/2018 8:55,153,133,88,79,453,4,50
1128,3/23/2018 9:00,127,119,77,68,391,4,50
1129,3/23/2018 9:05,131,145,85,76,437,4,50
1130,3/23/2018 9:10,123,127,95,86,431,4,50
1131,3/23/2018 9:15,126,116,82,74,398,4,50
1132,3/23/2018 9:20,150,135,89,80,454,4,50
1133,3/23/2018 9:25,118,114,99,89,420,4,50
1134,3/23/2018 9:30,131,127,98,89,445,4,50
1135,3/23/2018 9:35,144,114,93,84,435,4,50
1136,3/23/2018 9:40,133,119,91,82,425,4,50
1137,3/23/2018 9:45,140,115,88,79,422,4,50
1138,3/23/2018 9:50,122,121,88,79,410,4,50
1139,3/23/2018 9:55,127,113,90,81,411,4,50
1140,3/23/2018 10:00,118,128,80,71,397,4,50
1141,3/23/2018 10:05,117,122,94,85,418,4,50
1142,3/23/2018 10:10,108,109,82,74,373,4,50
1143,3/23/2018 10:15,120,104,84,75,383,4,50
1144,3/23/2018 10:20,131,132,90,81,434,4,50
1145,3/23/2018 10:25,121,122,94,85,422,4,50
1146,3/23/2018 10:30,128,118,83,75,404,4,50
1147,3/23/2018 10:35,132,111,85,77,405,4,50
1148,3/23/2018 10:40,118,115,82,74,389,4,50
1149,3/23/2018 10:45,113,102,92,83,390,4,50
1150,3/23/2018 10:50,113,122,88,79,402,4,50
1151,3/23/2018 10:55,124,109,83,75,391,4,50
1152,3/23/2018 11:00,133,123,80,72,408,4,50
1153,3/23/2018 11:05,113,112,84,75,384,4,50
1154,3/23/2018 11:10,115,111,83,75,384,4,50
1155,3/23/2018 11:15,118,116,91,82,407,4,50
1156,3/23/2018 11:20,122,119,93,84,418,4,50
1157,3/23/2018 11:25,128,102,88,79,397,4,50
1158,3/23/2018 11:30,120,116,83,75,394,4,50
1159,3/23/2018 11:35,118,115,88,79,400,4,50
1160,3/23/2018 11:40,122,122,94,85,423,4,50
1161,3/23/2018 11:45,122,128,82,74,406,4,50
1162,3/23/2018 11:50,112,120,88,79,399,4,50
1163,3/23/2018 11:55,133,128,93,84,438,4,50
1164,3/23/2018 12:00,130,132,84,75,421,4,50
1165,3/23/2018 12:05,119,109,84,75,387,4,50
1166,3/23/2018 12:10,127,131,87,78,423,4,50
1167,3/23/2018 12:15,122,131,87,78,418,4,50
1168,3/23/2018 12:20,108,118,88,79,393,4,50
1169,3/23/2018 12:25,117,122,93,84,416,4,50
1170,3/23/2018 12:30,128,126,98,89,441,4,50
1171,3/23/2018 12:35,112,116,93,84,405,4,50
1172,3/23/2018 12:40,116,122,88,79,405,4,50
1173,3/23/2018 12:45,130,112,88,79,409,4,50
1174,3/23/2018 12:50,128,108,89,80,405,4,50
1175,3/23/2018 12:55,134,119,93,84,430,4,50
1176,3/23/2018 13:00,133,114,77,69,393,4,50
1177,3/23/2018 13:05,121,106,69,61,357,4,50
1178,3/23/2018 13:10,119,111,75,67,372,4,50
1179,3/23/2018 13:15,114,100,68,60,342,4,50
1180,3/23/2018 13:20,108,103,71,63,345,4,50
1181,3/23/2018 13:25,114,98,64,56,332,4,50
1182,3/23/2018 13:30,125,114,92,83,414,4,50
1183,3/23/2018 13:35,129,118,86,77,410,4,50
1184,3/23/2018 13:40,115,105,85,77,382,4,50
1185,3/23/2018 13:45,115,108,79,70,372,4,50
1186,3/23/2018 13:50,124,134,95,86,439,4,50
1187,3/23/2018 13:55,126,126,91,82,425,4,50
1188,3/23/2018 14:00,120,103,92,83,398,4,50
1189,3/23/2018 14:05,119,120,89,80,408,4,50
1190,3/23/2018 14:10,118,106,88,79,391,4,50
1191,3/23/2018 14:15,139,119,104,94,456,4,50
1192,3/23/2018 14:20,130,109,94,85,418,4,50
1193,3/23/2018 14:25,135,124,107,98,464,4,50
1194,3/23/2018 14:30,122,121,105,96,444,4,50
1195,3/23/2018 14:35,143,138,117,107,505,4,50
1196,3/23/2018 14:40,124,121,105,96,446,4,50
1197,3/23/2018 14:45,144,139,118,108,509,4,50
1198,3/23/2018 14:50,141,126,109,99,475,4,50
1199,3/23/2018 14:55,134,133,114,104,485,4,50
1200,3/23/2018 15:00,133,126,109,99,467,4,50
1201,3/23/2018 15:05,137,125,108,98,468,4,50
1202,3/23/2018 15:10,142,144,122,111,519,4,50
1203,3/23/2018 15:15,172,144,122,111,549,4,50
1204,3/23/2018 15:20,143,127,109,100,479,4,50
1205,3/23/2018 15:25,157,140,119,109,525,4,50
1206,3/23/2018 15:30,138,139,118,108,503,4,50
1207,3/23/2018 15:35,153,145,122,112,532,4,50
1208,3/23/2018 15:40,146,147,124,113,530,4,50
1209,3/23/2018 15:45,155,133,114,104,506,4,50
1210,3/23/2018 15:50,157,139,118,108,522,4,50
1211,3/23/2018 15:55,150,123,107,97,477,4,50
1212,3/23/2018 16:00,127,126,109,99,461,4,50
1213,3/23/2018 16:05,162,122,106,96,486,4,50
1214,3/23/2018 16:10,138,129,111,101,479,4,50
1215,3/23/2018 16:15,149,130,112,102,493,4,50
1216,3/23/2018 16:20,151,152,127,117,547,4,50
1217,3/23/2018 16:25,139,142,120,110,511,4,50
1218,3/23/2018 16:30,168,144,122,111,545,4,50
1219,3/23/2018 16:35,158,131,112,102,503,4,50
1220,3/23/2018 16:40,152,148,124,114,538,4,50
1221,3/23/2018 16:45,151,136,116,106,509,4,50
1222,3/23/2018 16:50,150,128,110,100,488,4,50
1223,3/23/2018 16:55,156,143,121,111,531,4,50
1224,3/23/2018 17:00,139,131,112,102,484,4,50
1225,3/23/2018 17:05,148,141,119,109,517,4,50
1226,3/23/2018 17:10,145,134,114,105,498,4,50
1227,3/23/2018 17:15,151,138,117,107,513,4,50
1228,3/23/2018 17:20,149,136,116,106,507,4,50
1229,3/23/2018 17:25,148,125,108,98,479,4,50
1230,3/23/2018 17:30,173,146,123,113,555,4,50
1231,3/23/2018 17:35,154,141,119,109,523,4,50
1232,3/23/2018 17:40,144,137,117,107,505,4,50
1233,3/23/2018 17:45,156,145,122,112,535,4,50
1234,3/23/2018 17:50,154,148,124,114,540,4,50
1235,3/23/2018 17:55,134,127,109,100,470,4,50
1236,3/23/2018 18:00,134,148,124,114,520,4,50
1237,3/23/2018 18:05,124,132,113,103,472,4,50
1238,3/23/2018 18:10,137,128,110,100,475,4,50
1239,3/23/2018 18:15,134,128,110,100,472,4,50
1240,3/23/2018 18:20,148,122,101,91,462,4,50
1241,3/23/2018 18:25,117,123,96,87,423,4,50
1242,3/23/2018 18:30,125,109,94,85,413,4,50
1243,3/23/2018 18:35,134,129,102,93,458,4,50
1244,3/23/2018 18:40,124,131,108,98,461,4,50
1245,3/23/2018 18:45,141,140,113,103,497,4,50
1246,3/23/2018 18:50,115,115,98,89,417,4,50
1247,3/23/2018 18:55,129,134,93,84,440,4,50
1248,3/23/2018 19:00,126,116,91,82,415,4,50
1249,3/23/2018 19:05,116,122,99,90,427,4,50
1250,3/23/2018 19:10,113,117,94,85,409,4,50
1251,3/23/2018 19:15,121,104,87,78,390,4,50
1252,3/23/2018 19:20,109,107,94,85,395,4,50
1253,3/23/2018 19:25,130,126,93,84,433,4,50
1254,3/23/2018 19:30,92,108,92,83,375,4,50
1255,3/23/2018 19:35,98,105,83,74,360,4,50
1256,3/23/2018 19:40,91,96,80,72,339,4,50
1257,3/23/2018 19:45,98,98,83,75,354,4,50
1258,3/23/2018 19:50,99,114,90,81,384,4,50
1259,3/23/2018 19:55,130,116,90,81,417,4,50
1260,3/23/2018 20:00,123,123,97,88,431,4,50
1261,3/23/2018 20:05,99,97,85,77,358,4,50
1262,3/23/2018 20:10,118,102,92,83,395,4,50
1263,3/23/2018 20:15,109,111,83,74,377,4,50
1264,3/23/2018 20:20,98,95,84,75,352,4,50
1265,3/23/2018 20:25,99,94,86,77,356,4,50
1266,3/23/2018 20:30,76,101,80,71,328,4,50
1267,3/23/2018 20:35,100,120,84,75,379,4,50
1268,3/23/2018 20:40,110,102,92,83,387,4,50
1269,3/23/2018 20:45,99,108,89,80,376,4,50
1270,3/23/2018 20:50,99,93,80,72,344,4,50
1271,3/23/2018 20:55,92,99,78,70,339,4,50
1272,3/23/2018 21:00,77,93,82,73,325,4,50
1273,3/23/2018 21:05,76,81,76,68,301,4,50
1274,3/23/2018 21:10,95,93,79,70,337,4,50
1275,3/23/2018 21:15,84,91,78,70,323,4,50
1276,3/23/2018 21:20,90,88,68,60,306,4,50
1277,3/23/2018 21:25,85,98,82,73,338,4,50
1278,3/23/2018 21:30,83,87,69,62,301,4,50
1279,3/23/2018 21:35,82,86,73,65,306,4,50
1280,3/23/2018 21:40,69,86,76,68,299,4,50
1281,3/23/2018 21:45,79,83,76,68,306,4,50
1282,3/23/2018 21:50,81,88,72,64,305,4,50
1283,3/23/2018 21:55,80,76,72,64,292,4,50
1284,3/23/2018 22:00,70,86,64,57,277,4,50
1285,3/23/2018 22:05,70,71,67,60,268,4,50
1286,3/23/2018 22:10,77,71,67,60,275,4,50
1287,3/23/2018 22:15,78,80,69,61,288,4,50
1288,3/23/2018 22:20,63,81,75,67,286,4,50
1289,3/23/2018 22:25,60,70,59,51,240,4,50
1290,3/23/2018 22:30,69,67,59,52,247,4,50
1291,3/23/2018 22:35,52,72,63,55,242,4,50
1292,3/23/2018 22:40,58,76,66,58,258,4,50
1293,3/23/2018 22:45,56,70,61,54,241,4,50
1294,3/23/2018 22:50,56,66,61,54,237,4,50
1295,3/23/2018 22:55,43,64,51,44,202,4,50
1296,3/23/2018 23:00,33,35,43,36,147,4,50
1297,3/23/2018 23:05,56,52,50,43,201,4,50
1298,3/23/2018 23:10,49,58,60,52,219,4,50
1299,3/23/2018 23:15,41,51,52,45,189,4,50
1300,3/23/2018 23:20,43,54,43,36,176,4,50
1301,3/23/2018 23:25,39,58,52,45,194,4,50
1302,3/23/2018 23:30,39,51,48,41,179,4,50
1303,3/23/2018 23:35,42,49,53,45,189,4,50
1304,3/23/2018 23:40,33,45,48,41,167,4,50
1305,3/23/2018 23:45,34,51,51,44,180,4,50
1306,3/23/2018 23:50,34,59,45,38,176,4,50
1307,3/23/2018 23:55,34,41,40,33,148,4,50
1308,3/24/2018 0:00,50,47,43,36,176,4,50
1309,3/24/2018 0:05,29,50,32,26,137,4,50
1310,3/24/2018 0:10,27,58,40,33,158,4,50
1311,3/24/2018 0:15,24,34,38,32,128,4,50
1312,3/24/2018 0:20,43,43,37,31,154,4,50
1313,3/24/2018 0:25,19,37,38,31,125,4,50
1314,3/24/2018 0:30,20,46,30,23,119,4,50
1315,3/24/2018 0:35,26,38,32,26,122,4,50
1316,3/24/2018 0:40,18,41,40,33,132,4,50
1317,3/24/2018 0:45,23,40,30,25,118,4,50
1318,3/24/2018 0:50,23,34,34,27,118,4,50
1319,3/24/2018 0:55,18,30,33,26,107,4,50
1320,3/24/2018 1:00,27,33,31,25,116,4,50
1321,3/24/2018 1:05,15,31,22,16,84,4,50
1322,3/24/2018 1:10,17,31,27,21,96,4,50
1323,3/24/2018 1:15,22,26,32,25,105,4,50
1324,3/24/2018 1:20,21,28,35,28,112,4,50
1325,3/24/2018 1:25,23,30,29,23,105,4,50
1326,3/24/2018 1:30,25,31,27,22,105,4,50
1327,3/24/2018 1:35,20,44,24,18,106,4,50
1328,3/24/2018 1:40,12,31,25,20,88,4,50
1329,3/24/2018 1:45,11,18,27,21,77,4,50
1330,3/24/2018 1:50,15,22,26,20,83,4,50
1331,3/24/2018 1:55,17,21,17,12,67,4,50
1332,3/24/2018 2:00,24,39,27,28,118,4,50
1333,3/24/2018 2:05,13,22,34,28,97,4,50
1334,3/24/2018 2:10,15,29,27,21,92,4,50
1335,3/24/2018 2:15,10,28,19,14,71,4,50
1336,3/24/2018 2:20,16,23,23,17,79,4,50
1337,3/24/2018 2:25,14,25,20,15,74,4,50
1338,3/24/2018 2:30,16,23,21,15,75,4,50
1339,3/24/2018 2:35,9,18,27,21,75,4,50
1340,3/24/2018 2:40,12,19,20,15,66,4,50
1341,3/24/2018 2:45,19,24,20,15,78,4,50
1342,3/24/2018 2:50,13,18,20,14,65,4,50
1343,3/24/2018 2:55,8,11,19,13,51,4,50
1344,3/24/2018 3:00,7,28,16,11,62,4,50
1345,3/24/2018 3:05,17,28,14,9,68,4,50
1346,3/24/2018 3:10,5,16,23,18,62,4,50
1347,3/24/2018 3:15,9,12,22,16,59,4,50
1348,3/24/2018 3:20,14,21,24,18,77,4,50
1349,3/24/2018 3:25,7,27,19,14,67,4,50
1350,3/24/2018 3:30,12,21,18,13,64,4,50
1351,3/24/2018 3:35,11,22,21,15,69,4,50
1352,3/24/2018 3:40,11,17,21,15,64,4,50
1353,3/24/2018 3:45,15,25,16,11,67,4,50
1354,3/24/2018 3:50,12,10,19,14,55,4,50
1355,3/24/2018 3:55,13,15,22,16,66,4,50
1356,3/24/2018 4:00,12,12,17,12,53,4,50
1357,3/24/2018 4:05,7,13,13,8,41,4,50
1358,3/24/2018 4:10,11,20,19,13,63,4,50
1359,3/24/2018 4:15,16,18,20,15,69,4,50
1360,3/24/2018 4:20,15,24,21,15,75,4,50
1361,3/24/2018 4:25,17,21,20,14,72,4,50
1362,3/24/2018 4:30,16,19,27,22,84,4,50
1363,3/24/2018 4:35,23,31,30,25,109,4,50
1364,3/24/2018 4:40,25,36,32,25,118,4,50
1365,3/24/2018 4:45,23,27,25,20,95,4,50
1366,3/24/2018 4:50,21,31,29,23,104,4,50
1367,3/24/2018 4:55,16,22,17,11,66,4,50
1368,3/24/2018 5:00,23,20,30,25,98,4,50
1369,3/24/2018 5:05,19,25,22,17,83,4,50
1370,3/24/2018 5:10,22,31,27,22,102,4,50
1371,3/24/2018 5:15,15,30,33,27,105,4,50
1372,3/24/2018 5:20,41,37,32,27,137,4,50
1373,3/24/2018 5:25,34,41,30,24,129,4,50
1374,3/24/2018 5:30,26,42,40,34,142,4,50
1375,3/24/2018 5:35,47,36,32,27,142,4,50
1376,3/24/2018 5:40,43,42,36,30,151,4,50
1377,3/24/2018 5:45,28,40,34,28,130,4,50
1378,3/24/2018 5:50,47,45,44,37,173,4,50
1379,3/24/2018 5:55,32,44,40,34,150,4,50
1380,3/24/2018 6:00,36,46,42,36,160,4,50
1381,3/24/2018 6:05,31,56,35,28,150,4,50
1382,3/24/2018 6:10,33,45,40,34,152,4,50
1383,3/24/2018 6:15,45,51,45,38,179,4,50
1384,3/24/2018 6:20,51,45,48,42,186,4,50
1385,3/24/2018 6:25,61,59,58,51,229,4,50
1386,3/24/2018 6:30,67,71,58,51,247,4,50
1387,3/24/2018 6:35,69,71,62,55,257,4,50
1388,3/24/2018 6:40,59,76,64,57,256,4,50
1389,3/24/2018 6:45,69,74,67,60,270,4,50
1390,3/24/2018 6:50,70,89,69,62,290,4,50
1391,3/24/2018 6:55,68,72,64,57,261,4,50
1392,3/24/2018 7:00,62,79,70,62,273,4,50
1393,3/24/2018 7:05,62,72,55,48,237,4,50
1394,3/24/2018 7:10,70,67,61,53,251,4,50
1395,3/24/2018 7:15,79,71,67,60,277,4,50
1396,3/24/2018 7:20,76,92,67,59,294,4,50
1397,3/24/2018 7:25,89,76,69,62,296,4,50
1398,3/24/2018 7:30,97,97,85,76,355,4,50
1399,3/24/2018 7:35,105,99,87,78,369,4,50
1400,3/24/2018 7:40,100,97,76,68,341,4,50
1401,3/24/2018 7:45,118,112,87,78,395,4,50
1402,3/24/2018 7:50,99,108,92,83,382,4,50
1403,3/24/2018 7:55,76,99,83,75,333,4,50
1404,3/24/2018 8:00,104,102,81,72,359,4,50
1405,3/24/2018 8:05,123,103,77,69,372,4,50
1406,3/24/2018 8:10,107,107,72,64,350,4,50
1407,3/24/2018 8:15,110,109,79,70,368,4,50
1408,3/24/2018 8:20,113,112,78,70,373,4,50
1409,3/24/2018 8:25,102,102,83,75,362,4,50
1410,3/24/2018 8:30,114,115,80,71,380,4,50
1411,3/24/2018 8:35,93,86,80,72,331,4,50
1412,3/24/2018 8:40,114,91,84,75,364,4,50
1413,3/24/2018 8:45,103,101,86,77,367,4,50
1414,3/24/2018 8:50,117,130,93,84,424,4,50
1415,3/24/2018 8:55,112,113,90,81,396,4,50
1416,3/24/2018 9:00,115,137,84,75,411,4,50
1417,3/24/2018 9:05,96,103,84,75,358,4,50
1418,3/24/2018 9:10,118,125,102,93,438,4,50
1419,3/24/2018 9:15,115,109,91,82,397,4,50
1420,3/24/2018 9:20,147,148,99,90,484,4,50
1421,3/24/2018 9:25,138,114,93,84,429,4,50
1422,3/24/2018 9:30,128,126,93,84,431,4,50
1423,3/24/2018 9:35,126,126,95,86,433,4,50
1424,3/24/2018 9:40,134,129,92,83,438,4,50
1425,3/24/2018 9:45,122,133,92,83,430,4,50
1426,3/24/2018 9:50,122,111,97,88,418,4,50
1427,3/24/2018 9:55,121,116,92,83,412,4,50
1428,3/24/2018 10:00,118,123,89,80,410,4,50
1429,3/24/2018 10:05,129,127,88,79,423,4,50
1430,3/24/2018 10:10,113,128,93,84,418,4,50
1431,3/24/2018 10:15,110,111,91,82,394,4,50
1432,3/24/2018 10:20,114,120,90,81,405,4,50
1433,3/24/2018 10:25,115,120,89,80,404,4,50
1434,3/24/2018 10:30,132,143,94,85,454,4,50
1435,3/24/2018 10:35,119,138,101,92,450,4,50
1436,3/24/2018 10:40,112,116,102,92,422,4,50
1437,3/24/2018 10:45,132,143,112,102,489,4,50
1438,3/24/2018 10:50,134,154,109,99,496,4,50
1439,3/24/2018 10:55,130,125,108,98,461,4,50
1440,3/24/2018 11:00,110,134,109,99,452,4,50
1441,3/24/2018 11:05,128,128,85,76,417,4,50
1442,3/24/2018 11:10,127,119,104,94,444,4,50
1443,3/24/2018 11:15,121,108,94,85,408,4,50
1444,3/24/2018 11:20,119,137,93,84,433,4,50
1445,3/24/2018 11:25,134,136,103,93,466,4,50
1446,3/24/2018 11:30,116,125,102,92,435,4,50
1447,3/24/2018 11:35,135,133,98,89,455,4,50
1448,3/24/2018 11:40,106,120,98,89,413,4,50
1449,3/24/2018 11:45,138,138,101,91,468,4,50
1450,3/24/2018 11:50,123,133,102,92,450,4,50
1451,3/24/2018 11:55,127,126,103,93,449,4,50
1452,3/24/2018 12:00,110,125,85,77,397,4,50
1453,3/24/2018 12:05,111,117,97,88,413,4,50
1454,3/24/2018 12:10,120,125,101,91,437,4,50
1455,3/24/2018 12:15,113,113,98,89,413,4,50
1456,3/24/2018 12:20,104,101,91,82,378,4,50
1457,3/24/2018 12:25,96,106,85,77,364,4,50
1458,3/24/2018 12:30,115,120,104,95,434,4,50
1459,3/24/2018 12:35,112,108,89,80,389,4,50
1460,3/24/2018 12:40,105,135,105,95,440,4,50
1461,3/24/2018 12:45,111,121,101,91,424,4,50
1462,3/24/2018 12:50,123,118,93,84,418,4,50
1463,3/24/2018 12:55,125,106,91,82,404,4,50
1464,3/24/2018 13:00,118,122,103,93,436,4,50
1465,3/24/2018 13:05,115,108,94,85,402,4,50
1466,3/24/2018 13:10,115,124,96,87,422,4,50
1467,3/24/2018 13:15,122,113,92,83,410,4,50
1468,3/24/2018 13:20,126,129,96,86,437,4,50
1469,3/24/2018 13:25,118,117,99,90,424,4,50
1470,3/24/2018 13:30,112,126,92,83,413,4,50
1471,3/24/2018 13:35,114,114,95,86,409,4,50
1472,3/24/2018 13:40,120,130,98,88,436,4,50
1473,3/24/2018 13:45,117,120,104,95,436,4,50
1474,3/24/2018 13:50,117,123,104,94,438,4,50
1475,3/24/2018 13:55,113,118,96,87,414,4,50
1476,3/24/2018 14:00,110,113,97,88,408,4,50
1477,3/24/2018 14:05,109,107,91,82,389,4,50
1478,3/24/2018 14:10,113,106,94,85,398,4,50
1479,3/24/2018 14:15,118,116,95,86,415,4,50
1480,3/24/2018 14:20,110,124,96,86,416,4,50
1481,3/24/2018 14:25,117,121,93,84,415,4,50
1482,3/24/2018 14:30,109,113,88,79,389,4,50
1483,3/24/2018 14:35,121,130,96,87,434,4,50
1484,3/24/2018 14:40,129,114,95,86,424,4,50
1485,3/24/2018 14:45,133,105,92,83,413,4,50
1486,3/24/2018 14:50,118,122,92,83,415,4,50
1487,3/24/2018 14:55,114,110,97,88,409,4,50
1488,3/24/2018 15:00,129,119,88,80,416,4,50
1489,3/24/2018 15:05,118,129,87,78,412,4,50
1490,3/24/2018 15:10,117,113,89,80,399,4,50
1491,3/24/2018 15:15,118,112,93,84,407,4,50
1492,3/24/2018 15:20,125,117,92,83,417,4,50
1493,3/24/2018 15:25,109,118,94,85,406,4,50
1494,3/24/2018 15:30,104,100,90,81,375,4,50
1495,3/24/2018 15:35,103,125,85,76,389,4,50
1496,3/24/2018 15:40,126,129,98,88,441,4,50
1497,3/24/2018 15:45,131,118,91,82,422,4,50
1498,3/24/2018 15:50,113,127,107,98,445,4,50
1499,3/24/2018 15:55,108,126,102,92,428,4,50
1500,3/24/2018 16:00,129,118,93,84,424,4,50
1501,3/24/2018 16:05,115,110,95,86,406,4,50
1502,3/24/2018 16:10,82,89,78,70,319,4,50
1503,3/24/2018 16:15,116,110,94,85,405,4,50
1504,3/24/2018 16:20,132,125,81,73,411,4,50
1505,3/24/2018 16:25,112,114,93,83,402,4,50
1506,3/24/2018 16:30,117,103,92,83,395,4,50
1507,3/24/2018 16:35,115,121,101,92,429,4,50
1508,3/24/2018 16:40,117,121,98,88,424,4,50
1509,3/24/2018 16:45,122,127,102,93,444,4,50
1510,3/24/2018 16:50,125,126,103,93,447,4,50
1511,3/24/2018 16:55,123,123,107,97,450,4,50
1512,3/24/2018 17:00,126,122,96,87,431,4,50
1513,3/24/2018 17:05,137,114,100,91,442,4,50
1514,3/24/2018 17:10,117,119,101,91,428,4,50
1515,3/24/2018 17:15,125,128,104,94,451,4,50
1516,3/24/2018 17:20,126,127,109,99,461,4,50
1517,3/24/2018 17:25,117,130,101,92,440,4,50
1518,3/24/2018 17:30,108,114,100,91,413,4,50
1519,3/24/2018 17:35,132,125,102,92,451,4,50
1520,3/24/2018 17:40,136,115,101,91,443,4,50
1521,3/24/2018 17:45,131,116,89,81,417,4,50
1522,3/24/2018 17:50,104,123,104,94,425,4,50
1523,3/24/2018 17:55,124,109,97,87,417,4,50
1524,3/24/2018 18:00,116,122,99,89,426,4,50
1525,3/24/2018 18:05,106,112,97,88,403,4,50
1526,3/24/2018 18:10,115,119,91,82,407,4,50
1527,3/24/2018 18:15,121,133,105,95,454,4,50
1528,3/24/2018 18:20,99,110,88,79,376,4,50
1529,3/24/2018 18:25,114,112,96,87,409,4,50
1530,3/24/2018 18:30,107,125,92,83,407,4,50
1531,3/24/2018 18:35,116,131,94,85,426,4,50
1532,3/24/2018 18:40,111,129,97,88,425,4,50
1533,3/24/2018 18:45,105,113,96,87,401,4,50
1534,3/24/2018 18:50,106,111,89,80,386,4,50
1535,3/24/2018 18:55,107,117,91,82,397,4,50
1536,3/24/2018 19:00,114,119,88,79,400,4,50
1537,3/24/2018 19:05,100,120,91,82,393,4,50
1538,3/24/2018 19:10,96,104,92,83,375,4,50
1539,3/24/2018 19:15,98,103,91,82,374,4,50
1540,3/24/2018 19:20,106,99,83,74,362,4,50
1541,3/24/2018 19:25,93,93,84,75,345,4,50
1542,3/24/2018 19:30,100,99,87,78,364,4,50
1543,3/24/2018 19:35,79,92,78,70,319,4,50
1544,3/24/2018 19:40,72,89,79,71,311,4,50
1545,3/24/2018 19:45,86,82,72,64,304,4,50
1546,3/24/2018 19:50,78,89,82,73,322,4,50
1547,3/24/2018 19:55,100,89,79,70,338,4,50
1548,3/24/2018 20:00,86,92,81,72,331,4,50
1549,3/24/2018 20:05,97,113,81,73,364,4,50
1550,3/24/2018 20:10,73,95,76,68,312,4,50
1551,3/24/2018 20:15,72,88,77,69,306,4,50
1552,3/24/2018 20:20,94,100,83,75,352,4,50
1553,3/24/2018 20:25,77,96,76,68,317,4,50
1554,3/24/2018 20:30,81,101,69,61,312,4,50
1555,3/24/2018 20:35,95,103,78,70,346,4,50
1556,3/24/2018 20:40,74,82,64,56,276,4,50
1557,3/24/2018 20:45,86,86,77,68,317,4,50
1558,3/24/2018 20:50,88,99,73,65,325,4,50
1559,3/24/2018 20:55,88,92,76,67,323,4,50
1560,3/24/2018 21:00,72,94,73,65,304,4,50
1561,3/24/2018 21:05,87,86,69,61,303,4,50
1562,3/24/2018 21:10,66,87,75,67,295,4,50
1563,3/24/2018 21:15,89,82,67,59,297,4,50
1564,3/24/2018 21:20,65,84,70,62,281,4,50
1565,3/24/2018 21:25,77,78,67,59,281,4,50
1566,3/24/2018 21:30,86,93,76,68,323,4,50
1567,3/24/2018 21:35,79,89,68,60,296,4,50
1568,3/24/2018 21:40,62,84,59,52,257,4,50
1569,3/24/2018 21:45,74,96,67,59,296,4,50
1570,3/24/2018 21:50,70,95,74,66,305,4,50
1571,3/24/2018 21:55,64,82,67,59,272,4,50
1572,3/24/2018 22:00,54,74,65,57,250,4,50
1573,3/24/2018 22:05,73,75,64,56,268,4,50
1574,3/24/2018 22:10,77,73,62,54,266,4,50
1575,3/24/2018 22:15,83,87,65,57,292,4,50
1576,3/24/2018 22:20,59,73,70,62,264,4,50
1577,3/24/2018 22:25,55,78,66,58,257,4,50
1578,3/24/2018 22:30,59,76,68,60,263,4,50
1579,3/24/2018 22:35,65,72,55,47,239,4,50
1580,3/24/2018 22:40,59,81,64,57,261,4,50
1581,3/24/2018 22:45,72,84,66,58,280,4,50
1582,3/24/2018 22:50,75,73,62,54,264,4,50
1583,3/24/2018 22:55,60,71,67,60,258,4,50
1584,3/24/2018 23:00,44,71,56,49,220,4,50
1585,3/24/2018 23:05,63,72,51,44,230,4,50
1586,3/24/2018 23:10,64,66,55,48,233,4,50
1587,3/24/2018 23:15,56,53,57,49,215,4,50
1588,3/24/2018 23:20,62,59,45,38,204,4,50
1589,3/24/2018 23:25,43,67,58,51,219,4,50
1590,3/24/2018 23:30,37,65,55,48,205,4,50
1591,3/24/2018 23:35,48,53,51,44,196,4,50
1592,3/24/2018 23:40,49,60,53,46,208,4,50
1593,3/24/2018 23:45,45,62,52,45,204,4,50
1594,3/24/2018 23:50,29,39,44,37,149,4,50
1595,3/24/2018 23:55,16,31,37,30,114,4,50
1596,3/25/2018 0:00,6,9,25,19,59,4,50
1597,3/25/2018 0:05,48,73,52,45,218,4,50
1598,3/25/2018 0:10,29,64,53,46,192,4,50
1599,3/25/2018 0:15,17,27,34,27,105,4,50
1600,3/25/2018 0:20,20,52,46,40,158,4,50
1601,3/25/2018 0:25,13,33,47,40,133,4,50
1602,3/25/2018 0:30,20,49,45,38,152,4,50
1603,3/25/2018 0:35,25,39,38,31,133,4,50
1604,3/25/2018 0:40,19,36,37,31,123,4,50
1605,3/25/2018 0:45,17,49,41,35,142,4,50
1606,3/25/2018 0:50,14,45,39,33,131,4,50
1607,3/25/2018 0:55,12,39,35,29,115,4,50
1608,3/25/2018 1:00,13,28,27,21,89,4,50
1609,3/25/2018 1:05,29,32,29,24,114,4,50
1610,3/25/2018 1:10,12,38,29,24,103,4,50
1611,3/25/2018 1:15,11,29,31,26,97,4,50
1612,3/25/2018 1:20,10,24,30,25,89,4,50
1613,3/25/2018 1:25,13,30,27,21,91,4,50
1614,3/25/2018 1:30,11,21,25,19,76,4,50
1615,3/25/2018 1:35,9,23,27,21,80,4,50
1616,3/25/2018 1:40,8,29,28,22,87,4,50
1617,3/25/2018 1:45,14,25,23,17,79,4,50
1618,3/25/2018 1:50,11,28,27,21,87,4,50
1619,3/25/2018 1:55,10,23,22,17,72,4,50
1620,3/25/2018 2:00,10,26,27,21,84,4,50
1621,3/25/2018 2:05,10,29,25,19,83,4,50
1622,3/25/2018 2:10,4,17,20,15,56,4,50
1623,3/25/2018 2:15,8,17,28,23,76,4,50
1624,3/25/2018 2:20,4,21,25,19,69,4,50
1625,3/25/2018 2:25,7,25,24,19,75,4,50
1626,3/25/2018 2:30,8,18,23,18,67,4,50
1627,3/25/2018 2:35,5,19,25,20,69,4,50
1628,3/25/2018 2:40,10,21,22,17,70,4,50
1629,3/25/2018 2:45,7,16,22,16,61,4,50
1630,3/25/2018 2:50,8,16,19,13,56,4,50
1631,3/25/2018 2:55,2,18,23,18,61,4,50
1632,3/25/2018 3:00,6,11,26,20,63,4,50
1633,3/25/2018 3:05,5,11,19,14,49,4,50
1634,3/25/2018 3:10,0,13,19,13,45,4,50
1635,3/25/2018 3:15,6,13,19,13,51,4,50
1636,3/25/2018 3:20,1,8,14,9,32,4,50
1637,3/25/2018 3:25,3,13,19,14,49,4,50
1638,3/25/2018 3:30,4,14,21,15,54,4,50
1639,3/25/2018 3:35,1,11,19,14,45,4,50
1640,3/25/2018 3:40,3,3,16,12,34,4,50
1641,3/25/2018 3:45,3,10,18,13,44,4,50
1642,3/25/2018 3:50,6,10,21,16,53,4,50
1643,3/25/2018 3:55,6,9,20,15,50,4,50
1644,3/25/2018 4:00,2,17,17,11,47,4,50
1645,3/25/2018 4:05,3,11,12,8,34,4,50
1646,3/25/2018 4:10,3,10,14,9,36,4,50
1647,3/25/2018 4:15,0,6,21,15,42,4,50
1648,3/25/2018 4:20,4,19,17,11,51,4,50
1649,3/25/2018 4:25,13,20,17,12,62,4,50
1650,3/25/2018 4:30,4,12,17,11,44,4,50
1651,3/25/2018 4:35,5,19,19,14,57,4,50
1652,3/25/2018 4:40,10,20,19,14,63,4,50
1653,3/25/2018 4:45,2,7,17,12,38,4,50
1654,3/25/2018 4:50,11,23,27,21,82,4,50
1655,3/25/2018 4:55,9,19,21,15,64,4,50
1656,3/25/2018 5:00,2,17,22,16,57,4,50
1657,3/25/2018 5:05,10,18,21,15,64,4,50
1658,3/25/2018 5:10,7,15,18,13,53,4,50
1659,3/25/2018 5:15,7,24,21,15,67,4,50
1660,3/25/2018 5:20,7,23,21,16,67,4,50
1661,3/25/2018 5:25,11,22,18,13,64,4,50
1662,3/25/2018 5:30,10,25,27,21,83,4,50
1663,3/25/2018 5:35,12,24,21,16,73,4,50
1664,3/25/2018 5:40,8,18,30,25,81,4,50
1665,3/25/2018 5:45,9,22,26,20,77,4,50
1666,3/25/2018 5:50,11,28,27,21,87,4,50
1667,3/25/2018 5:55,6,22,25,20,73,4,50
1668,3/25/2018 6:00,8,18,23,18,67,4,50
1669,3/25/2018 6:05,11,28,31,25,95,4,50
1670,3/25/2018 6:10,7,19,20,15,61,4,50
1671,3/25/2018 6:15,6,27,24,19,76,4,50
1672,3/25/2018 6:20,18,25,29,23,95,4,50
1673,3/25/2018 6:25,9,31,31,25,96,4,50
1674,3/25/2018 6:30,13,30,32,27,102,4,50
1675,3/25/2018 6:35,21,33,34,28,116,4,50
1676,3/25/2018 6:40,20,43,45,39,147,4,50
1677,3/25/2018 6:45,28,52,36,30,146,4,50
1678,3/25/2018 6:50,24,43,40,33,140,4,50
1679,3/25/2018 6:55,26,38,46,39,149,4,50
1680,3/25/2018 7:00,18,39,43,36,136,4,50
1681,3/25/2018 7:05,25,45,38,32,140,4,50
1682,3/25/2018 7:10,14,34,41,35,124,4,50
1683,3/25/2018 7:15,30,38,42,35,145,4,50
1684,3/25/2018 7:20,26,45,41,35,147,4,50
1685,3/25/2018 7:25,30,58,42,35,165,4,50
1686,3/25/2018 7:30,35,61,53,45,194,4,50
1687,3/25/2018 7:35,37,50,51,44,182,4,50
1688,3/25/2018 7:40,39,68,51,44,202,4,50
1689,3/25/2018 7:45,32,53,48,41,174,4,50
1690,3/25/2018 7:50,35,58,51,44,188,4,50
1691,3/25/2018 7:55,33,56,49,41,179,4,50
1692,3/25/2018 8:00,34,58,56,49,197,4,50
1693,3/25/2018 8:05,29,63,57,50,199,4,50
1694,3/25/2018 8:10,41,56,58,51,206,4,50
1695,3/25/2018 8:15,51,66,56,49,222,4,50
1696,3/25/2018 8:20,37,57,45,39,178,4,50
1697,3/25/2018 8:25,46,60,57,50,213,4,50
1698,3/25/2018 8:30,52,66,61,53,232,4,50
1699,3/25/2018 8:35,55,78,57,50,240,4,50
1700,3/25/2018 8:40,47,78,63,55,243,4,50
1701,3/25/2018 8:45,52,80,75,66,273,4,50
1702,3/25/2018 8:50,45,70,68,60,243,4,50
1703,3/25/2018 8:55,48,52,58,50,208,4,50
1704,3/25/2018 9:00,53,75,56,49,233,4,50
1705,3/25/2018 9:05,50,73,57,50,230,4,50
1706,3/25/2018 9:10,72,94,57,50,273,4,50
1707,3/25/2018 9:15,70,70,57,50,247,4,50
1708,3/25/2018 9:20,62,53,54,47,216,4,50
1709,3/25/2018 9:25,57,67,56,48,228,4,50
1710,3/25/2018 9:30,126,114,68,60,368,4,50
1711,3/25/2018 9:35,110,123,65,57,355,4,50
1712,3/25/2018 9:40,120,114,92,83,409,4,50
1713,3/25/2018 9:45,102,106,83,75,366,4,50
1714,3/25/2018 9:50,100,103,72,64,339,4,50
1715,3/25/2018 9:55,73,81,70,62,286,4,50
1716,3/25/2018 10:00,101,112,84,75,372,4,50
1717,3/25/2018 10:05,129,123,82,73,407,4,50
1718,3/25/2018 10:10,97,110,82,73,362,4,50
1719,3/25/2018 10:15,96,104,80,71,351,4,50
1720,3/25/2018 10:20,89,109,82,74,354,4,50
1721,3/25/2018 10:25,98,99,86,77,360,4,50
1722,3/25/2018 10:30,105,102,92,83,382,4,50
1723,3/25/2018 10:35,116,120,98,89,423,4,50
1724,3/25/2018 10:40,123,121,93,84,421,4,50
1725,3/25/2018 10:45,138,126,78,69,411,4,50
1726,3/25/2018 10:50,121,125,98,88,432,4,50
1727,3/25/2018 10:55,112,106,94,85,397,4,50
1728,3/25/2018 11:00,108,111,95,86,400,4,50
1729,3/25/2018 11:05,104,122,84,75,385,4,50
1730,3/25/2018 11:10,115,132,84,75,406,4,50
1731,3/25/2018 11:15,118,128,90,82,418,4,50
1732,3/25/2018 11:20,114,111,94,85,404,4,50
1733,3/25/2018 11:25,116,130,102,92,440,4,50
1734,3/25/2018 11:30,99,126,96,87,408,4,50
1735,3/25/2018 11:35,107,134,90,82,413,4,50
1736,3/25/2018 11:40,123,129,97,87,436,4,50
1737,3/25/2018 11:45,107,118,88,79,392,4,50
1738,3/25/2018 11:50,115,116,92,83,406,4,50
1739,3/25/2018 11:55,101,100,90,81,372,4,50
0,3/25/2018 11:00,108,111,95,86,400,4,50
1,3/25/2018 11:05,104,122,84,75,385,4,50
2,3/25/2018 11:10,115,132,84,75,406,4,50
3,3/25/2018 11:15,118,128,90,82,418,4,50
4,3/25/2018 11:20,114,111,94,85,404,4,50
5,3/25/2018 11:25,116,130,102,92,440,4,50
6,3/25/2018 11:30,99,126,96,87,408,4,50
7,3/25/2018 11:35,107,134,90,82,413,4,50
8,3/25/2018 11:40,123,129,97,87,436,4,50
9,3/25/2018 11:45,107,118,88,79,392,4,50
10,3/25/2018 11:50,115,116,92,83,406,4,50
11,3/25/2018 11:55,101,100,90,81,372,4,50
12,3/25/2018 12:00,109,110,90,81,390,4,50
13,3/25/2018 12:05,105,113,83,75,376,4,50
14,3/25/2018 12:10,107,117,93,84,401,4,50
15,3/25/2018 12:15,119,123,106,96,444,4,50
16,3/25/2018 12:20,113,121,93,84,411,4,50
17,3/25/2018 12:25,123,132,91,82,428,4,50
18,3/25/2018 12:30,120,116,97,88,421,4,50
19,3/25/2018 12:35,108,113,89,81,391,4,50
20,3/25/2018 12:40,115,130,101,91,437,4,50
21,3/25/2018 12:45,105,108,96,87,396,4,50
22,3/25/2018 12:50,122,131,104,94,451,4,50
23,3/25/2018 12:55,112,127,104,94,437,4,50
24,3/25/2018 13:00,118,126,105,96,445,4,50
25,3/25/2018 13:05,101,106,93,84,384,4,50
26,3/25/2018 13:10,122,110,97,87,416,4,50
27,3/25/2018 13:15,116,125,91,82,414,4,50
28,3/25/2018 13:20,123,115,84,76,398,4,50
29,3/25/2018 13:25,125,129,93,84,431,4,50
30,3/25/2018 13:30,129,130,100,90,449,4,50
31,3/25/2018 13:35,126,113,95,85,419,4,50
32,3/25/2018 13:40,126,133,97,87,443,4,50
33,3/25/2018 13:45,127,128,101,91,447,4,50
34,3/25/2018 13:50,103,109,97,87,396,4,50
35,3/25/2018 13:55,112,130,93,84,419,4,50
36,3/25/2018 14:00,93,108,89,80,370,4,50
37,3/25/2018 14:05,121,116,92,83,412,4,50
38,3/25/2018 14:10,107,124,93,84,408,4,50
39,3/25/2018 14:15,117,110,89,81,397,4,50
40,3/25/2018 14:20,120,131,101,91,443,4,50
41,3/25/2018 14:25,106,113,95,86,400,4,50
42,3/25/2018 14:30,104,123,103,93,423,4,50
43,3/25/2018 14:35,110,119,84,75,388,4,50
44,3/25/2018 14:40,107,102,87,79,375,4,50
45,3/25/2018 14:45,109,112,91,82,394,4,50
46,3/25/2018 14:50,104,104,91,82,381,4,50
47,3/25/2018 14:55,98,100,76,68,342,4,50
48,3/25/2018 15:00,91,102,81,73,347,4,50
49,3/25/2018 15:05,140,137,89,81,447,4,50
50,3/25/2018 15:10,111,127,98,89,425,4,50
51,3/25/2018 15:15,99,116,91,82,388,4,50
52,3/25/2018 15:20,100,114,97,88,399,4,50
53,3/25/2018 15:25,97,112,82,73,364,4,50
54,3/25/2018 15:30,99,119,94,85,397,4,50
55,3/25/2018 15:35,106,133,88,79,406,4,50
56,3/25/2018 15:40,111,110,89,81,391,4,50
57,3/25/2018 15:45,119,126,95,86,426,4,50
58,3/25/2018 15:50,109,113,93,84,399,4,50
59,3/25/2018 15:55,104,104,92,83,383,4,50
60,3/25/2018 16:00,110,106,87,78,381,4,50
61,3/25/2018 16:05,98,101,85,76,360,4,50
62,3/25/2018 16:10,101,103,88,79,371,4,50
63,3/25/2018 16:15,106,113,99,90,408,4,50
64,3/25/2018 16:20,101,103,84,75,363,4,50
65,3/25/2018 16:25,96,111,94,85,386,4,50
66,3/25/2018 16:30,109,106,94,85,394,4,50
67,3/25/2018 16:35,103,113,95,86,397,4,50
68,3/25/2018 16:40,126,122,98,89,435,4,50
69,3/25/2018 16:45,118,120,93,84,415,4,50
70,3/25/2018 16:50,101,108,91,82,382,4,50
71,3/25/2018 16:55,133,108,96,87,424,4,50
72,3/25/2018 17:00,111,110,85,77,383,4,50
73,3/25/2018 17:05,99,118,80,72,369,4,50
74,3/25/2018 17:10,115,108,90,81,394,4,50
75,3/25/2018 17:15,108,115,93,84,400,4,50
76,3/25/2018 17:20,104,109,93,84,390,4,50
77,3/25/2018 17:25,118,101,87,79,385,4,50
78,3/25/2018 17:30,114,118,93,84,409,4,50
79,3/25/2018 17:35,103,119,95,86,403,4,50
80,3/25/2018 17:40,104,108,96,87,395,4,50
81,3/25/2018 17:45,108,109,95,86,398,4,50
82,3/25/2018 17:50,107,117,90,81,395,4,50
83,3/25/2018 17:55,102,114,94,85,395,4,50
84,3/25/2018 18:00,103,120,95,86,404,4,50
85,3/25/2018 18:05,111,110,75,66,362,4,50
86,3/25/2018 18:10,112,117,92,83,404,4,50
87,3/25/2018 18:15,110,111,88,79,388,4,50
88,3/25/2018 18:20,94,112,87,78,371,4,50
89,3/25/2018 18:25,115,125,88,79,407,4,50
90,3/25/2018 18:30,104,118,88,79,389,4,50
91,3/25/2018 18:35,91,100,82,74,347,4,50
92,3/25/2018 18:40,86,100,87,78,351,4,50
93,3/25/2018 18:45,93,112,79,70,354,4,50
94,3/25/2018 18:50,83,76,73,65,297,4,50
95,3/25/2018 18:55,85,98,74,66,323,4,50
96,3/25/2018 19:00,80,97,84,75,336,4,50
97,3/25/2018 19:05,92,94,80,72,338,4,50
98,3/25/2018 19:10,86,99,77,69,331,4,50
99,3/25/2018 19:15,89,84,72,64,309,4,50
100,3/25/2018 19:20,92,108,84,75,359,4,50
101,3/25/2018 19:25,104,99,82,74,359,4,50
102,3/25/2018 19:30,88,74,72,64,298,4,50
103,3/25/2018 19:35,79,94,79,70,322,4,50
104,3/25/2018 19:40,75,89,82,74,320,4,50
105,3/25/2018 19:45,89,90,72,64,315,4,50
106,3/25/2018 19:50,79,91,77,69,316,4,50
107,3/25/2018 19:55,85,87,75,66,313,4,50
108,3/25/2018 20:00,84,91,83,74,332,4,50
109,3/25/2018 20:05,81,95,82,73,331,4,50
110,3/25/2018 20:10,90,100,75,66,331,4,50
111,3/25/2018 20:15,84,88,66,58,296,4,50
112,3/25/2018 20:20,86,88,72,64,310,4,50
113,3/25/2018 20:25,71,73,61,53,258,4,50
114,3/25/2018 20:30,93,93,76,68,330,4,50
115,3/25/2018 20:35,73,77,74,65,289,4,50
116,3/25/2018 20:40,75,83,69,61,288,4,50
117,3/25/2018 20:45,80,79,65,57,281,4,50
118,3/25/2018 20:50,56,74,63,55,248,4,50
119,3/25/2018 20:55,80,73,61,53,267,4,50
120,3/25/2018 21:00,71,77,66,58,272,4,50
121,3/25/2018 21:05,80,76,61,53,270,4,50
122,3/25/2018 21:10,58,67,59,52,236,4,50
123,3/25/2018 21:15,66,84,72,64,286,4,50
124,3/25/2018 21:20,54,68,62,54,238,4,50
125,3/25/2018 21:25,70,79,75,67,291,4,50
126,3/25/2018 21:30,79,86,67,60,292,4,50
127,3/25/2018 21:35,70,91,64,57,282,4,50
128,3/25/2018 21:40,72,86,57,50,265,4,50
129,3/25/2018 21:45,48,79,54,47,228,4,50
130,3/25/2018 21:50,44,77,61,54,236,4,50
131,3/25/2018 21:55,66,84,61,54,265,4,50
132,3/25/2018 22:00,48,68,65,58,239,4,50
133,3/25/2018 22:05,46,58,56,49,209,4,50
134,3/25/2018 22:10,60,81,59,51,251,4,50
135,3/25/2018 22:15,66,74,61,53,254,4,50
136,3/25/2018 22:20,71,78,61,54,264,4,50
137,3/25/2018 22:25,48,67,57,50,222,4,50
138,3/25/2018 22:30,61,44,51,44,200,4,50
139,3/25/2018 22:35,51,48,53,46,198,4,50
140,3/25/2018 22:40,50,54,50,43,197,4,50
141,3/25/2018 22:45,41,53,47,40,181,4,50
142,3/25/2018 22:50,38,70,53,45,206,4,50
143,3/25/2018 22:55,26,32,40,34,132,4,50
144,3/25/2018 23:00,36,50,54,47,187,4,50
145,3/25/2018 23:05,17,30,40,33,120,4,50
146,3/25/2018 23:10,26,30,41,34,131,4,50
147,3/25/2018 23:15,59,70,47,40,216,4,50
148,3/25/2018 23:20,74,101,65,57,297,4,50
149,3/25/2018 23:25,57,94,67,59,277,4,50
150,3/25/2018 23:30,47,71,55,48,221,4,50
151,3/25/2018 23:35,51,68,53,45,217,4,50
152,3/25/2018 23:40,41,68,61,54,224,4,50
153,3/25/2018 23:45,55,64,51,44,214,4,50
154,3/25/2018 23:50,36,64,57,50,207,4,50
155,3/25/2018 23:55,36,51,44,38,169,4,50
156,3/26/2018 0:00,30,45,41,35,151,4,50
157,3/26/2018 0:05,31,51,42,35,159,4,50
158,3/26/2018 0:10,33,45,40,33,151,4,50
159,3/26/2018 0:15,35,57,43,37,172,4,50
160,3/26/2018 0:20,30,41,48,41,160,4,50
161,3/26/2018 0:25,18,30,34,28,110,4,50
162,3/26/2018 0:30,37,46,39,33,155,4,50
163,3/26/2018 0:35,29,24,36,29,118,4,50
164,3/26/2018 0:40,32,38,30,24,124,4,50
165,3/26/2018 0:45,21,47,36,29,133,4,50
166,3/26/2018 0:50,24,32,32,26,114,4,50
167,3/26/2018 0:55,21,32,38,31,122,4,50
168,3/26/2018 1:00,19,40,36,29,124,4,50
169,3/26/2018 1:05,5,26,25,19,75,4,50
170,3/26/2018 1:10,21,34,31,25,111,4,50
171,3/26/2018 1:15,12,31,31,26,100,4,50
172,3/26/2018 1:20,24,33,24,19,100,4,50
173,3/26/2018 1:25,7,27,21,16,71,4,50
174,3/26/2018 1:30,18,29,25,19,91,4,50
175,3/26/2018 1:35,17,21,32,26,96,4,50
176,3/26/2018 1:40,11,33,33,27,104,4,50
177,3/26/2018 1:45,17,30,23,17,87,4,50
178,3/26/2018 1:50,14,25,25,20,84,4,50
179,3/26/2018 1:55,18,22,29,23,92,4,50
180,3/26/2018 2:00,10,32,19,14,75,4,50
181,3/26/2018 2:05,16,32,25,19,92,4,50
182,3/26/2018 2:10,14,23,22,17,76,4,50
183,3/26/2018 2:15,4,19,21,16,60,4,50
184,3/26/2018 2:20,12,26,31,26,95,4,50
185,3/26/2018 2:25,9,28,23,18,78,4,50
186,3/26/2018 2:30,12,20,24,18,74,4,50
187,3/26/2018 2:35,12,33,22,17,84,4,50
188,3/26/2018 2:40,13,23,24,19,79,4,50
189,3/26/2018 2:45,19,25,24,18,86,4,50
190,3/26/2018 2:50,6,29,29,24,88,4,50
191,3/26/2018 2:55,6,11,19,14,50,4,50
192,3/26/2018 3:00,7,22,20,15,64,4,50
193,3/26/2018 3:05,6,20,25,19,70,4,50
194,3/26/2018 3:10,18,36,24,19,97,4,50
195,3/26/2018 3:15,17,35,27,22,101,4,50
196,3/26/2018 3:20,15,25,25,20,85,4,50
197,3/26/2018 3:25,18,35,29,23,105,4,50
198,3/26/2018 3:30,21,51,36,30,138,4,50
199,3/26/2018 3:35,23,44,31,25,123,4,50
200,3/26/2018 3:40,22,36,30,24,112,4,50
201,3/26/2018 3:45,21,41,31,25,118,4,50
202,3/26/2018 3:50,30,37,32,26,125,4,50
203,3/26/2018 3:55,28,39,30,24,121,4,50
204,3/26/2018 4:00,30,32,35,29,126,4,50
205,3/26/2018 4:05,30,58,40,34,162,4,50
206,3/26/2018 4:10,31,59,40,34,164,4,50
207,3/26/2018 4:15,60,76,54,47,237,4,50
208,3/26/2018 4:20,49,85,61,53,248,4,50
209,3/26/2018 4:25,61,73,61,53,248,4,50
210,3/26/2018 4:30,63,88,56,49,256,4,50
211,3/26/2018 4:35,70,87,67,59,283,4,50
212,3/26/2018 4:40,82,92,68,60,302,4,50
213,3/26/2018 4:45,90,77,61,53,281,4,50
214,3/26/2018 4:50,81,93,63,55,292,4,50
215,3/26/2018 4:55,80,98,75,67,320,4,50
216,3/26/2018 5:00,59,76,66,58,259,4,50
217,3/26/2018 5:05,82,76,68,60,286,4,50
218,3/26/2018 5:10,68,75,66,58,267,4,50
219,3/26/2018 5:15,83,86,67,59,295,4,50
220,3/26/2018 5:20,79,81,73,65,298,4,50
221,3/26/2018 5:25,94,89,72,64,319,4,50
222,3/26/2018 5:30,80,80,69,61,290,4,50
223,3/26/2018 5:35,108,103,91,82,384,4,50
224,3/26/2018 5:40,108,86,80,72,346,4,50
225,3/26/2018 5:45,132,120,84,75,411,4,50
226,3/26/2018 5:50,116,109,85,76,386,4,50
227,3/26/2018 5:55,122,97,86,77,382,4,50
228,3/26/2018 6:00,119,109,86,77,391,4,50
229,3/26/2018 6:05,116,112,89,80,397,4,50
230,3/26/2018 6:10,114,101,89,80,384,4,50
231,3/26/2018 6:15,122,98,87,78,385,4,50
232,3/26/2018 6:20,109,99,84,75,367,4,50
233,3/26/2018 6:25,116,114,92,83,405,4,50
234,3/26/2018 6:30,128,114,88,79,409,4,50
235,3/26/2018 6:35,150,135,106,96,487,4,50
236,3/26/2018 6:40,160,138,111,101,510,4,50
237,3/26/2018 6:45,172,131,100,90,493,4,50
238,3/26/2018 6:50,141,134,101,91,467,4,50
239,3/26/2018 6:55,168,147,86,77,478,4,50
240,3/26/2018 7:00,147,147,93,84,471,4,50
241,3/26/2018 7:05,177,148,100,90,515,4,50
242,3/26/2018 7:10,163,158,119,108,548,4,50
243,3/26/2018 7:15,144,132,108,98,482,4,50
244,3/26/2018 7:20,154,135,105,95,489,4,50
245,3/26/2018 7:25,149,139,101,92,481,4,50
246,3/26/2018 7:30,138,149,121,111,519,4,50
247,3/26/2018 7:35,156,161,109,99,525,4,50
248,3/26/2018 7:40,159,158,118,107,542,4,50
249,3/26/2018 7:45,147,140,94,85,466,4,50
250,3/26/2018 7:50,137,134,106,96,473,4,50
251,3/26/2018 7:55,154,150,103,93,500,4,50
252,3/26/2018 8:00,155,142,104,94,495,4,50
253,3/26/2018 8:05,149,137,106,96,488,4,50
254,3/26/2018 8:10,151,131,98,89,469,4,50
255,3/26/2018 8:15,150,156,101,91,498,4,50
256,3/26/2018 8:20,143,130,91,82,446,4,50
257,3/26/2018 8:25,151,133,98,88,470,4,50
258,3/26/2018 8:30,142,134,93,84,453,4,50
259,3/26/2018 8:35,139,129,86,77,431,4,50
260,3/26/2018 8:40,142,117,100,90,449,4,50
261,3/26/2018 8:45,149,137,86,77,449,4,50
262,3/26/2018 8:50,146,129,90,81,446,4,50
263,3/26/2018 8:55,111,116,88,79,394,4,50
264,3/26/2018 9:00,128,100,86,77,391,4,50
265,3/26/2018 9:05,127,112,77,69,385,4,50
266,3/26/2018 9:10,140,125,92,83,440,4,50
267,3/26/2018 9:15,128,114,100,91,433,4,50
268,3/26/2018 9:20,151,132,80,72,435,4,50
269,3/26/2018 9:25,120,104,80,71,375,4,50
270,3/26/2018 9:30,104,111,87,78,380,4,50
271,3/26/2018 9:35,112,112,87,78,389,4,50
272,3/26/2018 9:40,120,129,93,84,426,4,50
273,3/26/2018 9:45,123,108,82,73,386,4,50
274,3/26/2018 9:50,117,116,90,81,404,4,50
275,3/26/2018 9:55,108,105,89,80,382,4,50
276,3/26/2018 10:00,85,92,78,70,325,4,50
277,3/26/2018 10:05,88,73,61,53,275,4,50
278,3/26/2018 10:10,157,147,106,96,506,4,50
279,3/26/2018 10:15,115,115,83,75,388,4,50
280,3/26/2018 10:20,71,62,50,43,226,4,50
281,3/26/2018 10:25,98,88,68,60,314,4,50
282,3/26/2018 10:30,80,71,41,35,227,4,50
283,3/26/2018 10:35,33,38,35,29,135,4,50
284,3/26/2018 10:40,82,80,53,46,261,4,50
285,3/26/2018 10:45,160,156,89,80,485,4,50
286,3/26/2018 10:50,135,123,100,91,449,4,50
287,3/26/2018 10:55,83,97,81,73,334,4,50
288,3/26/2018 11:00,97,101,76,68,342,4,50
289,3/26/2018 11:05,80,97,72,64,313,4,50
290,3/26/2018 11:10,102,85,56,49,292,4,50
291,3/26/2018 11:15,48,44,31,25,148,4,50
292,3/26/2018 11:20,137,123,96,86,442,4,50
293,3/26/2018 11:25,138,123,85,76,422,4,50
294,3/26/2018 11:30,92,106,71,63,332,4,50
295,3/26/2018 11:35,122,100,79,70,371,4,50
296,3/26/2018 11:40,107,86,80,72,345,4,50
297,3/26/2018 11:45,96,108,82,73,359,4,50
298,3/26/2018 11:50,135,125,78,70,408,4,50
299,3/26/2018 11:55,106,121,92,83,402,4,50
300,3/26/2018 12:00,100,97,88,79,364,4,50
301,3/26/2018 12:05,89,83,78,70,320,4,50
302,3/26/2018 12:10,120,126,87,78,411,4,50
303,3/26/2018 12:15,82,103,77,69,331,4,50
304,3/26/2018 12:20,98,114,80,72,364,4,50
305,3/26/2018 12:25,116,100,89,81,386,4,50
306,3/26/2018 12:30,111,121,82,73,387,4,50
307,3/26/2018 12:35,100,114,90,81,385,4,50
308,3/26/2018 12:40,95,105,88,79,367,4,50
309,3/26/2018 12:45,113,120,84,75,392,4,50
310,3/26/2018 12:50,110,119,81,73,383,4,50
311,3/26/2018 12:55,101,114,82,73,370,4,50
312,3/26/2018 13:00,129,112,80,72,393,4,50
313,3/26/2018 13:05,88,101,90,81,360,4,50
314,3/26/2018 13:10,113,118,88,79,398,4,50
315,3/26/2018 13:15,129,109,78,70,386,4,50
316,3/26/2018 13:20,115,116,78,70,379,4,50
317,3/26/2018 13:25,102,132,90,81,405,4,50
318,3/26/2018 13:30,102,106,88,79,375,4,50
319,3/26/2018 13:35,116,111,98,89,414,4,50
320,3/26/2018 13:40,125,126,85,76,412,4,50
321,3/26/2018 13:45,107,93,85,76,361,4,50
322,3/26/2018 13:50,117,114,84,75,390,4,50
323,3/26/2018 13:55,108,112,88,79,387,4,50
324,3/26/2018 14:00,111,95,87,78,371,4,50
325,3/26/2018 14:05,107,117,92,83,399,4,50
326,3/26/2018 14:10,122,126,100,90,438,4,50
327,3/26/2018 14:15,114,127,88,79,408,4,50
328,3/26/2018 14:20,132,131,92,83,438,4,50
329,3/26/2018 14:25,117,112,85,77,391,4,50
330,3/26/2018 14:30,105,131,95,86,417,4,50
331,3/26/2018 14:35,117,120,96,87,420,4,50
332,3/26/2018 14:40,108,121,90,81,400,4,50
333,3/26/2018 14:45,150,141,104,94,489,4,50
334,3/26/2018 14:50,137,121,98,89,445,4,50
335,3/26/2018 14:55,127,127,89,80,423,4,50
336,3/26/2018 15:00,138,121,105,96,460,4,50
337,3/26/2018 15:05,149,117,98,89,453,4,50
338,3/26/2018 15:10,147,122,104,94,467,4,50
339,3/26/2018 15:15,146,138,80,71,435,4,50
340,3/26/2018 15:20,138,137,91,82,448,4,50
341,3/26/2018 15:25,139,136,88,79,442,4,50
342,3/26/2018 15:30,146,140,98,89,473,4,50
343,3/26/2018 15:35,148,139,112,101,500,4,50
344,3/26/2018 15:40,140,126,98,89,453,4,50
345,3/26/2018 15:45,157,140,106,97,500,4,50
346,3/26/2018 15:50,153,132,109,99,493,4,50
347,3/26/2018 15:55,150,124,106,96,476,4,50
348,3/26/2018 16:00,151,138,106,96,491,4,50
349,3/26/2018 16:05,165,125,101,92,483,4,50
350,3/26/2018 16:10,140,129,108,98,475,4,50
351,3/26/2018 16:15,143,132,112,101,488,4,50
352,3/26/2018 16:20,129,133,103,93,458,4,50
353,3/26/2018 16:25,153,134,106,97,490,4,50
354,3/26/2018 16:30,154,129,98,89,470,4,50
355,3/26/2018 16:35,142,128,110,100,480,4,50
356,3/26/2018 16:40,139,140,96,86,461,4,50
357,3/26/2018 16:45,136,139,116,105,496,4,50
358,3/26/2018 16:50,137,123,100,91,451,4,50
359,3/26/2018 16:55,163,148,115,105,531,4,50
360,3/26/2018 17:00,146,147,102,92,487,4,50
361,3/26/2018 17:05,135,145,114,104,498,4,50
362,3/26/2018 17:10,162,132,107,98,499,4,50
363,3/26/2018 17:15,166,159,108,98,531,4,50
364,3/26/2018 17:20,169,128,110,100,507,4,50
365,3/26/2018 17:25,147,133,111,101,492,4,50
366,3/26/2018 17:30,146,138,115,105,504,4,50
367,3/26/2018 17:35,158,148,119,108,533,4,50
368,3/26/2018 17:40,142,137,107,97,483,4,50
369,3/26/2018 17:45,153,138,112,101,504,4,50
370,3/26/2018 17:50,166,140,112,101,519,4,50
371,3/26/2018 17:55,165,134,103,93,495,4,50
372,3/26/2018 18:00,139,148,93,84,464,4,50
373,3/26/2018 18:05,152,157,98,89,496,4,50
374,3/26/2018 18:10,136,131,107,97,471,4,50
375,3/26/2018 18:15,157,148,106,96,507,4,50
376,3/26/2018 18:20,154,138,110,100,502,4,50
377,3/26/2018 18:25,135,125,106,97,463,4,50
378,3/26/2018 18:30,125,135,98,88,446,4,50
379,3/26/2018 18:35,117,113,97,88,415,4,50
380,3/26/2018 18:40,120,114,95,86,415,4,50
381,3/26/2018 18:45,119,109,95,86,409,4,50
382,3/26/2018 18:50,131,116,96,87,430,4,50
383,3/26/2018 18:55,107,115,91,82,395,4,50
384,3/26/2018 19:00,111,120,90,81,402,4,50
385,3/26/2018 19:05,103,102,89,81,375,4,50
386,3/26/2018 19:10,107,102,89,80,378,4,50
387,3/26/2018 19:15,104,119,98,89,410,4,50
388,3/26/2018 19:20,106,100,90,81,377,4,50
389,3/26/2018 19:25,111,104,74,66,355,4,50
390,3/26/2018 19:30,108,99,82,73,362,4,50
391,3/26/2018 19:35,93,94,80,72,339,4,50
392,3/26/2018 19:40,93,90,76,68,327,4,50
393,3/26/2018 19:45,94,94,70,62,320,4,50
394,3/26/2018 19:50,86,87,80,71,324,4,50
395,3/26/2018 19:55,91,78,71,63,303,4,50
396,3/26/2018 20:00,93,81,74,66,314,4,50
397,3/26/2018 20:05,81,100,72,64,317,4,50
398,3/26/2018 20:10,80,82,67,59,288,4,50
399,3/26/2018 20:15,96,86,69,62,313,4,50
400,3/26/2018 20:20,80,84,68,60,292,4,50
401,3/26/2018 20:25,79,73,71,63,286,4,50
402,3/26/2018 20:30,80,89,65,58,292,4,50
403,3/26/2018 20:35,65,82,69,61,277,4,50
404,3/26/2018 20:40,71,83,69,61,284,4,50
405,3/26/2018 20:45,70,72,70,62,274,4,50
406,3/26/2018 20:50,55,62,63,55,235,4,50
407,3/26/2018 20:55,55,72,63,55,245,4,50
408,3/26/2018 21:00,63,69,56,49,237,4,50
409,3/26/2018 21:05,67,74,68,60,269,4,50
410,3/26/2018 21:10,76,78,57,49,260,4,50
411,3/26/2018 21:15,73,63,61,54,251,4,50
412,3/26/2018 21:20,68,66,66,58,258,4,50
413,3/26/2018 21:25,73,81,60,53,267,4,50
414,3/26/2018 21:30,61,77,61,54,253,4,50
415,3/26/2018 21:35,66,72,56,49,243,4,50
416,3/26/2018 21:40,53,84,61,53,251,4,50
417,3/26/2018 21:45,57,64,59,51,231,4,50
418,3/26/2018 21:50,63,84,61,54,262,4,50
419,3/26/2018 21:55,60,60,52,45,217,4,50
420,3/26/2018 22:00,50,72,52,45,219,4,50
421,3/26/2018 22:05,50,66,53,46,215,4,50
422,3/26/2018 22:10,47,70,56,49,222,4,50
423,3/26/2018 22:15,49,55,50,43,197,4,50
424,3/26/2018 22:20,56,58,50,44,208,4,50
425,3/26/2018 22:25,54,62,56,49,221,4,50
426,3/26/2018 22:30,43,60,47,40,190,4,50
427,3/26/2018 22:35,46,51,53,45,195,4,50
428,3/26/2018 22:40,47,67,52,45,211,4,50
429,3/26/2018 22:45,45,48,53,46,192,4,50
430,3/26/2018 22:50,20,35,39,33,127,4,50
431,3/26/2018 22:55,19,59,37,31,146,4,50
432,3/26/2018 23:00,15,27,35,28,105,4,50
433,3/26/2018 23:05,32,47,43,36,158,4,50
434,3/26/2018 23:10,29,45,46,39,159,4,50
435,3/26/2018 23:15,94,101,55,48,298,4,50
436,3/26/2018 23:20,51,62,65,57,235,4,50
437,3/26/2018 23:25,57,79,68,60,264,4,50
438,3/26/2018 23:30,55,76,55,48,234,4,50
439,3/26/2018 23:35,43,70,48,41,202,4,50
440,3/26/2018 23:40,46,53,57,49,205,4,50
441,3/26/2018 23:45,26,43,47,40,156,4,50
442,3/26/2018 23:50,32,51,45,38,166,4,50
443,3/26/2018 23:55,24,42,37,31,134,4,50
444,3/27/2018 0:00,28,49,42,36,155,4,50
445,3/27/2018 0:05,23,45,39,33,140,4,50
446,3/27/2018 0:10,27,53,38,31,149,4,50
447,3/27/2018 0:15,9,22,34,28,93,4,50
448,3/27/2018 0:20,28,38,40,34,140,4,50
449,3/27/2018 0:25,31,47,36,30,144,4,50
450,3/27/2018 0:30,14,44,36,30,124,4,50
451,3/27/2018 0:35,19,43,39,33,134,4,50
452,3/27/2018 0:40,18,36,38,31,123,4,50
453,3/27/2018 0:45,22,37,33,27,119,4,50
454,3/27/2018 0:50,18,26,35,29,108,4,50
455,3/27/2018 0:55,11,28,26,21,86,4,50
456,3/27/2018 1:00,11,36,30,24,101,4,50
457,3/27/2018 1:05,13,26,27,21,87,4,50
458,3/27/2018 1:10,16,29,22,16,83,4,50
459,3/27/2018 1:15,17,33,30,25,105,4,50
460,3/27/2018 1:20,13,24,29,23,89,4,50
461,3/27/2018 1:25,15,34,24,18,91,4,50
462,3/27/2018 1:30,14,39,29,23,105,4,50
463,3/27/2018 1:35,14,24,27,21,86,4,50
464,3/27/2018 1:40,10,20,27,21,78,4,50
465,3/27/2018 1:45,9,24,24,18,75,4,50
466,3/27/2018 1:50,16,18,25,20,79,4,50
467,3/27/2018 1:55,12,25,23,18,78,4,50
468,3/27/2018 2:00,7,27,23,18,75,4,50
469,3/27/2018 2:05,10,28,23,18,79,4,50
470,3/27/2018 2:10,9,29,21,16,75,4,50
471,3/27/2018 2:15,14,24,25,20,83,4,50
472,3/27/2018 2:20,6,19,18,13,56,4,50
473,3/27/2018 2:25,14,30,25,19,88,4,50
474,3/27/2018 2:30,11,23,23,18,75,4,50
475,3/27/2018 2:35,10,21,27,21,79,4,50
476,3/27/2018 2:40,10,26,21,15,72,4,50
477,3/27/2018 2:45,12,31,27,21,91,4,50
478,3/27/2018 2:50,17,33,25,19,94,4,50
479,3/27/2018 2:55,14,20,24,18,76,4,50
480,3/27/2018 3:00,18,28,23,17,86,4,50
481,3/27/2018 3:05,10,21,26,20,77,4,50
482,3/27/2018 3:10,9,26,32,26,93,4,50
483,3/27/2018 3:15,15,26,24,18,83,4,50
484,3/27/2018 3:20,13,18,26,21,78,4,50
485,3/27/2018 3:25,15,28,27,22,92,4,50
486,3/27/2018 3:30,20,37,33,27,117,4,50
487,3/27/2018 3:35,22,45,33,27,127,4,50
488,3/27/2018 3:40,32,39,37,31,139,4,50
489,3/27/2018 3:45,26,50,40,33,149,4,50
490,3/27/2018 3:50,33,48,34,27,142,4,50
491,3/27/2018 3:55,27,38,32,26,123,4,50
492,3/27/2018 4:00,20,40,34,27,121,4,50
493,3/27/2018 4:05,29,43,33,27,132,4,50
494,3/27/2018 4:10,47,50,46,40,183,4,50
495,3/27/2018 4:15,49,60,53,46,208,4,50
496,3/27/2018 4:20,51,69,53,47,220,4,50
497,3/27/2018 4:25,52,79,56,49,236,4,50
498,3/27/2018 4:30,66,71,55,47,239,4,50
499,3/27/2018 4:35,54,63,61,53,231,4,50
500,3/27/2018 4:40,69,78,57,50,254,4,50
501,3/27/2018 4:45,68,66,56,49,239,4,50
502,3/27/2018 4:50,61,68,53,46,228,4,50
503,3/27/2018 4:55,59,55,53,46,213,4,50
504,3/27/2018 5:00,55,55,51,44,205,4,50
505,3/27/2018 5:05,60,57,50,43,210,4,50
506,3/27/2018 5:10,86,93,74,66,319,4,50
507,3/27/2018 5:15,96,93,80,71,340,4,50
508,3/27/2018 5:20,90,89,79,70,328,4,50
509,3/27/2018 5:25,92,93,80,71,336,4,50
510,3/27/2018 5:30,88,99,89,81,357,4,50
511,3/27/2018 5:35,112,100,86,77,375,4,50
512,3/27/2018 5:40,121,104,93,84,402,4,50
513,3/27/2018 5:45,122,114,82,74,392,4,50
514,3/27/2018 5:50,124,117,93,84,418,4,50
515,3/27/2018 5:55,120,97,75,67,359,4,50
516,3/27/2018 6:00,114,102,89,81,386,4,50
517,3/27/2018 6:05,126,111,90,81,408,4,50
518,3/27/2018 6:10,114,111,88,79,392,4,50
519,3/27/2018 6:15,114,99,82,73,368,4,50
520,3/27/2018 6:20,130,119,90,81,420,4,50
521,3/27/2018 6:25,111,120,95,86,412,4,50
522,3/27/2018 6:30,136,121,96,86,439,4,50
523,3/27/2018 6:35,146,134,105,95,480,4,50
524,3/27/2018 6:40,149,131,107,97,484,4,50
525,3/27/2018 6:45,160,138,103,93,494,4,50
526,3/27/2018 6:50,148,132,98,89,467,4,50
527,3/27/2018 6:55,160,149,108,98,515,4,50
528,3/27/2018 7:00,137,134,107,98,476,4,50
529,3/27/2018 7:05,158,128,106,97,489,4,50
530,3/27/2018 7:10,157,133,111,101,502,4,50
531,3/27/2018 7:15,156,150,115,105,526,4,50
532,3/27/2018 7:20,152,127,104,95,478,4,50
533,3/27/2018 7:25,164,143,101,91,499,4,50
534,3/27/2018 7:30,143,139,109,99,490,4,50
535,3/27/2018 7:35,146,136,105,95,482,4,50
536,3/27/2018 7:40,154,133,110,100,497,4,50
537,3/27/2018 7:45,143,147,108,98,496,4,50
538,3/27/2018 7:50,141,130,96,87,454,4,50
539,3/27/2018 7:55,141,130,104,94,469,4,50
540,3/27/2018 8:00,134,118,98,88,438,4,50
541,3/27/2018 8:05,137,124,106,96,463,4,50
542,3/27/2018 8:10,127,126,90,81,424,4,50
543,3/27/2018 8:15,143,126,94,85,448,4,50
544,3/27/2018 8:20,145,137,108,98,488,4,50
545,3/27/2018 8:25,130,126,96,87,439,4,50
546,3/27/2018 8:30,131,133,90,81,435,4,50
547,3/27/2018 8:35,124,130,80,72,406,4,50
548,3/27/2018 8:40,136,113,90,81,420,4,50
549,3/27/2018 8:45,133,101,88,79,401,4,50
550,3/27/2018 8:50,137,128,99,90,454,4,50
551,3/27/2018 8:55,138,132,88,79,437,4,50
552,3/27/2018 9:00,133,132,96,86,447,4,50
553,3/27/2018 9:05,115,103,90,81,389,4,50
554,3/27/2018 9:10,116,110,72,63,361,4,50
555,3/27/2018 9:15,112,121,78,70,381,4,50
556,3/27/2018 9:20,137,124,82,74,417,4,50
557,3/27/2018 9:25,120,127,80,71,398,4,50
558,3/27/2018 9:30,123,131,75,67,396,4,50
559,3/27/2018 9:35,126,123,70,62,381,4,50
560,3/27/2018 9:40,109,111,87,78,385,4,50
561,3/27/2018 9:45,116,118,85,76,395,4,50
562,3/27/2018 9:50,104,101,85,77,367,4,50
563,3/27/2018 9:55,120,119,79,70,388,4,50
564,3/27/2018 10:00,95,105,77,69,346,4,50
565,3/27/2018 10:05,110,103,73,65,351,4,50
566,3/27/2018 10:10,101,97,79,70,347,4,50
567,3/27/2018 10:15,106,108,85,77,376,4,50
568,3/27/2018 10:20,118,112,85,76,391,4,50
569,3/27/2018 10:25,114,102,77,69,362,4,50
570,3/27/2018 10:30,133,113,98,89,433,4,50
571,3/27/2018 10:35,133,114,91,82,420,4,50
572,3/27/2018 10:40,116,119,92,83,410,4,50
573,3/27/2018 10:45,131,131,94,85,441,4,50
574,3/27/2018 10:50,127,123,99,90,439,4,50
575,3/27/2018 10:55,119,124,99,90,432,4,50
576,3/27/2018 11:00,129,121,99,90,439,4,50
577,3/27/2018 11:05,98,104,79,71,352,4,50
578,3/27/2018 11:10,128,120,97,87,432,4,50
579,3/27/2018 11:15,134,120,102,93,449,4,50
580,3/27/2018 11:20,117,129,94,85,425,4,50
581,3/27/2018 11:25,127,111,90,81,409,4,50
582,3/27/2018 11:30,124,111,78,70,383,4,50
583,3/27/2018 11:35,126,119,96,86,427,4,50
584,3/27/2018 11:40,121,120,87,78,406,4,50
585,3/27/2018 11:45,120,125,95,86,426,4,50
586,3/27/2018 11:50,117,111,85,77,390,4,50
587,3/27/2018 11:55,117,117,90,81,405,4,50
588,3/27/2018 12:00,114,106,75,67,362,4,50
589,3/27/2018 12:05,89,95,71,63,318,4,50
590,3/27/2018 12:10,100,115,92,83,390,4,50
591,3/27/2018 12:15,113,134,90,81,418,4,50
592,3/27/2018 12:20,123,111,79,70,383,4,50
593,3/27/2018 12:25,110,117,80,72,379,4,50
594,3/27/2018 12:30,118,119,90,81,408,4,50
595,3/27/2018 12:35,106,106,92,83,387,4,50
596,3/27/2018 12:40,137,123,88,79,427,4,50
597,3/27/2018 12:45,131,124,88,79,422,4,50
598,3/27/2018 12:50,119,119,95,86,419,4,50
599,3/27/2018 12:55,120,105,77,68,370,4,50
600,3/27/2018 13:00,124,110,86,77,397,4,50
601,3/27/2018 13:05,118,117,82,74,391,4,50
602,3/27/2018 13:10,111,99,77,69,356,4,50
603,3/27/2018 13:15,121,119,85,76,401,4,50
604,3/27/2018 13:20,121,115,96,86,418,4,50
605,3/27/2018 13:25,124,110,85,76,395,4,50
606,3/27/2018 13:30,128,112,92,83,415,4,50
607,3/27/2018 13:35,136,131,101,92,460,4,50
608,3/27/2018 13:40,117,124,101,92,434,4,50
609,3/27/2018 13:45,126,120,101,92,439,4,50
610,3/27/2018 13:50,132,126,98,89,445,4,50
611,3/27/2018 13:55,128,112,94,85,419,4,50
612,3/27/2018 14:00,137,112,96,87,432,4,50
613,3/27/2018 14:05,133,122,76,68,399,4,50
614,3/27/2018 14:10,124,118,82,74,398,4,50
615,3/27/2018 14:15,147,127,100,90,464,4,50
616,3/27/2018 14:20,134,119,92,83,428,4,50
617,3/27/2018 14:25,124,116,93,84,417,4,50
618,3/27/2018 14:30,123,131,103,93,450,4,50
619,3/27/2018 14:35,56,81,51,43,231,4,50
620,3/27/2018 14:40,146,127,106,96,475,4,50
621,3/27/2018 14:45,186,155,109,99,549,4,50
622,3/27/2018 14:50,143,129,105,95,472,4,50
623,3/27/2018 14:55,141,131,101,92,465,4,50
624,3/27/2018 15:00,124,124,98,88,434,4,50
625,3/27/2018 15:05,137,127,92,83,439,4,50
626,3/27/2018 15:10,132,103,92,83,410,4,50
627,3/27/2018 15:15,148,119,103,93,463,4,50
628,3/27/2018 15:20,161,139,98,88,486,4,50
629,3/27/2018 15:25,141,131,104,94,470,4,50
630,3/27/2018 15:30,136,142,101,91,470,4,50
631,3/27/2018 15:35,156,128,87,78,449,4,50
632,3/27/2018 15:40,93,93,54,47,287,4,50
633,3/27/2018 15:45,90,101,73,65,329,4,50
634,3/27/2018 15:50,104,108,82,74,368,4,50
635,3/27/2018 15:55,114,106,76,68,364,4,50
636,3/27/2018 16:00,141,130,91,82,444,4,50
637,3/27/2018 16:05,151,151,84,75,461,4,50
638,3/27/2018 16:10,160,150,107,97,514,4,50
639,3/27/2018 16:15,134,111,98,89,432,4,50
640,3/27/2018 16:20,140,131,107,97,475,4,50
641,3/27/2018 16:25,138,148,105,96,487,4,50
642,3/27/2018 16:30,164,155,110,100,529,4,50
643,3/27/2018 16:35,170,152,113,103,538,4,50
644,3/27/2018 16:40,150,149,112,102,513,4,50
645,3/27/2018 16:45,166,149,101,91,507,4,50
646,3/27/2018 16:50,162,147,118,107,534,4,50
647,3/27/2018 16:55,148,133,98,89,468,4,50
648,3/27/2018 17:00,153,147,106,97,503,4,50
649,3/27/2018 17:05,161,140,93,84,478,4,50
650,3/27/2018 17:10,146,136,99,90,471,4,50
651,3/27/2018 17:15,156,155,116,105,532,4,50
652,3/27/2018 17:20,151,163,114,103,531,4,50
653,3/27/2018 17:25,137,143,112,102,494,4,50
654,3/27/2018 17:30,154,136,115,105,510,4,50
655,3/27/2018 17:35,153,147,109,99,508,4,50
656,3/27/2018 17:40,164,153,117,106,540,4,50
657,3/27/2018 17:45,171,146,114,103,534,4,50
658,3/27/2018 17:50,151,141,101,92,485,4,50
659,3/27/2018 17:55,159,135,105,95,494,4,50
660,3/27/2018 18:00,134,114,100,91,439,4,50
661,3/27/2018 18:05,141,160,106,96,503,4,50
662,3/27/2018 18:10,146,130,104,94,474,4,50
663,3/27/2018 18:15,150,139,112,102,503,4,50
664,3/27/2018 18:20,130,132,106,96,464,4,50
665,3/27/2018 18:25,123,122,106,96,447,4,50
666,3/27/2018 18:30,125,131,105,96,457,4,50
667,3/27/2018 18:35,149,129,103,93,474,4,50
668,3/27/2018 18:40,129,119,93,84,425,4,50
669,3/27/2018 18:45,137,115,92,83,427,4,50
670,3/27/2018 18:50,121,122,97,88,428,4,50
671,3/27/2018 18:55,112,108,96,87,403,4,50
672,3/27/2018 19:00,124,115,101,92,432,4,50
673,3/27/2018 19:05,129,108,93,84,414,4,50
674,3/27/2018 19:10,124,115,87,78,404,4,50
675,3/27/2018 19:15,118,104,93,84,399,4,50
676,3/27/2018 19:20,101,110,84,75,370,4,50
677,3/27/2018 19:25,99,93,74,65,331,4,50
678,3/27/2018 19:30,81,94,84,75,334,4,50
679,3/27/2018 19:35,97,103,81,73,354,4,50
680,3/27/2018 19:40,88,89,79,70,326,4,50
681,3/27/2018 19:45,89,106,85,77,357,4,50
682,3/27/2018 19:50,98,89,78,70,335,4,50
683,3/27/2018 19:55,86,83,76,68,313,4,50
684,3/27/2018 20:00,97,95,78,70,340,4,50
685,3/27/2018 20:05,89,96,80,72,337,4,50
686,3/27/2018 20:10,86,90,71,63,310,4,50
687,3/27/2018 20:15,96,87,77,69,329,4,50
688,3/27/2018 20:20,95,108,72,64,339,4,50
689,3/27/2018 20:25,85,93,80,72,330,4,50
690,3/27/2018 20:30,93,90,68,60,311,4,50
691,3/27/2018 20:35,80,83,68,60,291,4,50
692,3/27/2018 20:40,73,74,68,60,275,4,50
693,3/27/2018 20:45,76,102,72,64,314,4,50
694,3/27/2018 20:50,82,74,67,60,283,4,50
695,3/27/2018 20:55,79,96,73,65,313,4,50
696,3/27/2018 21:00,69,79,65,57,270,4,50
697,3/27/2018 21:05,57,84,71,63,275,4,50
698,3/27/2018 21:10,65,76,65,57,263,4,50
699,3/27/2018 21:15,69,68,67,59,263,4,50
700,3/27/2018 21:20,68,85,69,62,284,4,50
701,3/27/2018 21:25,68,58,60,52,238,4,50
702,3/27/2018 21:30,60,79,59,52,250,4,50
703,3/27/2018 21:35,59,78,59,52,248,4,50
704,3/27/2018 21:40,67,75,64,56,262,4,50
705,3/27/2018 21:45,61,71,57,49,238,4,50
706,3/27/2018 21:50,74,83,66,58,281,4,50
707,3/27/2018 21:55,60,79,62,55,256,4,50
708,3/27/2018 22:00,39,66,58,51,214,4,50
709,3/27/2018 22:05,49,65,59,52,225,4,50
710,3/27/2018 22:10,63,68,53,47,231,4,50
711,3/27/2018 22:15,62,66,53,47,228,4,50
712,3/27/2018 22:20,61,69,60,53,243,4,50
713,3/27/2018 22:25,39,70,53,46,208,4,50
714,3/27/2018 22:30,59,58,46,40,203,4,50
715,3/27/2018 22:35,53,65,53,46,217,4,50
716,3/27/2018 22:40,49,58,49,41,197,4,50
717,3/27/2018 22:45,41,68,51,44,204,4,50
718,3/27/2018 22:50,40,54,52,45,191,4,50
719,3/27/2018 22:55,41,57,46,40,184,4,50
720,3/27/2018 23:00,28,41,40,34,143,4,50
721,3/27/2018 23:05,37,48,40,34,159,4,50
722,3/27/2018 23:10,47,52,43,37,179,4,50
723,3/27/2018 23:15,41,61,48,41,191,4,50
724,3/27/2018 23:20,32,47,38,31,148,4,50
725,3/27/2018 23:25,36,53,35,29,153,4,50
726,3/27/2018 23:30,27,43,41,35,146,4,50
727,3/27/2018 23:35,24,54,45,38,161,4,50
728,3/27/2018 23:40,23,43,40,34,140,4,50
729,3/27/2018 23:45,40,41,37,31,149,4,50
730,3/27/2018 23:50,33,42,40,34,149,4,50
731,3/27/2018 23:55,28,40,33,27,128,4,50
732,3/28/2018 0:00,19,38,34,27,118,4,50
733,3/28/2018 0:05,25,30,35,29,119,4,50
734,3/28/2018 0:10,20,37,34,28,119,4,50
735,3/28/2018 0:15,23,34,30,25,112,4,50
736,3/28/2018 0:20,19,29,29,23,100,4,50
737,3/28/2018 0:25,24,32,24,18,98,4,50
738,3/28/2018 0:30,17,35,27,22,101,4,50
739,3/28/2018 0:35,21,35,30,24,110,4,50
740,3/28/2018 0:40,18,36,30,23,107,4,50
741,3/28/2018 0:45,18,19,20,15,72,4,50
742,3/28/2018 0:50,14,25,23,18,80,4,50
743,3/28/2018 0:55,5,20,18,13,56,4,50
744,3/28/2018 1:00,11,20,19,14,64,4,50
745,3/28/2018 1:05,9,10,19,14,52,4,50
746,3/28/2018 1:10,10,14,22,16,62,4,50
747,3/28/2018 1:15,13,23,22,16,74,4,50
748,3/28/2018 1:20,7,14,21,15,57,4,50
749,3/28/2018 1:25,9,23,21,16,69,4,50
750,3/28/2018 1:30,6,17,19,14,56,4,50
751,3/28/2018 1:35,11,19,16,11,57,4,50
752,3/28/2018 1:40,9,22,17,11,59,4,50
753,3/28/2018 1:45,11,13,20,15,59,4,50
754,3/28/2018 1:50,8,10,15,10,43,4,50
755,3/28/2018 1:55,8,14,15,10,47,4,50
756,3/28/2018 2:00,6,12,14,10,42,4,50
757,3/28/2018 2:05,8,13,15,10,46,4,50
758,3/28/2018 2:10,8,15,15,9,47,4,50
759,3/28/2018 2:15,13,20,19,14,66,4,50
760,3/28/2018 2:20,8,16,14,9,47,4,50
761,3/28/2018 2:25,6,21,20,15,62,4,50
762,3/28/2018 2:30,10,16,15,10,51,4,50
763,3/28/2018 2:35,10,20,14,9,53,4,50
764,3/28/2018 2:40,8,16,19,14,57,4,50
765,3/28/2018 2:45,11,21,17,11,60,4,50
766,3/28/2018 2:50,7,11,18,13,49,4,50
767,3/28/2018 2:55,6,18,16,11,51,4,50
768,3/28/2018 3:00,6,13,17,11,47,4,50
769,3/28/2018 3:05,7,7,13,8,35,4,50
770,3/28/2018 3:10,9,10,17,12,48,4,50
771,3/28/2018 3:15,4,7,15,10,36,4,50
772,3/28/2018 3:20,10,18,19,14,61,4,50
773,3/28/2018 3:25,9,21,19,14,63,4,50
774,3/28/2018 3:30,17,16,16,11,60,4,50
775,3/28/2018 3:35,14,19,22,16,71,4,50
776,3/28/2018 3:40,17,22,18,12,69,4,50
777,3/28/2018 3:45,16,23,23,17,79,4,50
778,3/28/2018 3:50,19,27,23,18,87,4,50
779,3/28/2018 3:55,17,20,25,20,82,4,50
780,3/28/2018 4:00,16,21,20,15,72,4,50
781,3/28/2018 4:05,17,27,20,14,78,4,50
782,3/28/2018 4:10,26,28,27,21,102,4,50
783,3/28/2018 4:15,26,44,31,25,126,4,50
784,3/28/2018 4:20,35,34,39,33,141,4,50
785,3/28/2018 4:25,35,41,41,35,152,4,50
786,3/28/2018 4:30,38,47,35,29,149,4,50
787,3/28/2018 4:35,50,50,50,43,193,4,50
788,3/28/2018 4:40,48,51,45,38,182,4,50
789,3/28/2018 4:45,53,61,54,47,215,4,50
790,3/28/2018 4:50,52,59,46,40,197,4,50
791,3/28/2018 4:55,51,55,42,36,184,4,50
792,3/28/2018 5:00,71,72,58,51,252,4,50
793,3/28/2018 5:05,64,62,59,52,237,4,50
794,3/28/2018 5:10,72,80,68,60,280,4,50
795,3/28/2018 5:15,95,87,75,66,323,4,50
796,3/28/2018 5:20,93,89,63,55,300,4,50
797,3/28/2018 5:25,87,92,77,68,324,4,50
798,3/28/2018 5:30,113,108,84,75,380,4,50
799,3/28/2018 5:35,129,103,83,75,390,4,50
800,3/28/2018 5:40,108,113,88,79,388,4,50
801,3/28/2018 5:45,124,112,82,74,392,4,50
802,3/28/2018 5:50,121,109,80,72,382,4,50
803,3/28/2018 5:55,127,118,84,75,404,4,50
804,3/28/2018 6:00,131,117,91,82,421,4,50
805,3/28/2018 6:05,133,109,91,82,415,4,50
806,3/28/2018 6:10,126,121,82,74,403,4,50
807,3/28/2018 6:15,119,103,92,83,397,4,50
808,3/28/2018 6:20,124,110,95,86,415,4,50
809,3/28/2018 6:25,142,131,93,84,450,4,50
810,3/28/2018 6:30,139,129,106,96,470,4,50
811,3/28/2018 6:35,151,126,107,97,481,4,50
812,3/28/2018 6:40,151,116,99,90,456,4,50
813,3/28/2018 6:45,168,152,102,92,514,4,50
814,3/28/2018 6:50,148,133,111,101,493,4,50
815,3/28/2018 6:55,160,145,103,93,501,4,50
816,3/28/2018 7:00,154,147,96,86,483,4,50
817,3/28/2018 7:05,143,129,98,89,459,4,50
818,3/28/2018 7:10,142,147,110,100,499,4,50
819,3/28/2018 7:15,163,138,100,90,491,4,50
820,3/28/2018 7:20,139,141,103,93,476,4,50
821,3/28/2018 7:25,146,132,111,101,490,4,50
822,3/28/2018 7:30,154,138,98,88,478,4,50
823,3/28/2018 7:35,163,146,123,112,544,4,50
824,3/28/2018 7:40,143,135,101,91,470,4,50
825,3/28/2018 7:45,160,127,101,91,479,4,50
826,3/28/2018 7:50,121,140,109,99,469,4,50
827,3/28/2018 7:55,144,130,109,99,482,4,50
828,3/28/2018 8:00,141,127,85,76,429,4,50
829,3/28/2018 8:05,123,134,95,86,438,4,50
830,3/28/2018 8:10,136,132,98,89,455,4,50
831,3/28/2018 8:15,131,125,99,90,445,4,50
832,3/28/2018 8:20,166,138,95,85,484,4,50
833,3/28/2018 8:25,142,139,98,88,467,4,50
834,3/28/2018 8:30,126,129,93,84,432,4,50
835,3/28/2018 8:35,132,123,92,83,430,4,50
836,3/28/2018 8:40,132,117,87,78,414,4,50
837,3/28/2018 8:45,136,123,99,90,448,4,50
838,3/28/2018 8:50,140,131,100,91,462,4,50
839,3/28/2018 8:55,129,116,99,90,434,4,50
840,3/28/2018 9:00,127,118,91,82,418,4,50
841,3/28/2018 9:05,150,130,90,81,451,4,50
842,3/28/2018 9:10,120,129,90,81,420,4,50
843,3/28/2018 9:15,116,118,93,84,411,4,50
844,3/28/2018 9:20,122,120,93,84,419,4,50
845,3/28/2018 9:25,117,118,87,78,400,4,50
846,3/28/2018 9:30,122,109,88,79,398,4,50
847,3/28/2018 9:35,103,127,72,64,366,4,50
848,3/28/2018 9:40,118,114,92,83,407,4,50
849,3/28/2018 9:45,107,124,96,86,413,4,50
850,3/28/2018 9:50,132,124,85,77,418,4,50
851,3/28/2018 9:55,99,103,75,66,343,4,50
852,3/28/2018 10:00,98,103,73,65,339,4,50
853,3/28/2018 10:05,116,103,86,77,382,4,50
854,3/28/2018 10:10,118,99,88,79,384,4,50
855,3/28/2018 10:15,115,101,82,74,372,4,50
856,3/28/2018 10:20,111,109,86,77,383,4,50
857,3/28/2018 10:25,116,103,84,75,378,4,50
858,3/28/2018 10:30,120,112,82,74,388,4,50
859,3/28/2018 10:35,110,111,92,83,396,4,50
860,3/28/2018 10:40,123,128,93,84,428,4,50
861,3/28/2018 10:45,115,129,94,85,423,4,50
862,3/28/2018 10:50,116,102,85,76,379,4,50
863,3/28/2018 10:55,112,112,93,84,401,4,50
864,3/28/2018 11:00,115,115,89,80,399,4,50
865,3/28/2018 11:05,117,127,91,82,417,4,50
866,3/28/2018 11:10,101,98,84,76,359,4,50
867,3/28/2018 11:15,103,108,80,71,362,4,50
868,3/28/2018 11:20,89,116,88,79,372,4,50
869,3/28/2018 11:25,108,93,82,74,357,4,50
870,3/28/2018 11:30,125,121,93,84,423,4,50
871,3/28/2018 11:35,108,107,88,79,382,4,50
872,3/28/2018 11:40,106,103,87,78,374,4,50
873,3/28/2018 11:45,107,123,94,85,409,4,50
874,3/28/2018 11:50,113,109,95,86,403,4,50
875,3/28/2018 11:55,115,105,89,81,390,4,50
876,3/28/2018 12:00,111,115,86,77,389,4,50
877,3/28/2018 12:05,110,104,87,79,380,4,50
878,3/28/2018 12:10,129,112,85,77,403,4,50
879,3/28/2018 12:15,123,105,92,83,403,4,50
880,3/28/2018 12:20,119,114,82,73,388,4,50
881,3/28/2018 12:25,118,106,87,78,389,4,50
882,3/28/2018 12:30,110,115,92,83,400,4,50
883,3/28/2018 12:35,118,118,84,75,395,4,50
884,3/28/2018 12:40,117,110,96,86,409,4,50
885,3/28/2018 12:45,108,97,75,66,346,4,50
886,3/28/2018 12:50,111,109,88,79,387,4,50
887,3/28/2018 12:55,96,117,85,76,374,4,50
888,3/28/2018 13:00,123,122,98,88,431,4,50
889,3/28/2018 13:05,124,108,93,84,409,4,50
890,3/28/2018 13:10,126,120,99,90,435,4,50
891,3/28/2018 13:15,115,115,95,86,411,4,50
892,3/28/2018 13:20,124,116,96,87,423,4,50
893,3/28/2018 13:25,128,129,97,88,442,4,50
894,3/28/2018 13:30,126,115,95,86,422,4,50
895,3/28/2018 13:35,138,126,96,87,447,4,50
896,3/28/2018 13:40,128,123,85,77,413,4,50
897,3/28/2018 13:45,121,125,96,87,429,4,50
898,3/28/2018 13:50,148,127,90,81,446,4,50
899,3/28/2018 13:55,126,122,85,77,410,4,50
900,3/28/2018 14:00,114,117,90,81,402,4,50
901,3/28/2018 14:05,114,119,85,76,394,4,50
902,3/28/2018 14:10,116,124,83,75,398,4,50
903,3/28/2018 14:15,118,109,81,73,381,4,50
904,3/28/2018 14:20,128,116,85,76,405,4,50
905,3/28/2018 14:25,130,117,99,90,436,4,50
906,3/28/2018 14:30,132,114,89,80,415,4,50
907,3/28/2018 14:35,141,128,101,91,461,4,50
908,3/28/2018 14:40,133,128,101,91,453,4,50
909,3/28/2018 14:45,135,125,101,92,453,4,50
910,3/28/2018 14:50,130,117,95,86,428,4,50
911,3/28/2018 14:55,135,133,98,89,455,4,50
912,3/28/2018 15:00,139,118,88,79,424,4,50
913,3/28/2018 15:05,147,131,93,84,455,4,50
914,3/28/2018 15:10,147,143,114,103,507,4,50
915,3/28/2018 15:15,137,142,104,94,477,4,50
916,3/28/2018 15:20,128,144,98,89,459,4,50
917,3/28/2018 15:25,144,132,98,89,463,4,50
918,3/28/2018 15:30,155,134,101,91,481,4,50
919,3/28/2018 15:35,159,160,117,106,542,4,50
920,3/28/2018 15:40,141,130,112,101,484,4,50
921,3/28/2018 15:45,154,133,106,96,489,4,50
922,3/28/2018 15:50,152,148,109,100,509,4,50
923,3/28/2018 15:55,136,130,94,85,445,4,50
924,3/28/2018 16:00,150,123,104,94,471,4,50
925,3/28/2018 16:05,144,144,105,95,488,4,50
926,3/28/2018 16:10,160,139,117,107,523,4,50
927,3/28/2018 16:15,151,131,104,94,480,4,50
928,3/28/2018 16:20,166,138,106,96,506,4,50
929,3/28/2018 16:25,124,126,107,97,454,4,50
930,3/28/2018 16:30,157,130,105,95,487,4,50
931,3/28/2018 16:35,161,158,120,109,548,4,50
932,3/28/2018 16:40,158,152,113,103,526,4,50
933,3/28/2018 16:45,157,132,113,103,505,4,50
934,3/28/2018 16:50,144,136,114,104,498,4,50
935,3/28/2018 16:55,149,130,112,102,493,4,50
936,3/28/2018 17:00,158,147,106,96,507,4,50
937,3/28/2018 17:05,123,117,91,82,413,4,50
938,3/28/2018 17:10,77,90,80,72,319,4,50
939,3/28/2018 17:15,76,76,73,65,290,4,50
940,3/28/2018 17:20,47,62,63,55,227,4,50
941,3/28/2018 17:25,56,62,63,55,236,4,50
942,3/28/2018 17:30,64,94,75,66,299,4,50
943,3/28/2018 17:35,55,76,70,62,263,4,50
944,3/28/2018 17:40,58,67,67,59,251,4,50
945,3/28/2018 17:45,68,82,70,62,282,4,50
946,3/28/2018 17:50,155,141,111,102,509,4,50
947,3/28/2018 17:55,159,175,113,103,550,4,50
948,3/28/2018 18:00,150,161,114,103,528,4,50
949,3/28/2018 18:05,154,151,114,104,523,4,50
950,3/28/2018 18:10,147,122,106,96,471,4,50
951,3/28/2018 18:15,173,153,111,101,538,4,50
952,3/28/2018 18:20,152,135,105,95,487,4,50
953,3/28/2018 18:25,168,146,102,92,508,4,50
954,3/28/2018 18:30,162,135,103,94,494,4,50
955,3/28/2018 18:35,142,131,107,97,477,4,50
956,3/28/2018 18:40,162,156,102,92,512,4,50
957,3/28/2018 18:45,124,110,97,88,419,4,50
958,3/28/2018 18:50,136,133,106,96,471,4,50
959,3/28/2018 18:55,129,127,100,90,446,4,50
960,3/28/2018 19:00,136,126,99,90,451,4,50
961,3/28/2018 19:05,118,112,94,85,409,4,50
962,3/28/2018 19:10,131,119,99,89,438,4,50
963,3/28/2018 19:15,120,116,99,89,424,4,50
964,3/28/2018 19:20,113,104,93,84,394,4,50
965,3/28/2018 19:25,127,135,94,85,441,4,50
966,3/28/2018 19:30,106,112,96,86,400,4,50
967,3/28/2018 19:35,118,107,95,86,406,4,50
968,3/28/2018 19:40,108,101,87,79,375,4,50
969,3/28/2018 19:45,117,108,88,79,392,4,50
970,3/28/2018 19:50,113,106,89,80,388,4,50
971,3/28/2018 19:55,109,90,83,74,356,4,50
972,3/28/2018 20:00,116,115,85,77,393,4,50
973,3/28/2018 20:05,92,103,72,64,331,4,50
974,3/28/2018 20:10,93,110,69,61,333,4,50
975,3/28/2018 20:15,81,99,69,61,310,4,50
976,3/28/2018 20:20,101,100,72,64,337,4,50
977,3/28/2018 20:25,83,107,85,77,352,4,50
978,3/28/2018 20:30,82,82,71,63,298,4,50
979,3/28/2018 20:35,83,96,71,63,313,4,50
980,3/28/2018 20:40,69,86,74,66,295,4,50
981,3/28/2018 20:45,75,81,65,57,278,4,50
982,3/28/2018 20:50,88,92,69,62,311,4,50
983,3/28/2018 20:55,71,76,73,65,285,4,50
984,3/28/2018 21:00,85,81,73,65,304,4,50
985,3/28/2018 21:05,87,82,69,61,299,4,50
986,3/28/2018 21:10,73,79,75,67,294,4,50
987,3/28/2018 21:15,79,78,65,57,279,4,50
988,3/28/2018 21:20,80,82,56,49,267,4,50
989,3/28/2018 21:25,71,79,75,66,291,4,50
990,3/28/2018 21:30,72,73,59,52,256,4,50
991,3/28/2018 21:35,66,71,65,57,259,4,50
992,3/28/2018 21:40,75,78,68,60,281,4,50
993,3/28/2018 21:45,68,66,64,56,254,4,50
994,3/28/2018 21:50,79,73,58,51,261,4,50
995,3/28/2018 21:55,71,84,56,48,259,4,50
996,3/28/2018 22:00,63,67,49,42,221,4,50
997,3/28/2018 22:05,70,63,61,54,248,4,50
998,3/28/2018 22:10,65,62,54,47,228,4,50
999,3/28/2018 22:15,66,75,68,60,269,4,50
1000,3/28/2018 22:20,55,76,61,53,245,4,50
1001,3/28/2018 22:25,56,61,56,49,222,4,50
1002,3/28/2018 22:30,61,67,49,42,219,4,50
1003,3/28/2018 22:35,53,61,53,47,214,4,50
1004,3/28/2018 22:40,65,75,56,49,245,4,50
1005,3/28/2018 22:45,46,66,47,40,199,4,50
1006,3/28/2018 22:50,39,62,60,53,214,4,50
1007,3/28/2018 22:55,36,59,53,46,194,4,50
1008,3/28/2018 23:00,36,38,45,38,157,4,50
1009,3/28/2018 23:05,46,50,46,40,182,4,50
1010,3/28/2018 23:10,34,48,47,40,169,4,50
1011,3/28/2018 23:15,35,46,44,38,163,4,50
1012,3/28/2018 23:20,38,48,38,32,156,4,50
1013,3/28/2018 23:25,28,42,37,31,138,4,50
1014,3/28/2018 23:30,25,47,46,39,157,4,50
1015,3/28/2018 23:35,29,31,35,29,124,4,50
1016,3/28/2018 23:40,29,47,41,35,152,4,50
1017,3/28/2018 23:45,31,36,44,37,148,4,50
1018,3/28/2018 23:50,30,41,33,27,131,4,50
1019,3/28/2018 23:55,13,33,32,27,105,4,50
1020,3/29/2018 0:00,13,23,25,19,80,4,50
1021,3/29/2018 0:05,22,24,31,25,102,4,50
1022,3/29/2018 0:10,16,34,33,27,110,4,50
1023,3/29/2018 0:15,16,28,26,21,91,4,50
1024,3/29/2018 0:20,19,32,24,19,94,4,50
1025,3/29/2018 0:25,19,28,29,23,99,4,50
1026,3/29/2018 0:30,18,24,25,19,86,4,50
1027,3/29/2018 0:35,18,25,21,16,80,4,50
1028,3/29/2018 0:40,13,18,22,17,70,4,50
1029,3/29/2018 0:45,14,21,29,23,87,4,50
1030,3/29/2018 0:50,14,27,20,15,76,4,50
1031,3/29/2018 0:55,13,17,21,15,66,4,50
1032,3/29/2018 1:00,4,16,17,11,48,4,50
1033,3/29/2018 1:05,15,22,16,10,63,4,50
1034,3/29/2018 1:10,15,13,21,16,65,4,50
1035,3/29/2018 1:15,10,24,17,11,62,4,50
1036,3/29/2018 1:20,8,19,21,15,63,4,50
1037,3/29/2018 1:25,11,16,17,12,56,4,50
1038,3/29/2018 1:30,15,19,19,14,67,4,50
1039,3/29/2018 1:35,9,20,13,8,50,4,50
1040,3/29/2018 1:40,8,13,19,14,54,4,50
1041,3/29/2018 1:45,6,28,15,10,59,4,50
1042,3/29/2018 1:50,12,23,17,12,64,4,50
1043,3/29/2018 1:55,3,12,14,9,38,4,50
1044,3/29/2018 2:00,7,12,15,9,43,4,50
1045,3/29/2018 2:05,8,16,15,10,49,4,50
1046,3/29/2018 2:10,8,15,15,9,47,4,50
1047,3/29/2018 2:15,9,11,16,11,47,4,50
1048,3/29/2018 2:20,8,22,21,15,66,4,50
1049,3/29/2018 2:25,8,9,17,11,45,4,50
1050,3/29/2018 2:30,18,14,15,9,56,4,50
1051,3/29/2018 2:35,12,16,15,10,53,4,50
1052,3/29/2018 2:40,11,16,18,13,58,4,50
1053,3/29/2018 2:45,8,11,15,10,44,4,50
1054,3/29/2018 2:50,13,13,15,10,51,4,50
1055,3/29/2018 2:55,3,11,16,11,41,4,50
1056,3/29/2018 3:00,14,15,15,9,53,4,50
1057,3/29/2018 3:05,8,16,13,8,45,4,50
1058,3/29/2018 3:10,6,20,20,14,60,4,50
1059,3/29/2018 3:15,6,13,13,8,40,4,50
1060,3/29/2018 3:20,13,14,18,13,58,4,50
1061,3/29/2018 3:25,7,19,22,16,64,4,50
1062,3/29/2018 3:30,12,17,19,13,61,4,50
1063,3/29/2018 3:35,14,29,23,18,84,4,50
1064,3/29/2018 3:40,15,32,18,13,78,4,50
1065,3/29/2018 3:45,14,24,24,19,81,4,50
1066,3/29/2018 3:50,11,26,21,16,74,4,50
1067,3/29/2018 3:55,12,19,29,23,83,4,50
1068,3/29/2018 4:00,15,24,17,12,68,4,50
1069,3/29/2018 4:05,17,28,27,22,94,4,50
1070,3/29/2018 4:10,24,26,28,22,100,4,50
1071,3/29/2018 4:15,30,40,34,28,132,4,50
1072,3/29/2018 4:20,33,28,34,28,123,4,50
1073,3/29/2018 4:25,36,49,40,34,159,4,50
1074,3/29/2018 4:30,44,50,39,33,166,4,50
1075,3/29/2018 4:35,46,46,49,42,183,4,50
1076,3/29/2018 4:40,46,47,45,38,176,4,50
1077,3/29/2018 4:45,53,56,46,40,195,4,50
1078,3/29/2018 4:50,40,60,53,46,199,4,50
1079,3/29/2018 4:55,66,63,45,38,212,4,50
1080,3/29/2018 5:00,58,55,49,42,204,4,50
1081,3/29/2018 5:05,59,66,53,46,224,4,50
1082,3/29/2018 5:10,68,76,60,53,257,4,50
1083,3/29/2018 5:15,87,82,72,64,305,4,50
1084,3/29/2018 5:20,94,75,69,61,299,4,50
1085,3/29/2018 5:25,89,94,81,73,337,4,50
1086,3/29/2018 5:30,111,99,82,73,365,4,50
1087,3/29/2018 5:35,115,94,77,69,355,4,50
1088,3/29/2018 5:40,116,97,82,73,368,4,50
1089,3/29/2018 5:45,127,110,97,88,422,4,50
1090,3/29/2018 5:50,122,106,86,77,391,4,50
1091,3/29/2018 5:55,137,125,102,92,456,4,50
1092,3/29/2018 6:00,111,106,90,81,388,4,50
1093,3/29/2018 6:05,128,112,77,68,385,4,50
1094,3/29/2018 6:10,132,112,93,84,421,4,50
1095,3/29/2018 6:15,124,107,81,73,385,4,50
1096,3/29/2018 6:20,118,110,97,88,413,4,50
1097,3/29/2018 6:25,132,118,93,84,427,4,50
1098,3/29/2018 6:30,139,126,98,89,452,4,50
1099,3/29/2018 6:35,125,111,87,78,401,4,50
1100,3/29/2018 6:40,153,123,93,84,453,4,50
1101,3/29/2018 6:45,149,131,101,92,473,4,50
1102,3/29/2018 6:50,160,127,88,79,454,4,50
1103,3/29/2018 6:55,146,124,104,94,468,4,50
1104,3/29/2018 7:00,149,137,94,85,465,4,50
1105,3/29/2018 7:05,155,131,98,88,472,4,50
1106,3/29/2018 7:10,141,141,99,90,471,4,50
1107,3/29/2018 7:15,129,106,94,85,414,4,50
1108,3/29/2018 7:20,154,142,105,95,496,4,50
1109,3/29/2018 7:25,164,137,116,105,522,4,50
1110,3/29/2018 7:30,143,138,112,102,495,4,50
1111,3/29/2018 7:35,138,143,112,102,495,4,50
1112,3/29/2018 7:40,149,145,111,101,506,4,50
1113,3/29/2018 7:45,144,136,112,101,493,4,50
1114,3/29/2018 7:50,148,142,97,88,475,4,50
1115,3/29/2018 7:55,128,128,106,96,458,4,50
1116,3/29/2018 8:00,129,123,93,84,429,4,50
1117,3/29/2018 8:05,143,127,95,86,451,4,50
1118,3/29/2018 8:10,130,120,88,79,417,4,50
1119,3/29/2018 8:15,147,136,95,86,464,4,50
1120,3/29/2018 8:20,151,132,89,80,452,4,50
1121,3/29/2018 8:25,156,138,92,83,469,4,50
1122,3/29/2018 8:30,138,133,82,74,427,4,50
1123,3/29/2018 8:35,128,126,87,78,419,4,50
1124,3/29/2018 8:40,132,116,90,81,419,4,50
1125,3/29/2018 8:45,123,130,93,84,430,4,50
1126,3/29/2018 8:50,118,126,94,85,423,4,50
1127,3/29/2018 8:55,124,114,90,81,409,4,50
1128,3/29/2018 9:00,128,131,88,79,426,4,50
1129,3/29/2018 9:05,128,119,89,81,417,4,50
1130,3/29/2018 9:10,135,110,89,80,414,4,50
1131,3/29/2018 9:15,109,136,92,83,420,4,50
1132,3/29/2018 9:20,118,114,81,73,386,4,50
1133,3/29/2018 9:25,124,115,90,81,410,4,50
1134,3/29/2018 9:30,133,130,85,77,425,4,50
1135,3/29/2018 9:35,128,112,96,86,422,4,50
1136,3/29/2018 9:40,120,119,89,80,408,4,50
1137,3/29/2018 9:45,105,115,95,86,401,4,50
1138,3/29/2018 9:50,113,100,88,79,380,4,50
1139,3/29/2018 9:55,120,95,87,78,380,4,50
1140,3/29/2018 10:00,107,106,77,68,358,4,50
1141,3/29/2018 10:05,118,103,75,67,363,4,50
1142,3/29/2018 10:10,124,114,77,68,383,4,50
1143,3/29/2018 10:15,115,96,87,78,376,4,50
1144,3/29/2018 10:20,124,120,94,85,423,4,50
1145,3/29/2018 10:25,136,127,97,87,447,4,50
1146,3/29/2018 10:30,111,121,91,82,405,4,50
1147,3/29/2018 10:35,132,122,89,80,423,4,50
1148,3/29/2018 10:40,121,120,89,80,410,4,50
1149,3/29/2018 10:45,139,119,87,78,423,4,50
1150,3/29/2018 10:50,123,119,93,84,419,4,50
1151,3/29/2018 10:55,125,128,83,75,411,4,50
1152,3/29/2018 11:00,116,118,90,81,405,4,50
1153,3/29/2018 11:05,102,100,87,78,367,4,50
1154,3/29/2018 11:10,128,118,85,76,407,4,50
1155,3/29/2018 11:15,100,99,89,81,369,4,50
1156,3/29/2018 11:20,111,116,70,62,359,4,50
1157,3/29/2018 11:25,102,109,82,73,366,4,50
1158,3/29/2018 11:30,103,97,85,77,362,4,50
1159,3/29/2018 11:35,106,124,81,73,384,4,50
1160,3/29/2018 11:40,124,126,96,86,432,4,50
1161,3/29/2018 11:45,128,112,99,89,428,4,50
1162,3/29/2018 11:50,119,112,72,63,366,4,50
1163,3/29/2018 11:55,120,118,99,89,426,4,50
1164,3/29/2018 12:00,121,127,78,70,396,4,50
1165,3/29/2018 12:05,108,109,81,73,371,4,50
1166,3/29/2018 12:10,116,116,82,73,387,4,50
1167,3/29/2018 12:15,130,117,97,87,431,4,50
1168,3/29/2018 12:20,114,116,89,80,399,4,50
1169,3/29/2018 12:25,125,121,95,86,427,4,50
1170,3/29/2018 12:30,124,112,85,76,397,4,50
1171,3/29/2018 12:35,120,106,82,74,382,4,50
1172,3/29/2018 12:40,121,124,75,67,387,4,50
1173,3/29/2018 12:45,117,102,91,82,392,4,50
1174,3/29/2018 12:50,119,118,84,75,396,4,50
1175,3/29/2018 12:55,117,106,94,85,402,4,50
1176,3/29/2018 13:00,109,113,94,85,401,4,50
1177,3/29/2018 13:05,113,108,93,84,398,4,50
1178,3/29/2018 13:10,108,113,94,85,400,4,50
1179,3/29/2018 13:15,114,119,91,82,406,4,50
1180,3/29/2018 13:20,111,114,88,79,392,4,50
1181,3/29/2018 13:25,116,117,85,77,395,4,50
1182,3/29/2018 13:30,128,117,98,88,431,4,50
1183,3/29/2018 13:35,124,123,92,83,422,4,50
1184,3/29/2018 13:40,124,122,97,88,431,4,50
1185,3/29/2018 13:45,126,127,97,88,438,4,50
1186,3/29/2018 13:50,122,133,99,90,444,4,50
1187,3/29/2018 13:55,140,121,105,95,461,4,50
1188,3/29/2018 14:00,143,123,96,86,448,4,50
1189,3/29/2018 14:05,144,124,91,82,441,4,50
1190,3/29/2018 14:10,124,119,95,86,424,4,50
1191,3/29/2018 14:15,139,127,97,88,451,4,50
1192,3/29/2018 14:20,138,131,101,91,461,4,50
1193,3/29/2018 14:25,137,125,88,79,429,4,50
1194,3/29/2018 14:30,153,128,93,84,458,4,50
1195,3/29/2018 14:35,147,130,104,94,475,4,50
1196,3/29/2018 14:40,141,137,103,93,474,4,50
1197,3/29/2018 14:45,131,132,109,99,471,4,50
1198,3/29/2018 14:50,138,124,98,89,449,4,50
1199,3/29/2018 14:55,143,141,103,93,480,4,50
1200,3/29/2018 15:00,149,136,104,94,483,4,50
1201,3/29/2018 15:05,154,138,115,105,512,4,50
1202,3/29/2018 15:10,147,141,113,103,504,4,50
1203,3/29/2018 15:15,142,144,104,94,484,4,50
1204,3/29/2018 15:20,150,138,100,90,478,4,50
1205,3/29/2018 15:25,143,145,90,81,459,4,50
1206,3/29/2018 15:30,163,138,111,102,514,4,50
1207,3/29/2018 15:35,132,127,101,92,452,4,50
1208,3/29/2018 15:40,161,139,110,100,510,4,50
1209,3/29/2018 15:45,131,129,107,98,465,4,50
1210,3/29/2018 15:50,147,127,105,96,475,4,50
1211,3/29/2018 15:55,139,116,102,92,449,4,50
1212,3/29/2018 16:00,143,121,102,93,459,4,50
1213,3/29/2018 16:05,139,129,99,90,457,4,50
1214,3/29/2018 16:10,148,143,109,100,500,4,50
1215,3/29/2018 16:15,169,143,116,105,533,4,50
1216,3/29/2018 16:20,145,136,105,95,481,4,50
1217,3/29/2018 16:25,151,131,103,93,478,4,50
1218,3/29/2018 16:30,150,125,107,98,480,4,50
1219,3/29/2018 16:35,151,138,106,96,491,4,50
1220,3/29/2018 16:40,144,139,118,108,509,4,50
1221,3/29/2018 16:45,148,140,112,102,502,4,50
1222,3/29/2018 16:50,140,123,107,97,467,4,50
1223,3/29/2018 16:55,151,137,116,105,509,4,50
1224,3/29/2018 17:00,150,144,110,100,504,4,50
1225,3/29/2018 17:05,140,157,120,109,526,4,50
1226,3/29/2018 17:10,151,144,116,105,516,4,50
1227,3/29/2018 17:15,154,150,109,99,512,4,50
1228,3/29/2018 17:20,164,161,109,99,533,4,50
1229,3/29/2018 17:25,170,132,106,97,505,4,50
1230,3/29/2018 17:30,139,148,93,84,464,4,50
1231,3/29/2018 17:35,159,141,92,83,475,4,50
1232,3/29/2018 17:40,148,144,103,94,489,4,50
1233,3/29/2018 17:45,167,123,93,84,467,4,50
1234,3/29/2018 17:50,148,139,129,105,521,4,0
1235,3/29/2018 17:55,144,130,125,103,502,4,0
1236,3/29/2018 18:00,136,124,124,101,485,4,0
1237,3/29/2018 18:05,133,133,124,102,492,4,0
1238,3/29/2018 18:10,142,127,124,101,494,4,0
1239,3/29/2018 18:15,141,134,123,101,499,4,0
1240,3/29/2018 18:20,138,134,123,101,496,4,0
1241,3/29/2018 18:25,127,121,122,100,470,4,0
1242,3/29/2018 18:30,130,127,120,98,475,4,0
1243,3/29/2018 18:35,131,110,118,97,456,4,0
1244,3/29/2018 18:40,126,126,117,96,465,4,0
1245,3/29/2018 18:45,120,121,116,95,452,4,0
1246,3/29/2018 18:50,116,116,114,94,440,4,0
1247,3/29/2018 18:55,111,107,112,92,422,4,0
1248,3/29/2018 19:00,118,112,114,93,437,4,0
1249,3/29/2018 19:05,107,107,114,94,422,4,0
1250,3/29/2018 19:10,106,117,113,92,428,4,0
1251,3/29/2018 19:15,110,108,110,90,418,4,0
1252,3/29/2018 19:20,119,113,108,89,429,4,0
1253,3/29/2018 19:25,104,98,103,85,390,4,0
1254,3/29/2018 19:30,100,104,100,82,386,4,0
1255,3/29/2018 19:35,95,102,98,81,376,4,0
1256,3/29/2018 19:40,94,92,96,79,361,4,0
1257,3/29/2018 19:45,100,95,93,76,364,4,0
1258,3/29/2018 19:50,95,93,91,75,354,4,0
1259,3/29/2018 19:55,96,92,85,70,343,4,0
1260,3/29/2018 20:00,89,92,84,68,333,4,0
1261,3/29/2018 20:05,88,90,82,67,327,4,0
1262,3/29/2018 20:10,77,95,82,67,321,4,0
1263,3/29/2018 20:15,90,101,80,66,337,4,0
1264,3/29/2018 20:20,88,103,81,66,338,4,0
1265,3/29/2018 20:25,90,93,78,64,325,4,0
1266,3/29/2018 20:30,91,93,77,63,324,4,0
1267,3/29/2018 20:35,79,76,75,61,291,4,0
1268,3/29/2018 20:40,85,94,75,67,321,4,50
1269,3/29/2018 20:45,64,103,82,73,322,4,50
1270,3/29/2018 20:50,81,77,62,55,275,4,50
1271,3/29/2018 20:55,80,119,73,65,337,4,50
1272,3/29/2018 21:00,63,84,69,62,278,4,50
1273,3/29/2018 21:05,77,86,67,59,289,4,50
1274,3/29/2018 21:10,88,89,80,72,329,4,50
1275,3/29/2018 21:15,75,99,75,66,315,4,50
1276,3/29/2018 21:20,74,81,69,61,285,4,50
1277,3/29/2018 21:25,75,87,68,60,290,4,50
1278,3/29/2018 21:30,80,93,67,59,299,4,50
1279,3/29/2018 21:35,93,101,75,66,335,4,50
1280,3/29/2018 21:40,79,91,65,57,292,4,50
1281,3/29/2018 21:45,69,96,69,62,296,4,50
1282,3/29/2018 21:50,79,80,64,57,280,4,50
1283,3/29/2018 21:55,72,74,64,57,267,4,50
1284,3/29/2018 22:00,64,83,69,62,278,4,50
1285,3/29/2018 22:05,76,89,69,62,296,4,50
1286,3/29/2018 22:10,83,72,63,56,274,4,50
1287,3/29/2018 22:15,73,77,72,64,286,4,50
1288,3/29/2018 22:20,73,79,69,61,282,4,50
1289,3/29/2018 22:25,71,86,61,53,271,4,50
1290,3/29/2018 22:30,59,62,59,51,231,4,50
1291,3/29/2018 22:35,62,68,55,48,233,4,50
1292,3/29/2018 22:40,62,61,56,48,227,4,50
1293,3/29/2018 22:45,69,64,56,49,238,4,50
1294,3/29/2018 22:50,54,68,64,57,243,4,50
1295,3/29/2018 22:55,29,39,46,39,153,4,50
1296,3/29/2018 23:00,36,41,48,41,166,4,50
1297,3/29/2018 23:05,50,66,50,44,210,4,50
1298,3/29/2018 23:10,76,91,70,62,299,4,50
1299,3/29/2018 23:15,78,91,83,75,327,4,50
1300,3/29/2018 23:20,79,83,78,70,310,4,50
1301,3/29/2018 23:25,70,106,76,68,320,4,50
1302,3/29/2018 23:30,72,83,71,63,289,4,50
1303,3/29/2018 23:35,41,68,57,50,216,4,50
1304,3/29/2018 23:40,29,49,50,43,171,4,50
1305,3/29/2018 23:45,32,43,49,42,166,4,50
1306,3/29/2018 23:50,41,57,43,37,178,4,50
1307,3/29/2018 23:55,67,70,55,48,240,4,50
1308,3/30/2018 0:00,60,63,62,55,240,4,50
1309,3/30/2018 0:05,45,69,55,48,217,4,50
1310,3/30/2018 0:10,47,67,50,43,207,4,50
1311,3/30/2018 0:15,49,73,59,52,233,4,50
1312,3/30/2018 0:20,44,74,53,45,216,4,50
1313,3/30/2018 0:25,33,48,40,34,155,4,50
1314,3/30/2018 0:30,35,51,42,35,163,4,50
1315,3/30/2018 0:35,33,53,38,32,156,4,50
1316,3/30/2018 0:40,38,62,44,38,182,4,50
1317,3/30/2018 0:45,30,52,41,35,158,4,50
1318,3/30/2018 0:50,30,52,46,40,168,4,50
1319,3/30/2018 0:55,36,59,42,35,172,4,50
1320,3/30/2018 1:00,21,36,40,34,131,4,50
1321,3/30/2018 1:05,17,34,33,26,110,4,50
1322,3/30/2018 1:10,24,41,41,35,141,4,50
1323,3/30/2018 1:15,31,43,34,27,135,4,50
1324,3/30/2018 1:20,24,45,38,32,139,4,50
1325,3/30/2018 1:25,29,44,38,31,142,4,50
1326,3/30/2018 1:30,27,37,29,23,116,4,50
1327,3/30/2018 1:35,19,31,34,27,111,4,50
1328,3/30/2018 1:40,26,36,36,30,128,4,50
1329,3/30/2018 1:45,18,31,31,25,105,4,50
1330,3/30/2018 1:50,16,33,34,28,111,4,50
1331,3/30/2018 1:55,17,29,31,26,103,4,50
1332,3/30/2018 2:00,16,30,29,24,99,4,50
1333,3/30/2018 2:05,10,31,30,25,96,4,50
1334,3/30/2018 2:10,27,37,34,27,125,4,50
1335,3/30/2018 2:15,9,26,28,22,85,4,50
1336,3/30/2018 2:20,15,29,34,27,105,4,50
1337,3/30/2018 2:25,17,39,28,23,107,4,50
1338,3/30/2018 2:30,28,43,26,20,117,4,50
1339,3/30/2018 2:35,20,30,28,22,100,4,50
1340,3/30/2018 2:40,20,33,30,24,107,4,50
1341,3/30/2018 2:45,21,26,29,23,99,4,50
1342,3/30/2018 2:50,22,24,25,20,91,4,50
1343,3/30/2018 2:55,18,35,24,18,95,4,50
1344,3/30/2018 3:00,17,27,26,21,91,4,50
1345,3/30/2018 3:05,22,35,29,24,110,4,50
1346,3/30/2018 3:10,22,32,27,22,103,4,50
1347,3/30/2018 3:15,14,37,27,22,100,4,50
1348,3/30/2018 3:20,10,24,31,25,90,4,50
1349,3/30/2018 3:25,23,36,30,24,113,4,50
1350,3/30/2018 3:30,27,43,31,25,126,4,50
1351,3/30/2018 3:35,23,51,32,26,132,4,50
1352,3/30/2018 3:40,29,52,35,29,145,4,50
1353,3/30/2018 3:45,34,47,34,27,142,4,50
1354,3/30/2018 3:50,23,37,36,30,126,4,50
1355,3/30/2018 3:55,29,38,35,29,131,4,50
1356,3/30/2018 4:00,34,40,29,24,127,4,50
1357,3/30/2018 4:05,42,43,30,24,139,4,50
1358,3/30/2018 4:10,46,45,44,37,172,4,50
1359,3/30/2018 4:15,35,48,42,36,161,4,50
1360,3/30/2018 4:20,38,39,43,36,156,4,50
1361,3/30/2018 4:25,77,77,53,46,253,4,50
1362,3/30/2018 4:30,55,77,59,51,242,4,50
1363,3/30/2018 4:35,72,76,65,57,270,4,50
1364,3/30/2018 4:40,75,90,65,57,287,4,50
1365,3/30/2018 4:45,76,94,74,66,310,4,50
1366,3/30/2018 4:50,63,71,59,52,245,4,50
1367,3/30/2018 4:55,60,63,56,49,228,4,50
1368,3/30/2018 5:00,60,65,52,45,222,4,50
1369,3/30/2018 5:05,58,64,57,50,229,4,50
1370,3/30/2018 5:10,68,76,69,62,275,4,50
1371,3/30/2018 5:15,73,77,72,64,286,4,50
1372,3/30/2018 5:20,90,78,72,64,304,4,50
1373,3/30/2018 5:25,57,58,60,53,228,4,50
1374,3/30/2018 5:30,70,70,60,52,252,4,50
1375,3/30/2018 5:35,98,92,69,62,321,4,50
1376,3/30/2018 5:40,98,105,81,73,357,4,50
1377,3/30/2018 5:45,85,92,82,74,333,4,50
1378,3/30/2018 5:50,100,96,77,69,342,4,50
1379,3/30/2018 5:55,91,83,74,66,314,4,50
1380,3/30/2018 6:00,93,83,73,65,314,4,50
1381,3/30/2018 6:05,74,79,70,62,285,4,50
1382,3/30/2018 6:10,91,100,67,59,317,4,50
1383,3/30/2018 6:15,120,95,87,78,380,4,50
1384,3/30/2018 6:20,122,117,88,79,406,4,50
1385,3/30/2018 6:25,121,110,85,77,393,4,50
1386,3/30/2018 6:30,136,119,94,85,434,4,50
1387,3/30/2018 6:35,130,121,85,77,413,4,50
1388,3/30/2018 6:40,160,134,82,73,449,4,50
1389,3/30/2018 6:45,130,125,96,87,438,4,50
1390,3/30/2018 6:50,136,123,88,79,426,4,50
1391,3/30/2018 6:55,139,124,87,78,428,4,50
1392,3/30/2018 7:00,131,107,92,83,413,4,50
1393,3/30/2018 7:05,142,124,85,77,428,4,50
1394,3/30/2018 7:10,146,128,94,85,453,4,50
1395,3/30/2018 7:15,139,118,100,91,448,4,50
1396,3/30/2018 7:20,126,119,81,73,399,4,50
1397,3/30/2018 7:25,136,117,92,83,428,4,50
1398,3/30/2018 7:30,137,131,99,90,457,4,50
1399,3/30/2018 7:35,147,138,108,98,491,4,50
1400,3/30/2018 7:40,127,133,106,97,463,4,50
1401,3/30/2018 7:45,135,136,89,80,440,4,50
1402,3/30/2018 7:50,141,130,110,100,481,4,50
1403,3/30/2018 7:55,133,131,89,80,433,4,50
1404,3/30/2018 8:00,117,116,93,84,410,4,50
1405,3/30/2018 8:05,119,124,97,88,428,4,50
1406,3/30/2018 8:10,118,120,89,80,407,4,50
1407,3/30/2018 8:15,122,125,101,92,440,4,50
1408,3/30/2018 8:20,128,122,96,86,432,4,50
1409,3/30/2018 8:25,117,116,92,83,408,4,50
1410,3/30/2018 8:30,120,112,82,73,387,4,50
1411,3/30/2018 8:35,128,109,84,75,396,4,50
1412,3/30/2018 8:40,126,123,97,88,434,4,50
1413,3/30/2018 8:45,126,124,96,86,432,4,50
1414,3/30/2018 8:50,126,131,99,89,445,4,50
1415,3/30/2018 8:55,115,127,91,82,415,4,50
1416,3/30/2018 9:00,122,100,81,73,376,4,50
1417,3/30/2018 9:05,126,119,80,72,397,4,50
1418,3/30/2018 9:10,109,113,72,64,358,4,50
1419,3/30/2018 9:15,108,104,82,74,368,4,50
1420,3/30/2018 9:20,128,114,90,81,413,4,50
1421,3/30/2018 9:25,112,116,73,65,366,4,50
1422,3/30/2018 9:30,117,110,83,75,385,4,50
1423,3/30/2018 9:35,134,125,87,78,424,4,50
1424,3/30/2018 9:40,126,118,95,86,425,4,50
1425,3/30/2018 9:45,129,124,96,87,436,4,50
1426,3/30/2018 9:50,127,114,93,84,418,4,50
1427,3/30/2018 9:55,103,112,76,68,359,4,50
1428,3/30/2018 10:00,111,111,85,77,384,4,50
1429,3/30/2018 10:05,116,131,72,64,383,4,50
1430,3/30/2018 10:10,119,122,82,73,396,4,50
1431,3/30/2018 10:15,126,117,89,80,412,4,50
1432,3/30/2018 10:20,117,123,96,86,422,4,50
1433,3/30/2018 10:25,133,122,100,90,445,4,50
1434,3/30/2018 10:30,141,124,89,80,434,4,50
1435,3/30/2018 10:35,130,122,95,86,433,4,50
1436,3/30/2018 10:40,107,117,98,89,411,4,50
1437,3/30/2018 10:45,126,132,96,87,441,4,50
1438,3/30/2018 10:50,132,120,98,89,439,4,50
1439,3/30/2018 10:55,116,113,93,84,406,4,50
1440,3/30/2018 11:00,115,117,94,85,411,4,50
1441,3/30/2018 11:05,124,114,85,76,399,4,50
1442,3/30/2018 11:10,110,112,93,84,399,4,50
1443,3/30/2018 11:15,114,114,97,88,413,4,50
1444,3/30/2018 11:20,108,117,86,77,388,4,50
1445,3/30/2018 11:25,109,126,96,87,418,4,50
1446,3/30/2018 11:30,131,136,92,83,442,4,50
1447,3/30/2018 11:35,124,113,94,85,416,4,50
1448,3/30/2018 11:40,129,127,99,89,444,4,50
1449,3/30/2018 11:45,118,140,97,88,443,4,50
1450,3/30/2018 11:50,127,129,104,94,454,4,50
1451,3/30/2018 11:55,134,122,101,91,448,4,50
1452,3/30/2018 12:00,138,123,98,88,447,4,50
1453,3/30/2018 12:05,138,136,89,80,443,4,50
1454,3/30/2018 12:10,138,127,89,80,434,4,50
1455,3/30/2018 12:15,133,132,86,77,428,4,50
1456,3/30/2018 12:20,146,134,93,84,457,4,50
1457,3/30/2018 12:25,148,133,85,76,442,4,50
1458,3/30/2018 12:30,109,114,78,70,371,4,50
1459,3/30/2018 12:35,124,123,80,71,398,4,50
1460,3/30/2018 12:40,112,114,86,77,389,4,50
1461,3/30/2018 12:45,134,126,92,83,435,4,50
1462,3/30/2018 12:50,137,128,90,81,436,4,50
1463,3/30/2018 12:55,126,131,108,98,463,4,50
1464,3/30/2018 13:00,136,131,96,87,450,4,50
1465,3/30/2018 13:05,124,118,82,73,397,4,50
1466,3/30/2018 13:10,121,120,94,85,420,4,50
1467,3/30/2018 13:15,133,129,85,77,424,4,50
1468,3/30/2018 13:20,121,115,101,92,429,4,50
1469,3/30/2018 13:25,129,128,110,100,467,4,50
1470,3/30/2018 13:30,129,128,102,92,451,4,50
1471,3/30/2018 13:35,124,125,106,96,451,4,50
1472,3/30/2018 13:40,132,124,96,86,438,4,50
1473,3/30/2018 13:45,118,117,83,74,392,4,50
1474,3/30/2018 13:50,127,116,89,80,412,4,50
1475,3/30/2018 13:55,133,121,101,91,446,4,50
1476,3/30/2018 14:00,121,109,97,87,414,4,50
1477,3/30/2018 14:05,121,129,102,92,444,4,50
1478,3/30/2018 14:10,144,128,97,88,457,4,50
1479,3/30/2018 14:15,101,106,86,77,370,4,50
1480,3/30/2018 14:20,133,118,90,81,422,4,50
1481,3/30/2018 14:25,130,128,88,79,425,4,50
1482,3/30/2018 14:30,133,124,96,86,439,4,50
1483,3/30/2018 14:35,137,127,101,91,456,4,50
1484,3/30/2018 14:40,137,140,104,94,475,4,50
1485,3/30/2018 14:45,143,148,111,101,503,4,50
1486,3/30/2018 14:50,124,130,98,89,441,4,50
1487,3/30/2018 14:55,130,131,97,88,446,4,50
1488,3/30/2018 15:00,146,117,101,91,455,4,50
1489,3/30/2018 15:05,133,128,107,98,466,4,50
1490,3/30/2018 15:10,143,137,108,98,486,4,50
1491,3/30/2018 15:15,153,137,99,90,479,4,50
1492,3/30/2018 15:20,133,120,104,95,452,4,50
1493,3/30/2018 15:25,154,148,119,108,529,4,50
1494,3/30/2018 15:30,166,154,102,92,514,4,50
1495,3/30/2018 15:35,142,132,108,98,480,4,50
1496,3/30/2018 15:40,149,134,114,104,501,4,50
1497,3/30/2018 15:45,148,124,107,98,477,4,50
1498,3/30/2018 15:50,140,142,110,100,492,4,50
1499,3/30/2018 15:55,141,118,103,94,456,4,50
1500,3/30/2018 16:00,124,121,105,96,446,4,50
1501,3/30/2018 16:05,165,145,109,99,518,4,50
1502,3/30/2018 16:10,149,136,111,101,497,4,50
1503,3/30/2018 16:15,143,136,109,99,487,4,50
1504,3/30/2018 16:20,119,123,107,97,446,4,50
1505,3/30/2018 16:25,147,134,112,102,495,4,50
1506,3/30/2018 16:30,146,138,117,106,507,4,50
1507,3/30/2018 16:35,129,126,101,91,447,4,50
1508,3/30/2018 16:40,143,136,109,99,487,4,50
1509,3/30/2018 16:45,154,150,116,105,525,4,50
1510,3/30/2018 16:50,134,120,104,95,453,4,50
1511,3/30/2018 16:55,144,146,103,93,486,4,50
1512,3/30/2018 17:00,160,145,103,93,501,4,50
1513,3/30/2018 17:05,140,141,111,101,493,4,50
1514,3/30/2018 17:10,148,127,95,86,456,4,50
1515,3/30/2018 17:15,147,139,117,107,510,4,50
1516,3/30/2018 17:20,132,129,104,94,459,4,50
1517,3/30/2018 17:25,147,133,114,104,498,4,50
1518,3/30/2018 17:30,151,133,108,98,490,4,50
1519,3/30/2018 17:35,138,118,102,92,450,4,50
1520,3/30/2018 17:40,144,140,96,86,466,4,50
1521,3/30/2018 17:45,141,144,105,95,485,4,50
1522,3/30/2018 17:50,140,135,110,100,485,4,50
1523,3/30/2018 17:55,135,136,116,106,493,4,50
1524,3/30/2018 18:00,144,128,102,93,467,4,50
1525,3/30/2018 18:05,127,131,110,100,468,4,50
1526,3/30/2018 18:10,122,124,107,98,451,4,50
1527,3/30/2018 18:15,123,133,110,100,466,4,50
1528,3/30/2018 18:20,136,136,91,82,445,4,50
1529,3/30/2018 18:25,128,124,101,91,444,4,50
1530,3/30/2018 18:30,122,131,102,92,447,4,50
1531,3/30/2018 18:35,120,110,97,88,415,4,50
1532,3/30/2018 18:40,133,123,87,78,421,4,50
1533,3/30/2018 18:45,109,116,99,90,414,4,50
1534,3/30/2018 18:50,119,103,92,83,397,4,50
1535,3/30/2018 18:55,96,112,82,73,363,4,50
1536,3/30/2018 19:00,93,100,84,75,352,4,50
1537,3/30/2018 19:05,91,90,83,74,338,4,50
1538,3/30/2018 19:10,100,95,81,72,348,4,50
1539,3/30/2018 19:15,95,110,80,71,356,4,50
1540,3/30/2018 19:20,102,111,77,68,358,4,50
1541,3/30/2018 19:25,94,120,95,86,395,4,50
1542,3/30/2018 19:30,101,103,84,76,364,4,50
1543,3/30/2018 19:35,91,109,93,84,377,4,50
1544,3/30/2018 19:40,96,94,85,77,352,4,50
1545,3/30/2018 19:45,81,93,81,72,327,4,50
1546,3/30/2018 19:50,85,95,65,57,302,4,50
1547,3/30/2018 19:55,80,76,73,65,294,4,50
1548,3/30/2018 20:00,75,92,76,68,311,4,50
1549,3/30/2018 20:05,78,100,79,70,327,4,50
1550,3/30/2018 20:10,75,85,79,70,309,4,50
1551,3/30/2018 20:15,79,92,75,67,313,4,50
1552,3/30/2018 20:20,82,96,80,72,330,4,50
1553,3/30/2018 20:25,97,100,80,72,349,4,50
1554,3/30/2018 20:30,68,91,80,72,311,4,50
1555,3/30/2018 20:35,78,81,71,63,293,4,50
1556,3/30/2018 20:40,67,77,61,53,258,4,50
1557,3/30/2018 20:45,72,90,67,60,289,4,50
1558,3/30/2018 20:50,78,102,82,74,336,4,50
1559,3/30/2018 20:55,80,83,76,67,306,4,50
1560,3/30/2018 21:00,71,89,68,60,288,4,50
1561,3/30/2018 21:05,63,83,64,57,267,4,50
1562,3/30/2018 21:10,55,80,66,58,259,4,50
1563,3/30/2018 21:15,76,76,64,57,273,4,50
1564,3/30/2018 21:20,76,78,71,63,288,4,50
1565,3/30/2018 21:25,65,67,64,56,252,4,50
1566,3/30/2018 21:30,69,80,69,62,280,4,50
1567,3/30/2018 21:35,74,91,73,65,303,4,50
1568,3/30/2018 21:40,64,59,61,53,237,4,50
1569,3/30/2018 21:45,68,83,69,61,281,4,50
1570,3/30/2018 21:50,72,60,60,52,244,4,50
1571,3/30/2018 21:55,63,80,62,55,260,4,50
1572,3/30/2018 22:00,74,71,60,53,258,4,50
1573,3/30/2018 22:05,56,84,62,54,256,4,50
1574,3/30/2018 22:10,62,75,61,53,251,4,50
1575,3/30/2018 22:15,70,68,64,57,259,4,50
1576,3/30/2018 22:20,75,85,62,54,276,4,50
1577,3/30/2018 22:25,83,93,70,62,308,4,50
1578,3/30/2018 22:30,77,78,67,59,281,4,50
1579,3/30/2018 22:35,64,62,59,51,236,4,50
1580,3/30/2018 22:40,56,66,55,48,225,4,50
1581,3/30/2018 22:45,55,81,62,54,252,4,50
1582,3/30/2018 22:50,63,70,62,55,250,4,50
1583,3/30/2018 22:55,69,71,63,55,258,4,50
1584,3/30/2018 23:00,52,68,54,47,221,4,50
1585,3/30/2018 23:05,44,57,59,52,212,4,50
1586,3/30/2018 23:10,39,63,59,51,212,4,50
1587,3/30/2018 23:15,53,72,61,53,239,4,50
1588,3/30/2018 23:20,62,71,55,48,236,4,50
1589,3/30/2018 23:25,51,61,57,49,218,4,50
1590,3/30/2018 23:30,42,63,56,48,209,4,50
1591,3/30/2018 23:35,53,51,53,46,203,4,50
1592,3/30/2018 23:40,40,63,54,47,204,4,50
1593,3/30/2018 23:45,33,49,54,46,182,4,50
1594,3/30/2018 23:50,36,66,56,49,207,4,50
1595,3/30/2018 23:55,50,68,50,43,211,4,50
1596,3/31/2018 0:00,47,84,64,56,251,4,50
1597,3/31/2018 0:05,51,78,57,50,236,4,50
1598,3/31/2018 0:10,31,38,45,39,153,4,50
1599,3/31/2018 0:15,21,33,40,34,128,4,50
1600,3/31/2018 0:20,25,42,45,38,150,4,50
1601,3/31/2018 0:25,27,38,40,33,138,4,50
1602,3/31/2018 0:30,21,36,36,30,123,4,50
1603,3/31/2018 0:35,19,34,42,35,130,4,50
1604,3/31/2018 0:40,24,34,41,34,133,4,50
1605,3/31/2018 0:45,20,46,37,31,134,4,50
1606,3/31/2018 0:50,22,44,43,36,145,4,50
1607,3/31/2018 0:55,30,27,38,31,126,4,50
1608,3/31/2018 1:00,22,28,29,23,102,4,50
1609,3/31/2018 1:05,22,33,27,22,104,4,50
1610,3/31/2018 1:10,12,29,28,23,92,4,50
1611,3/31/2018 1:15,24,29,27,21,101,4,50
1612,3/31/2018 1:20,14,24,28,22,88,4,50
1613,3/31/2018 1:25,22,31,24,18,95,4,50
1614,3/31/2018 1:30,16,28,29,24,97,4,50
1615,3/31/2018 1:35,20,22,33,26,101,4,50
1616,3/31/2018 1:40,23,33,25,20,101,4,50
1617,3/31/2018 1:45,9,27,21,16,73,4,50
1618,3/31/2018 1:50,20,28,21,16,85,4,50
1619,3/31/2018 1:55,11,20,26,21,78,4,50
1620,3/31/2018 2:00,14,24,22,16,76,4,50
1621,3/31/2018 2:05,16,21,24,19,80,4,50
1622,3/31/2018 2:10,18,34,22,16,90,4,50
1623,3/31/2018 2:15,18,25,23,17,83,4,50
1624,3/31/2018 2:20,7,27,21,16,71,4,50
1625,3/31/2018 2:25,16,18,24,18,76,4,50
1626,3/31/2018 2:30,21,23,21,16,81,4,50
1627,3/31/2018 2:35,17,23,23,18,81,4,50
1628,3/31/2018 2:40,17,18,21,16,72,4,50
1629,3/31/2018 2:45,4,12,22,17,55,4,50
1630,3/31/2018 2:50,10,13,19,14,56,4,50
1631,3/31/2018 2:55,11,16,15,10,52,4,50
1632,3/31/2018 3:00,13,23,23,18,77,4,50
1633,3/31/2018 3:05,8,15,15,10,48,4,50
1634,3/31/2018 3:10,10,10,17,11,48,4,50
1635,3/31/2018 3:15,12,17,20,15,64,4,50
1636,3/31/2018 3:20,11,12,19,14,56,4,50
1637,3/31/2018 3:25,5,17,20,15,57,4,50
1638,3/31/2018 3:30,9,15,20,15,59,4,50
1639,3/31/2018 3:35,11,14,23,17,65,4,50
1640,3/31/2018 3:40,6,16,20,15,57,4,50
1641,3/31/2018 3:45,9,13,15,9,46,4,50
1642,3/31/2018 3:50,13,15,22,17,67,4,50
1643,3/31/2018 3:55,10,18,20,15,63,4,50
1644,3/31/2018 4:00,11,18,20,15,64,4,50
1645,3/31/2018 4:05,10,16,19,14,59,4,50
1646,3/31/2018 4:10,17,21,19,14,71,4,50
1647,3/31/2018 4:15,10,18,18,13,59,4,50
1648,3/31/2018 4:20,17,17,15,10,59,4,50
1649,3/31/2018 4:25,9,21,20,14,64,4,50
1650,3/31/2018 4:30,9,23,19,14,65,4,50
1651,3/31/2018 4:35,16,27,22,17,82,4,50
1652,3/31/2018 4:40,22,26,22,17,87,4,50
1653,3/31/2018 4:45,16,26,22,17,81,4,50
1654,3/31/2018 4:50,22,22,21,16,81,4,50
1655,3/31/2018 4:55,21,22,25,19,87,4,50
1656,3/31/2018 5:00,14,30,22,16,82,4,50
1657,3/31/2018 5:05,24,39,25,20,108,4,50
1658,3/31/2018 5:10,26,36,29,23,114,4,50
1659,3/31/2018 5:15,21,32,28,23,104,4,50
1660,3/31/2018 5:20,27,31,27,21,106,4,50
1661,3/31/2018 5:25,28,44,34,27,133,4,50
1662,3/31/2018 5:30,29,41,32,27,129,4,50
1663,3/31/2018 5:35,30,43,36,30,139,4,50
1664,3/31/2018 5:40,34,48,48,41,171,4,50
1665,3/31/2018 5:45,23,44,39,33,139,4,50
1666,3/31/2018 5:50,32,37,38,32,139,4,50
1667,3/31/2018 5:55,31,45,35,29,140,4,50
1668,3/31/2018 6:00,28,39,40,34,141,4,50
1669,3/31/2018 6:05,27,40,37,31,135,4,50
1670,3/31/2018 6:10,28,36,40,34,138,4,50
1671,3/31/2018 6:15,37,42,43,37,159,4,50
1672,3/31/2018 6:20,43,53,47,40,183,4,50
1673,3/31/2018 6:25,43,49,48,42,182,4,50
1674,3/31/2018 6:30,49,60,47,40,196,4,50
1675,3/31/2018 6:35,42,66,55,48,211,4,50
1676,3/31/2018 6:40,62,65,61,53,241,4,50
1677,3/31/2018 6:45,54,61,56,49,220,4,50
1678,3/31/2018 6:50,66,61,52,45,224,4,50
1679,3/31/2018 6:55,57,59,61,53,230,4,50
1680,3/31/2018 7:00,57,64,58,51,230,4,50
1681,3/31/2018 7:05,54,65,43,37,199,4,50
1682,3/31/2018 7:10,66,70,53,47,236,4,50
1683,3/31/2018 7:15,59,47,52,45,203,4,50
1684,3/31/2018 7:20,71,64,64,57,256,4,50
1685,3/31/2018 7:25,80,83,61,54,278,4,50
1686,3/31/2018 7:30,69,82,77,69,297,4,50
1687,3/31/2018 7:35,84,90,69,62,305,4,50
1688,3/31/2018 7:40,90,92,82,73,337,4,50
1689,3/31/2018 7:45,84,87,80,72,323,4,50
1690,3/31/2018 7:50,80,90,75,66,311,4,50
1691,3/31/2018 7:55,82,81,70,62,295,4,50
1692,3/31/2018 8:00,64,84,69,62,279,4,50
1693,3/31/2018 8:05,85,79,72,64,300,4,50
1694,3/31/2018 8:10,85,97,69,61,312,4,50
1695,3/31/2018 8:15,88,100,70,62,320,4,50
1696,3/31/2018 8:20,80,83,74,66,303,4,50
1697,3/31/2018 8:25,84,91,79,70,324,4,50
1698,3/31/2018 8:30,121,108,89,80,398,4,50
1699,3/31/2018 8:35,92,103,80,71,346,4,50
1700,3/31/2018 8:40,109,114,86,77,386,4,50
1701,3/31/2018 8:45,97,96,86,77,356,4,50
1702,3/31/2018 8:50,94,100,84,75,353,4,50
1703,3/31/2018 8:55,106,98,80,72,356,4,50
1704,3/31/2018 9:00,94,115,82,73,364,4,50
1705,3/31/2018 9:05,89,88,77,68,322,4,50
1706,3/31/2018 9:10,90,104,81,73,348,4,50
1707,3/31/2018 9:15,103,122,89,80,394,4,50
1708,3/31/2018 9:20,121,112,82,73,388,4,50
1709,3/31/2018 9:25,109,103,85,76,373,4,50
1710,3/31/2018 9:30,104,113,87,78,382,4,50
1711,3/31/2018 9:35,122,133,88,79,422,4,50
1712,3/31/2018 9:40,120,129,86,78,413,4,50
1713,3/31/2018 9:45,117,122,104,94,437,4,50
1714,3/31/2018 9:50,128,130,96,86,440,4,50
1715,3/31/2018 9:55,118,115,85,76,394,4,50
1716,3/31/2018 10:00,118,123,98,88,427,4,50
1717,3/31/2018 10:05,122,121,88,79,410,4,50
1718,3/31/2018 10:10,137,125,98,89,449,4,50
1719,3/31/2018 10:15,108,110,85,76,379,4,50
1720,3/31/2018 10:20,122,135,97,88,442,4,50
1721,3/31/2018 10:25,123,136,106,96,461,4,50
1722,3/31/2018 10:30,134,125,94,85,438,4,50
1723,3/31/2018 10:35,135,134,101,92,462,4,50
1724,3/31/2018 10:40,134,126,90,81,431,4,50
1725,3/31/2018 10:45,148,130,101,92,471,4,50
1726,3/31/2018 10:50,126,109,94,85,414,4,50
1727,3/31/2018 10:55,108,118,87,78,391,4,50
1728,3/31/2018 11:00,114,128,94,85,421,4,50
1729,3/31/2018 11:05,122,135,93,84,434,4,50
1730,3/31/2018 11:10,118,121,101,91,431,4,50
1731,3/31/2018 11:15,109,109,89,80,387,4,50
1732,3/31/2018 11:20,124,121,105,95,445,4,50
1733,3/31/2018 11:25,125,116,96,86,423,4,50
1734,3/31/2018 11:30,131,138,104,94,467,4,50
1735,3/31/2018 11:35,128,112,92,83,415,4,50
1736,3/31/2018 11:40,143,121,102,93,459,4,50
1737,3/31/2018 11:45,99,121,85,77,382,4,50
1738,3/31/2018 11:50,107,129,98,89,423,4,50
1739,3/31/2018 11:55,104,99,88,79,370,4,50
