,5 Minutes,Lane 1 Flow (Veh/5 Minutes),Lane 2 Flow (Veh/5 Minutes),Lane 3 Flow (Veh/5 Minutes),Lane 4 Flow (Veh/5 Minutes),Flow (Veh/5 Minutes),# Lane Points,% Observed
1275,3/23/2018 21:15,84,91,78,70,323,4,50
1276,3/23/2018 21:20,90,88,68,60,306,4,50
1277,3/23/2018 21:25,85,98,82,73,338,4,50
1278,3/23/2018 21:30,83,87,69,62,301,4,50
1279,3/23/2018 21:35,82,86,73,65,306,4,50
1280,3/23/2018 21:40,69,86,76,68,299,4,50
1281,3/23/2018 21:45,79,83,76,68,306,4,50
1282,3/23/2018 21:50,81,88,72,64,305,4,50
1283,3/23/2018 21:55,80,76,72,64,292,4,50
1284,3/23/2018 22:00,70,86,64,57,277,4,50
1285,3/23/2018 22:05,70,71,67,60,268,4,50
1286,3/23/2018 22:10,77,71,67,60,275,4,50
1287,3/23/2018 22:15,78,80,69,61,288,4,50
1288,3/23/2018 22:20,63,81,75,67,286,4,50
1289,3/23/2018 22:25,60,70,59,51,240,4,50
1290,3/23/2018 22:30,69,67,59,52,247,4,50
1291,3/23/2018 22:35,52,72,63,55,242,4,50
1292,3/23/2018 22:40,58,76,66,58,258,4,50
1293,3/23/2018 22:45,56,70,61,54,241,4,50
1294,3/23/2018 22:50,56,66,61,54,237,4,50
1295,3/23/2018 22:55,43,64,51,44,202,4,50
1296,3/23/2018 23:00,33,35,43,36,147,4,50
1297,3/23/2018 23:05,56,52,50,43,201,4,50
1298,3/23/2018 23:10,49,58,60,52,219,4,50
1299,3/23/2018 23:15,41,51,52,45,189,4,50
1300,3/23/2018 23:20,43,54,43,36,176,4,50
1301,3/23/2018 23:25,39,58,52,45,194,4,50
1302,3/23/2018 23:30,39,51,48,41,179,4,50
1303,3/23/2018 23:35,42,49,53,45,189,4,50
1304,3/23/2018 23:40,33,45,48,41,167,4,50
1305,3/23/2018 23:45,34,51,51,44,180,4,50
1306,3/23/2018 23:50,34,59,45,38,176,4,50
1307,3/23/2018 23:55,34,41,40,33,148,4,50
1308,3/24/2018 0:00,50,47,43,36,176,4,50
1309,3/24/2018 0:05,29,50,32,26,137,4,50
1310,3/24/2018 0:10,27,58,40,33,158,4,50
1311,3/24/2018 0:15,24,34,38,32,128,4,50
1312,3/24/2018 0:20,43,43,37,31,154,4,50
1313,3/24/2018 0:25,19,37,38,31,125,4,50
1314,3/24/2018 0:30,20,46,30,23,119,4,50
1315,3/24/2018 0:35,26,38,32,26,122,4,50
1316,3/24/2018 0:40,18,41,40,33,132,4,50
1317,3/24/2018 0:45,23,40,30,25,118,4,50
1318,3/24/2018 0:50,23,34,34,27,118,4,50
1319,3/24/2018 0:55,18,30,33,26,107,4,50
1320,3/24/2018 1:00,27,33,31,25,116,4,50
1321,3/24/2018 1:05,15,31,22,16,84,4,50
1322,3/24/2018 1:10,17,31,27,21,96,4,50
1323,3/24/2018 1:15,22,26,32,25,105,4,50
1324,3/24/2018 1:20,21,28,35,28,112,4,50
1325,3/24/2018 1:25,23,30,29,23,105,4,50
1326,3/24/2018 1:30,25,31,27,22,105,4,50
1327,3/24/2018 1:35,20,44,24,18,106,4,50
1328,3/24/2018 1:40,12,31,25,20,88,4,50
1329,3/24/2018 1:45,11,18,27,21,77,4,50
1330,3/24/2018 1:50,15,22,26,20,83,4,50
1331,3/24/2018 1:55,17,21,17,12,67,4,50
1332,3/24/2018 2:00,24,39,27,28,118,4,50
1333,3/24/2018 2:05,13,22,34,28,97,4,50
1334,3/24/2018 2:10,15,29,27,21,92,4,50
1335,3/24/2018 2:15,10,28,19,14,71,4,50
1336,3/24/2018 2:20,16,23,23,17,79,4,50
1337,3/24/2018 2:25,14,25,20,15,74,4,50
1338,3/24/2018 2:30,16,23,21,15,75,4,50
1339,3/24/2018 2:35,9,18,27,21,75,4,50
1340,3/24/2018 2:40,12,19,20,15,66,4,50
1341,3/24/2018 2:45,19,24,20,15,78,4,50
1342,3/24/2018 2:50,13,18,20,14,65,4,50
1343,3/24/2018 2:55,8,11,19,13,51,4,50
1344,3/24/2018 3:00,7,28,16,11,62,4,50
1345,3/24/2018 3:05,17,28,14,9,68,4,50
1346,3/24/2018 3:10,5,16,23,18,62,4,50
1347,3/24/2018 3:15,9,12,22,16,59,4,50
1348,3/24/2018 3:20,14,21,24,18,77,4,50
1349,3/24/2018 3:25,7,27,19,14,67,4,50
1350,3/24/2018 3:30,12,21,18,13,64,4,50
1351,3/24/2018 3:35,11,22,21,15,69,4,50
1352,3/24/2018 3:40,11,17,21,15,64,4,50
1353,3/24/2018 3:45,15,25,16,11,67,4,50
1354,3/24/2018 3:50,12,10,19,14,55,4,50
1355,3/24/2018 3:55,13,15,22,16,66,4,50
1356,3/24/2018 4:00,12,12,17,12,53,4,50
1357,3/24/2018 4:05,7,13,13,8,41,4,50
1358,3/24/2018 4:10,11,20,19,13,63,4,50
1359,3/24/2018 4:15,16,18,20,15,69,4,50
1360,3/24/2018 4:20,15,24,21,15,75,4,50
1361,3/24/2018 4:25,17,21,20,14,72,4,50
1362,3/24/2018 4:30,16,19,27,22,84,4,50
1363,3/24/2018 4:35,23,31,30,25,109,4,50
1364,3/24/2018 4:40,25,36,32,25,118,4,50
1365,3/24/2018 4:45,23,27,25,20,95,4,50
1366,3/24/2018 4:50,21,31,29,23,104,4,50
1367,3/24/2018 4:55,16,22,17,11,66,4,50
1368,3/24/2018 5:00,23,20,30,25,98,4,50
1369,3/24/2018 5:05,19,25,22,17,83,4,50
1370,3/24/2018 5:10,22,31,27,22,102,4,50
1371,3/24/2018 5:15,15,30,33,27,105,4,50
1372,3/24/2018 5:20,41,37,32,27,137,4,50
1373,3/24/2018 5:25,34,41,30,24,129,4,50
1374,3/24/2018 5:30,26,42,40,34,142,4,50
1375,3/24/2018 5:35,47,36,32,27,142,4,50
1376,3/24/2018 5:40,43,42,36,30,151,4,50
1377,3/24/2018 5:45,28,40,34,28,130,4,50
1378,3/24/2018 5:50,47,45,44,37,173,4,50
1379,3/24/2018 5:55,32,44,40,34,150,4,50
1380,3/24/2018 6:00,36,46,42,36,160,4,50
1381,3/24/2018 6:05,31,56,35,28,150,4,50
1382,3/24/2018 6:10,33,45,40,34,152,4,50
1383,3/24/2018 6:15,45,51,45,38,179,4,50
1384,3/24/2018 6:20,51,45,48,42,186,4,50
1385,3/24/2018 6:25,61,59,58,51,229,4,50
1386,3/24/2018 6:30,67,71,58,51,247,4,50
1387,3/24/2018 6:35,69,71,62,55,257,4,50
1388,3/24/2018 6:40,59,76,64,57,256,4,50
1389,3/24/2018 6:45,69,74,67,60,270,4,50
1390,3/24/2018 6:50,70,89,69,62,290,4,50
1391,3/24/2018 6:55,68,72,64,57,261,4,50
1392,3/24/2018 7:00,62,79,70,62,273,4,50
1393,3/24/2018 7:05,62,72,55,48,237,4,50
1394,3/24/2018 7:10,70,67,61,53,251,4,50
1395,3/24/2018 7:15,79,71,67,60,277,4,50
1396,3/24/2018 7:20,76,92,67,59,294,4,50
1397,3/24/2018 7:25,89,76,69,62,296,4,50
1398,3/24/2018 7:30,97,97,85,76,355,4,50
1399,3/24/2018 7:35,105,99,87,78,369,4,50
1400,3/24/2018 7:40,100,97,76,68,341,4,50
1401,3/24/2018 7:45,118,112,87,78,395,4,50
1402,3/24/2018 7:50,99,108,92,83,382,4,50
1403,3/24/2018 7:55,76,99,83,75,333,4,50
1404,3/24/2018 8:00,104,102,81,72,359,4,50
1405,3/24/2018 8:05,123,103,77,69,372,4,50
1406,3/24/2018 8:10,107,107,72,64,350,4,50
1407,3/24/2018 8:15,110,109,79,70,368,4,50
1408,3/24/2018 8:20,113,112,78,70,373,4,50
1409,3/24/2018 8:25,102,102,83,75,362,4,50
1410,3/24/2018 8:30,114,115,80,71,380,4,50
1411,3/24/2018 8:35,93,86,80,72,331,4,50
1412,3/24/2018 8:40,114,91,84,75,364,4,50
1413,3/24/2018 8:45,103,101,86,77,367,4,50
1414,3/24/2018 8:50,117,130,93,84,424,4,50
1415,3/24/2018 8:55,112,113,90,81,396,4,50
1416,3/24/2018 9:00,115,137,84,75,411,4,50
1417,3/24/2018 9:05,96,103,84,75,358,4,50
1418,3/24/2018 9:10,118,125,102,93,438,4,50
1419,3/24/2018 9:15,115,109,91,82,397,4,50
1420,3/24/2018 9:20,147,148,99,90,484,4,50
1421,3/24/2018 9:25,138,114,93,84,429,4,50
1422,3/24/2018 9:30,128,126,93,84,431,4,50
1423,3/24/2018 9:35,126,126,95,86,433,4,50
1424,3/24/2018 9:40,134,129,92,83,438,4,50
1425,3/24/2018 9:45,122,133,92,83,430,4,50
1426,3/24/2018 9:50,122,111,97,88,418,4,50
1427,3/24/2018 9:55,121,116,92,83,412,4,50
1428,3/24/2018 10:00,118,123,89,80,410,4,50
1429,3/24/2018 10:05,129,127,88,79,423,4,50
1430,3/24/2018 10:10,113,128,93,84,418,4,50
1431,3/24/2018 10:15,110,111,91,82,394,4,50
1432,3/24/2018 10:20,114,120,90,81,405,4,50
1433,3/24/2018 10:25,115,120,89,80,404,4,50
1434,3/24/2018 10:30,132,143,94,85,454,4,50
1435,3/24/2018 10:35,119,138,101,92,450,4,50
1436,3/24/2018 10:40,112,116,102,92,422,4,50
1437,3/24/2018 10:45,132,143,112,102,489,4,50
1438,3/24/2018 10:50,134,154,109,99,496,4,50
1439,3/24/2018 10:55,130,125,108,98,461,4,50
1440,3/24/2018 11:00,110,134,109,99,452,4,50
1441,3/24/2018 11:05,128,128,85,76,417,4,50
1442,3/24/2018 11:10,127,119,104,94,444,4,50
1443,3/24/2018 11:15,121,108,94,85,408,4,50
1444,3/24/2018 11:20,119,137,93,84,433,4,50
1445,3/24/2018 11:25,134,136,103,93,466,4,50
1446,3/24/2018 11:30,116,125,102,92,435,4,50
1447,3/24/2018 11:35,135,133,98,89,455,4,50
1448,3/24/2018 11:40,106,120,98,89,413,4,50
1449,3/24/2018 11:45,138,138,101,91,468,4,50
1450,3/24/2018 11:50,123,133,102,92,450,4,50
1451,3/24/2018 11:55,127,126,103,93,449,4,50
1452,3/24/2018 12:00,110,125,85,77,397,4,50
1453,3/24/2018 12:05,111,117,97,88,413,4,50
1454,3/24/2018 12:10,120,125,101,91,437,4,50
1455,3/24/2018 12:15,113,113,98,89,413,4,50
1456,3/24/2018 12:20,104,101,91,82,378,4,50
1457,3/24/2018 12:25,96,106,85,77,364,4,50
1458,3/24/2018 12:30,115,120,104,95,434,4,50
1459,3/24/2018 12:35,112,108,89,80,389,4,50
1460,3/24/2018 12:40,105,135,105,95,440,4,50
1461,3/24/2018 12:45,111,121,101,91,424,4,50
1462,3/24/2018 12:50,123,118,93,84,418,4,50
1463,3/24/2018 12:55,125,106,91,82,404,4,50
1464,3/24/2018 13:00,118,122,103,93,436,4,50
1465,3/24/2018 13:05,115,108,94,85,402,4,50
1466,3/24/2018 13:10,115,124,96,87,422,4,50
1467,3/24/2018 13:15,122,113,92,83,410,4,50
1468,3/24/2018 13:20,126,129,96,86,437,4,50
1469,3/24/2018 13:25,118,117,99,90,424,4,50
1470,3/24/2018 13:30,112,126,92,83,413,4,50
1471,3/24/2018 13:35,114,114,95,86,409,4,50
1472,3/24/2018 13:40,120,130,98,88,436,4,50
1473,3/24/2018 13:45,117,120,104,95,436,4,50
1474,3/24/2018 13:50,117,123,104,94,438,4,50
1475,3/24/2018 13:55,113,118,96,87,414,4,50
1476,3/24/2018 14:00,110,113,97,88,408,4,50
1477,3/24/2018 14:05,109,107,91,82,389,4,50
1478,3/24/2018 14:10,113,106,94,85,398,4,50
1479,3/24/2018 14:15,118,116,95,86,415,4,50
1480,3/24/2018 14:20,110,124,96,86,416,4,50
1481,3/24/2018 14:25,117,121,93,84,415,4,50
1482,3/24/2018 14:30,109,113,88,79,389,4,50
1483,3/24/2018 14:35,121,130,96,87,434,4,50
1484,3/24/2018 14:40,129,114,95,86,424,4,50
1485,3/24/2018 14:45,133,105,92,83,413,4,50
1486,3/24/2018 14:50,118,122,92,83,415,4,50
1487,3/24/2018 14:55,114,110,97,88,409,4,50
1488,3/24/2018 15:00,129,119,88,80,416,4,50
1489,3/24/2018 15:05,118,129,87,78,412,4,50
1490,3/24/2018 15:10,117,113,89,80,399,4,50
1491,3/24/2018 15:15,118,112,93,84,407,4,50
1492,3/24/2018 15:20,125,117,92,83,417,4,50
1493,3/24/2018 15:25,109,118,94,85,406,4,50
1494,3/24/2018 15:30,104,100,90,81,375,4,50
1495,3/24/2018 15:35,103,125,85,76,389,4,50
1496,3/24/2018 15:40,126,129,98,88,441,4,50
1497,3/24/2018 15:45,131,118,91,82,422,4,50
1498,3/24/2018 15:50,113,127,107,98,445,4,50
1499,3/24/2018 15:55,108,126,102,92,428,4,50
1500,3/24/2018 16:00,129,118,93,84,424,4,50
1501,3/24/2018 16:05,115,110,95,86,406,4,50
1502,3/24/2018 16:10,82,89,78,70,319,4,50
1503,3/24/2018 16:15,116,110,94,85,405,4,50
1504,3/24/2018 16:20,132,125,81,73,411,4,50
1505,3/24/2018 16:25,112,114,93,83,402,4,50
1506,3/24/2018 16:30,117,103,92,83,395,4,50
1507,3/24/2018 16:35,115,121,101,92,429,4,50
1508,3/24/2018 16:40,117,121,98,88,424,4,50
1509,3/24/2018 16:45,122,127,102,93,444,4,50
1510,3/24/2018 16:50,125,126,103,93,447,4,50
1511,3/24/2018 16:55,123,123,107,97,450,4,50
1512,3/24/2018 17:00,126,122,96,87,431,4,50
1513,3/24/2018 17:05,137,114,100,91,442,4,50
1514,3/24/2018 17:10,117,119,101,91,428,4,50
1515,3/24/2018 17:15,125,128,104,94,451,4,50
1516,3/24/2018 17:20,126,127,109,99,461,4,50
1517,3/24/2018 17:25,117,130,101,92,440,4,50
1518,3/24/2018 17:30,108,114,100,91,413,4,50
1519,3/24/2018 17:35,132,125,102,92,451,4,50
1520,3/24/2018 17:40,136,115,101,91,443,4,50
1521,3/24/2018 17:45,131,116,89,81,417,4,50
1522,3/24/2018 17:50,104,123,104,94,425,4,50
1523,3/24/2018 17:55,124,109,97,87,417,4,50
1524,3/24/2018 18:00,116,122,99,89,426,4,50
1525,3/24/2018 18:05,106,112,97,88,403,4,50
1526,3/24/2018 18:10,115,119,91,82,407,4,50
1527,3/24/2018 18:15,121,133,105,95,454,4,50
1528,3/24/2018 18:20,99,110,88,79,376,4,50
1529,3/24/2018 18:25,114,112,96,87,409,4,50
1530,3/24/2018 18:30,107,125,92,83,407,4,50
1531,3/24/2018 18:35,116,131,94,85,426,4,50
1532,3/24/2018 18:40,111,129,97,88,425,4,50
1533,3/24/2018 18:45,105,113,96,87,401,4,50
1534,3/24/2018 18:50,106,111,89,80,386,4,50
1535,3/24/2018 18:55,107,117,91,82,397,4,50
1536,3/24/2018 19:00,114,119,88,79,400,4,50
1537,3/24/2018 19:05,100,120,91,82,393,4,50
1538,3/24/2018 19:10,96,104,92,83,375,4,50
1539,3/24/2018 19:15,98,103,91,82,374,4,50
1540,3/24/2018 19:20,106,99,83,74,362,4,50
1541,3/24/2018 19:25,93,93,84,75,345,4,50
1542,3/24/2018 19:30,100,99,87,78,364,4,50
1543,3/24/2018 19:35,79,92,78,70,319,4,50
1544,3/24/2018 19:40,72,89,79,71,311,4,50
1545,3/24/2018 19:45,86,82,72,64,304,4,50
1546,3/24/2018 19:50,78,89,82,73,322,4,50
1547,3/24/2018 19:55,100,89,79,70,338,4,50
1548,3/24/2018 20:00,86,92,81,72,331,4,50
1549,3/24/2018 20:05,97,113,81,73,364,4,50
1550,3/24/2018 20:10,73,95,76,68,312,4,50
1551,3/24/2018 20:15,72,88,77,69,306,4,50
1552,3/24/2018 20:20,94,100,83,75,352,4,50
1553,3/24/2018 20:25,77,96,76,68,317,4,50
1554,3/24/2018 20:30,81,101,69,61,312,4,50
1555,3/24/2018 20:35,95,103,78,70,346,4,50
1556,3/24/2018 20:40,74,82,64,56,276,4,50
1557,3/24/2018 20:45,86,86,77,68,317,4,50
1558,3/24/2018 20:50,88,99,73,65,325,4,50
1559,3/24/2018 20:55,88,92,76,67,323,4,50
1560,3/24/2018 21:00,72,94,73,65,304,4,50
1561,3/24/2018 21:05,87,86,69,61,303,4,50
1562,3/24/2018 21:10,66,87,75,67,295,4,50
1563,3/24/2018 21:15,89,82,67,59,297,4,50
1564,3/24/2018 21:20,65,84,70,62,281,4,50
1565,3/24/2018 21:25,77,78,67,59,281,4,50
1566,3/24/2018 21:30,86,93,76,68,323,4,50
1567,3/24/2018 21:35,79,89,68,60,296,4,50
1568,3/24/2018 21:40,62,84,59,52,257,4,50
1569,3/24/2018 21:45,74,96,67,59,296,4,50
1570,3/24/2018 21:50,70,95,74,66,305,4,50
1571,3/24/2018 21:55,64,82,67,59,272,4,50
1572,3/24/2018 22:00,54,74,65,57,250,4,50
1573,3/24/2018 22:05,73,75,64,56,268,4,50
1574,3/24/2018 22:10,77,73,62,54,266,4,50
1575,3/24/2018 22:15,83,87,65,57,292,4,50
1576,3/24/2018 22:20,59,73,70,62,264,4,50
1577,3/24/2018 22:25,55,78,66,58,257,4,50
1578,3/24/2018 22:30,59,76,68,60,263,4,50
1579,3/24/2018 22:35,65,72,55,47,239,4,50
1580,3/24/2018 22:40,59,81,64,57,261,4,50
1581,3/24/2018 22:45,72,84,66,58,280,4,50
1582,3/24/2018 22:50,75,73,62,54,264,4,50
1583,3/24/2018 22:55,60,71,67,60,258,4,50
1584,3/24/2018 23:00,44,71,56,49,220,4,50
1585,3/24/2018 23:05,63,72,51,44,230,4,50
1586,3/24/2018 23:10,64,66,55,48,233,4,50
1587,3/24/2018 23:15,56,53,57,49,215,4,50
1588,3/24/2018 23:20,62,59,45,38,204,4,50
1589,3/24/2018 23:25,43,67,58,51,219,4,50
1590,3/24/2018 23:30,37,65,55,48,205,4,50
1591,3/24/2018 23:35,48,53,51,44,196,4,50
1592,3/24/2018 23:40,49,60,53,46,208,4,50
1593,3/24/2018 23:45,45,62,52,45,204,4,50
1594,3/24/2018 23:50,29,39,44,37,149,4,50
1595,3/24/2018 23:55,16,31,37,30,114,4,50
1596,3/25/2018 0:00,6,9,25,19,59,4,50
1597,3/25/2018 0:05,48,73,52,45,218,4,50
1598,3/25/2018 0:10,29,64,53,46,192,4,50
1599,3/25/2018 0:15,17,27,34,27,105,4,50
1600,3/25/2018 0:20,20,52,46,40,158,4,50
1601,3/25/2018 0:25,13,33,47,40,133,4,50
1602,3/25/2018 0:30,20,49,45,38,152,4,50
1603,3/25/2018 0:35,25,39,38,31,133,4,50
1604,3/25/2018 0:40,19,36,37,31,123,4,50
1605,3/25/2018 0:45,17,49,41,35,142,4,50
1606,3/25/2018 0:50,14,45,39,33,131,4,50
1607,3/25/2018 0:55,12,39,35,29,115,4,50
1608,3/25/2018 1:00,13,28,27,21,89,4,50
1609,3/25/2018 1:05,29,32,29,24,114,4,50
1610,3/25/2018 1:10,12,38,29,24,103,4,50
1611,3/25/2018 1:15,11,29,31,26,97,4,50
1612,3/25/2018 1:20,10,24,30,25,89,4,50
1613,3/25/2018 1:25,13,30,27,21,91,4,50
1614,3/25/2018 1:30,11,21,25,19,76,4,50
1615,3/25/2018 1:35,9,23,27,21,80,4,50
1616,3/25/2018 1:40,8,29,28,22,87,4,50
1617,3/25/2018 1:45,14,25,23,17,79,4,50
1618,3/25/2018 1:50,11,28,27,21,87,4,50
1619,3/25/2018 1:55,10,23,22,17,72,4,50
1620,3/25/2018 2:00,10,26,27,21,84,4,50
1621,3/25/2018 2:05,10,29,25,19,83,4,50
1622,3/25/2018 2:10,4,17,20,15,56,4,50
1623,3/25/2018 2:15,8,17,28,23,76,4,50
1624,3/25/2018 2:20,4,21,25,19,69,4,50
1625,3/25/2018 2:25,7,25,24,19,75,4,50
1626,3/25/2018 2:30,8,18,23,18,67,4,50
1627,3/25/2018 2:35,5,19,25,20,69,4,50
1628,3/25/2018 2:40,10,21,22,17,70,4,50
1629,3/25/2018 2:45,7,16,22,16,61,4,50
1630,3/25/2018 2:50,8,16,19,13,56,4,50
1631,3/25/2018 2:55,2,18,23,18,61,4,50
1632,3/25/2018 3:00,6,11,26,20,63,4,50
1633,3/25/2018 3:05,5,11,19,14,49,4,50
1634,3/25/2018 3:10,0,13,19,13,45,4,50
1635,3/25/2018 3:15,6,13,19,13,51,4,50
1636,3/25/2018 3:20,1,8,14,9,32,4,50
1637,3/25/2018 3:25,3,13,19,14,49,4,50
1638,3/25/2018 3:30,4,14,21,15,54,4,50
1639,3/25/2018 3:35,1,11,19,14,45,4,50
1640,3/25/2018 3:40,3,3,16,12,34,4,50
1641,3/25/2018 3:45,3,10,18,13,44,4,50
1642,3/25/2018 3:50,6,10,21,16,53,4,50
1643,3/25/2018 3:55,6,9,20,15,50,4,50
1644,3/25/2018 4:00,2,17,17,11,47,4,50
1645,3/25/2018 4:05,3,11,12,8,34,4,50
1646,3/25/2018 4:10,3,10,14,9,36,4,50
1647,3/25/2018 4:15,0,6,21,15,42,4,50
1648,3/25/2018 4:20,4,19,17,11,51,4,50
1649,3/25/2018 4:25,13,20,17,12,62,4,50
1650,3/25/2018 4:30,4,12,17,11,44,4,50
1651,3/25/2018 4:35,5,19,19,14,57,4,50
1652,3/25/2018 4:40,10,20,19,14,63,4,50
1653,3/25/2018 4:45,2,7,17,12,38,4,50
1654,3/25/2018 4:50,11,23,27,21,82,4,50
1655,3/25/2018 4:55,9,19,21,15,64,4,50
1656,3/25/2018 5:00,2,17,22,16,57,4,50
1657,3/25/2018 5:05,10,18,21,15,64,4,50
1658,3/25/2018 5:10,7,15,18,13,53,4,50
1659,3/25/2018 5:15,7,24,21,15,67,4,50
1660,3/25/2018 5:20,7,23,21,16,67,4,50
1661,3/25/2018 5:25,11,22,18,13,64,4,50
1662,3/25/2018 5:30,10,25,27,21,83,4,50
1663,3/25/2018 5:35,12,24,21,16,73,4,50
1664,3/25/2018 5:40,8,18,30,25,81,4,50
1665,3/25/2018 5:45,9,22,26,20,77,4,50
1666,3/25/2018 5:50,11,28,27,21,87,4,50
1667,3/25/2018 5:55,6,22,25,20,73,4,50
1668,3/25/2018 6:00,8,18,23,18,67,4,50
1669,3/25/2018 6:05,11,28,31,25,95,4,50
1670,3/25/2018 6:10,7,19,20,15,61,4,50
1671,3/25/2018 6:15,6,27,24,19,76,4,50
1672,3/25/2018 6:20,18,25,29,23,95,4,50
1673,3/25/2018 6:25,9,31,31,25,96,4,50
1674,3/25/2018 6:30,13,30,32,27,102,4,50
1675,3/25/2018 6:35,21,33,34,28,116,4,50
1676,3/25/2018 6:40,20,43,45,39,147,4,50
1677,3/25/2018 6:45,28,52,36,30,146,4,50
1678,3/25/2018 6:50,24,43,40,33,140,4,50
1679,3/25/2018 6:55,26,38,46,39,149,4,50
1680,3/25/2018 7:00,18,39,43,36,136,4,50
1681,3/25/2018 7:05,25,45,38,32,140,4,50
1682,3/25/2018 7:10,14,34,41,35,124,4,50
1683,3/25/2018 7:15,30,38,42,35,145,4,50
1684,3/25/2018 7:20,26,45,41,35,147,4,50
1685,3/25/2018 7:25,30,58,42,35,165,4,50
1686,3/25/2018 7:30,35,61,53,45,194,4,50
1687,3/25/2018 7:35,37,50,51,44,182,4,50
1688,3/25/2018 7:40,39,68,51,44,202,4,50
1689,3/25/2018 7:45,32,53,48,41,174,4,50
1690,3/25/2018 7:50,35,58,51,44,188,4,50
1691,3/25/2018 7:55,33,56,49,41,179,4,50
1692,3/25/2018 8:00,34,58,56,49,197,4,50
1693,3/25/2018 8:05,29,63,57,50,199,4,50
1694,3/25/2018 8:10,41,56,58,51,206,4,50
1695,3/25/2018 8:15,51,66,56,49,222,4,50
1696,3/25/2018 8:20,37,57,45,39,178,4,50
1697,3/25/2018 8:25,46,60,57,50,213,4,50
1698,3/25/2018 8:30,52,66,61,53,232,4,50
1699,3/25/2018 8:35,55,78,57,50,240,4,50
1700,3/25/2018 8:40,47,78,63,55,243,4,50
1701,3/25/2018 8:45,52,80,75,66,273,4,50
1702,3/25/2018 8:50,45,70,68,60,243,4,50
1703,3/25/2018 8:55,48,52,58,50,208,4,50
1704,3/25/2018 9:00,53,75,56,49,233,4,50
1705,3/25/2018 9:05,50,73,57,50,230,4,50
1706,3/25/2018 9:10,72,94,57,50,273,4,50
1707,3/25/2018 9:15,70,70,57,50,247,4,50
1708,3/25/2018 9:20,62,53,54,47,216,4,50
1709,3/25/2018 9:25,57,67,56,48,228,4,50
1710,3/25/2018 9:30,126,114,68,60,368,4,50
1711,3/25/2018 9:35,110,123,65,57,355,4,50
1712,3/25/2018 9:40,120,114,92,83,409,4,50
1713,3/25/2018 9:45,102,106,83,75,366,4,50
1714,3/25/2018 9:50,100,103,72,64,339,4,50
1715,3/25/2018 9:55,73,81,70,62,286,4,50
1716,3/25/2018 10:00,101,112,84,75,372,4,50
1717,3/25/2018 10:05,129,123,82,73,407,4,50
1718,3/25/2018 10:10,97,110,82,73,362,4,50
1719,3/25/2018 10:15,96,104,80,71,351,4,50
1720,3/25/2018 10:20,89,109,82,74,354,4,50
1721,3/25/2018 10:25,98,99,86,77,360,4,50
1722,3/25/2018 10:30,105,102,92,83,382,4,50
1723,3/25/2018 10:35,116,120,98,89,423,4,50
1724,3/25/2018 10:40,123,121,93,84,421,4,50
1725,3/25/2018 10:45,138,126,78,69,411,4,50
1726,3/25/2018 10:50,121,125,98,88,432,4,50
1727,3/25/2018 10:55,112,106,94,85,397,4,50
1728,3/25/2018 11:00,108,111,95,86,400,4,50
1729,3/25/2018 11:05,104,122,84,75,385,4,50
1730,3/25/2018 11:10,115,132,84,75,406,4,50
1731,3/25/2018 11:15,118,128,90,82,418,4,50
1732,3/25/2018 11:20,114,111,94,85,404,4,50
1733,3/25/2018 11:25,116,130,102,92,440,4,50
1734,3/25/2018 11:30,99,126,96,87,408,4,50
1735,3/25/2018 11:35,107,134,90,82,413,4,50
1736,3/25/2018 11:40,123,129,97,87,436,4,50
1737,3/25/2018 11:45,107,118,88,79,392,4,50
1738,3/25/2018 11:50,115,116,92,83,406,4,50
1739,3/25/2018 11:55,101,100,90,81,372,4,50
0,3/25/2018 11:00,108,111,95,86,400,4,50
1,3/25/2018 11:05,104,122,84,75,385,4,50
2,3/25/2018 11:10,115,132,84,75,406,4,50
3,3/25/2018 11:15,118,128,90,82,418,4,50
4,3/25/2018 11:20,114,111,94,85,404,4,50
5,3/25/2018 11:25,116,130,102,92,440,4,50
6,3/25/2018 11:30,99,126,96,87,408,4,50
7,3/25/2018 11:35,107,134,90,82,413,4,50
8,3/25/2018 11:40,123,129,97,87,436,4,50
9,3/25/2018 11:45,107,118,88,79,392,4,50
10,3/25/2018 11:50,115,116,92,83,406,4,50
11,3/25/2018 11:55,101,100,90,81,372,4,50
12,3/25/2018 12:00,109,110,90,81,390,4,50
13,3/25/2018 12:05,105,113,83,75,376,4,50
14,3/25/2018 12:10,107,117,93,84,401,4,50
15,3/25/2018 12:15,119,123,106,96,444,4,50
16,3/25/2018 12:20,113,121,93,84,411,4,50
17,3/25/2018 12:25,123,132,91,82,428,4,50
18,3/25/2018 12:30,120,116,97,88,421,4,50
19,3/25/2018 12:35,108,113,89,81,391,4,50
20,3/25/2018 12:40,115,130,101,91,437,4,50
21,3/25/2018 12:45,105,108,96,87,396,4,50
22,3/25/2018 12:50,122,131,104,94,451,4,50
23,3/25/2018 12:55,112,127,104,94,437,4,50
24,3/25/2018 13:00,118,126,105,96,445,4,50
25,3/25/2018 13:05,101,106,93,84,384,4,50
26,3/25/2018 13:10,122,110,97,87,416,4,50
27,3/25/2018 13:15,116,125,91,82,414,4,50
28,3/25/2018 13:20,123,115,84,76,398,4,50
29,3/25/2018 13:25,125,129,93,84,431,4,50
30,3/25/2018 13:30,129,130,100,90,449,4,50
31,3/25/2018 13:35,126,113,95,85,419,4,50
32,3/25/2018 13:40,126,133,97,87,443,4,50
33,3/25/2018 13:45,127,128,101,91,447,4,50
34,3/25/2018 13:50,103,109,97,87,396,4,50
35,3/25/2018 13:55,112,130,93,84,419,4,50
36,3/25/2018 14:00,93,108,89,80,370,4,50
37,3/25/2018 14:05,121,116,92,83,412,4,50
38,3/25/2018 14:10,107,124,93,84,408,4,50
39,3/25/2018 14:15,117,110,89,81,397,4,50
40,3/25/2018 14:20,120,131,101,91,443,4,50
41,3/25/2018 14:25,106,113,95,86,400,4,50
42,3/25/2018 14:30,104,123,103,93,423,4,50
43,3/25/2018 14:35,110,119,84,75,388,4,50
44,3/25/2018 14:40,107,102,87,79,375,4,50
45,3/25/2018 14:45,109,112,91,82,394,4,50
46,3/25/2018 14:50,104,104,91,82,381,4,50
47,3/25/2018 14:55,98,100,76,68,342,4,50
48,3/25/2018 15:00,91,102,81,73,347,4,50
49,3/25/2018 15:05,140,137,89,81,447,4,50
50,3/25/2018 15:10,111,127,98,89,425,4,50
51,3/25/2018 15:15,99,116,91,82,388,4,50
52,3/25/2018 15:20,100,114,97,88,399,4,50
53,3/25/2018 15:25,97,112,82,73,364,4,50
54,3/25/2018 15:30,99,119,94,85,397,4,50
55,3/25/2018 15:35,106,133,88,79,406,4,50
56,3/25/2018 15:40,111,110,89,81,391,4,50
57,3/25/2018 15:45,119,126,95,86,426,4,50
58,3/25/2018 15:50,109,113,93,84,399,4,50
59,3/25/2018 15:55,104,104,92,83,383,4,50
60,3/25/2018 16:00,110,106,87,78,381,4,50
61,3/25/2018 16:05,98,101,85,76,360,4,50
62,3/25/2018 16:10,101,103,88,79,371,4,50
63,3/25/2018 16:15,106,113,99,90,408,4,50
64,3/25/2018 16:20,101,103,84,75,363,4,50
65,3/25/2018 16:25,96,111,94,85,386,4,50
66,3/25/2018 16:30,109,106,94,85,394,4,50
67,3/25/2018 16:35,103,113,95,86,397,4,50
68,3/25/2018 16:40,126,122,98,89,435,4,50
69,3/25/2018 16:45,118,120,93,84,415,4,50
70,3/25/2018 16:50,101,108,91,82,382,4,50
71,3/25/2018 16:55,133,108,96,87,424,4,50
72,3/25/2018 17:00,111,110,85,77,383,4,50
73,3/25/2018 17:05,99,118,80,72,369,4,50
74,3/25/2018 17:10,115,108,90,81,394,4,50
75,3/25/2018 17:15,108,115,93,84,400,4,50
76,3/25/2018 17:20,104,109,93,84,390,4,50
77,3/25/2018 17:25,118,101,87,79,385,4,50
78,3/25/2018 17:30,114,118,93,84,409,4,50
79,3/25/2018 17:35,103,119,95,86,403,4,50
80,3/25/2018 17:40,104,108,96,87,395,4,50
81,3/25/2018 17:45,108,109,95,86,398,4,50
82,3/25/2018 17:50,107,117,90,81,395,4,50
83,3/25/2018 17:55,102,114,94,85,395,4,50
84,3/25/2018 18:00,103,120,95,86,404,4,50
85,3/25/2018 18:05,111,110,75,66,362,4,50
86,3/25/2018 18:10,112,117,92,83,404,4,50
87,3/25/2018 18:15,110,111,88,79,388,4,50
88,3/25/2018 18:20,94,112,87,78,371,4,50
89,3/25/2018 18:25,115,125,88,79,407,4,50
90,3/25/2018 18:30,104,118,88,79,389,4,50
91,3/25/2018 18:35,91,100,82,74,347,4,50
92,3/25/2018 18:40,86,100,87,78,351,4,50
93,3/25/2018 18:45,93,112,79,70,354,4,50
94,3/25/2018 18:50,83,76,73,65,297,4,50
95,3/25/2018 18:55,85,98,74,66,323,4,50
96,3/25/2018 19:00,80,97,84,75,336,4,50
97,3/25/2018 19:05,92,94,80,72,338,4,50
98,3/25/2018 19:10,86,99,77,69,331,4,50
99,3/25/2018 19:15,89,84,72,64,309,4,50
100,3/25/2018 19:20,92,108,84,75,359,4,50
101,3/25/2018 19:25,104,99,82,74,359,4,50
102,3/25/2018 19:30,88,74,72,64,298,4,50
103,3/25/2018 19:35,79,94,79,70,322,4,50
104,3/25/2018 19:40,75,89,82,74,320,4,50
105,3/25/2018 19:45,89,90,72,64,315,4,50
106,3/25/2018 19:50,79,91,77,69,316,4,50
107,3/25/2018 19:55,85,87,75,66,313,4,50
108,3/25/2018 20:00,84,91,83,74,332,4,50
109,3/25/2018 20:05,81,95,82,73,331,4,50
110,3/25/2018 20:10,90,100,75,66,331,4,50
111,3/25/2018 20:15,84,88,66,58,296,4,50
112,3/25/2018 20:20,86,88,72,64,310,4,50
113,3/25/2018 20:25,71,73,61,53,258,4,50
114,3/25/2018 20:30,93,93,76,68,330,4,50
115,3/25/2018 20:35,73,77,74,65,289,4,50
116,3/25/2018 20:40,75,83,69,61,288,4,50
117,3/25/2018 20:45,80,79,65,57,281,4,50
118,3/25/2018 20:50,56,74,63,55,248,4,50
119,3/25/2018 20:55,80,73,61,53,267,4,50
120,3/25/2018 21:00,71,77,66,58,272,4,50
121,3/25/2018 21:05,80,76,61,53,270,4,50
122,3/25/2018 21:10,58,67,59,52,236,4,50
123,3/25/2018 21:15,66,84,72,64,286,4,50
124,3/25/2018 21:20,54,68,62,54,238,4,50
125,3/25/2018 21:25,70,79,75,67,291,4,50
126,3/25/2018 21:30,79,86,67,60,292,4,50
127,3/25/2018 21:35,70,91,64,57,282,4,50
128,3/25/2018 21:40,72,86,57,50,265,4,50
129,3/25/2018 21:45,48,79,54,47,228,4,50
130,3/25/2018 21:50,44,77,61,54,236,4,50
131,3/25/2018 21:55,66,84,61,54,265,4,50
132,3/25/2018 22:00,48,68,65,58,239,4,50
133,3/25/2018 22:05,46,58,56,49,209,4,50
134,3/25/2018 22:10,60,81,59,51,251,4,50
135,3/25/2018 22:15,66,74,61,53,254,4,50
136,3/25/2018 22:20,71,78,61,54,264,4,50
137,3/25/2018 22:25,48,67,57,50,222,4,50
138,3/25/2018 22:30,61,44,51,44,200,4,50
139,3/25/2018 22:35,51,48,53,46,198,4,50
140,3/25/2018 22:40,50,54,50,43,197,4,50
141,3/25/2018 22:45,41,53,47,40,181,4,50
142,3/25/2018 22:50,38,70,53,45,206,4,50
143,3/25/2018 22:55,26,32,40,34,132,4,50
144,3/25/2018 23:00,36,50,54,47,187,4,50
145,3/25/2018 23:05,17,30,40,33,120,4,50
146,3/25/2018 23:10,26,30,41,34,131,4,50
147,3/25/2018 23:15,59,70,47,40,216,4,50
148,3/25/2018 23:20,74,101,65,57,297,4,50
149,3/25/2018 23:25,57,94,67,59,277,4,50
150,3/25/2018 23:30,47,71,55,48,221,4,50
151,3/25/2018 23:35,51,68,53,45,217,4,50
152,3/25/2018 23:40,41,68,61,54,224,4,50
153,3/25/2018 23:45,55,64,51,44,214,4,50
154,3/25/2018 23:50,36,64,57,50,207,4,50
155,3/25/2018 23:55,36,51,44,38,169,4,50
156,3/26/2018 0:00,30,45,41,35,151,4,50
157,3/26/2018 0:05,31,51,42,35,159,4,50
158,3/26/2018 0:10,33,45,40,33,151,4,50
159,3/26/2018 0:15,35,57,43,37,172,4,50
160,3/26/2018 0:20,30,41,48,41,160,4,50
161,3/26/2018 0:25,18,30,34,28,110,4,50
162,3/26/2018 0:30,37,46,39,33,155,4,50
163,3/26/2018 0:35,29,24,36,29,118,4,50
164,3/26/2018 0:40,32,38,30,24,124,4,50
165,3/26/2018 0:45,21,47,36,29,133,4,50
166,3/26/2018 0:50,24,32,32,26,114,4,50
167,3/26/2018 0:55,21,32,38,31,122,4,50
168,3/26/2018 1:00,19,40,36,29,124,4,50
169,3/26/2018 1:05,5,26,25,19,75,4,50
170,3/26/2018 1:10,21,34,31,25,111,4,50
171,3/26/2018 1:15,12,31,31,26,100,4,50
172,3/26/2018 1:20,24,33,24,19,100,4,50
173,3/26/2018 1:25,7,27,21,16,71,4,50
174,3/26/2018 1:30,18,29,25,19,91,4,50
175,3/26/2018 1:35,17,21,32,26,96,4,50
176,3/26/2018 1:40,11,33,33,27,104,4,50
177,3/26/2018 1:45,17,30,23,17,87,4,50
178,3/26/2018 1:50,14,25,25,20,84,4,50
179,3/26/2018 1:55,18,22,29,23,92,4,50
180,3/26/2018 2:00,10,32,19,14,75,4,50
181,3/26/2018 2:05,16,32,25,19,92,4,50
182,3/26/2018 2:10,14,23,22,17,76,4,50
183,3/26/2018 2:15,4,19,21,16,60,4,50
184,3/26/2018 2:20,12,26,31,26,95,4,50
185,3/26/2018 2:25,9,28,23,18,78,4,50
186,3/26/2018 2:30,12,20,24,18,74,4,50
187,3/26/2018 2:35,12,33,22,17,84,4,50
188,3/26/2018 2:40,13,23,24,19,79,4,50
189,3/26/2018 2:45,19,25,24,18,86,4,50
190,3/26/2018 2:50,6,29,29,24,88,4,50
191,3/26/2018 2:55,6,11,19,14,50,4,50
192,3/26/2018 3:00,7,22,20,15,64,4,50
193,3/26/2018 3:05,6,20,25,19,70,4,50
194,3/26/2018 3:10,18,36,24,19,97,4,50
195,3/26/2018 3:15,17,35,27,22,101,4,50
196,3/26/2018 3:20,15,25,25,20,85,4,50
197,3/26/2018 3:25,18,35,29,23,105,4,50
198,3/26/2018 3:30,21,51,36,30,138,4,50
199,3/26/2018 3:35,23,44,31,25,123,4,50
200,3/26/2018 3:40,22,36,30,24,112,4,50
201,3/26/2018 3:45,21,41,31,25,118,4,50
202,3/26/2018 3:50,30,37,32,26,125,4,50
203,3/26/2018 3:55,28,39,30,24,121,4,50
204,3/26/2018 4:00,30,32,35,29,126,4,50
205,3/26/2018 4:05,30,58,40,34,162,4,50
206,3/26/2018 4:10,31,59,40,34,164,4,50
207,3/26/2018 4:15,60,76,54,47,237,4,50
208,3/26/2018 4:20,49,85,61,53,248,4,50
209,3/26/2018 4:25,61,73,61,53,248,4,50
210,3/26/2018 4:30,63,88,56,49,256,4,50
211,3/26/2018 4:35,70,87,67,59,283,4,50
212,3/26/2018 4:40,82,92,68,60,302,4,50
213,3/26/2018 4:45,90,77,61,53,281,4,50
214,3/26/2018 4:50,81,93,63,55,292,4,50
215,3/26/2018 4:55,80,98,75,67,320,4,50
216,3/26/2018 5:00,59,76,66,58,259,4,50
217,3/26/2018 5:05,82,76,68,60,286,4,50
218,3/26/2018 5:10,68,75,66,58,267,4,50
219,3/26/2018 5:15,83,86,67,59,295,4,50
220,3/26/2018 5:20,79,81,73,65,298,4,50
221,3/26/2018 5:25,94,89,72,64,319,4,50
222,3/26/2018 5:30,80,80,69,61,290,4,50
223,3/26/2018 5:35,108,103,91,82,384,4,50
224,3/26/2018 5:40,108,86,80,72,346,4,50
225,3/26/2018 5:45,132,120,84,75,411,4,50
226,3/26/2018 5:50,116,109,85,76,386,4,50
227,3/26/2018 5:55,122,97,86,77,382,4,50
228,3/26/2018 6:00,119,109,86,77,391,4,50
229,3/26/2018 6:05,116,112,89,80,397,4,50
230,3/26/2018 6:10,114,101,89,80,384,4,50
231,3/26/2018 6:15,122,98,87,78,385,4,50
232,3/26/2018 6:20,109,99,84,75,367,4,50
233,3/26/2018 6:25,116,114,92,83,405,4,50
234,3/26/2018 6:30,128,114,88,79,409,4,50
235,3/26/2018 6:35,150,135,106,96,487,4,50
236,3/26/2018 6:40,160,138,111,101,510,4,50
237,3/26/2018 6:45,172,131,100,90,493,4,50
238,3/26/2018 6:50,141,134,101,91,467,4,50
239,3/26/2018 6:55,168,147,86,77,478,4,50
240,3/26/2018 7:00,147,147,93,84,471,4,50
241,3/26/2018 7:05,177,148,100,90,515,4,50
242,3/26/2018 7:10,163,158,119,108,548,4,50
243,3/26/2018 7:15,144,132,108,98,482,4,50
244,3/26/2018 7:20,154,135,105,95,489,4,50
245,3/26/2018 7:25,149,139,101,92,481,4,50
246,3/26/2018 7:30,138,149,121,111,519,4,50
247,3/26/2018 7:35,156,161,109,99,525,4,50
248,3/26/2018 7:40,159,158,118,107,542,4,50
249,3/26/2018 7:45,147,140,94,85,466,4,50
250,3/26/2018 7:50,137,134,106,96,473,4,50
251,3/26/2018 7:55,154,150,103,93,500,4,50
252,3/26/2018 8:00,155,142,104,94,495,4,50
253,3/26/2018 8:05,149,137,106,96,488,4,50
254,3/26/2018 8:10,151,131,98,89,469,4,50
255,3/26/2018 8:15,150,156,101,91,498,4,50
256,3/26/2018 8:20,143,130,91,82,446,4,50
257,3/26/2018 8:25,151,133,98,88,470,4,50
258,3/26/2018 8:30,142,134,93,84,453,4,50
259,3/26/2018 8:35,139,129,86,77,431,4,50
260,3/26/2018 8:40,142,117,100,90,449,4,50
261,3/26/2018 8:45,149,137,86,77,449,4,50
262,3/26/2018 8:50,146,129,90,81,446,4,50
263,3/26/2018 8:55,111,116,88,79,394,4,50
264,3/26/2018 9:00,128,100,86,77,391,4,50
265,3/26/2018 9:05,127,112,77,69,385,4,50
266,3/26/2018 9:10,140,125,92,83,440,4,50
267,3/26/2018 9:15,128,114,100,91,433,4,50
268,3/26/2018 9:20,151,132,80,72,435,4,50
269,3/26/2018 9:25,120,104,80,71,375,4,50
270,3/26/2018 9:30,104,111,87,78,380,4,50
271,3/26/2018 9:35,112,112,87,78,389,4,50
272,3/26/2018 9:40,120,129,93,84,426,4,50
273,3/26/2018 9:45,123,108,82,73,386,4,50
274,3/26/2018 9:50,117,116,90,81,404,4,50
275,3/26/2018 9:55,108,105,89,80,382,4,50
276,3/26/2018 10:00,85,92,78,70,325,4,50
277,3/26/2018 10:05,88,73,61,53,275,4,50
278,3/26/2018 10:10,157,147,106,96,506,4,50
279,3/26/2018 10:15,115,115,83,75,388,4,50
280,3/26/2018 10:20,71,62,50,43,226,4,50
281,3/26/2018 10:25,98,88,68,60,314,4,50
282,3/26/2018 10:30,80,71,41,35,227,4,50
283,3/26/2018 10:35,33,38,35,29,135,4,50
284,3/26/2018 10:40,82,80,53,46,261,4,50
285,3/26/2018 10:45,160,156,89,80,485,4,50
286,3/26/2018 10:50,135,123,100,91,449,4,50
287,3/26/2018 10:55,83,97,81,73,334,4,50
288,3/26/2018 11:00,97,101,76,68,342,4,50
289,3/26/2018 11:05,80,97,72,64,313,4,50
290,3/26/2018 11:10,102,85,56,49,292,4,50
291,3/26/2018 11:15,48,44,31,25,148,4,50
292,3/26/2018 11:20,137,123,96,86,442,4,50
293,3/26/2018 11:25,138,123,85,76,422,4,50
294,3/26/2018 11:30,92,106,71,63,332,4,50
295,3/26/2018 11:35,122,100,79,70,371,4,50
296,3/26/2018 11:40,107,86,80,72,345,4,50
297,3/26/2018 11:45,96,108,82,73,359,4,50
298,3/26/2018 11:50,135,125,78,70,408,4,50
299,3/26/2018 11:55,106,121,92,83,402,4,50
300,3/26/2018 12:00,100,97,88,79,364,4,50
301,3/26/2018 12:05,89,83,78,70,320,4,50
302,3/26/2018 12:10,120,126,87,78,411,4,50
303,3/26/2018 12:15,82,103,77,69,331,4,50
304,3/26/2018 12:20,98,114,80,72,364,4,50
305,3/26/2018 12:25,116,100,89,81,386,4,50
306,3/26/2018 12:30,111,121,82,73,387,4,50
307,3/26/2018 12:35,100,114,90,81,385,4,50
308,3/26/2018 12:40,95,105,88,79,367,4,50
309,3/26/2018 12:45,113,120,84,75,392,4,50
310,3/26/2018 12:50,110,119,81,73,383,4,50
311,3/26/2018 12:55,101,114,82,73,370,4,50
312,3/26/2018 13:00,129,112,80,72,393,4,50
313,3/26/2018 13:05,88,101,90,81,360,4,50
314,3/26/2018 13:10,113,118,88,79,398,4,50
315,3/26/2018 13:15,129,109,78,70,386,4,50
316,3/26/2018 13:20,115,116,78,70,379,4,50
317,3/26/2018 13:25,102,132,90,81,405,4,50
318,3/26/2018 13:30,102,106,88,79,375,4,50
319,3/26/2018 13:35,116,111,98,89,414,4,50
320,3/26/2018 13:40,125,126,85,76,412,4,50
321,3/26/2018 13:45,107,93,85,76,361,4,50
322,3/26/2018 13:50,117,114,84,75,390,4,50
323,3/26/2018 13:55,108,112,88,79,387,4,50
324,3/26/2018 14:00,111,95,87,78,371,4,50
325,3/26/2018 14:05,107,117,92,83,399,4,50
326,3/26/2018 14:10,122,126,100,90,438,4,50
327,3/26/2018 14:15,114,127,88,79,408,4,50
328,3/26/2018 14:20,132,131,92,83,438,4,50
329,3/26/2018 14:25,117,112,85,77,391,4,50
330,3/26/2018 14:30,105,131,95,86,417,4,50
331,3/26/2018 14:35,117,120,96,87,420,4,50
332,3/26/2018 14:40,108,121,90,81,400,4,50
333,3/26/2018 14:45,150,141,104,94,489,4,50
334,3/26/2018 14:50,137,121,98,89,445,4,50
335,3/26/2018 14:55,127,127,89,80,423,4,50
336,3/26/2018 15:00,138,121,105,96,460,4,50
337,3/26/2018 15:05,149,117,98,89,453,4,50
338,3/26/2018 15:10,147,122,104,94,467,4,50
339,3/26/2018 15:15,146,138,80,71,435,4,50
340,3/26/2018 15:20,138,137,91,82,448,4,50
341,3/26/2018 15:25,139,136,88,79,442,4,50
342,3/26/2018 15:30,146,140,98,89,473,4,50
343,3/26/2018 15:35,148,139,112,101,500,4,50
344,3/26/2018 15:40,140,126,98,89,453,4,50
345,3/26/2018 15:45,157,140,106,97,500,4,50
346,3/26/2018 15:50,153,132,109,99,493,4,50
347,3/26/2018 15:55,150,124,106,96,476,4,50
348,3/26/2018 16:00,151,138,106,96,491,4,50
349,3/26/2018 16:05,165,125,101,92,483,4,50
350,3/26/2018 16:10,140,129,108,98,475,4,50
351,3/26/2018 16:15,143,132,112,101,488,4,50
352,3/26/2018 16:20,129,133,103,93,458,4,50
353,3/26/2018 16:25,153,134,106,97,490,4,50
354,3/26/2018 16:30,154,129,98,89,470,4,50
355,3/26/2018 16:35,142,128,110,100,480,4,50
356,3/26/2018 16:40,139,140,96,86,461,4,50
357,3/26/2018 16:45,136,139,116,105,496,4,50
358,3/26/2018 16:50,137,123,100,91,451,4,50
359,3/26/2018 16:55,163,148,115,105,531,4,50
360,3/26/2018 17:00,146,147,102,92,487,4,50
361,3/26/2018 17:05,135,145,114,104,498,4,50
362,3/26/2018 17:10,162,132,107,98,499,4,50
363,3/26/2018 17:15,166,159,108,98,531,4,50
364,3/26/2018 17:20,169,128,110,100,507,4,50
365,3/26/2018 17:25,147,133,111,101,492,4,50
366,3/26/2018 17:30,146,138,115,105,504,4,50
367,3/26/2018 17:35,158,148,119,108,533,4,50
368,3/26/2018 17:40,142,137,107,97,483,4,50
369,3/26/2018 17:45,153,138,112,101,504,4,50
370,3/26/2018 17:50,166,140,112,101,519,4,50
371,3/26/2018 17:55,165,134,103,93,495,4,50
372,3/26/2018 18:00,139,148,93,84,464,4,50
373,3/26/2018 18:05,152,157,98,89,496,4,50
374,3/26/2018 18:10,136,131,107,97,471,4,50
375,3/26/2018 18:15,157,148,106,96,507,4,50
376,3/26/2018 18:20,154,138,110,100,502,4,50
377,3/26/2018 18:25,135,125,106,97,463,4,50
378,3/26/2018 18:30,125,135,98,88,446,4,50
379,3/26/2018 18:35,117,113,97,88,415,4,50
380,3/26/2018 18:40,120,114,95,86,415,4,50
381,3/26/2018 18:45,119,109,95,86,409,4,50
382,3/26/2018 18:50,131,116,96,87,430,4,50
383,3/26/2018 18:55,107,115,91,82,395,4,50
384,3/26/2018 19:00,111,120,90,81,402,4,50
385,3/26/2018 19:05,103,102,89,81,375,4,50
386,3/26/2018 19:10,107,102,89,80,378,4,50
387,3/26/2018 19:15,104,119,98,89,410,4,50
388,3/26/2018 19:20,106,100,90,81,377,4,50
389,3/26/2018 19:25,111,104,74,66,355,4,50
390,3/26/2018 19:30,108,99,82,73,362,4,50
391,3/26/2018 19:35,93,94,80,72,339,4,50
392,3/26/2018 19:40,93,90,76,68,327,4,50
393,3/26/2018 19:45,94,94,70,62,320,4,50
394,3/26/2018 19:50,86,87,80,71,324,4,50
395,3/26/2018 19:55,91,78,71,63,303,4,50
396,3/26/2018 20:00,93,81,74,66,314,4,50
397,3/26/2018 20:05,81,100,72,64,317,4,50
398,3/26/2018 20:10,80,82,67,59,288,4,50
399,3/26/2018 20:15,96,86,69,62,313,4,50
400,3/26/2018 20:20,80,84,68,60,292,4,50
401,3/26/2018 20:25,79,73,71,63,286,4,50
402,3/26/2018 20:30,80,89,65,58,292,4,50
403,3/26/2018 20:35,65,82,69,61,277,4,50
404,3/26/2018 20:40,71,83,69,61,284,4,50
405,3/26/2018 20:45,70,72,70,62,274,4,50
406,3/26/2018 20:50,55,62,63,55,235,4,50
407,3/26/2018 20:55,55,72,63,55,245,4,50
408,3/26/2018 21:00,63,69,56,49,237,4,50
409,3/26/2018 21:05,67,74,68,60,269,4,50
410,3/26/2018 21:10,76,78,57,49,260,4,50
411,3/26/2018 21:15,73,63,61,54,251,4,50
412,3/26/2018 21:20,68,66,66,58,258,4,50
413,3/26/2018 21:25,73,81,60,53,267,4,50
414,3/26/2018 21:30,61,77,61,54,253,4,50
415,3/26/2018 21:35,66,72,56,49,243,4,50
416,3/26/2018 21:40,53,84,61,53,251,4,50
417,3/26/2018 21:45,57,64,59,51,231,4,50
418,3/26/2018 21:50,63,84,61,54,262,4,50
419,3/26/2018 21:55,60,60,52,45,217,4,50
420,3/26/2018 22:00,50,72,52,45,219,4,50
421,3/26/2018 22:05,50,66,53,46,215,4,50
422,3/26/2018 22:10,47,70,56,49,222,4,50
423,3/26/2018 22:15,49,55,50,43,197,4,50
424,3/26/2018 22:20,56,58,50,44,208,4,50
425,3/26/2018 22:25,54,62,56,49,221,4,50
426,3/26/2018 22:30,43,60,47,40,190,4,50
427,3/26/2018 22:35,46,51,53,45,195,4,50
428,3/26/2018 22:40,47,67,52,45,211,4,50
429,3/26/2018 22:45,45,48,53,46,192,4,50
430,3/26/2018 22:50,20,35,39,33,127,4,50
431,3/26/2018 22:55,19,59,37,31,146,4,50
432,3/26/2018 23:00,15,27,35,28,105,4,50
433,3/26/2018 23:05,32,47,43,36,158,4,50
434,3/26/2018 23:10,29,45,46,39,159,4,50
435,3/26/2018 23:15,94,101,55,48,298,4,50
436,3/26/2018 23:20,51,62,65,57,235,4,50
437,3/26/2018 23:25,57,79,68,60,264,4,50
438,3/26/2018 23:30,55,76,55,48,234,4,50
439,3/26/2018 23:35,43,70,48,41,202,4,50
440,3/26/2018 23:40,46,53,57,49,205,4,50
441,3/26/2018 23:45,26,43,47,40,156,4,50
442,3/26/2018 23:50,32,51,45,38,166,4,50
443,3/26/2018 23:55,24,42,37,31,134,4,50
444,3/27/2018 0:00,28,49,42,36,155,4,50
445,3/27/2018 0:05,23,45,39,33,140,4,50
446,3/27/2018 0:10,27,53,38,31,149,4,50
447,3/27/2018 0:15,9,22,34,28,93,4,50
448,3/27/2018 0:20,28,38,40,34,140,4,50
449,3/27/2018 0:25,31,47,36,30,144,4,50
450,3/27/2018 0:30,14,44,36,30,124,4,50
451,3/27/2018 0:35,19,43,39,33,134,4,50
452,3/27/2018 0:40,18,36,38,31,123,4,50
453,3/27/2018 0:45,22,37,33,27,119,4,50
454,3/27/2018 0:50,18,26,35,29,108,4,50
455,3/27/2018 0:55,11,28,26,21,86,4,50
456,3/27/2018 1:00,11,36,30,24,101,4,50
457,3/27/2018 1:05,13,26,27,21,87,4,50
458,3/27/2018 1:10,16,29,22,16,83,4,50
459,3/27/2018 1:15,17,33,30,25,105,4,50
460,3/27/2018 1:20,13,24,29,23,89,4,50
461,3/27/2018 1:25,15,34,24,18,91,4,50
462,3/27/2018 1:30,14,39,29,23,105,4,50
463,3/27/2018 1:35,14,24,27,21,86,4,50
464,3/27/2018 1:40,10,20,27,21,78,4,50
465,3/27/2018 1:45,9,24,24,18,75,4,50
466,3/27/2018 1:50,16,18,25,20,79,4,50
467,3/27/2018 1:55,12,25,23,18,78,4,50
468,3/27/2018 2:00,7,27,23,18,75,4,50
469,3/27/2018 2:05,10,28,23,18,79,4,50
470,3/27/2018 2:10,9,29,21,16,75,4,50
471,3/27/2018 2:15,14,24,25,20,83,4,50
472,3/27/2018 2:20,6,19,18,13,56,4,50
473,3/27/2018 2:25,14,30,25,19,88,4,50
474,3/27/2018 2:30,11,23,23,18,75,4,50
475,3/27/2018 2:35,10,21,27,21,79,4,50
476,3/27/2018 2:40,10,26,21,15,72,4,50
477,3/27/2018 2:45,12,31,27,21,91,4,50
478,3/27/2018 2:50,17,33,25,19,94,4,50
479,3/27/2018 2:55,14,20,24,18,76,4,50
480,3/27/2018 3:00,18,28,23,17,86,4,50
481,3/27/2018 3:05,10,21,26,20,77,4,50
482,3/27/2018 3:10,9,26,32,26,93,4,50
483,3/27/2018 3:15,15,26,24,18,83,4,50
484,3/27/2018 3:20,13,18,26,21,78,4,50
485,3/27/2018 3:25,15,28,27,22,92,4,50
486,3/27/2018 3:30,20,37,33,27,117,4,50
487,3/27/2018 3:35,22,45,33,27,127,4,50
488,3/27/2018 3:40,32,39,37,31,139,4,50
489,3/27/2018 3:45,26,50,40,33,149,4,50
490,3/27/2018 3:50,33,48,34,27,142,4,50
491,3/27/2018 3:55,27,38,32,26,123,4,50
492,3/27/2018 4:00,20,40,34,27,121,4,50
493,3/27/2018 4:05,29,43,33,27,132,4,50
494,3/27/2018 4:10,47,50,46,40,183,4,50
495,3/27/2018 4:15,49,60,53,46,208,4,50
496,3/27/2018 4:20,51,69,53,47,220,4,50
497,3/27/2018 4:25,52,79,56,49,236,4,50
498,3/27/2018 4:30,66,71,55,47,239,4,50
499,3/27/2018 4:35,54,63,61,53,231,4,50
500,3/27/2018 4:40,69,78,57,50,254,4,50
501,3/27/2018 4:45,68,66,56,49,239,4,50
502,3/27/2018 4:50,61,68,53,46,228,4,50
503,3/27/2018 4:55,59,55,53,46,213,4,50
504,3/27/2018 5:00,55,55,51,44,205,4,50
505,3/27/2018 5:05,60,57,50,43,210,4,50
506,3/27/2018 5:10,86,93,74,66,319,4,50
507,3/27/2018 5:15,96,93,80,71,340,4,50
508,3/27/2018 5:20,90,89,79,70,328,4,50
509,3/27/2018 5:25,92,93,80,71,336,4,50
510,3/27/2018 5:30,88,99,89,81,357,4,50
511,3/27/2018 5:35,112,100,86,77,375,4,50
512,3/27/2018 5:40,121,104,93,84,402,4,50
513,3/27/2018 5:45,122,114,82,74,392,4,50
514,3/27/2018 5:50,124,117,93,84,418,4,50
515,3/27/2018 5:55,120,97,75,67,359,4,50
516,3/27/2018 6:00,114,102,89,81,386,4,50
517,3/27/2018 6:05,126,111,90,81,408,4,50
518,3/27/2018 6:10,114,111,88,79,392,4,50
519,3/27/2018 6:15,114,99,82,73,368,4,50
520,3/27/2018 6:20,130,119,90,81,420,4,50
521,3/27/2018 6:25,111,120,95,86,412,4,50
522,3/27/2018 6:30,136,121,96,86,439,4,50
523,3/27/2018 6:35,146,134,105,95,480,4,50
524,3/27/2018 6:40,149,131,107,97,484,4,50
525,3/27/2018 6:45,160,138,103,93,494,4,50
526,3/27/2018 6:50,148,132,98,89,467,4,50
527,3/27/2018 6:55,160,149,108,98,515,4,50
528,3/27/2018 7:00,137,134,107,98,476,4,50
529,3/27/2018 7:05,158,128,106,97,489,4,50
530,3/27/2018 7:10,157,133,111,101,502,4,50
531,3/27/2018 7:15,156,150,115,105,526,4,50
532,3/27/2018 7:20,152,127,104,95,478,4,50
533,3/27/2018 7:25,164,143,101,91,499,4,50
534,3/27/2018 7:30,143,139,109,99,490,4,50
535,3/27/2018 7:35,146,136,105,95,482,4,50
536,3/27/2018 7:40,154,133,110,100,497,4,50
537,3/27/2018 7:45,143,147,108,98,496,4,50
538,3/27/2018 7:50,141,130,96,87,454,4,50
539,3/27/2018 7:55,141,130,104,94,469,4,50
540,3/27/2018 8:00,134,118,98,88,438,4,50
541,3/27/2018 8:05,137,124,106,96,463,4,50
542,3/27/2018 8:10,127,126,90,81,424,4,50
543,3/27/2018 8:15,143,126,94,85,448,4,50
544,3/27/2018 8:20,145,137,108,98,488,4,50
545,3/27/2018 8:25,130,126,96,87,439,4,50
546,3/27/2018 8:30,131,133,90,81,435,4,50
547,3/27/2018 8:35,124,130,80,72,406,4,50
548,3/27/2018 8:40,136,113,90,81,420,4,50
549,3/27/2018 8:45,133,101,88,79,401,4,50
550,3/27/2018 8:50,137,128,99,90,454,4,50
551,3/27/2018 8:55,138,132,88,79,437,4,50
552,3/27/2018 9:00,133,132,96,86,447,4,50
553,3/27/2018 9:05,115,103,90,81,389,4,50
554,3/27/2018 9:10,116,110,72,63,361,4,50
555,3/27/2018 9:15,112,121,78,70,381,4,50
556,3/27/2018 9:20,137,124,82,74,417,4,50
557,3/27/2018 9:25,120,127,80,71,398,4,50
558,3/27/2018 9:30,123,131,75,67,396,4,50
559,3/27/2018 9:35,126,123,70,62,381,4,50
560,3/27/2018 9:40,109,111,87,78,385,4,50
561,3/27/2018 9:45,116,118,85,76,395,4,50
562,3/27/2018 9:50,104,101,85,77,367,4,50
563,3/27/2018 9:55,120,119,79,70,388,4,50
564,3/27/2018 10:00,95,105,77,69,346,4,50
565,3/27/2018 10:05,110,103,73,65,351,4,50
566,3/27/2018 10:10,101,97,79,70,347,4,50
567,3/27/2018 10:15,106,108,85,77,376,4,50
568,3/27/2018 10:20,118,112,85,76,391,4,50
569,3/27/2018 10:25,114,102,77,69,362,4,50
570,3/27/2018 10:30,133,113,98,89,433,4,50
571,3/27/2018 10:35,133,114,91,82,420,4,50
572,3/27/2018 10:40,116,119,92,83,410,4,50
573,3/27/2018 10:45,131,131,94,85,441,4,50
574,3/27/2018 10:50,127,123,99,90,439,4,50
575,3/27/2018 10:55,119,124,99,90,432,4,50
576,3/27/2018 11:00,129,121,99,90,439,4,50
577,3/27/2018 11:05,98,104,79,71,352,4,50
578,3/27/2018 11:10,128,120,97,87,432,4,50
579,3/27/2018 11:15,134,120,102,93,449,4,50
580,3/27/2018 11:20,117,129,94,85,425,4,50
581,3/27/2018 11:25,127,111,90,81,409,4,50
582,3/27/2018 11:30,124,111,78,70,383,4,50
583,3/27/2018 11:35,126,119,96,86,427,4,50
584,3/27/2018 11:40,121,120,87,78,406,4,50
585,3/27/2018 11:45,120,125,95,86,426,4,50
586,3/27/2018 11:50,117,111,85,77,390,4,50
587,3/27/2018 11:55,117,117,90,81,405,4,50
588,3/27/2018 12:00,114,106,75,67,362,4,50
589,3/27/2018 12:05,89,95,71,63,318,4,50
590,3/27/2018 12:10,100,115,92,83,390,4,50
591,3/27/2018 12:15,113,134,90,81,418,4,50
592,3/27/2018 12:20,123,111,79,70,383,4,50
593,3/27/2018 12:25,110,117,80,72,379,4,50
594,3/27/2018 12:30,118,119,90,81,408,4,50
595,3/27/2018 12:35,106,106,92,83,387,4,50
596,3/27/2018 12:40,137,123,88,79,427,4,50
597,3/27/2018 12:45,131,124,88,79,422,4,50
598,3/27/2018 12:50,119,119,95,86,419,4,50
599,3/27/2018 12:55,120,105,77,68,370,4,50
600,3/27/2018 13:00,124,110,86,77,397,4,50
601,3/27/2018 13:05,118,117,82,74,391,4,50
602,3/27/2018 13:10,111,99,77,69,356,4,50
603,3/27/2018 13:15,121,119,85,76,401,4,50
604,3/27/2018 13:20,121,115,96,86,418,4,50
605,3/27/2018 13:25,124,110,85,76,395,4,50
606,3/27/2018 13:30,128,112,92,83,415,4,50
607,3/27/2018 13:35,136,131,101,92,460,4,50
608,3/27/2018 13:40,117,124,101,92,434,4,50
609,3/27/2018 13:45,126,120,101,92,439,4,50
610,3/27/2018 13:50,132,126,98,89,445,4,50
611,3/27/2018 13:55,128,112,94,85,419,4,50
612,3/27/2018 14:00,137,112,96,87,432,4,50
613,3/27/2018 14:05,133,122,76,68,399,4,50
614,3/27/2018 14:10,124,118,82,74,398,4,50
615,3/27/2018 14:15,147,127,100,90,464,4,50
616,3/27/2018 14:20,134,119,92,83,428,4,50
617,3/27/2018 14:25,124,116,93,84,417,4,50
618,3/27/2018 14:30,123,131,103,93,450,4,50
619,3/27/2018 14:35,56,81,51,43,231,4,50
620,3/27/2018 14:40,146,127,106,96,475,4,50
621,3/27/2018 14:45,186,155,109,99,549,4,50
622,3/27/2018 14:50,143,129,105,95,472,4,50
623,3/27/2018 14:55,141,131,101,92,465,4,50
624,3/27/2018 15:00,124,124,98,88,434,4,50
625,3/27/2018 15:05,137,127,92,83,439,4,50
626,3/27/2018 15:10,132,103,92,83,410,4,50
627,3/27/2018 15:15,148,119,103,93,463,4,50
628,3/27/2018 15:20,161,139,98,88,486,4,50
629,3/27/2018 15:25,141,131,104,94,470,4,50
630,3/27/2018 15:30,136,142,101,91,470,4,50
631,3/27/2018 15:35,156,128,87,78,449,4,50
632,3/27/2018 15:40,93,93,54,47,287,4,50
633,3/27/2018 15:45,90,101,73,65,329,4,50
634,3/27/2018 15:50,104,108,82,74,368,4,50
635,3/27/2018 15:55,114,106,76,68,364,4,50
636,3/27/2018 16:00,141,130,91,82,444,4,50
637,3/27/2018 16:05,151,151,84,75,461,4,50
638,3/27/2018 16:10,160,150,107,97,514,4,50
639,3/27/2018 16:15,134,111,98,89,432,4,50
640,3/27/2018 16:20,140,131,107,97,475,4,50
641,3/27/2018 16:25,138,148,105,96,487,4,50
642,3/27/2018 16:30,164,155,110,100,529,4,50
643,3/27/2018 16:35,170,152,113,103,538,4,50
644,3/27/2018 16:40,150,149,112,102,513,4,50
645,3/27/2018 16:45,166,149,101,91,507,4,50
646,3/27/2018 16:50,162,147,118,107,534,4,50
647,3/27/2018 16:55,148,133,98,89,468,4,50
648,3/27/2018 17:00,153,147,106,97,503,4,50
649,3/27/2018 17:05,161,140,93,84,478,4,50
650,3/27/2018 17:10,146,136,99,90,471,4,50
651,3/27/2018 17:15,156,155,116,105,532,4,50
652,3/27/2018 17:20,151,163,114,103,531,4,50
653,3/27/2018 17:25,137,143,112,102,494,4,50
654,3/27/2018 17:30,154,136,115,105,510,4,50
655,3/27/2018 17:35,153,147,109,99,508,4,50
656,3/27/2018 17:40,164,153,117,106,540,4,50
657,3/27/2018 17:45,171,146,114,103,534,4,50
658,3/27/2018 17:50,151,141,101,92,485,4,50
659,3/27/2018 17:55,159,135,105,95,494,4,50
660,3/27/2018 18:00,134,114,100,91,439,4,50
661,3/27/2018 18:05,141,160,106,96,503,4,50
662,3/27/2018 18:10,146,130,104,94,474,4,50
663,3/27/2018 18:15,150,139,112,102,503,4,50
664,3/27/2018 18:20,130,132,106,96,464,4,50
665,3/27/2018 18:25,123,122,106,96,447,4,50
666,3/27/2018 18:30,125,131,105,96,457,4,50
667,3/27/2018 18:35,149,129,103,93,474,4,50
668,3/27/2018 18:40,129,119,93,84,425,4,50
669,3/27/2018 18:45,137,115,92,83,427,4,50
670,3/27/2018 18:50,121,122,97,88,428,4,50
671,3/27/2018 18:55,112,108,96,87,403,4,50
672,3/27/2018 19:00,124,115,101,92,432,4,50
673,3/27/2018 19:05,129,108,93,84,414,4,50
674,3/27/2018 19:10,124,115,87,78,404,4,50
675,3/27/2018 19:15,118,104,93,84,399,4,50
676,3/27/2018 19:20,101,110,84,75,370,4,50
677,3/27/2018 19:25,99,93,74,65,331,4,50
678,3/27/2018 19:30,81,94,84,75,334,4,50
679,3/27/2018 19:35,97,103,81,73,354,4,50
680,3/27/2018 19:40,88,89,79,70,326,4,50
681,3/27/2018 19:45,89,106,85,77,357,4,50
682,3/27/2018 19:50,98,89,78,70,335,4,50
683,3/27/2018 19:55,86,83,76,68,313,4,50
684,3/27/2018 20:00,97,95,78,70,340,4,50
685,3/27/2018 20:05,89,96,80,72,337,4,50
686,3/27/2018 20:10,86,90,71,63,310,4,50
687,3/27/2018 20:15,96,87,77,69,329,4,50
688,3/27/2018 20:20,95,108,72,64,339,4,50
689,3/27/2018 20:25,85,93,80,72,330,4,50
690,3/27/2018 20:30,93,90,68,60,311,4,50
691,3/27/2018 20:35,80,83,68,60,291,4,50
692,3/27/2018 20:40,73,74,68,60,275,4,50
693,3/27/2018 20:45,76,102,72,64,314,4,50
694,3/27/2018 20:50,82,74,67,60,283,4,50
695,3/27/2018 20:55,79,96,73,65,313,4,50
696,3/27/2018 21:00,69,79,65,57,270,4,50
697,3/27/2018 21:05,57,84,71,63,275,4,50
698,3/27/2018 21:10,65,76,65,57,263,4,50
699,3/27/2018 21:15,69,68,67,59,263,4,50
700,3/27/2018 21:20,68,85,69,62,284,4,50
701,3/27/2018 21:25,68,58,60,52,238,4,50
702,3/27/2018 21:30,60,79,59,52,250,4,50
703,3/27/2018 21:35,59,78,59,52,248,4,50
704,3/27/2018 21:40,67,75,64,56,262,4,50
705,3/27/2018 21:45,61,71,57,49,238,4,50
706,3/27/2018 21:50,74,83,66,58,281,4,50
707,3/27/2018 21:55,60,79,62,55,256,4,50
708,3/27/2018 22:00,39,66,58,51,214,4,50
709,3/27/2018 22:05,49,65,59,52,225,4,50
710,3/27/2018 22:10,63,68,53,47,231,4,50
711,3/27/2018 22:15,62,66,53,47,228,4,50
712,3/27/2018 22:20,61,69,60,53,243,4,50
713,3/27/2018 22:25,39,70,53,46,208,4,50
714,3/27/2018 22:30,59,58,46,40,203,4,50
715,3/27/2018 22:35,53,65,53,46,217,4,50
716,3/27/2018 22:40,49,58,49,41,197,4,50
717,3/27/2018 22:45,41,68,51,44,204,4,50
718,3/27/2018 22:50,40,54,52,45,191,4,50
719,3/27/2018 22:55,41,57,46,40,184,4,50
720,3/27/2018 23:00,28,41,40,34,143,4,50
721,3/27/2018 23:05,37,48,40,34,159,4,50
722,3/27/2018 23:10,47,52,43,37,179,4,50
723,3/27/2018 23:15,41,61,48,41,191,4,50
724,3/27/2018 23:20,32,47,38,31,148,4,50
725,3/27/2018 23:25,36,53,35,29,153,4,50
726,3/27/2018 23:30,27,43,41,35,146,4,50
727,3/27/2018 23:35,24,54,45,38,161,4,50
728,3/27/2018 23:40,23,43,40,34,140,4,50
729,3/27/2018 23:45,40,41,37,31,149,4,50
730,3/27/2018 23:50,33,42,40,34,149,4,50
731,3/27/2018 23:55,28,40,33,27,128,4,50
732,3/28/2018 0:00,19,38,34,27,118,4,50
733,3/28/2018 0:05,25,30,35,29,119,4,50
734,3/28/2018 0:10,20,37,34,28,119,4,50
735,3/28/2018 0:15,23,34,30,25,112,4,50
736,3/28/2018 0:20,19,29,29,23,100,4,50
737,3/28/2018 0:25,24,32,24,18,98,4,50
738,3/28/2018 0:30,17,35,27,22,101,4,50
739,3/28/2018 0:35,21,35,30,24,110,4,50
740,3/28/2018 0:40,18,36,30,23,107,4,50
741,3/28/2018 0:45,18,19,20,15,72,4,50
742,3/28/2018 0:50,14,25,23,18,80,4,50
743,3/28/2018 0:55,5,20,18,13,56,4,50
744,3/28/2018 1:00,11,20,19,14,64,4,50
745,3/28/2018 1:05,9,10,19,14,52,4,50
746,3/28/2018 1:10,10,14,22,16,62,4,50
747,3/28/2018 1:15,13,23,22,16,74,4,50
748,3/28/2018 1:20,7,14,21,15,57,4,50
749,3/28/2018 1:25,9,23,21,16,69,4,50
750,3/28/2018 1:30,6,17,19,14,56,4,50
751,3/28/2018 1:35,11,19,16,11,57,4,50
752,3/28/2018 1:40,9,22,17,11,59,4,50
753,3/28/2018 1:45,11,13,20,15,59,4,50
754,3/28/2018 1:50,8,10,15,10,43,4,50
755,3/28/2018 1:55,8,14,15,10,47,4,50
756,3/28/2018 2:00,6,12,14,10,42,4,50
757,3/28/2018 2:05,8,13,15,10,46,4,50
758,3/28/2018 2:10,8,15,15,9,47,4,50
759,3/28/2018 2:15,13,20,19,14,66,4,50
760,3/28/2018 2:20,8,16,14,9,47,4,50
761,3/28/2018 2:25,6,21,20,15,62,4,50
762,3/28/2018 2:30,10,16,15,10,51,4,50
763,3/28/2018 2:35,10,20,14,9,53,4,50
764,3/28/2018 2:40,8,16,19,14,57,4,50
765,3/28/2018 2:45,11,21,17,11,60,4,50
766,3/28/2018 2:50,7,11,18,13,49,4,50
767,3/28/2018 2:55,6,18,16,11,51,4,50
768,3/28/2018 3:00,6,13,17,11,47,4,50
769,3/28/2018 3:05,7,7,13,8,35,4,50
770,3/28/2018 3:10,9,10,17,12,48,4,50
771,3/28/2018 3:15,4,7,15,10,36,4,50
772,3/28/2018 3:20,10,18,19,14,61,4,50
773,3/28/2018 3:25,9,21,19,14,63,4,50
774,3/28/2018 3:30,17,16,16,11,60,4,50
775,3/28/2018 3:35,14,19,22,16,71,4,50
776,3/28/2018 3:40,17,22,18,12,69,4,50
777,3/28/2018 3:45,16,23,23,17,79,4,50
778,3/28/2018 3:50,19,27,23,18,87,4,50
779,3/28/2018 3:55,17,20,25,20,82,4,50
780,3/28/2018 4:00,16,21,20,15,72,4,50
781,3/28/2018 4:05,17,27,20,14,78,4,50
782,3/28/2018 4:10,26,28,27,21,102,4,50
783,3/28/2018 4:15,26,44,31,25,126,4,50
784,3/28/2018 4:20,35,34,39,33,141,4,50
785,3/28/2018 4:25,35,41,41,35,152,4,50
786,3/28/2018 4:30,38,47,35,29,149,4,50
787,3/28/2018 4:35,50,50,50,43,193,4,50
788,3/28/2018 4:40,48,51,45,38,182,4,50
789,3/28/2018 4:45,53,61,54,47,215,4,50
790,3/28/2018 4:50,52,59,46,40,197,4,50
791,3/28/2018 4:55,51,55,42,36,184,4,50
792,3/28/2018 5:00,71,72,58,51,252,4,50
793,3/28/2018 5:05,64,62,59,52,237,4,50
794,3/28/2018 5:10,72,80,68,60,280,4,50
795,3/28/2018 5:15,95,87,75,66,323,4,50
796,3/28/2018 5:20,93,89,63,55,300,4,50
797,3/28/2018 5:25,87,92,77,68,324,4,50
798,3/28/2018 5:30,113,108,84,75,380,4,50
799,3/28/2018 5:35,129,103,83,75,390,4,50
800,3/28/2018 5:40,108,113,88,79,388,4,50
801,3/28/2018 5:45,124,112,82,74,392,4,50
802,3/28/2018 5:50,121,109,80,72,382,4,50
803,3/28/2018 5:55,127,118,84,75,404,4,50
804,3/28/2018 6:00,131,117,91,82,421,4,50
805,3/28/2018 6:05,133,109,91,82,415,4,50
806,3/28/2018 6:10,126,121,82,74,403,4,50
807,3/28/2018 6:15,119,103,92,83,397,4,50
808,3/28/2018 6:20,124,110,95,86,415,4,50
809,3/28/2018 6:25,142,131,93,84,450,4,50
810,3/28/2018 6:30,139,129,106,96,470,4,50
811,3/28/2018 6:35,151,126,107,97,481,4,50
812,3/28/2018 6:40,151,116,99,90,456,4,50
813,3/28/2018 6:45,168,152,102,92,514,4,50
814,3/28/2018 6:50,148,133,111,101,493,4,50
815,3/28/2018 6:55,160,145,103,93,501,4,50
816,3/28/2018 7:00,154,147,96,86,483,4,50
817,3/28/2018 7:05,143,129,98,89,459,4,50
818,3/28/2018 7:10,142,147,110,100,499,4,50
819,3/28/2018 7:15,163,138,100,90,491,4,50
820,3/28/2018 7:20,139,141,103,93,476,4,50
821,3/28/2018 7:25,146,132,111,101,490,4,50
822,3/28/2018 7:30,154,138,98,88,478,4,50
823,3/28/2018 7:35,163,146,123,112,544,4,50
824,3/28/2018 7:40,143,135,101,91,470,4,50
825,3/28/2018 7:45,160,127,101,91,479,4,50
826,3/28/2018 7:50,121,140,109,99,469,4,50
827,3/28/2018 7:55,144,130,109,99,482,4,50
828,3/28/2018 8:00,141,127,85,76,429,4,50
829,3/28/2018 8:05,123,134,95,86,438,4,50
830,3/28/2018 8:10,136,132,98,89,455,4,50
831,3/28/2018 8:15,131,125,99,90,445,4,50
832,3/28/2018 8:20,166,138,95,85,484,4,50
833,3/28/2018 8:25,142,139,98,88,467,4,50
834,3/28/2018 8:30,126,129,93,84,432,4,50
835,3/28/2018 8:35,132,123,92,83,430,4,50
836,3/28/2018 8:40,132,117,87,78,414,4,50
837,3/28/2018 8:45,136,123,99,90,448,4,50
838,3/28/2018 8:50,140,131,100,91,462,4,50
839,3/28/2018 8:55,129,116,99,90,434,4,50
840,3/28/2018 9:00,127,118,91,82,418,4,50
841,3/28/2018 9:05,150,130,90,81,451,4,50
842,3/28/2018 9:10,120,129,90,81,420,4,50
843,3/28/2018 9:15,116,118,93,84,411,4,50
844,3/28/2018 9:20,122,120,93,84,419,4,50
845,3/28/2018 9:25,117,118,87,78,400,4,50
846,3/28/2018 9:30,122,109,88,79,398,4,50
847,3/28/2018 9:35,103,127,72,64,366,4,50
848,3/28/2018 9:40,118,114,92,83,407,4,50
849,3/28/2018 9:45,107,124,96,86,413,4,50
850,3/28/2018 9:50,132,124,85,77,418,4,50
851,3/28/2018 9:55,99,103,75,66,343,4,50
852,3/28/2018 10:00,98,103,73,65,339,4,50
853,3/28/2018 10:05,116,103,86,77,382,4,50
854,3/28/2018 10:10,118,99,88,79,384,4,50
855,3/28/2018 10:15,115,101,82,74,372,4,50
856,3/28/2018 10:20,111,109,86,77,383,4,50
857,3/28/2018 10:25,116,103,84,75,378,4,50
858,3/28/2018 10:30,120,112,82,74,388,4,50
859,3/28/2018 10:35,110,111,92,83,396,4,50
860,3/28/2018 10:40,123,128,93,84,428,4,50
861,3/28/2018 10:45,115,129,94,85,423,4,50
862,3/28/2018 10:50,116,102,85,76,379,4,50
863,3/28/2018 10:55,112,112,93,84,401,4,50
864,3/28/2018 11:00,115,115,89,80,399,4,50
865,3/28/2018 11:05,117,127,91,82,417,4,50
866,3/28/2018 11:10,101,98,84,76,359,4,50
867,3/28/2018 11:15,103,108,80,71,362,4,50
868,3/28/2018 11:20,89,116,88,79,372,4,50
869,3/28/2018 11:25,108,93,82,74,357,4,50
870,3/28/2018 11:30,125,121,93,84,423,4,50
871,3/28/2018 11:35,108,107,88,79,382,4,50
872,3/28/2018 11:40,106,103,87,78,374,4,50
873,3/28/2018 11:45,107,123,94,85,409,4,50
874,3/28/2018 11:50,113,109,95,86,403,4,50
875,3/28/2018 11:55,115,105,89,81,390,4,50
876,3/28/2018 12:00,111,115,86,77,389,4,50
877,3/28/2018 12:05,110,104,87,79,380,4,50
878,3/28/2018 12:10,129,112,85,77,403,4,50
879,3/28/2018 12:15,123,105,92,83,403,4,50
880,3/28/2018 12:20,119,114,82,73,388,4,50
881,3/28/2018 12:25,118,106,87,78,389,4,50
882,3/28/2018 12:30,110,115,92,83,400,4,50
883,3/28/2018 12:35,118,118,84,75,395,4,50
884,3/28/2018 12:40,117,110,96,86,409,4,50
885,3/28/2018 12:45,108,97,75,66,346,4,50
886,3/28/2018 12:50,111,109,88,79,387,4,50
887,3/28/2018 12:55,96,117,85,76,374,4,50
888,3/28/2018 13:00,123,122,98,88,431,4,50
889,3/28/2018 13:05,124,108,93,84,409,4,50
890,3/28/2018 13:10,126,120,99,90,435,4,50
891,3/28/2018 13:15,115,115,95,86,411,4,50
892,3/28/2018 13:20,124,116,96,87,423,4,50
893,3/28/2018 13:25,128,129,97,88,442,4,50
894,3/28/2018 13:30,126,115,95,86,422,4,50
895,3/28/2018 13:35,138,126,96,87,447,4,50
896,3/28/2018 13:40,128,123,85,77,413,4,50
897,3/28/2018 13:45,121,125,96,87,429,4,50
898,3/28/2018 13:50,148,127,90,81,446,4,50
899,3/28/2018 13:55,126,122,85,77,410,4,50
900,3/28/2018 14:00,114,117,90,81,402,4,50
901,3/28/2018 14:05,114,119,85,76,394,4,50
902,3/28/2018 14:10,116,124,83,75,398,4,50
903,3/28/2018 14:15,118,109,81,73,381,4,50
904,3/28/2018 14:20,128,116,85,76,405,4,50
905,3/28/2018 14:25,130,117,99,90,436,4,50
906,3/28/2018 14:30,132,114,89,80,415,4,50
907,3/28/2018 14:35,141,128,101,91,461,4,50
908,3/28/2018 14:40,133,128,101,91,453,4,50
909,3/28/2018 14:45,135,125,101,92,453,4,50
910,3/28/2018 14:50,130,117,95,86,428,4,50
911,3/28/2018 14:55,135,133,98,89,455,4,50
912,3/28/2018 15:00,139,118,88,79,424,4,50
913,3/28/2018 15:05,147,131,93,84,455,4,50
914,3/28/2018 15:10,147,143,114,103,507,4,50
915,3/28/2018 15:15,137,142,104,94,477,4,50
916,3/28/2018 15:20,128,144,98,89,459,4,50
917,3/28/2018 15:25,144,132,98,89,463,4,50
918,3/28/2018 15:30,155,134,101,91,481,4,50
919,3/28/2018 15:35,159,160,117,106,542,4,50
920,3/28/2018 15:40,141,130,112,101,484,4,50
921,3/28/2018 15:45,154,133,106,96,489,4,50
922,3/28/2018 15:50,152,148,109,100,509,4,50
923,3/28/2018 15:55,136,130,94,85,445,4,50
924,3/28/2018 16:00,150,123,104,94,471,4,50
925,3/28/2018 16:05,144,144,105,95,488,4,50
926,3/28/2018 16:10,160,139,117,107,523,4,50
927,3/28/2018 16:15,151,131,104,94,480,4,50
928,3/28/2018 16:20,166,138,106,96,506,4,50
929,3/28/2018 16:25,124,126,107,97,454,4,50
930,3/28/2018 16:30,157,130,105,95,487,4,50
931,3/28/2018 16:35,161,158,120,109,548,4,50
932,3/28/2018 16:40,158,152,113,103,526,4,50
933,3/28/2018 16:45,157,132,113,103,505,4,50
934,3/28/2018 16:50,144,136,114,104,498,4,50
935,3/28/2018 16:55,149,130,112,102,493,4,50
936,3/28/2018 17:00,158,147,106,96,507,4,50
937,3/28/2018 17:05,123,117,91,82,413,4,50
938,3/28/2018 17:10,77,90,80,72,319,4,50
939,3/28/2018 17:15,76,76,73,65,290,4,50
940,3/28/2018 17:20,47,62,63,55,227,4,50
941,3/28/2018 17:25,56,62,63,55,236,4,50
942,3/28/2018 17:30,64,94,75,66,299,4,50
943,3/28/2018 17:35,55,76,70,62,263,4,50
944,3/28/2018 17:40,58,67,67,59,251,4,50
945,3/28/2018 17:45,68,82,70,62,282,4,50
946,3/28/2018 17:50,155,141,111,102,509,4,50
947,3/28/2018 17:55,159,175,113,103,550,4,50
948,3/28/2018 18:00,150,161,114,103,528,4,50
949,3/28/2018 18:05,154,151,114,104,523,4,50
950,3/28/2018 18:10,147,122,106,96,471,4,50
951,3/28/2018 18:15,173,153,111,101,538,4,50
952,3/28/2018 18:20,152,135,105,95,487,4,50
953,3/28/2018 18:25,168,146,102,92,508,4,50
954,3/28/2018 18:30,162,135,103,94,494,4,50
955,3/28/2018 18:35,142,131,107,97,477,4,50
956,3/28/2018 18:40,162,156,102,92,512,4,50
957,3/28/2018 18:45,124,110,97,88,419,4,50
958,3/28/2018 18:50,136,133,106,96,471,4,50
959,3/28/2018 18:55,129,127,100,90,446,4,50
960,3/28/2018 19:00,136,126,99,90,451,4,50
961,3/28/2018 19:05,118,112,94,85,409,4,50
962,3/28/2018 19:10,131,119,99,89,438,4,50
963,3/28/2018 19:15,120,116,99,89,424,4,50
964,3/28/2018 19:20,113,104,93,84,394,4,50
965,3/28/2018 19:25,127,135,94,85,441,4,50
966,3/28/2018 19:30,106,112,96,86,400,4,50
967,3/28/2018 19:35,118,107,95,86,406,4,50
968,3/28/2018 19:40,108,101,87,79,375,4,50
969,3/28/2018 19:45,117,108,88,79,392,4,50
970,3/28/2018 19:50,113,106,89,80,388,4,50
971,3/28/2018 19:55,109,90,83,74,356,4,50
972,3/28/2018 20:00,116,115,85,77,393,4,50
973,3/28/2018 20:05,92,103,72,64,331,4,50
974,3/28/2018 20:10,93,110,69,61,333,4,50
975,3/28/2018 20:15,81,99,69,61,310,4,50
976,3/28/2018 20:20,101,100,72,64,337,4,50
977,3/28/2018 20:25,83,107,85,77,352,4,50
978,3/28/2018 20:30,82,82,71,63,298,4,50
979,3/28/2018 20:35,83,96,71,63,313,4,50
980,3/28/2018 20:40,69,86,74,66,295,4,50
981,3/28/2018 20:45,75,81,65,57,278,4,50
982,3/28/2018 20:50,88,92,69,62,311,4,50
983,3/28/2018 20:55,71,76,73,65,285,4,50
984,3/28/2018 21:00,85,81,73,65,304,4,50
985,3/28/2018 21:05,87,82,69,61,299,4,50
986,3/28/2018 21:10,73,79,75,67,294,4,50
987,3/28/2018 21:15,79,78,65,57,279,4,50
988,3/28/2018 21:20,80,82,56,49,267,4,50
989,3/28/2018 21:25,71,79,75,66,291,4,50
990,3/28/2018 21:30,72,73,59,52,256,4,50
991,3/28/2018 21:35,66,71,65,57,259,4,50
992,3/28/2018 21:40,75,78,68,60,281,4,50
993,3/28/2018 21:45,68,66,64,56,254,4,50
994,3/28/2018 21:50,79,73,58,51,261,4,50
995,3/28/2018 21:55,71,84,56,48,259,4,50
996,3/28/2018 22:00,63,67,49,42,221,4,50
997,3/28/2018 22:05,70,63,61,54,248,4,50
998,3/28/2018 22:10,65,62,54,47,228,4,50
999,3/28/2018 22:15,66,75,68,60,269,4,50
1000,3/28/2018 22:20,55,76,61,53,245,4,50
1001,3/28/2018 22:25,56,61,56,49,222,4,50
1002,3/28/2018 22:30,61,67,49,42,219,4,50
1003,3/28/2018 22:35,53,61,53,47,214,4,50
1004,3/28/2018 22:40,65,75,56,49,245,4,50
1005,3/28/2018 22:45,46,66,47,40,199,4,50
1006,3/28/2018 22:50,39,62,60,53,214,4,50
1007,3/28/2018 22:55,36,59,53,46,194,4,50
1008,3/28/2018 23:00,36,38,45,38,157,4,50
1009,3/28/2018 23:05,46,50,46,40,182,4,50
1010,3/28/2018 23:10,34,48,47,40,169,4,50
1011,3/28/2018 23:15,35,46,44,38,163,4,50
1012,3/28/2018 23:20,38,48,38,32,156,4,50
1013,3/28/2018 23:25,28,42,37,31,138,4,50
1014,3/28/2018 23:30,25,47,46,39,157,4,50
1015,3/28/2018 23:35,29,31,35,29,124,4,50
1016,3/28/2018 23:40,29,47,41,35,152,4,50
1017,3/28/2018 23:45,31,36,44,37,148,4,50
1018,3/28/2018 23:50,30,41,33,27,131,4,50
1019,3/28/2018 23:55,13,33,32,27,105,4,50
1020,3/29/2018 0:00,13,23,25,19,80,4,50
1021,3/29/2018 0:05,22,24,31,25,102,4,50
1022,3/29/2018 0:10,16,34,33,27,110,4,50
1023,3/29/2018 0:15,16,28,26,21,91,4,50
1024,3/29/2018 0:20,19,32,24,19,94,4,50
1025,3/29/2018 0:25,19,28,29,23,99,4,50
1026,3/29/2018 0:30,18,24,25,19,86,4,50
1027,3/29/2018 0:35,18,25,21,16,80,4,50
1028,3/29/2018 0:40,13,18,22,17,70,4,50
1029,3/29/2018 0:45,14,21,29,23,87,4,50
1030,3/29/2018 0:50,14,27,20,15,76,4,50
1031,3/29/2018 0:55,13,17,21,15,66,4,50
1032,3/29/2018 1:00,4,16,17,11,48,4,50
1033,3/29/2018 1:05,15,22,16,10,63,4,50
1034,3/29/2018 1:10,15,13,21,16,65,4,50
1035,3/29/2018 1:15,10,24,17,11,62,4,50
1036,3/29/2018 1:20,8,19,21,15,63,4,50
1037,3/29/2018 1:25,11,16,17,12,56,4,50
1038,3/29/2018 1:30,15,19,19,14,67,4,50
1039,3/29/2018 1:35,9,20,13,8,50,4,50
1040,3/29/2018 1:40,8,13,19,14,54,4,50
1041,3/29/2018 1:45,6,28,15,10,59,4,50
1042,3/29/2018 1:50,12,23,17,12,64,4,50
1043,3/29/2018 1:55,3,12,14,9,38,4,50
1044,3/29/2018 2:00,7,12,15,9,43,4,50
1045,3/29/2018 2:05,8,16,15,10,49,4,50
1046,3/29/2018 2:10,8,15,15,9,47,4,50
1047,3/29/2018 2:15,9,11,16,11,47,4,50
1048,3/29/2018 2:20,8,22,21,15,66,4,50
1049,3/29/2018 2:25,8,9,17,11,45,4,50
1050,3/29/2018 2:30,18,14,15,9,56,4,50
1051,3/29/2018 2:35,12,16,15,10,53,4,50
1052,3/29/2018 2:40,11,16,18,13,58,4,50
1053,3/29/2018 2:45,8,11,15,10,44,4,50
1054,3/29/2018 2:50,13,13,15,10,51,4,50
1055,3/29/2018 2:55,3,11,16,11,41,4,50
1056,3/29/2018 3:00,14,15,15,9,53,4,50
1057,3/29/2018 3:05,8,16,13,8,45,4,50
1058,3/29/2018 3:10,6,20,20,14,60,4,50
1059,3/29/2018 3:15,6,13,13,8,40,4,50
1060,3/29/2018 3:20,13,14,18,13,58,4,50
1061,3/29/2018 3:25,7,19,22,16,64,4,50
1062,3/29/2018 3:30,12,17,19,13,61,4,50
1063,3/29/2018 3:35,14,29,23,18,84,4,50
1064,3/29/2018 3:40,15,32,18,13,78,4,50
1065,3/29/2018 3:45,14,24,24,19,81,4,50
1066,3/29/2018 3:50,11,26,21,16,74,4,50
1067,3/29/2018 3:55,12,19,29,23,83,4,50
1068,3/29/2018 4:00,15,24,17,12,68,4,50
1069,3/29/2018 4:05,17,28,27,22,94,4,50
1070,3/29/2018 4:10,24,26,28,22,100,4,50
1071,3/29/2018 4:15,30,40,34,28,132,4,50
1072,3/29/2018 4:20,33,28,34,28,123,4,50
1073,3/29/2018 4:25,36,49,40,34,159,4,50
1074,3/29/2018 4:30,44,50,39,33,166,4,50
1075,3/29/2018 4:35,46,46,49,42,183,4,50
1076,3/29/2018 4:40,46,47,45,38,176,4,50
1077,3/29/2018 4:45,53,56,46,40,195,4,50
1078,3/29/2018 4:50,40,60,53,46,199,4,50
1079,3/29/2018 4:55,66,63,45,38,212,4,50
1080,3/29/2018 5:00,58,55,49,42,204,4,50
1081,3/29/2018 5:05,59,66,53,46,224,4,50
1082,3/29/2018 5:10,68,76,60,53,257,4,50
1083,3/29/2018 5:15,87,82,72,64,305,4,50
1084,3/29/2018 5:20,94,75,69,61,299,4,50
1085,3/29/2018 5:25,89,94,81,73,337,4,50
1086,3/29/2018 5:30,111,99,82,73,365,4,50
1087,3/29/2018 5:35,115,94,77,69,355,4,50
1088,3/29/2018 5:40,116,97,82,73,368,4,50
1089,3/29/2018 5:45,127,110,97,88,422,4,50
1090,3/29/2018 5:50,122,106,86,77,391,4,50
1091,3/29/2018 5:55,137,125,102,92,456,4,50
1092,3/29/2018 6:00,111,106,90,81,388,4,50
1093,3/29/2018 6:05,128,112,77,68,385,4,50
1094,3/29/2018 6:10,132,112,93,84,421,4,50
1095,3/29/2018 6:15,124,107,81,73,385,4,50
1096,3/29/2018 6:20,118,110,97,88,413,4,50
1097,3/29/2018 6:25,132,118,93,84,427,4,50
1098,3/29/2018 6:30,139,126,98,89,452,4,50
1099,3/29/2018 6:35,125,111,87,78,401,4,50
1100,3/29/2018 6:40,153,123,93,84,453,4,50
1101,3/29/2018 6:45,149,131,101,92,473,4,50
1102,3/29/2018 6:50,160,127,88,79,454,4,50
1103,3/29/2018 6:55,146,124,104,94,468,4,50
1104,3/29/2018 7:00,149,137,94,85,465,4,50
1105,3/29/2018 7:05,155,131,98,88,472,4,50
1106,3/29/2018 7:10,141,141,99,90,471,4,50
1107,3/29/2018 7:15,129,106,94,85,414,4,50
1108,3/29/2018 7:20,154,142,105,95,496,4,50
1109,3/29/2018 7:25,164,137,116,105,522,4,50
1110,3/29/2018 7:30,143,138,112,102,495,4,50
1111,3/29/2018 7:35,138,143,112,102,495,4,50
1112,3/29/2018 7:40,149,145,111,101,506,4,50
1113,3/29/2018 7:45,144,136,112,101,493,4,50
1114,3/29/2018 7:50,148,142,97,88,475,4,50
1115,3/29/2018 7:55,128,128,106,96,458,4,50
1116,3/29/2018 8:00,129,123,93,84,429,4,50
1117,3/29/2018 8:05,143,127,95,86,451,4,50
1118,3/29/2018 8:10,130,120,88,79,417,4,50
1119,3/29/2018 8:15,147,136,95,86,464,4,50
1120,3/29/2018 8:20,151,132,89,80,452,4,50
1121,3/29/2018 8:25,156,138,92,83,469,4,50
1122,3/29/2018 8:30,138,133,82,74,427,4,50
1123,3/29/2018 8:35,128,126,87,78,419,4,50
1124,3/29/2018 8:40,132,116,90,81,419,4,50
1125,3/29/2018 8:45,123,130,93,84,430,4,50
1126,3/29/2018 8:50,118,126,94,85,423,4,50
1127,3/29/2018 8:55,124,114,90,81,409,4,50
1128,3/29/2018 9:00,128,131,88,79,426,4,50
1129,3/29/2018 9:05,128,119,89,81,417,4,50
1130,3/29/2018 9:10,135,110,89,80,414,4,50
1131,3/29/2018 9:15,109,136,92,83,420,4,50
1132,3/29/2018 9:20,118,114,81,73,386,4,50
1133,3/29/2018 9:25,124,115,90,81,410,4,50
1134,3/29/2018 9:30,133,130,85,77,425,4,50
1135,3/29/2018 9:35,128,112,96,86,422,4,50
1136,3/29/2018 9:40,120,119,89,80,408,4,50
1137,3/29/2018 9:45,105,115,95,86,401,4,50
1138,3/29/2018 9:50,113,100,88,79,380,4,50
1139,3/29/2018 9:55,120,95,87,78,380,4,50
1140,3/29/2018 10:00,107,106,77,68,358,4,50
1141,3/29/2018 10:05,118,103,75,67,363,4,50
1142,3/29/2018 10:10,124,114,77,68,383,4,50
1143,3/29/2018 10:15,115,96,87,78,376,4,50
1144,3/29/2018 10:20,124,120,94,85,423,4,50
1145,3/29/2018 10:25,136,127,97,87,447,4,50
1146,3/29/2018 10:30,111,121,91,82,405,4,50
1147,3/29/2018 10:35,132,122,89,80,423,4,50
1148,3/29/2018 10:40,121,120,89,80,410,4,50
1149,3/29/2018 10:45,139,119,87,78,423,4,50
1150,3/29/2018 10:50,123,119,93,84,419,4,50
1151,3/29/2018 10:55,125,128,83,75,411,4,50
1152,3/29/2018 11:00,116,118,90,81,405,4,50
1153,3/29/2018 11:05,102,100,87,78,367,4,50
1154,3/29/2018 11:10,128,118,85,76,407,4,50
1155,3/29/2018 11:15,100,99,89,81,369,4,50
1156,3/29/2018 11:20,111,116,70,62,359,4,50
1157,3/29/2018 11:25,102,109,82,73,366,4,50
1158,3/29/2018 11:30,103,97,85,77,362,4,50
1159,3/29/2018 11:35,106,124,81,73,384,4,50
1160,3/29/2018 11:40,124,126,96,86,432,4,50
1161,3/29/2018 11:45,128,112,99,89,428,4,50
1162,3/29/2018 11:50,119,112,72,63,366,4,50
1163,3/29/2018 11:55,120,118,99,89,426,4,50
1164,3/29/2018 12:00,121,127,78,70,396,4,50
1165,3/29/2018 12:05,108,109,81,73,371,4,50
1166,3/29/2018 12:10,116,116,82,73,387,4,50
1167,3/29/2018 12:15,130,117,97,87,431,4,50
1168,3/29/2018 12:20,114,116,89,80,399,4,50
1169,3/29/2018 12:25,125,121,95,86,427,4,50
1170,3/29/2018 12:30,124,112,85,76,397,4,50
1171,3/29/2018 12:35,120,106,82,74,382,4,50
1172,3/29/2018 12:40,121,124,75,67,387,4,50
1173,3/29/2018 12:45,117,102,91,82,392,4,50
1174,3/29/2018 12:50,119,118,84,75,396,4,50
1175,3/29/2018 12:55,117,106,94,85,402,4,50
1176,3/29/2018 13:00,109,113,94,85,401,4,50
1177,3/29/2018 13:05,113,108,93,84,398,4,50
1178,3/29/2018 13:10,108,113,94,85,400,4,50
1179,3/29/2018 13:15,114,119,91,82,406,4,50
1180,3/29/2018 13:20,111,114,88,79,392,4,50
1181,3/29/2018 13:25,116,117,85,77,395,4,50
1182,3/29/2018 13:30,128,117,98,88,431,4,50
1183,3/29/2018 13:35,124,123,92,83,422,4,50
1184,3/29/2018 13:40,124,122,97,88,431,4,50
1185,3/29/2018 13:45,126,127,97,88,438,4,50
1186,3/29/2018 13:50,122,133,99,90,444,4,50
1187,3/29/2018 13:55,140,121,105,95,461,4,50
1188,3/29/2018 14:00,143,123,96,86,448,4,50
1189,3/29/2018 14:05,144,124,91,82,441,4,50
1190,3/29/2018 14:10,124,119,95,86,424,4,50
1191,3/29/2018 14:15,139,127,97,88,451,4,50
1192,3/29/2018 14:20,138,131,101,91,461,4,50
1193,3/29/2018 14:25,137,125,88,79,429,4,50
1194,3/29/2018 14:30,153,128,93,84,458,4,50
1195,3/29/2018 14:35,147,130,104,94,475,4,50
1196,3/29/2018 14:40,141,137,103,93,474,4,50
1197,3/29/2018 14:45,131,132,109,99,471,4,50
1198,3/29/2018 14:50,138,124,98,89,449,4,50
1199,3/29/2018 14:55,143,141,103,93,480,4,50
1200,3/29/2018 15:00,149,136,104,94,483,4,50
1201,3/29/2018 15:05,154,138,115,105,512,4,50
1202,3/29/2018 15:10,147,141,113,103,504,4,50
1203,3/29/2018 15:15,142,144,104,94,484,4,50
1204,3/29/2018 15:20,150,138,100,90,478,4,50
1205,3/29/2018 15:25,143,145,90,81,459,4,50
1206,3/29/2018 15:30,163,138,111,102,514,4,50
1207,3/29/2018 15:35,132,127,101,92,452,4,50
1208,3/29/2018 15:40,161,139,110,100,510,4,50
1209,3/29/2018 15:45,131,129,107,98,465,4,50
1210,3/29/2018 15:50,147,127,105,96,475,4,50
1211,3/29/2018 15:55,139,116,102,92,449,4,50
1212,3/29/2018 16:00,143,121,102,93,459,4,50
1213,3/29/2018 16:05,139,129,99,90,457,4,50
1214,3/29/2018 16:10,148,143,109,100,500,4,50
1215,3/29/2018 16:15,169,143,116,105,533,4,50
1216,3/29/2018 16:20,145,136,105,95,481,4,50
1217,3/29/2018 16:25,151,131,103,93,478,4,50
1218,3/29/2018 16:30,150,125,107,98,480,4,50
1219,3/29/2018 16:35,151,138,106,96,491,4,50
1220,3/29/2018 16:40,144,139,118,108,509,4,50
1221,3/29/2018 16:45,148,140,112,102,502,4,50
1222,3/29/2018 16:50,140,123,107,97,467,4,50
1223,3/29/2018 16:55,151,137,116,105,509,4,50
1224,3/29/2018 17:00,150,144,110,100,504,4,50
1225,3/29/2018 17:05,140,157,120,109,526,4,50
1226,3/29/2018 17:10,151,144,116,105,516,4,50
1227,3/29/2018 17:15,154,150,109,99,512,4,50
1228,3/29/2018 17:20,164,161,109,99,533,4,50
1229,3/29/2018 17:25,170,132,106,97,505,4,50
1230,3/29/2018 17:30,139,148,93,84,464,4,50
1231,3/29/2018 17:35,159,141,92,83,475,4,50
1232,3/29/2018 17:40,148,144,103,94,489,4,50
1233,3/29/2018 17:45,167,123,93,84,467,4,50
1234,3/29/2018 17:50,148,139,129,105,521,4,0
1235,3/29/2018 17:55,144,130,125,103,502,4,0
1236,3/29/2018 18:00,136,124,124,101,485,4,0
1237,3/29/2018 18:05,133,133,124,102,492,4,0
1238,3/29/2018 18:10,142,127,124,101,494,4,0
1239,3/29/2018 18:15,141,134,123,101,499,4,0
1240,3/29/2018 18:20,138,134,123,101,496,4,0
1241,3/29/2018 18:25,127,121,122,100,470,4,0
1242,3/29/2018 18:30,130,127,120,98,475,4,0
1243,3/29/2018 18:35,131,110,118,97,456,4,0
1244,3/29/2018 18:40,126,126,117,96,465,4,0
1245,3/29/2018 18:45,120,121,116,95,452,4,0
1246,3/29/2018 18:50,116,116,114,94,440,4,0
1247,3/29/2018 18:55,111,107,112,92,422,4,0
1248,3/29/2018 19:00,118,112,114,93,437,4,0
1249,3/29/2018 19:05,107,107,114,94,422,4,0
1250,3/29/2018 19:10,106,117,113,92,428,4,0
1251,3/29/2018 19:15,110,108,110,90,418,4,0
1252,3/29/2018 19:20,119,113,108,89,429,4,0
1253,3/29/2018 19:25,104,98,103,85,390,4,0
1254,3/29/2018 19:30,100,104,100,82,386,4,0
1255,3/29/2018 19:35,95,102,98,81,376,4,0
1256,3/29/2018 19:40,94,92,96,79,361,4,0
1257,3/29/2018 19:45,100,95,93,76,364,4,0
1258,3/29/2018 19:50,95,93,91,75,354,4,0
1259,3/29/2018 19:55,96,92,85,70,343,4,0
1260,3/29/2018 20:00,89,92,84,68,333,4,0
1261,3/29/2018 20:05,88,90,82,67,327,4,0
1262,3/29/2018 20:10,77,95,82,67,321,4,0
1263,3/29/2018 20:15,90,101,80,66,337,4,0
1264,3/29/2018 20:20,88,103,81,66,338,4,0
1265,3/29/2018 20:25,90,93,78,64,325,4,0
1266,3/29/2018 20:30,91,93,77,63,324,4,0
1267,3/29/2018 20:35,79,76,75,61,291,4,0
1268,3/29/2018 20:40,85,94,75,67,321,4,50
1269,3/29/2018 20:45,64,103,82,73,322,4,50
1270,3/29/2018 20:50,81,77,62,55,275,4,50
1271,3/29/2018 20:55,80,119,73,65,337,4,50
1272,3/29/2018 21:00,63,84,69,62,278,4,50
1273,3/29/2018 21:05,77,86,67,59,289,4,50
1274,3/29/2018 21:10,88,89,80,72,329,4,50
1275,3/29/2018 21:15,75,99,75,66,315,4,50
1276,3/29/2018 21:20,74,81,69,61,285,4,50
1277,3/29/2018 21:25,75,87,68,60,290,4,50
1278,3/29/2018 21:30,80,93,67,59,299,4,50
1279,3/29/2018 21:35,93,101,75,66,335,4,50
1280,3/29/2018 21:40,79,91,65,57,292,4,50
1281,3/29/2018 21:45,69,96,69,62,296,4,50
1282,3/29/2018 21:50,79,80,64,57,280,4,50
1283,3/29/2018 21:55,72,74,64,57,267,4,50
1284,3/29/2018 22:00,64,83,69,62,278,4,50
1285,3/29/2018 22:05,76,89,69,62,296,4,50
1286,3/29/2018 22:10,83,72,63,56,274,4,50
1287,3/29/2018 22:15,73,77,72,64,286,4,50
1288,3/29/2018 22:20,73,79,69,61,282,4,50
1289,3/29/2018 22:25,71,86,61,53,271,4,50
1290,3/29/2018 22:30,59,62,59,51,231,4,50
1291,3/29/2018 22:35,62,68,55,48,233,4,50
1292,3/29/2018 22:40,62,61,56,48,227,4,50
1293,3/29/2018 22:45,69,64,56,49,238,4,50
1294,3/29/2018 22:50,54,68,64,57,243,4,50
1295,3/29/2018 22:55,29,39,46,39,153,4,50
1296,3/29/2018 23:00,36,41,48,41,166,4,50
1297,3/29/2018 23:05,50,66,50,44,210,4,50
1298,3/29/2018 23:10,76,91,70,62,299,4,50
1299,3/29/2018 23:15,78,91,83,75,327,4,50
1300,3/29/2018 23:20,79,83,78,70,310,4,50
1301,3/29/2018 23:25,70,106,76,68,320,4,50
1302,3/29/2018 23:30,72,83,71,63,289,4,50
1303,3/29/2018 23:35,41,68,57,50,216,4,50
1304,3/29/2018 23:40,29,49,50,43,171,4,50
1305,3/29/2018 23:45,32,43,49,42,166,4,50
1306,3/29/2018 23:50,41,57,43,37,178,4,50
1307,3/29/2018 23:55,67,70,55,48,240,4,50
1308,3/30/2018 0:00,60,63,62,55,240,4,50
1309,3/30/2018 0:05,45,69,55,48,217,4,50
1310,3/30/2018 0:10,47,67,50,43,207,4,50
1311,3/30/2018 0:15,49,73,59,52,233,4,50
1312,3/30/2018 0:20,44,74,53,45,216,4,50
1313,3/30/2018 0:25,33,48,40,34,155,4,50
1314,3/30/2018 0:30,35,51,42,35,163,4,50
1315,3/30/2018 0:35,33,53,38,32,156,4,50
1316,3/30/2018 0:40,38,62,44,38,182,4,50
1317,3/30/2018 0:45,30,52,41,35,158,4,50
1318,3/30/2018 0:50,30,52,46,40,168,4,50
1319,3/30/2018 0:55,36,59,42,35,172,4,50
1320,3/30/2018 1:00,21,36,40,34,131,4,50
1321,3/30/2018 1:05,17,34,33,26,110,4,50
1322,3/30/2018 1:10,24,41,41,35,141,4,50
1323,3/30/2018 1:15,31,43,34,27,135,4,50
1324,3/30/2018 1:20,24,45,38,32,139,4,50
1325,3/30/2018 1:25,29,44,38,31,142,4,50
1326,3/30/2018 1:30,27,37,29,23,116,4,50
1327,3/30/2018 1:35,19,31,34,27,111,4,50
1328,3/30/2018 1:40,26,36,36,30,128,4,50
1329,3/30/2018 1:45,18,31,31,25,105,4,50
1330,3/30/2018 1:50,16,33,34,28,111,4,50
1331,3/30/2018 1:55,17,29,31,26,103,4,50
1332,3/30/2018 2:00,16,30,29,24,99,4,50
1333,3/30/2018 2:05,10,31,30,25,96,4,50
1334,3/30/2018 2:10,27,37,34,27,125,4,50
1335,3/30/2018 2:15,9,26,28,22,85,4,50
1336,3/30/2018 2:20,15,29,34,27,105,4,50
1337,3/30/2018 2:25,17,39,28,23,107,4,50
1338,3/30/2018 2:30,28,43,26,20,117,4,50
1339,3/30/2018 2:35,20,30,28,22,100,4,50
1340,3/30/2018 2:40,20,33,30,24,107,4,50
1341,3/30/2018 2:45,21,26,29,23,99,4,50
1342,3/30/2018 2:50,22,24,25,20,91,4,50
1343,3/30/2018 2:55,18,35,24,18,95,4,50
1344,3/30/2018 3:00,17,27,26,21,91,4,50
1345,3/30/2018 3:05,22,35,29,24,110,4,50
1346,3/30/2018 3:10,22,32,27,22,103,4,50
1347,3/30/2018 3:15,14,37,27,22,100,4,50
1348,3/30/2018 3:20,10,24,31,25,90,4,50
1349,3/30/2018 3:25,23,36,30,24,113,4,50
1350,3/30/2018 3:30,27,43,31,25,126,4,50
1351,3/30/2018 3:35,23,51,32,26,132,4,50
1352,3/30/2018 3:40,29,52,35,29,145,4,50
1353,3/30/2018 3:45,34,47,34,27,142,4,50
1354,3/30/2018 3:50,23,37,36,30,126,4,50
1355,3/30/2018 3:55,29,38,35,29,131,4,50
1356,3/30/2018 4:00,34,40,29,24,127,4,50
1357,3/30/2018 4:05,42,43,30,24,139,4,50
1358,3/30/2018 4:10,46,45,44,37,172,4,50
1359,3/30/2018 4:15,35,48,42,36,161,4,50
1360,3/30/2018 4:20,38,39,43,36,156,4,50
1361,3/30/2018 4:25,77,77,53,46,253,4,50
1362,3/30/2018 4:30,55,77,59,51,242,4,50
1363,3/30/2018 4:35,72,76,65,57,270,4,50
1364,3/30/2018 4:40,75,90,65,57,287,4,50
1365,3/30/2018 4:45,76,94,74,66,310,4,50
1366,3/30/2018 4:50,63,71,59,52,245,4,50
1367,3/30/2018 4:55,60,63,56,49,228,4,50
1368,3/30/2018 5:00,60,65,52,45,222,4,50
1369,3/30/2018 5:05,58,64,57,50,229,4,50
1370,3/30/2018 5:10,68,76,69,62,275,4,50
1371,3/30/2018 5:15,73,77,72,64,286,4,50
1372,3/30/2018 5:20,90,78,72,64,304,4,50
1373,3/30/2018 5:25,57,58,60,53,228,4,50
1374,3/30/2018 5:30,70,70,60,52,252,4,50
1375,3/30/2018 5:35,98,92,69,62,321,4,50
1376,3/30/2018 5:40,98,105,81,73,357,4,50
1377,3/30/2018 5:45,85,92,82,74,333,4,50
1378,3/30/2018 5:50,100,96,77,69,342,4,50
1379,3/30/2018 5:55,91,83,74,66,314,4,50
1380,3/30/2018 6:00,93,83,73,65,314,4,50
1381,3/30/2018 6:05,74,79,70,62,285,4,50
1382,3/30/2018 6:10,91,100,67,59,317,4,50
1383,3/30/2018 6:15,120,95,87,78,380,4,50
1384,3/30/2018 6:20,122,117,88,79,406,4,50
1385,3/30/2018 6:25,121,110,85,77,393,4,50
1386,3/30/2018 6:30,136,119,94,85,434,4,50
1387,3/30/2018 6:35,130,121,85,77,413,4,50
1388,3/30/2018 6:40,160,134,82,73,449,4,50
1389,3/30/2018 6:45,130,125,96,87,438,4,50
1390,3/30/2018 6:50,136,123,88,79,426,4,50
1391,3/30/2018 6:55,139,124,87,78,428,4,50
1392,3/30/2018 7:00,131,107,92,83,413,4,50
1393,3/30/2018 7:05,142,124,85,77,428,4,50
1394,3/30/2018 7:10,146,128,94,85,453,4,50
1395,3/30/2018 7:15,139,118,100,91,448,4,50
1396,3/30/2018 7:20,126,119,81,73,399,4,50
1397,3/30/2018 7:25,136,117,92,83,428,4,50
1398,3/30/2018 7:30,137,131,99,90,457,4,50
1399,3/30/2018 7:35,147,138,108,98,491,4,50
1400,3/30/2018 7:40,127,133,106,97,463,4,50
1401,3/30/2018 7:45,135,136,89,80,440,4,50
1402,3/30/2018 7:50,141,130,110,100,481,4,50
1403,3/30/2018 7:55,133,131,89,80,433,4,50
1404,3/30/2018 8:00,117,116,93,84,410,4,50
1405,3/30/2018 8:05,119,124,97,88,428,4,50
1406,3/30/2018 8:10,118,120,89,80,407,4,50
1407,3/30/2018 8:15,122,125,101,92,440,4,50
1408,3/30/2018 8:20,128,122,96,86,432,4,50
1409,3/30/2018 8:25,117,116,92,83,408,4,50
1410,3/30/2018 8:30,120,112,82,73,387,4,50
1411,3/30/2018 8:35,128,109,84,75,396,4,50
1412,3/30/2018 8:40,126,123,97,88,434,4,50
1413,3/30/2018 8:45,126,124,96,86,432,4,50
1414,3/30/2018 8:50,126,131,99,89,445,4,50
1415,3/30/2018 8:55,115,127,91,82,415,4,50
1416,3/30/2018 9:00,122,100,81,73,376,4,50
1417,3/30/2018 9:05,126,119,80,72,397,4,50
1418,3/30/2018 9:10,109,113,72,64,358,4,50
1419,3/30/2018 9:15,108,104,82,74,368,4,50
1420,3/30/2018 9:20,128,114,90,81,413,4,50
1421,3/30/2018 9:25,112,116,73,65,366,4,50
1422,3/30/2018 9:30,117,110,83,75,385,4,50
1423,3/30/2018 9:35,134,125,87,78,424,4,50
1424,3/30/2018 9:40,126,118,95,86,425,4,50
1425,3/30/2018 9:45,129,124,96,87,436,4,50
1426,3/30/2018 9:50,127,114,93,84,418,4,50
1427,3/30/2018 9:55,103,112,76,68,359,4,50
1428,3/30/2018 10:00,111,111,85,77,384,4,50
1429,3/30/2018 10:05,116,131,72,64,383,4,50
1430,3/30/2018 10:10,119,122,82,73,396,4,50
1431,3/30/2018 10:15,126,117,89,80,412,4,50
1432,3/30/2018 10:20,117,123,96,86,422,4,50
1433,3/30/2018 10:25,133,122,100,90,445,4,50
1434,3/30/2018 10:30,141,124,89,80,434,4,50
1435,3/30/2018 10:35,130,122,95,86,433,4,50
1436,3/30/2018 10:40,107,117,98,89,411,4,50
1437,3/30/2018 10:45,126,132,96,87,441,4,50
1438,3/30/2018 10:50,132,120,98,89,439,4,50
1439,3/30/2018 10:55,116,113,93,84,406,4,50
1440,3/30/2018 11:00,115,117,94,85,411,4,50
1441,3/30/2018 11:05,124,114,85,76,399,4,50
1442,3/30/2018 11:10,110,112,93,84,399,4,50
1443,3/30/2018 11:15,114,114,97,88,413,4,50
1444,3/30/2018 11:20,108,117,86,77,388,4,50
1445,3/30/2018 11:25,109,126,96,87,418,4,50
1446,3/30/2018 11:30,131,136,92,83,442,4,50
1447,3/30/2018 11:35,124,113,94,85,416,4,50
1448,3/30/2018 11:40,129,127,99,89,444,4,50
1449,3/30/2018 11:45,118,140,97,88,443,4,50
1450,3/30/2018 11:50,127,129,104,94,454,4,50
1451,3/30/2018 11:55,134,122,101,91,448,4,50
1452,3/30/2018 12:00,138,123,98,88,447,4,50
1453,3/30/2018 12:05,138,136,89,80,443,4,50
1454,3/30/2018 12:10,138,127,89,80,434,4,50
1455,3/30/2018 12:15,133,132,86,77,428,4,50
1456,3/30/2018 12:20,146,134,93,84,457,4,50
1457,3/30/2018 12:25,148,133,85,76,442,4,50
1458,3/30/2018 12:30,109,114,78,70,371,4,50
1459,3/30/2018 12:35,124,123,80,71,398,4,50
1460,3/30/2018 12:40,112,114,86,77,389,4,50
1461,3/30/2018 12:45,134,126,92,83,435,4,50
1462,3/30/2018 12:50,137,128,90,81,436,4,50
1463,3/30/2018 12:55,126,131,108,98,463,4,50
1464,3/30/2018 13:00,136,131,96,87,450,4,50
1465,3/30/2018 13:05,124,118,82,73,397,4,50
1466,3/30/2018 13:10,121,120,94,85,420,4,50
1467,3/30/2018 13:15,133,129,85,77,424,4,50
1468,3/30/2018 13:20,121,115,101,92,429,4,50
1469,3/30/2018 13:25,129,128,110,100,467,4,50
1470,3/30/2018 13:30,129,128,102,92,451,4,50
1471,3/30/2018 13:35,124,125,106,96,451,4,50
1472,3/30/2018 13:40,132,124,96,86,438,4,50
1473,3/30/2018 13:45,118,117,83,74,392,4,50
1474,3/30/2018 13:50,127,116,89,80,412,4,50
1475,3/30/2018 13:55,133,121,101,91,446,4,50
1476,3/30/2018 14:00,121,109,97,87,414,4,50
1477,3/30/2018 14:05,121,129,102,92,444,4,50
1478,3/30/2018 14:10,144,128,97,88,457,4,50
1479,3/30/2018 14:15,101,106,86,77,370,4,50
1480,3/30/2018 14:20,133,118,90,81,422,4,50
1481,3/30/2018 14:25,130,128,88,79,425,4,50
1482,3/30/2018 14:30,133,124,96,86,439,4,50
1483,3/30/2018 14:35,137,127,101,91,456,4,50
1484,3/30/2018 14:40,137,140,104,94,475,4,50
1485,3/30/2018 14:45,143,148,111,101,503,4,50
1486,3/30/2018 14:50,124,130,98,89,441,4,50
1487,3/30/2018 14:55,130,131,97,88,446,4,50
1488,3/30/2018 15:00,146,117,101,91,455,4,50
1489,3/30/2018 15:05,133,128,107,98,466,4,50
1490,3/30/2018 15:10,143,137,108,98,486,4,50
1491,3/30/2018 15:15,153,137,99,90,479,4,50
1492,3/30/2018 15:20,133,120,104,95,452,4,50
1493,3/30/2018 15:25,154,148,119,108,529,4,50
1494,3/30/2018 15:30,166,154,102,92,514,4,50
1495,3/30/2018 15:35,142,132,108,98,480,4,50
1496,3/30/2018 15:40,149,134,114,104,501,4,50
1497,3/30/2018 15:45,148,124,107,98,477,4,50
1498,3/30/2018 15:50,140,142,110,100,492,4,50
1499,3/30/2018 15:55,141,118,103,94,456,4,50
1500,3/30/2018 16:00,124,121,105,96,446,4,50
1501,3/30/2018 16:05,165,145,109,99,518,4,50
1502,3/30/2018 16:10,149,136,111,101,497,4,50
1503,3/30/2018 16:15,143,136,109,99,487,4,50
1504,3/30/2018 16:20,119,123,107,97,446,4,50
1505,3/30/2018 16:25,147,134,112,102,495,4,50
1506,3/30/2018 16:30,146,138,117,106,507,4,50
1507,3/30/2018 16:35,129,126,101,91,447,4,50
1508,3/30/2018 16:40,143,136,109,99,487,4,50
1509,3/30/2018 16:45,154,150,116,105,525,4,50
1510,3/30/2018 16:50,134,120,104,95,453,4,50
1511,3/30/2018 16:55,144,146,103,93,486,4,50
1512,3/30/2018 17:00,160,145,103,93,501,4,50
1513,3/30/2018 17:05,140,141,111,101,493,4,50
1514,3/30/2018 17:10,148,127,95,86,456,4,50
1515,3/30/2018 17:15,147,139,117,107,510,4,50
1516,3/30/2018 17:20,132,129,104,94,459,4,50
1517,3/30/2018 17:25,147,133,114,104,498,4,50
1518,3/30/2018 17:30,151,133,108,98,490,4,50
1519,3/30/2018 17:35,138,118,102,92,450,4,50
1520,3/30/2018 17:40,144,140,96,86,466,4,50
1521,3/30/2018 17:45,141,144,105,95,485,4,50
1522,3/30/2018 17:50,140,135,110,100,485,4,50
1523,3/30/2018 17:55,135,136,116,106,493,4,50
1524,3/30/2018 18:00,144,128,102,93,467,4,50
1525,3/30/2018 18:05,127,131,110,100,468,4,50
1526,3/30/2018 18:10,122,124,107,98,451,4,50
1527,3/30/2018 18:15,123,133,110,100,466,4,50
1528,3/30/2018 18:20,136,136,91,82,445,4,50
1529,3/30/2018 18:25,128,124,101,91,444,4,50
1530,3/30/2018 18:30,122,131,102,92,447,4,50
1531,3/30/2018 18:35,120,110,97,88,415,4,50
1532,3/30/2018 18:40,133,123,87,78,421,4,50
1533,3/30/2018 18:45,109,116,99,90,414,4,50
1534,3/30/2018 18:50,119,103,92,83,397,4,50
1535,3/30/2018 18:55,96,112,82,73,363,4,50
1536,3/30/2018 19:00,93,100,84,75,352,4,50
1537,3/30/2018 19:05,91,90,83,74,338,4,50
1538,3/30/2018 19:10,100,95,81,72,348,4,50
1539,3/30/2018 19:15,95,110,80,71,356,4,50
1540,3/30/2018 19:20,102,111,77,68,358,4,50
1541,3/30/2018 19:25,94,120,95,86,395,4,50
1542,3/30/2018 19:30,101,103,84,76,364,4,50
1543,3/30/2018 19:35,91,109,93,84,377,4,50
1544,3/30/2018 19:40,96,94,85,77,352,4,50
1545,3/30/2018 19:45,81,93,81,72,327,4,50
1546,3/30/2018 19:50,85,95,65,57,302,4,50
1547,3/30/2018 19:55,80,76,73,65,294,4,50
1548,3/30/2018 20:00,75,92,76,68,311,4,50
1549,3/30/2018 20:05,78,100,79,70,327,4,50
1550,3/30/2018 20:10,75,85,79,70,309,4,50
1551,3/30/2018 20:15,79,92,75,67,313,4,50
1552,3/30/2018 20:20,82,96,80,72,330,4,50
1553,3/30/2018 20:25,97,100,80,72,349,4,50
1554,3/30/2018 20:30,68,91,80,72,311,4,50
1555,3/30/2018 20:35,78,81,71,63,293,4,50
1556,3/30/2018 20:40,67,77,61,53,258,4,50
1557,3/30/2018 20:45,72,90,67,60,289,4,50
1558,3/30/2018 20:50,78,102,82,74,336,4,50
1559,3/30/2018 20:55,80,83,76,67,306,4,50
1560,3/30/2018 21:00,71,89,68,60,288,4,50
1561,3/30/2018 21:05,63,83,64,57,267,4,50
1562,3/30/2018 21:10,55,80,66,58,259,4,50
1563,3/30/2018 21:15,76,76,64,57,273,4,50
1564,3/30/2018 21:20,76,78,71,63,288,4,50
1565,3/30/2018 21:25,65,67,64,56,252,4,50
1566,3/30/2018 21:30,69,80,69,62,280,4,50
1567,3/30/2018 21:35,74,91,73,65,303,4,50
1568,3/30/2018 21:40,64,59,61,53,237,4,50
1569,3/30/2018 21:45,68,83,69,61,281,4,50
1570,3/30/2018 21:50,72,60,60,52,244,4,50
1571,3/30/2018 21:55,63,80,62,55,260,4,50
1572,3/30/2018 22:00,74,71,60,53,258,4,50
1573,3/30/2018 22:05,56,84,62,54,256,4,50
1574,3/30/2018 22:10,62,75,61,53,251,4,50
1575,3/30/2018 22:15,70,68,64,57,259,4,50
1576,3/30/2018 22:20,75,85,62,54,276,4,50
1577,3/30/2018 22:25,83,93,70,62,308,4,50
1578,3/30/2018 22:30,77,78,67,59,281,4,50
1579,3/30/2018 22:35,64,62,59,51,236,4,50
1580,3/30/2018 22:40,56,66,55,48,225,4,50
1581,3/30/2018 22:45,55,81,62,54,252,4,50
1582,3/30/2018 22:50,63,70,62,55,250,4,50
1583,3/30/2018 22:55,69,71,63,55,258,4,50
1584,3/30/2018 23:00,52,68,54,47,221,4,50
1585,3/30/2018 23:05,44,57,59,52,212,4,50
1586,3/30/2018 23:10,39,63,59,51,212,4,50
1587,3/30/2018 23:15,53,72,61,53,239,4,50
1588,3/30/2018 23:20,62,71,55,48,236,4,50
1589,3/30/2018 23:25,51,61,57,49,218,4,50
1590,3/30/2018 23:30,42,63,56,48,209,4,50
1591,3/30/2018 23:35,53,51,53,46,203,4,50
1592,3/30/2018 23:40,40,63,54,47,204,4,50
1593,3/30/2018 23:45,33,49,54,46,182,4,50
1594,3/30/2018 23:50,36,66,56,49,207,4,50
1595,3/30/2018 23:55,50,68,50,43,211,4,50
1596,3/31/2018 0:00,47,84,64,56,251,4,50
1597,3/31/2018 0:05,51,78,57,50,236,4,50
1598,3/31/2018 0:10,31,38,45,39,153,4,50
1599,3/31/2018 0:15,21,33,40,34,128,4,50
1600,3/31/2018 0:20,25,42,45,38,150,4,50
1601,3/31/2018 0:25,27,38,40,33,138,4,50
1602,3/31/2018 0:30,21,36,36,30,123,4,50
1603,3/31/2018 0:35,19,34,42,35,130,4,50
1604,3/31/2018 0:40,24,34,41,34,133,4,50
1605,3/31/2018 0:45,20,46,37,31,134,4,50
1606,3/31/2018 0:50,22,44,43,36,145,4,50
1607,3/31/2018 0:55,30,27,38,31,126,4,50
1608,3/31/2018 1:00,22,28,29,23,102,4,50
1609,3/31/2018 1:05,22,33,27,22,104,4,50
1610,3/31/2018 1:10,12,29,28,23,92,4,50
1611,3/31/2018 1:15,24,29,27,21,101,4,50
1612,3/31/2018 1:20,14,24,28,22,88,4,50
1613,3/31/2018 1:25,22,31,24,18,95,4,50
1614,3/31/2018 1:30,16,28,29,24,97,4,50
1615,3/31/2018 1:35,20,22,33,26,101,4,50
1616,3/31/2018 1:40,23,33,25,20,101,4,50
1617,3/31/2018 1:45,9,27,21,16,73,4,50
1618,3/31/2018 1:50,20,28,21,16,85,4,50
1619,3/31/2018 1:55,11,20,26,21,78,4,50
1620,3/31/2018 2:00,14,24,22,16,76,4,50
1621,3/31/2018 2:05,16,21,24,19,80,4,50
1622,3/31/2018 2:10,18,34,22,16,90,4,50
1623,3/31/2018 2:15,18,25,23,17,83,4,50
1624,3/31/2018 2:20,7,27,21,16,71,4,50
1625,3/31/2018 2:25,16,18,24,18,76,4,50
1626,3/31/2018 2:30,21,23,21,16,81,4,50
1627,3/31/2018 2:35,17,23,23,18,81,4,50
1628,3/31/2018 2:40,17,18,21,16,72,4,50
1629,3/31/2018 2:45,4,12,22,17,55,4,50
1630,3/31/2018 2:50,10,13,19,14,56,4,50
1631,3/31/2018 2:55,11,16,15,10,52,4,50
1632,3/31/2018 3:00,13,23,23,18,77,4,50
1633,3/31/2018 3:05,8,15,15,10,48,4,50
1634,3/31/2018 3:10,10,10,17,11,48,4,50
1635,3/31/2018 3:15,12,17,20,15,64,4,50
1636,3/31/2018 3:20,11,12,19,14,56,4,50
1637,3/31/2018 3:25,5,17,20,15,57,4,50
1638,3/31/2018 3:30,9,15,20,15,59,4,50
1639,3/31/2018 3:35,11,14,23,17,65,4,50
1640,3/31/2018 3:40,6,16,20,15,57,4,50
1641,3/31/2018 3:45,9,13,15,9,46,4,50
1642,3/31/2018 3:50,13,15,22,17,67,4,50
1643,3/31/2018 3:55,10,18,20,15,63,4,50
1644,3/31/2018 4:00,11,18,20,15,64,4,50
1645,3/31/2018 4:05,10,16,19,14,59,4,50
1646,3/31/2018 4:10,17,21,19,14,71,4,50
1647,3/31/2018 4:15,10,18,18,13,59,4,50
1648,3/31/2018 4:20,17,17,15,10,59,4,50
1649,3/31/2018 4:25,9,21,20,14,64,4,50
1650,3/31/2018 4:30,9,23,19,14,65,4,50
1651,3/31/2018 4:35,16,27,22,17,82,4,50
1652,3/31/2018 4:40,22,26,22,17,87,4,50
1653,3/31/2018 4:45,16,26,22,17,81,4,50
1654,3/31/2018 4:50,22,22,21,16,81,4,50
1655,3/31/2018 4:55,21,22,25,19,87,4,50
1656,3/31/2018 5:00,14,30,22,16,82,4,50
1657,3/31/2018 5:05,24,39,25,20,108,4,50
1658,3/31/2018 5:10,26,36,29,23,114,4,50
1659,3/31/2018 5:15,21,32,28,23,104,4,50
1660,3/31/2018 5:20,27,31,27,21,106,4,50
1661,3/31/2018 5:25,28,44,34,27,133,4,50
1662,3/31/2018 5:30,29,41,32,27,129,4,50
1663,3/31/2018 5:35,30,43,36,30,139,4,50
1664,3/31/2018 5:40,34,48,48,41,171,4,50
1665,3/31/2018 5:45,23,44,39,33,139,4,50
1666,3/31/2018 5:50,32,37,38,32,139,4,50
1667,3/31/2018 5:55,31,45,35,29,140,4,50
1668,3/31/2018 6:00,28,39,40,34,141,4,50
1669,3/31/2018 6:05,27,40,37,31,135,4,50
1670,3/31/2018 6:10,28,36,40,34,138,4,50
1671,3/31/2018 6:15,37,42,43,37,159,4,50
1672,3/31/2018 6:20,43,53,47,40,183,4,50
1673,3/31/2018 6:25,43,49,48,42,182,4,50
1674,3/31/2018 6:30,49,60,47,40,196,4,50
1675,3/31/2018 6:35,42,66,55,48,211,4,50
1676,3/31/2018 6:40,62,65,61,53,241,4,50
1677,3/31/2018 6:45,54,61,56,49,220,4,50
1678,3/31/2018 6:50,66,61,52,45,224,4,50
1679,3/31/2018 6:55,57,59,61,53,230,4,50
1680,3/31/2018 7:00,57,64,58,51,230,4,50
1681,3/31/2018 7:05,54,65,43,37,199,4,50
1682,3/31/2018 7:10,66,70,53,47,236,4,50
1683,3/31/2018 7:15,59,47,52,45,203,4,50
1684,3/31/2018 7:20,71,64,64,57,256,4,50
1685,3/31/2018 7:25,80,83,61,54,278,4,50
1686,3/31/2018 7:30,69,82,77,69,297,4,50
1687,3/31/2018 7:35,84,90,69,62,305,4,50
1688,3/31/2018 7:40,90,92,82,73,337,4,50
1689,3/31/2018 7:45,84,87,80,72,323,4,50
1690,3/31/2018 7:50,80,90,75,66,311,4,50
1691,3/31/2018 7:55,82,81,70,62,295,4,50
1692,3/31/2018 8:00,64,84,69,62,279,4,50
1693,3/31/2018 8:05,85,79,72,64,300,4,50
1694,3/31/2018 8:10,85,97,69,61,312,4,50
1695,3/31/2018 8:15,88,100,70,62,320,4,50
1696,3/31/2018 8:20,80,83,74,66,303,4,50
1697,3/31/2018 8:25,84,91,79,70,324,4,50
1698,3/31/2018 8:30,121,108,89,80,398,4,50
1699,3/31/2018 8:35,92,103,80,71,346,4,50
1700,3/31/2018 8:40,109,114,86,77,386,4,50
1701,3/31/2018 8:45,97,96,86,77,356,4,50
1702,3/31/2018 8:50,94,100,84,75,353,4,50
1703,3/31/2018 8:55,106,98,80,72,356,4,50
1704,3/31/2018 9:00,94,115,82,73,364,4,50
1705,3/31/2018 9:05,89,88,77,68,322,4,50
1706,3/31/2018 9:10,90,104,81,73,348,4,50
1707,3/31/2018 9:15,103,122,89,80,394,4,50
1708,3/31/2018 9:20,121,112,82,73,388,4,50
1709,3/31/2018 9:25,109,103,85,76,373,4,50
1710,3/31/2018 9:30,104,113,87,78,382,4,50
1711,3/31/2018 9:35,122,133,88,79,422,4,50
1712,3/31/2018 9:40,120,129,86,78,413,4,50
1713,3/31/2018 9:45,117,122,104,94,437,4,50
1714,3/31/2018 9:50,128,130,96,86,440,4,50
1715,3/31/2018 9:55,118,115,85,76,394,4,50
1716,3/31/2018 10:00,118,123,98,88,427,4,50
1717,3/31/2018 10:05,122,121,88,79,410,4,50
1718,3/31/2018 10:10,137,125,98,89,449,4,50
1719,3/31/2018 10:15,108,110,85,76,379,4,50
1720,3/31/2018 10:20,122,135,97,88,442,4,50
1721,3/31/2018 10:25,123,136,106,96,461,4,50
1722,3/31/2018 10:30,134,125,94,85,438,4,50
1723,3/31/2018 10:35,135,134,101,92,462,4,50
1724,3/31/2018 10:40,134,126,90,81,431,4,50
1725,3/31/2018 10:45,148,130,101,92,471,4,50
1726,3/31/2018 10:50,126,109,94,85,414,4,50
1727,3/31/2018 10:55,108,118,87,78,391,4,50
1728,3/31/2018 11:00,114,128,94,85,421,4,50
1729,3/31/2018 11:05,122,135,93,84,434,4,50
1730,3/31/2018 11:10,118,121,101,91,431,4,50
1731,3/31/2018 11:15,109,109,89,80,387,4,50
1732,3/31/2018 11:20,124,121,105,95,445,4,50
1733,3/31/2018 11:25,125,116,96,86,423,4,50
1734,3/31/2018 11:30,131,138,104,94,467,4,50
1735,3/31/2018 11:35,128,112,92,83,415,4,50
1736,3/31/2018 11:40,143,121,102,93,459,4,50
1737,3/31/2018 11:45,99,121,85,77,382,4,50
1738,3/31/2018 11:50,107,129,98,89,423,4,50
1739,3/31/2018 11:55,104,99,88,79,370,4,50
